cust_id,year,emp_length_int,home_ownership,home_ownership_cat,income_category,income_cat,loan_amount,loan_term,loan_term_cat,purpose,purpose_cat,interest_payments,interest_payment_cat,loan_condition,loan_condition_cat,interest_rate,grade,grade_cat,dti,total_pymnt,total_rec_prncp,recoveries,installment,Account No,Transation_Date,TRANSACTION DETAILS, WITHDRAWAL AMT , DEPOSIT AMT ,BALANCE AMT,Surname,CreditScore,Geography,EstimatedSalary,Taxrating_2019,Taxrating_2018,Taxrating_2017
1,2011,10,RENT,1,Low,1,5000, 36 months,1,credit_card,1,Low,1,Good Loan,0,10.65,B,2,27.65,5861.071414,5000,0,162.87,409000000000,29-Jun-17,TRF FROM  Indiaforensic SERVICES,,1000000.00,1000000.00,Hargrave,619,France,101348.88,1,1,0
2,2011,0.5,RENT,1,Low,1,2500, 60 months,2,car,2,High,2,Bad Loan,1,15.27,C,3,1,1008.71,456.46,117.08,59.83,409000000001,5-Jul-17,TRF FROM  Indiaforensic SERVICES,,1000000.00,2000000.00,Hill,608,Spain,112542.58,1,1,0
3,2011,10,RENT,1,Low,1,2400, 36 months,1,small_business,3,High,2,Good Loan,0,15.96,C,3,8.72,3003.653644,2400,0,84.33,409000000002,18-Jul-17,FDRL/INTERNAL FUND TRANSFE,,500000.00,2500000.00,Onio,502,France,113931.57,1,1,0
4,2011,10,RENT,1,Low,1,10000, 36 months,1,other,4,High,2,Good Loan,0,13.49,C,3,20,12226.30221,10000,0,339.31,409000000003,1-Aug-17,TRF FRM  Indiaforensic SERVICES,,3000000.00,5500000.00,Boni,699,France,93826.63,1,1,0
5,2011,1,RENT,1,Low,1,3000, 60 months,2,other,4,Low,1,Good Loan,0,12.69,B,2,17.94,3242.17,2233.1,0,67.79,409000000004,16-Aug-17,FDRL/INTERNAL FUND TRANSFE,,500000.00,6000000.00,Mitchell,850,Spain,79084.10,1,1,0
6,2011,3,RENT,1,Low,1,5000, 36 months,1,wedding,5,Low,1,Good Loan,0,7.9,A,1,11.2,5631.377753,5000,0,156.46,409000000005,16-Aug-17,FDRL/INTERNAL FUND TRANSFE,,500000.00,6500000.00,Chu,645,Spain,149756.71,1,1,0
7,2011,8,RENT,1,Low,1,7000, 60 months,2,debt_consolidation,6,High,2,Good Loan,0,15.96,C,3,23.51,8136.84,5110.85,0,170.08,409000000006,16-Aug-17,FDRL/INTERNAL FUND TRANSFE,,500000.00,7000000.00,Bartlett,822,France,10062.80,1,1,0
8,2011,9,RENT,1,Low,1,3000, 36 months,1,car,2,High,2,Good Loan,0,18.64,E,5,5.35,3938.144334,3000,0,109.43,409000000007,16-Aug-17,FDRL/INTERNAL FUND TRANSFE,,500000.00,7500000.00,Obinna,376,Germany,119346.88,1,1,0
9,2011,4,OWN,2,Low,1,5600, 60 months,2,small_business,3,High,2,Bad Loan,1,21.28,F,6,5.55,646.02,162.02,189.06,152.39,409000000008,16-Aug-17,FDRL/INTERNAL FUND TRANSFE,,500000.00,8000000.00,He,501,France,74940.50,1,1,0
10,2011,0.5,RENT,1,Low,1,5375, 60 months,2,other,4,Low,1,Bad Loan,1,12.69,B,2,18.08,1476.19,673.48,269.29,121.45,409000000009,16-Aug-17,FDRL/INTERNAL FUND TRANSFE,,500000.00,8500000.00,H?,684,France,71725.73,1,1,0
11,2011,5,OWN,2,Low,1,6500, 60 months,2,debt_consolidation,6,High,2,Good Loan,0,14.65,C,3,16.12,7677.52,6500,0,153.45,409000000010,16-Aug-17,INDO GIBL Indiaforensic STL01071,"133,900.00",,8366100.00,Bearce,528,France,80181.12,1,1,1
12,2011,10,OWN,2,Low,1,12000, 36 months,1,debt_consolidation,6,Low,1,Good Loan,0,12.69,B,2,10.78,13943.08,12000,0,402.54,409000000011,16-Aug-17,INDO GIBL Indiaforensic STL02071,"18,000.00",,8348100.00,Andrews,497,Spain,76390.01,1,1,1
13,2011,0.5,RENT,1,Low,1,9000, 36 months,1,debt_consolidation,6,High,2,Bad Loan,1,13.49,C,3,10.08,2270.7,1256.14,444.3,305.38,409000000012,16-Aug-17,INDO GIBL Indiaforensic STL03071,"5,000.00",,8343100.00,Kay,476,France,26260.98,1,1,1
14,2011,3,RENT,1,Low,1,3000, 36 months,1,credit_card,1,Low,1,Good Loan,0,9.91,B,2,12.56,3478.981915,3000,0,96.68,409000000013,16-Aug-17,INDO GIBL Indiaforensic STL04071,"195,800.00",,8147300.00,Chin,549,France,190857.79,1,1,1
15,2011,3,RENT,1,Low,1,10000, 36 months,1,other,4,Low,1,Bad Loan,1,10.65,B,2,7.06,7471.99,5433.47,645.1,325.74,409000000014,16-Aug-17,INDO GIBL Indiaforensic STL05071,"81,600.00",,8065700.00,Scott,635,Spain,65951.65,1,1,1
16,2011,0.5,RENT,1,Low,1,1000, 36 months,1,debt_consolidation,6,High,2,Good Loan,0,16.29,D,4,20.31,1270.171106,1000,0,35.31,409000000015,16-Aug-17,INDO GIBL Indiaforensic STL06071,"41,800.00",,8023900.00,Goforth,616,Germany,64327.26,1,1,1
17,2011,4,RENT,1,Low,1,10000, 36 months,1,home_improvement,7,High,2,Good Loan,0,15.27,C,3,18.6,12519.26045,10000,0,347.98,409000000016,16-Aug-17,INDO GIBL Indiaforensic STL07071,"98,500.00",,7925400.00,Romeo,653,Germany,5097.67,1,1,1
18,2011,10,MORTGAGE,3,Medium,2,3600, 36 months,1,major_purchase,8,Low,1,Good Loan,0,6.03,A,1,10.52,3785.02,3600,0,109.57,409000000017,16-Aug-17,INDO GIBL Indiaforensic STL10071,"143,800.00",,7781600.00,Henderson,549,Spain,14406.41,1,1,1
19,2011,1,MORTGAGE,3,Low,1,6000, 36 months,1,medical,9,Low,1,Good Loan,0,11.71,B,2,18.44,7164.499852,6000,0,198.46,409000000018,16-Aug-17,INDO GIBL Indiaforensic STL11071,"331,650.00",,7449950.00,Muldrow,587,Spain,158684.81,1,1,1
20,2011,6,RENT,1,Low,1,9200, 36 months,1,debt_consolidation,6,Low,1,Good Loan,0,6.03,A,1,9.86,9459.96,9200,0,280.01,409000000019,16-Aug-17,INDO GIBL Indiaforensic STL12071,"129,000.00",,7320950.00,Hao,726,France,54724.03,1,1,1
21,2011,3,RENT,1,Low,1,20250, 60 months,2,debt_consolidation,6,High,2,Good Loan,0,15.27,C,3,26.53,27663.04267,20250,0,484.63,409000000020,16-Aug-17,INDO GIBL Indiaforensic STL13071,"230,013.00",,7090937.00,McDonald,732,France,170886.17,1,1,1
22,2011,10,RENT,1,Medium,2,21000, 36 months,1,debt_consolidation,6,Low,1,Bad Loan,1,12.42,B,2,13.22,14025.4,10694.96,0,701.73,409000000021,16-Aug-17,INDO GIBL Indiaforensic STL14071,"367,900.00",,6723037.00,Dellucci,636,Spain,138555.46,1,1,1
23,2011,10,OWN,2,Low,1,10000, 36 months,1,credit_card,1,Low,1,Good Loan,0,11.71,B,2,11.18,11902.56157,10000,0,330.76,409000000022,16-Aug-17,INDO GIBL Indiaforensic STL15071,"108,000.00",,6615037.00,Gerasimov,510,Spain,118913.53,1,1,1
24,2011,5,RENT,1,Low,1,10000, 36 months,1,debt_consolidation,6,Low,1,Good Loan,0,11.71,B,2,16.01,11536.31,10000,0,330.76,409000000023,16-Aug-17,INDO GIBL Indiaforensic STL16071,"64,800.00",,6550237.00,Mosman,669,France,8487.75,1,1,1
25,2011,1,RENT,1,Low,1,6000, 36 months,1,major_purchase,8,Low,1,Bad Loan,1,11.71,B,2,2.4,2050.14,1305.58,269.31,198.46,409000000024,16-Aug-17,INDO GIBL Indiaforensic STL17071,"141,000.00",,6409237.00,Yen,846,France,187616.16,1,1,1
26,2011,2,MORTGAGE,3,Low,1,15000, 36 months,1,credit_card,1,Low,1,Good Loan,0,9.91,B,2,29.44,15823.48,15000,0,483.38,409000000025,16-Aug-17,INDO GIBL Indiaforensic STL18071,"61,750.00",,6347487.00,Maclean,577,France,124508.29,1,1,1
27,2011,9,RENT,1,Low,1,15000, 36 months,1,debt_consolidation,6,High,2,Bad Loan,1,14.27,C,3,15.22,0,0,0,514.64,409000000026,16-Aug-17,INDO GIBL Indiaforensic STL19071,"67,920.00",,6279567.00,Young,756,Germany,170041.95,1,1,1
28,2011,2,RENT,1,Low,1,5000, 60 months,2,other,4,High,2,Bad Loan,1,16.77,D,4,13.97,1609.12,629.05,260.96,123.65,409000000027,16-Aug-17,INDO GIBL Indiaforensic STL20071,"78,100.00",,6201467.00,Nebechi,571,France,38433.35,1,1,1
29,2011,10,MORTGAGE,3,Medium,2,4000, 36 months,1,debt_consolidation,6,Low,1,Good Loan,0,11.71,B,2,5.63,4484.79,4000,0,132.31,409000000028,16-Aug-17,INDO GIBL Indiaforensic STL21071,"35,650.00",,6165817.00,McWilliams,574,Germany,100187.43,1,1,1
30,2011,0.5,RENT,1,Low,1,8500, 36 months,1,credit_card,1,Low,1,Good Loan,0,11.71,B,2,12.19,10122.20861,8500,0,281.15,409000000029,16-Aug-17,INDO GIBL Indiaforensic STL22071,"206,000.00",,5959817.00,Lucciano,411,France,53483.21,1,1,1
31,2011,7,MORTGAGE,3,Low,1,4375, 36 months,1,debt_consolidation,6,Low,1,Good Loan,0,7.51,A,1,20.34,4898.543558,4375,0,136.11,409000000030,16-Aug-17,INDO GIBL Indiaforensic STL24071,"35,300.00",,5924517.00,Azikiwe,591,Spain,140469.38,1,1,1
32,2011,5,MORTGAGE,3,Low,1,31825, 36 months,1,debt_consolidation,6,Low,1,Good Loan,0,7.9,A,1,14.03,34886.08,31825,0,995.82,409000000031,16-Aug-17,INDO GIBL Indiaforensic STL25071,"49,800.00",,5874717.00,Odinakachukwu,533,France,156731.91,1,1,1
33,2011,2,RENT,1,Low,1,10000, 60 months,2,debt_consolidation,6,High,2,Good Loan,0,15.96,C,3,22.83,11622.36,7304.67,0,242.97,409000000032,16-Aug-17,INDO GIBL Indiaforensic STL26071,"53,000.00",,5821717.00,Sanderson,553,Germany,81898.81,1,1,1
34,2011,2,RENT,1,Low,1,5000, 36 months,1,debt_consolidation,6,Low,1,Good Loan,0,8.9,A,1,11.93,5714.592129,5000,0,158.77,409000000033,16-Aug-17,INDO GIBL Indiaforensic STL27071,"91,300.00",,5730417.00,Maggard,520,Spain,34410.55,1,1,1
35,2011,7,RENT,1,Low,1,7000, 36 months,1,credit_card,1,High,2,Good Loan,0,15.96,C,3,6.35,8848.94043,7000,0,245.97,409000000034,16-Aug-17,INDO GIBL Indiaforensic STL28071,"57,499.00",,5672918.00,Clements,722,Spain,142033.07,1,1,1
36,2011,10,RENT,1,Low,1,12400, 36 months,1,credit_card,1,Low,1,Good Loan,0,10.65,B,2,11.8,14537.45953,12400,0,403.91,409000000035,16-Aug-17,INDO GIBL Indiaforensic STL30071,"20,000.00",,5652918.00,Lombardo,475,France,27822.99,1,1,1
37,2011,2,RENT,1,Low,1,10800, 36 months,1,moving,10,Low,1,Good Loan,0,9.91,B,2,5.5,12157.2,10800,0,348.03,409000000036,16-Aug-17,INDO GIBL Indiaforensic STL31071,"19,400.00",,5633518.00,Watson,490,Spain,114066.77,1,1,1
38,2011,1,RENT,1,Low,1,15000, 36 months,1,debt_consolidation,6,Low,1,Good Loan,0,7.9,A,1,8.48,16662.6,15000,0,469.36,409000000037,6-Sep-17,INDO GIBL Indiaforensic STL01081,"40,500.00",,5593018.00,Lorenzo,804,Spain,98453.45,1,1,1
39,2011,1,RENT,1,Low,1,6000, 36 months,1,debt_consolidation,6,Low,1,Good Loan,0,12.42,B,2,10.62,7125.283165,6000,0,200.5,409000000038,6-Sep-17,INDO GIBL Indiaforensic STL02081,"242,300.00",,5350718.00,Armstrong,850,France,40812.90,1,1,1
40,2011,1,RENT,1,Low,1,12500, 60 months,2,debt_consolidation,6,Low,1,Good Loan,0,12.69,B,2,16.04,13506.54,9306.87,0,282.44,409000000039,6-Sep-17,INDO GIBL Indiaforensic STL03081,"90,100.00",,5260618.00,Cameron,582,Germany,178074.04,1,1,1
41,2011,4,RENT,1,Low,1,9600, 36 months,1,other,4,Low,1,Good Loan,0,7.51,A,1,6.63,10749.76265,9600,0,298.67,409000000040,6-Sep-17,INDO GIBL Indiaforensic STL04081,"113,250.00",,5147368.00,Hsiao,472,Spain,70154.22,1,1,1
42,2011,10,RENT,1,Low,1,12000, 36 months,1,debt_consolidation,6,Low,1,Good Loan,0,7.9,A,1,16.7,13516.38296,12000,0,375.49,409000000041,6-Sep-17,INDO GIBL Indiaforensic STL05081,"12,500.00",,5134868.00,Clarke,465,France,181297.65,1,1,1
43,2011,9,MORTGAGE,3,Low,1,3000, 36 months,1,other,4,High,2,Good Loan,0,18.25,D,4,17.39,3915.027595,3000,0,108.84,409000000042,6-Sep-17,INDO GIBL Indiaforensic STL06081,"40,000.00",,5094868.00,Osborne,556,France,94153.83,1,1,1
44,2011,10,RENT,1,Low,1,4400, 36 months,1,debt_consolidation,6,High,2,Good Loan,0,16.77,D,4,20.01,5626.892655,4400,0,156.37,409000000043,6-Sep-17,INDO GIBL Indiaforensic STL07081,"206,900.00",,4887968.00,Lavine,834,France,194365.76,1,1,1
45,2011,10,MORTGAGE,3,Low,1,6000, 36 months,1,debt_consolidation,6,Low,1,Good Loan,0,6.03,A,1,5.34,6065.86,6000,0,182.62,409000000044,6-Sep-17,INDO GIBL Indiaforensic STL08081,"276,000.00",,4611968.00,Bianchi,660,Spain,158338.39,1,1,1
46,2011,6,RENT,1,Low,1,14000, 36 months,1,small_business,3,Low,1,Good Loan,0,9.91,B,2,10,16239.91413,14000,0,451.15,409000000045,6-Sep-17,INDO GIBL Indiaforensic STL09081,"171,000.00",,4440968.00,Tyler,776,Germany,126517.46,1,1,1
47,2011,10,MORTGAGE,3,Low,1,5000, 36 months,1,debt_consolidation,6,Low,1,Bad Loan,1,8.9,A,1,16.33,5021.37,4217.38,107,158.77,409000000046,6-Sep-17,INDO GIBL Indiaforensic STL10081,"40,100.00",,4400868.00,Martin,829,Germany,119708.21,1,1,1
48,2011,6,RENT,1,Low,1,10000, 36 months,1,other,4,Low,1,Good Loan,0,10.65,B,2,11.47,11724.56774,10000,0,325.74,409000000047,6-Sep-17,INDO GIBL Indiaforensic STL11081,"189,800.00",,4211068.00,Okagbue,637,Germany,117622.80,1,1,1
49,2011,10,RENT,1,Low,1,10000, 36 months,1,credit_card,1,Low,1,Good Loan,0,6.03,A,1,12.74,10282.67,10000,0,304.36,409000000048,6-Sep-17,INDO GIBL Indiaforensic STL12081,"55,800.00",,4155268.00,Yin,550,Germany,90878.13,1,1,1
50,2011,5,RENT,1,Low,1,11000, 36 months,1,debt_consolidation,6,Low,1,Good Loan,0,6.62,A,1,10.85,12157.38005,11000,0,337.75,409000000049,6-Sep-17,INDO GIBL Indiaforensic STL13081,"95,400.00",,4059868.00,Buccho,776,Germany,194099.12,1,1,1
51,2011,8,MORTGAGE,3,Low,1,15000, 36 months,1,debt_consolidation,6,Low,1,Bad Loan,1,9.91,B,2,9.12,16177.77,13556.45,222.81,483.38,409000000050,6-Sep-17,INDO GIBL Indiaforensic STL14081,"271,323.00",,3788545.00,Chidiebele,698,Germany,198059.16,1,1,1
52,2011,9,RENT,1,Medium,2,25600, 36 months,1,credit_card,1,Low,1,Good Loan,0,9.91,B,2,15.71,29695.62268,25600,0,824.96,409000000051,6-Sep-17,INDO GIBL Indiaforensic STL16081,"200,600.00",,3587945.00,Trevisani,585,Germany,86424.57,1,1,1
53,2011,0.5,RENT,1,Low,1,7000, 36 months,1,debt_consolidation,6,Low,1,Good Loan,0,10.65,B,2,7.38,8205.473816,7000,0,228.02,409000000052,6-Sep-17,INDO GIBL Indiaforensic STL17081,"176,900.00",,3411045.00,O'Brien,788,France,116978.19,1,1,1
54,2011,4,RENT,1,Low,1,12000, 36 months,1,car,2,High,2,Bad Loan,1,15.96,C,3,20.88,3521.95,1903.66,578.94,421.65,409000000053,6-Sep-17,INDO GIBL Indiaforensic STL18081,"150,050.00",,3260995.00,Parkhill,655,Germany,164040.94,1,1,1
55,2011,1,RENT,1,Low,1,12000, 36 months,1,credit_card,1,Low,1,Good Loan,0,9.91,B,2,8.11,13748.21311,12000,0,386.7,409000000054,6-Sep-17,INDO GIBL Indiaforensic STL19081,"82,500.00",,3178495.00,Yoo,601,Germany,40014.76,1,1,1
56,2011,7,RENT,1,Low,1,21000, 60 months,2,debt_consolidation,6,High,2,Bad Loan,1,19.91,E,5,21.58,18319.14,8990.81,0,555.33,409000000055,6-Sep-17,INDO GIBL Indiaforensic STL20081,"14,800.00",,3163695.00,Phillipps,619,France,113410.49,1,1,1
57,2011,7,RENT,1,Low,1,16000, 60 months,2,credit_card,1,High,2,Good Loan,0,19.91,E,5,20.52,20876.1,16000,0,423.11,409000000056,6-Sep-17,INDO GIBL Indiaforensic STL21081,"150,600.00",,3013095.00,Tsao,656,France,87107.57,1,1,1
58,2011,0.5,OWN,2,Low,1,10000, 36 months,1,debt_consolidation,6,Low,1,Good Loan,0,12.42,B,2,18.58,11474.76,10000,0,334.16,409000000057,6-Sep-17,INDO GIBL Indiaforensic STL22081,"203,325.00",,2809770.00,Endrizzi,725,Germany,45613.75,1,1,1
59,2011,2,RENT,1,Low,1,10000, 36 months,1,credit_card,1,Low,1,Good Loan,0,10.65,B,2,19.14,10575.94,10000,0,325.74,409000000058,6-Sep-17,INDO GIBL Indiaforensic STL23081,"123,900.00",,2685870.00,T'ien,511,Spain,1643.11,1,1,1
60,2011,1,MORTGAGE,3,Low,1,7100, 36 months,1,debt_consolidation,6,High,2,Good Loan,0,16.77,D,4,24,9079.334843,7100,0,252.33,409000000059,6-Sep-17,INDO GIBL Indiaforensic STL24081,"33,863.00",,2652007.00,Velazquez,614,France,46775.28,1,1,1
61,2011,0.5,MORTGAGE,3,Low,1,13000, 60 months,2,debt_consolidation,6,Low,1,Good Loan,0,12.69,B,2,13.72,17402.23999,13000,0,293.74,409000000060,6-Sep-17,INDO GIBL Indiaforensic STL25081,"32,000.00",,2620007.00,Hunter,742,Germany,84509.57,1,1,1
62,2011,6,RENT,1,Low,1,17500, 60 months,2,small_business,3,High,2,Good Loan,0,17.27,D,4,19.47,10713.52,6487.75,0,223.74,409000000061,6-Sep-17,INDO GIBL Indiaforensic STL26081,"8,299.00",,2611708.00,Clark,687,Germany,126494.82,1,1,1
63,2011,0.5,RENT,1,Low,1,17675, 60 months,2,debt_consolidation,6,High,2,Good Loan,0,14.65,C,3,16.46,21323.43,17675,0,417.25,409000000062,6-Sep-17,INDO GIBL Indiaforensic STL28081,"52,219.00",,2559489.00,Jeffrey,555,Spain,178798.13,1,1,1
64,2011,0.5,RENT,1,Low,1,8000, 36 months,1,debt_consolidation,6,High,2,Good Loan,0,16.77,D,4,21.64,10267.26214,8000,0,284.31,409000000063,6-Sep-17,INDO GIBL Indiaforensic STL29081,"96,450.00",,2463039.00,Pirozzi,684,Spain,99398.36,1,1,1
65,2011,10,RENT,1,Low,1,10000, 60 months,2,debt_consolidation,6,Low,1,Bad Loan,1,10.65,B,2,21.73,8772.91,5495.38,847.3,215.69,409000000064,6-Sep-17,INDO GIBL Indiaforensic STL30081,"139,863.00",,2323176.00,Jackson,603,Germany,92840.67,1,1,1
66,2011,7,MORTGAGE,3,Low,1,3500, 36 months,1,debt_consolidation,6,Low,1,Good Loan,0,10.65,B,2,5.39,4103.168128,3500,0,114.01,409000000065,6-Sep-17,INDO GIBL Indiaforensic STL31081,"52,723.00",,2270453.00,Hammond,751,Germany,27758.36,1,1,1
67,2011,5,RENT,1,Low,1,12500, 60 months,2,debt_consolidation,6,High,2,Bad Loan,1,17.27,D,4,13.16,5577.75,2812.82,22.5,223.11,409000000066,25-Sep-17,INDO GIBL Indiaforensic STL01091,"77,251.00",,2193202.00,Brownless,581,Germany,110431.51,1,1,1
68,2011,4,RENT,1,Low,1,16425, 36 months,1,debt_consolidation,6,High,2,Good Loan,0,14.27,C,3,22.71,18172.71,16425,0,563.53,409000000067,25-Sep-17,INDO GIBL Indiaforensic STL02091,"20,000.00",,2173202.00,Chibugo,735,Germany,196673.28,1,1,1
69,2011,4,RENT,1,Low,1,8200, 60 months,2,small_business,3,High,2,Bad Loan,1,21.28,F,6,12.48,4173.57,1525.83,381.89,223.14,409000000068,25-Sep-17,INDO GIBL Indiaforensic STL03091,"10,000.00",,2163202.00,Glauert,661,Germany,113656.85,1,1,1
70,2011,2,OWN,2,Low,1,15000, 36 months,1,credit_card,1,High,2,Good Loan,0,14.65,C,3,11.88,18562.40042,15000,0,517.42,409000000069,25-Sep-17,INDO GIBL Indiaforensic STL04091,"103,600.00",,2059602.00,Pisano,675,France,18203.00,1,1,1
71,2011,5,MORTGAGE,3,Low,1,20975, 60 months,2,credit_card,1,High,2,Good Loan,0,17.58,D,4,18.79,18097.34458,13575,0,341.63,409000000070,25-Sep-17,INDO GIBL Indiaforensic STL05091,"71,000.00",,1988602.00,Konovalova,738,Germany,28373.86,1,1,1
72,2011,5,RENT,1,Low,1,6400, 36 months,1,debt_consolidation,6,High,2,Bad Loan,1,16.77,D,4,20.22,4776.45,3334.25,10.29,227.45,409000000071,25-Sep-17,INDO GIBL Indiaforensic STL06091,"129,400.00",,1859202.00,McKee,813,France,33953.87,1,1,1
73,2011,1,RENT,1,Low,1,3000, 36 months,1,debt_consolidation,6,High,2,Good Loan,0,13.49,C,3,18.11,3246.8,3000,0,101.8,409000000072,25-Sep-17,INDO GIBL Indiaforensic STL07091,"290,163.00",,1569039.00,Palermo,657,Spain,44203.55,1,1,1
74,2011,3,RENT,1,Low,1,12000, 36 months,1,credit_card,1,High,2,Good Loan,0,16.77,D,4,20.57,15346.46687,12000,0,426.47,409000000073,25-Sep-17,INDO GIBL Indiaforensic STL08091,"34,300.00",,1534739.00,Ballard,604,Germany,58426.81,1,1,1
75,2011,0.5,OWN,2,Medium,2,14400, 36 months,1,debt_consolidation,6,Low,1,Good Loan,0,8.9,A,1,14.85,16459.51914,14400,0,457.25,409000000074,25-Sep-17,INDO GIBL Indiaforensic STL09091,"49,800.00",,1484939.00,Wallace,519,France,145562.40,1,1,1
76,2011,10,RENT,1,Low,1,12000, 36 months,1,debt_consolidation,6,High,2,Good Loan,0,14.65,C,3,16.56,12699.48,12000,0,413.94,409000000075,25-Sep-17,INDO GIBL Indiaforensic STL10091,"44,800.00",,1440139.00,Cavenagh,735,France,22388.00,1,1,1
77,2011,10,MORTGAGE,3,Low,1,11000, 36 months,1,debt_consolidation,6,High,2,Good Loan,0,13.49,C,3,21.82,13413.21605,11000,0,373.24,409000000076,25-Sep-17,INDO GIBL Indiaforensic STL11091,"151,550.00",,1288589.00,Hu,664,France,139161.64,1,1,1
78,2011,0.5,RENT,1,Low,1,7250, 60 months,2,debt_consolidation,6,High,2,Good Loan,0,21.67,F,6,24.82,8201.53,7200,0,197.51,409000000077,25-Sep-17,INDO GIBL Indiaforensic STL12091,"310,399.00",,978190.00,Read,678,France,148210.64,1,1,1
79,2011,1,MORTGAGE,3,Low,1,15000, 36 months,1,small_business,3,Low,1,Good Loan,0,7.9,A,1,9.65,15557.64,15000,0,469.36,409000000078,25-Sep-17,INDO GIBL Indiaforensic STL13091,"271,401.00",,706789.00,Bushell,757,Spain,194239.63,1,1,1
80,2011,10,MORTGAGE,3,Low,1,18000, 60 months,2,debt_consolidation,6,High,2,Good Loan,0,19.91,E,5,6.81,26027.53964,18000,0,475.99,409000000079,25-Sep-17,INDO GIBL Indiaforensic STL14091,"275,449.00",,431340.00,Postle,416,Germany,98301.61,1,1,1
81,2011,3,MORTGAGE,3,Medium,2,35000, 60 months,2,home_improvement,7,High,2,Good Loan,0,17.27,D,4,7.51,28871.92,22075,0,551.84,409000000080,25-Sep-17,INDO GIBL Indiaforensic STL15091,"51,502.00",,379838.00,Buley,665,France,171413.66,1,1,1
82,2011,2,RENT,1,Low,1,10000, 36 months,1,credit_card,1,High,2,Good Loan,0,14.27,C,3,15.39,10671.62,10000,0,343.09,409000000081,25-Sep-17,INDO GIBL Indiaforensic STL16091,"36,650.00",,343188.00,Leonard,777,France,136458.19,1,1,1
83,2011,6,RENT,1,Low,1,11800, 36 months,1,credit_card,1,Low,1,Good Loan,0,12.69,B,2,9.86,14243.15837,11800,0,395.83,409000000082,25-Sep-17,INDO GIBL Indiaforensic STL17091,"99,600.00",,243588.00,Mills,543,France,26019.59,1,1,1
84,2011,4,RENT,1,Low,1,4500, 36 months,1,major_purchase,8,Low,1,Good Loan,0,6.03,A,1,4.44,4930.30217,4500,0,136.96,409000000083,25-Sep-17,FDRL/INTERNAL FUND TRANSFE,,500000.00,743588.00,Onyeorulu,506,France,159235.29,1,1,1
85,2011,10,RENT,1,Low,1,7000, 36 months,1,credit_card,1,Low,1,Good Loan,0,12.69,B,2,11.35,8449.394742,7000,0,234.82,409000000084,25-Sep-17,FDRL/INTERNAL FUND TRANSFE,,500000.00,1243588.00,Beit,493,France,1907.66,1,1,1
86,2011,2,RENT,1,Low,1,9200, 36 months,1,debt_consolidation,6,Low,1,Good Loan,0,12.42,B,2,19.96,10480.84,9200,0,307.43,409000000085,25-Sep-17,FDRL/INTERNAL FUND TRANSFE,,500000.00,1743588.00,Ndukaku,652,Spain,114675.75,1,1,1
87,2011,4,RENT,1,Low,1,14000, 60 months,2,other,4,High,2,Good Loan,0,17.27,D,4,6.34,16777.04,10157.6,0,349.98,409000000086,25-Sep-17,FDRL/INTERNAL FUND TRANSFE,,500000.00,2243588.00,Gant,750,Spain,128643.35,1,1,1
88,2011,0.5,MORTGAGE,3,Low,1,4500, 60 months,2,car,2,Low,1,Good Loan,0,10.65,B,2,5.4,4907.8,4500,0,97.06,409000000087,25-Sep-17,FDRL/INTERNAL FUND TRANSFE,,500000.00,2743588.00,Rowley,729,France,151869.35,1,1,1
89,2011,9,RENT,1,Low,1,12000, 36 months,1,debt_consolidation,6,High,2,Good Loan,0,16.29,D,4,16.85,14685.36,12000,0,423.61,409000000088,26-Sep-17,INDO GIBL Indiaforensic STL18091,"411,763.00",,2331825.00,Sharpe,646,France,93251.42,1,1,1
90,2011,4,RENT,1,Low,1,12000, 36 months,1,debt_consolidation,6,High,2,Good Loan,0,13.49,C,3,21.33,13985.67622,12000,0,407.17,409000000089,26-Sep-17,INDO GIBL Indiaforensic STL19091,"355,138.00",,1976687.00,Osborne,635,Germany,156791.36,1,1,1
91,2011,0.5,RENT,1,Low,1,12000, 36 months,1,credit_card,1,Low,1,Good Loan,0,10.65,B,2,23.94,12779.62,12000,0,390.88,409000000090,26-Sep-17,INDO GIBL Indiaforensic STL20091,"88,656.00",,1888031.00,Heap,647,Spain,174205.22,1,1,1
92,2011,3,MORTGAGE,3,Low,1,7000, 36 months,1,credit_card,1,Low,1,Good Loan,0,10.65,B,2,5.38,7687.73,7000,0,228.02,409000000091,26-Sep-17,INDO GIBL Indiaforensic STL21091,"14,800.00",,1873231.00,Ritchie,808,France,147132.46,1,1,1
93,2011,3,RENT,1,Medium,2,8200, 60 months,2,debt_consolidation,6,High,2,Good Loan,0,19.42,E,5,2.8,11894.8952,8200,0,214.62,409000000092,26-Sep-17,INDO GIBL Indiaforensic STL22091,"27,000.00",,1846231.00,Cole,524,France,109614.57,1,1,1
94,2011,10,RENT,1,Low,1,10500, 36 months,1,medical,9,Low,1,Good Loan,0,12.69,B,2,20.73,11232.14,10500,0,352.23,409000000093,26-Sep-17,INDO GIBL Indiaforensic STL23091,"42,850.00",,1803381.00,Capon,769,France,172290.61,1,1,1
95,2011,4,OWN,2,Low,1,7000, 36 months,1,debt_consolidation,6,Low,1,Good Loan,0,11.71,B,2,21.01,7932.3,7000,0,231.54,409000000094,26-Sep-17,INDO GIBL Indiaforensic STL24091,"39,925.00",,1763456.00,Capon,730,Spain,85982.47,1,1,1
96,2011,6,RENT,1,Low,1,15300, 60 months,2,credit_card,1,High,2,Good Loan,0,22.06,F,6,20.58,20295.8,10776.09,0,423.1,409000000095,26-Sep-17,INDO GIBL Indiaforensic STL25091,"202,106.00",,1561350.00,Fiorentini,515,Spain,121277.78,1,1,1
97,2011,4,MORTGAGE,3,Low,1,20000, 60 months,2,debt_consolidation,6,Low,1,Good Loan,0,11.71,B,2,10.04,15161.27,12800,0,282.86,409000000096,27-Sep-17,INDO GIBL Indiaforensic STL26091,"169,802.00",,1391548.00,Graham,773,Spain,64595.25,1,1,1
98,2011,7,MORTGAGE,3,Low,1,17500, 60 months,2,credit_card,1,High,2,Bad Loan,1,17.27,D,4,21.31,10037.1,3077.85,3486,437.47,409000000097,28-Sep-17,INDO GIBL Indiaforensic STL27091,"200,570.00",,1190978.00,Yuille,814,Germany,197276.13,1,1,1
99,2011,10,MORTGAGE,3,Low,1,3500, 36 months,1,car,2,Low,1,Good Loan,0,6.03,A,1,2.31,3834.66085,3500,0,106.53,409000000098,3-Oct-17,INDO GIBL Indiaforensic STL28091,"12,106.00",,1178872.00,Allard,710,Spain,99645.04,1,1,1
100,2011,0.5,RENT,1,Low,1,6000, 60 months,2,major_purchase,8,Low,1,Good Loan,0,12.69,B,2,13.66,6495.11,4472.4,0,135.57,409000000099,3-Oct-17,INDO GIBL Indiaforensic STL29091,"12,611.00",,1166261.00,Fanucci,413,France,6534.18,1,1,1
101,2011,2,RENT,1,Low,1,6200, 36 months,1,debt_consolidation,6,Low,1,Bad Loan,1,9.91,B,2,20.64,2452.22,1700.79,258.27,199.8,409000000100,3-Oct-17,INDO GIBL Indiaforensic STL30091,"9,375.00",,1156886.00,Fu,665,France,161848.03,1,1,1
102,2011,7,RENT,1,Low,1,16000, 60 months,2,debt_consolidation,6,High,2,Good Loan,0,17.58,D,4,15.56,19297.95,11584.03,0,402.65,409000000101,4-Oct-17,INDO GIBL Indiaforensic STL03101,"125,200.00",,1031686.00,Hung,623,France,167162.43,1,1,1
103,2011,8,OWN,2,Low,1,6000, 36 months,1,debt_consolidation,6,Low,1,Good Loan,0,8.9,A,1,13.17,6857.167486,6000,0,190.52,409000000102,5-Oct-17,INDO GIBL Indiaforensic STL04101,"61,400.00",,970286.00,Hung,738,France,41970.72,1,1,1
104,2011,6,RENT,1,Medium,2,7200, 36 months,1,credit_card,1,Low,1,Good Loan,0,9.91,B,2,6.12,8350.844344,7200,0,232.02,409000000103,6-Oct-17,INDO GIBL Indiaforensic STL05101,"143,700.00",,826586.00,Bradley,528,Spain,60536.56,1,1,1
105,2011,7,MORTGAGE,3,Low,1,9500, 36 months,1,credit_card,1,Low,1,Good Loan,0,8.9,A,1,8.18,10493.71,9500,0,301.66,409000000104,16-Oct-17,FDRL/INTERNAL FUND TRANSFE,,500000.00,1326586.00,Dunbabin,670,Spain,177655.68,1,1,1
106,2011,10,RENT,1,Low,1,18825, 60 months,2,debt_consolidation,6,High,2,Bad Loan,1,16.77,D,4,23.18,18218.25,8087.75,3343.79,465.53,409000000105,16-Oct-17,FDRL/INTERNAL FUND TRANSFE,,500000.00,1826586.00,Mauldon,622,Spain,30984.59,1,1,1
107,2011,10,RENT,1,Low,1,24000, 36 months,1,debt_consolidation,6,Low,1,Good Loan,0,10.65,B,2,14.8,28140.92936,24000,0,781.76,409000000106,16-Oct-17,FDRL/INTERNAL FUND TRANSFE,,500000.00,2326586.00,Stiger,582,Germany,10054.53,1,1,1
108,2011,10,RENT,1,Low,1,6000, 36 months,1,debt_consolidation,6,High,2,Good Loan,0,13.49,C,3,11.58,7326.009787,6000,0,203.59,409000000107,17-Oct-17,INDO GIBL Indiaforensic STL06101,"6,000.00",,2320586.00,Parsons,785,Germany,36976.52,1,1,1
109,2011,5,RENT,1,Low,1,6000, 36 months,1,debt_consolidation,6,High,2,Good Loan,0,13.49,C,3,15.38,7325.544153,6000,0,203.59,409000000108,17-Oct-17,INDO GIBL Indiaforensic STL07101,"97,950.00",,2222636.00,Walkom,605,Spain,71862.79,1,1,1
110,2011,10,MORTGAGE,3,Low,1,2100, 36 months,1,vacation,11,Low,1,Good Loan,0,12.42,B,2,19.72,2552.485243,2100,0,70.18,409000000109,17-Oct-17,INDO GIBL Indiaforensic STL08101,"33,000.00",,2189636.00,T'ang,479,Germany,99449.86,1,1,1
111,2011,8,MORTGAGE,3,Medium,2,5500, 36 months,1,small_business,3,Low,1,Good Loan,0,6.62,A,1,9.69,6077.875619,5500,0,168.88,409000000110,17-Oct-17,INDO GIBL Indiaforensic STL09101,"329,300.00",,1860336.00,Eremenko,685,Germany,63082.88,1,1,1
112,2011,8,OWN,2,Low,1,11000, 36 months,1,debt_consolidation,6,Low,1,Good Loan,0,6.62,A,1,20.5,12156.85732,11000,0,337.75,409000000111,17-Oct-17,INDO GIBL Indiaforensic STL10101,"18,000.00",,1842336.00,Rowntree,538,Germany,27231.26,1,1,1
113,2011,3,MORTGAGE,3,Medium,2,26800, 60 months,2,debt_consolidation,6,High,2,Good Loan,0,20.89,F,6,12.15,32887.69,26800,0,723.38,409000000112,17-Oct-17,INDO GIBL Indiaforensic STL11101,"113,400.00",,1728936.00,Thorpe,562,France,86797.41,1,1,1
114,2011,5,MORTGAGE,3,Low,1,8000, 36 months,1,debt_consolidation,6,Low,1,Good Loan,0,12.69,B,2,10.05,8999.1,8000,0,268.36,409000000113,17-Oct-17,INDO GIBL Indiaforensic STL12101,"262,226.00",,1466710.00,Chiemela,675,Spain,22994.32,1,1,1
115,2011,1,RENT,1,Low,1,10000, 36 months,1,credit_card,1,High,2,Bad Loan,1,18.25,D,4,24.14,11730.6,8320.22,229.06,362.78,409000000114,17-Oct-17,INDO GIBL Indiaforensic STL13101,"318,750.00",,1147960.00,Fanucci,721,Germany,101300.94,1,1,1
116,2011,9,MORTGAGE,3,Low,1,8000, 36 months,1,credit_card,1,Low,1,Good Loan,0,11.71,B,2,9.7,9434.776936,8000,0,264.61,409000000115,17-Oct-17,INDO GIBL Indiaforensic STL14101,"65,549.00",,1082411.00,Ko,628,Germany,74169.13,1,1,1
117,2011,6,RENT,1,Low,1,10000, 36 months,1,debt_consolidation,6,Low,1,Good Loan,0,8.9,A,1,7,10868.92,10000,0,317.54,409000000116,18-Oct-17,INDO GIBL Indiaforensic STL17101,"206,501.00",,875910.00,Welch,668,Germany,115638.29,1,1,1
118,2011,2,MORTGAGE,3,Medium,2,12000, 36 months,1,debt_consolidation,6,Low,1,Good Loan,0,11.71,B,2,13.32,14182.29986,12000,0,396.92,409000000117,21-Oct-17,FDRL/INTERNAL FUND TRANSFE,,500000.00,1375910.00,Duncan,506,France,31766.30,1,1,1
119,2011,1,RENT,1,Low,1,10000, 36 months,1,debt_consolidation,6,Low,1,Good Loan,0,7.9,A,1,25.26,11264.00958,10000,0,312.91,409000000118,21-Oct-17,INDO GIBL Indiaforensic STL18101,"85,000.00",,1290910.00,Chidozie,524,Germany,199725.39,1,1,1
120,2011,1,RENT,1,Low,1,12000, 36 months,1,debt_consolidation,6,Low,1,Good Loan,0,9.91,B,2,16.44,13920.02507,12000,0,386.7,409000000119,21-Oct-17,INDO GIBL Indiaforensic STL19101,"76,389.00",,1214521.00,Wu,699,Germany,120834.48,1,1,1
121,2011,10,MORTGAGE,3,Low,1,25000, 60 months,2,credit_card,1,High,2,Bad Loan,1,13.49,C,3,14.15,23880.65,13833.2,2010.58,575.12,409000000120,21-Oct-17,INDO GIBL Indiaforensic STL20101,"62,725.00",,1151796.00,Culbreth,828,France,38131.77,1,1,1
122,2011,4,RENT,1,Low,1,19750, 36 months,1,debt_consolidation,6,Low,1,Bad Loan,1,10.65,B,2,22.8,11930.65,8590.58,641.29,643.33,409000000121,23-Oct-17,INDO GIBL Indiaforensic STL21101,"39,000.00",,1112796.00,Kennedy,674,Spain,100130.95,1,1,1
123,2011,3,RENT,1,Low,1,10000, 36 months,1,debt_consolidation,6,Low,1,Good Loan,0,9.91,B,2,14.81,10904.24,10000,0,322.25,409000000122,23-Oct-17,INDO GIBL Indiaforensic STL22101,"9,600.00",,1103196.00,Cameron,656,France,141069.88,1,1,1
124,2011,4,RENT,1,Low,1,13650, 36 months,1,debt_consolidation,6,Low,1,Good Loan,0,12.42,B,2,24.09,16011.18,13650,0,456.12,409000000123,24-Oct-17,INDO GIBL Indiaforensic STL23101,"123,260.00",,979936.00,Calabresi,684,Germany,198129.36,1,1,1
125,2011,10,RENT,1,Low,1,28000, 60 months,2,debt_consolidation,6,High,2,Bad Loan,1,19.91,E,5,20.7,12173.07,4281.54,3132.16,312.04,409000000124,25-Oct-17,INDO GIBL Indiaforensic STL24101,"369,803.00",,610133.00,Zetticci,625,France,183646.41,1,1,1
126,2011,10,RENT,1,Low,1,18000, 36 months,1,debt_consolidation,6,Low,1,Good Loan,0,7.9,A,1,27.55,20275.33655,18000,0,563.23,409000000125,26-Oct-17,INDO GIBL Indiaforensic STL25101,"170,125.00",,440008.00,Fuller,432,France,110265.24,1,1,1
127,2011,7,RENT,1,Low,1,2500, 36 months,1,debt_consolidation,6,High,2,Good Loan,0,14.27,C,3,10.33,2529.9,2500,0,85.78,409000000126,26-Oct-17,FDRL/INTERNAL FUND TRANSFE,,500000.00,940008.00,MacDonald,549,France,8636.05,1,1,1
128,2011,10,RENT,1,Low,1,21000, 60 months,2,credit_card,1,High,2,Good Loan,0,20.3,E,5,23.21,27085.42,21000,0,559.89,409000000127,27-Oct-17,INDO GIBL Indiaforensic STL26101,"208,000.00",,732008.00,Piccio,625,Germany,46824.08,1,1,1
129,2011,6,MORTGAGE,3,Medium,2,35000, 36 months,1,debt_consolidation,6,Low,1,Good Loan,0,8.9,A,1,22.71,40006.54992,35000,0,1111.37,409000000128,30-Oct-17,FDRL/INTERNAL FUND TRANSFE,,500000.00,1232008.00,Kennedy,828,France,171378.77,1,1,1
130,2011,3,RENT,1,Low,1,10000, 36 months,1,credit_card,1,Low,1,Good Loan,0,7.51,A,1,9.75,11027.3,10000,0,311.11,409000000129,30-Oct-17,INDO GIBL Indiaforensic STL27101,"291,150.00",,940858.00,Fernie,770,France,167256.35,1,1,1
131,2011,0.5,RENT,1,Low,1,7000, 36 months,1,credit_card,1,Low,1,Good Loan,0,12.69,B,2,15.8,8452.256793,7000,0,234.82,409000000130,30-Oct-17,INDO GIBL Indiaforensic STL28101,"24,000.00",,916858.00,He,758,France,124226.16,1,1,1
132,2011,8,MORTGAGE,3,Low,1,24000, 36 months,1,home_improvement,7,High,2,Bad Loan,1,15.96,C,3,9.17,5895.68,3813.57,0,843.3,409000000131,31-Oct-17,INDO GIBL Indiaforensic STL30101,"141,546.00",,775312.00,Kaodilinakachukwu,795,Germany,114935.21,1,1,1
133,2011,5,MORTGAGE,3,Low,1,10625, 36 months,1,medical,9,Low,1,Good Loan,0,7.51,A,1,18.89,11841.94071,10625,0,330.56,409000000132,1-Nov-17,INDO GIBL Indiaforensic STL31101,"80,000.00",,695312.00,Cocci,687,France,35608.88,1,1,1
134,2011,2,RENT,1,Low,1,5000, 36 months,1,debt_consolidation,6,High,2,Good Loan,0,14.65,C,3,18.3,5682.08,5000,0,172.48,409000000133,2-Nov-17,INDO GIBL Indiaforensic STL01111,"46,250.00",,649062.00,Alekseeva,686,France,16459.37,1,1,1
135,2011,10,RENT,1,Low,1,8850, 36 months,1,credit_card,1,Low,1,Good Loan,0,6.62,A,1,17.71,9781.605755,8850,0,271.73,409000000134,3-Nov-17,INDO GIBL Indiaforensic STL02111,"42,825.00",,606237.00,Chinweike,789,Germany,124411.08,1,1,1
136,2011,4,RENT,1,Low,1,6375, 36 months,1,debt_consolidation,6,Low,1,Good Loan,0,7.51,A,1,4.8,6737.55,6375,0,198.34,409000000135,6-Nov-17,INDO GIBL Indiaforensic STL03111,"179,463.00",,426774.00,Arthur,589,Germany,34941.23,1,1,1
137,2011,1,RENT,1,Low,1,6000, 36 months,1,credit_card,1,Low,1,Good Loan,0,11.71,B,2,2.97,7041.293751,6000,0,198.46,409000000136,6-Nov-17,INDO GIBL Indiaforensic STL04111,"18,949.00",,407825.00,Li,461,Germany,167784.28,1,1,1
138,2011,10,RENT,1,Low,1,11100, 36 months,1,credit_card,1,Low,1,Bad Loan,1,6.62,A,1,29.85,8120.14,6516.79,626.5,340.82,409000000137,6-Nov-17,INDO GIBL Indiaforensic STL05111,"91,441.00",,316384.00,Ma,637,France,93165.34,1,1,1
139,2011,2,MORTGAGE,3,Low,1,10000, 60 months,2,debt_consolidation,6,Low,1,Good Loan,0,12.69,B,2,10.82,12727.42606,10000,0,225.95,409000000138,7-Nov-17,INDO GIBL Indiaforensic STL06111,"147,750.00",,168634.00,Chia,584,Spain,75161.25,1,1,1
140,2011,5,MORTGAGE,3,Low,1,6200, 36 months,1,small_business,3,Low,1,Good Loan,0,6.03,A,1,18.2,6793.070094,6200,0,188.71,409000000139,8-Nov-17,FDRL/INTERNAL FUND TRANSFE,,500000.00,668634.00,Vasin,579,Spain,8590.83,1,1,1
141,2011,1,RENT,1,Low,1,15000, 36 months,1,debt_consolidation,6,High,2,Good Loan,0,18.64,E,5,19.69,19401.71938,15000,0,547.12,409000000140,8-Nov-17,FDRL/INTERNAL FUND TRANSFE,,500000.00,1168634.00,Groves,756,Germany,189543.90,1,1,1
142,2011,2,RENT,1,Low,1,4200, 36 months,1,other,4,Low,1,Good Loan,0,11.71,B,2,16.91,5000.46251,4200,0,138.92,409000000141,8-Nov-17,INDO GIBL Indiaforensic STL07111,"110,188.00",,1058446.00,Tien,663,France,180427.24,1,1,1
143,2011,4,RENT,1,Low,1,14000, 36 months,1,debt_consolidation,6,High,2,Good Loan,0,14.27,C,3,7.36,14487.95,14000,0,480.33,409000000142,9-Nov-17,INDO GIBL Indiaforensic STL08111,"61,870.00",,996576.00,Forwood,682,France,193318.33,1,1,1
144,2011,1,MORTGAGE,3,Low,1,8875, 36 months,1,debt_consolidation,6,Low,1,Good Loan,0,7.51,A,1,23.53,9712.65,8875,0,276.11,409000000143,10-Nov-17,INDO GIBL Indiaforensic STL09111,"84,101.00",,912475.00,Greeves,793,Spain,159123.82,1,1,1
145,2011,7,RENT,1,Low,1,13500, 36 months,1,debt_consolidation,6,Low,1,Good Loan,0,9.91,B,2,12.38,15657.93938,13500,0,435.04,409000000144,14-Nov-17,INDO GIBL Indiaforensic STL10111,"129,700.00",,782775.00,Taylor,691,France,126213.84,1,1,1
146,2011,2,RENT,1,Low,1,12000, 36 months,1,debt_consolidation,6,Low,1,Bad Loan,1,9.91,B,2,7.83,11234.49,9011.72,414.89,386.7,409000000145,14-Nov-17,INDO GIBL Indiaforensic STL11111,"7,499.00",,775276.00,Madukwe,485,Spain,54141.50,1,1,1
147,2011,4,RENT,1,Low,1,16000, 60 months,2,debt_consolidation,6,High,2,Good Loan,0,19.91,E,5,15.8,22277.26289,16000,0,423.11,409000000146,14-Nov-17,INDO GIBL Indiaforensic STL12111,"80,100.00",,695176.00,Bennelong,635,Spain,141075.51,1,1,1
148,2011,8,MORTGAGE,3,Low,1,21600, 60 months,2,debt_consolidation,6,High,2,Good Loan,0,19.42,E,5,16.74,27580.75,21600,0,565.32,409000000147,14-Nov-17,INDO GIBL Indiaforensic STL13111,"143,850.00",,551326.00,Olisanugo,650,France,24495.03,1,1,1
149,2011,6,MORTGAGE,3,Low,1,6000, 36 months,1,home_improvement,7,Low,1,Good Loan,0,10.65,B,2,12.86,6999.427407,6000,0,195.44,409000000148,15-Nov-17,INDO GIBL Indiaforensic STL14111,"289,500.00",,261826.00,Chukwufumnanya,735,France,74836.34,1,1,1
150,2011,5,OWN,2,Low,1,8450, 60 months,2,debt_consolidation,6,High,2,Good Loan,0,16.77,D,4,22.51,12188.56442,8450,0,208.97,409000000149,17-Nov-17,FDRL/INTERNAL FUND TRANSFE,,500000.00,761826.00,Harris,416,France,878.87,1,1,1
151,2011,1,RENT,1,Low,1,20000, 60 months,2,credit_card,1,High,2,Good Loan,0,13.49,C,3,17.68,26397.31306,20000,0,460.1,409000000150,17-Nov-17,FDRL/INTERNAL FUND TRANSFE,,500000.00,1261826.00,Morgan,754,Spain,89520.75,1,1,1
152,2011,8,RENT,1,Low,1,10000, 36 months,1,debt_consolidation,6,Low,1,Bad Loan,1,11.71,B,2,22.08,6002.23,4293.91,319.46,330.76,409000000151,17-Nov-17,INDO GIBL Indiaforensic STL16111,"94,900.00",,1166926.00,Alexeeva,535,France,149892.79,1,1,1
153,2011,5,MORTGAGE,3,Low,1,12000, 36 months,1,credit_card,1,High,2,Good Loan,0,16.29,D,4,18.18,14946.56002,12000,0,423.61,409000000152,17-Nov-17,INDO GIBL Indiaforensic STL15111,"224,851.00",,942075.00,Metcalfe,716,Spain,180800.42,1,1,1
154,2011,10,RENT,1,Low,1,13475, 60 months,2,credit_card,1,High,2,Bad Loan,1,13.49,C,3,21.89,6198.89,3516.74,0,309.99,409000000153,18-Nov-17,INDO GIBL Indiaforensic STL17111,"284,953.00",,657122.00,Humphries,539,France,98646.22,1,1,1
155,2011,5,RENT,1,Low,1,7200, 36 months,1,major_purchase,8,Low,1,Good Loan,0,12.42,B,2,17.43,8677.15634,7200,0,240.59,409000000154,20-Nov-17,INDO GIBL Indiaforensic STL18111,"115,150.00",,541972.00,Milne,614,France,109041.53,1,1,1
156,2011,1,MORTGAGE,3,Low,1,5600, 36 months,1,debt_consolidation,6,High,2,Bad Loan,1,14.65,C,3,12.24,1350.86,905.39,0,193.17,409000000155,20-Nov-17,INDO GIBL Indiaforensic STL19111,"40,000.00",,501972.00,Chou,706,Spain,17941.16,1,1,1
157,2011,0.5,RENT,1,Low,1,12000, 36 months,1,debt_consolidation,6,High,2,Good Loan,0,14.27,C,3,10.86,14396.58,12000,0,411.71,409000000156,21-Nov-17,FDRL/INTERNAL FUND TRANSFE,,500000.00,1001972.00,Li,758,France,82996.47,1,1,1
158,2011,2,RENT,1,Low,1,8500, 36 months,1,credit_card,1,Low,1,Good Loan,0,6.03,A,1,1.73,9074.73,8500,0,258.71,409000000157,21-Nov-17,INDO GIBL Indiaforensic STL20111,"145,900.00",,856072.00,Clayton,586,Spain,92067.35,1,1,1
159,2011,2,RENT,1,Low,1,8000, 36 months,1,credit_card,1,Low,1,Good Loan,0,9.91,B,2,18.28,9279.812752,8000,0,257.8,409000000158,22-Nov-17,INDO GIBL Indiaforensic STL21111,"83,251.00",,772821.00,Maclean,646,France,104719.66,1,1,1
160,2011,10,RENT,1,Low,1,8000, 36 months,1,credit_card,1,Low,1,Good Loan,0,12.42,B,2,15,9622.78032,8000,0,267.33,409000000159,23-Nov-17,INDO GIBL Indiaforensic STL22111,"192,200.00",,580621.00,Chigolum,631,Germany,112687.57,1,1,1
161,2011,10,RENT,1,Low,1,16000, 60 months,2,debt_consolidation,6,High,2,Good Loan,0,15.27,C,3,17.44,22394.08,16000,0,382.92,409000000160,24-Nov-17,INDO GIBL Indiaforensic STL23111,"74,799.00",,505822.00,Wilkinson,717,Spain,84699.56,1,1,1
162,2011,2,MORTGAGE,3,Low,1,15000, 36 months,1,house,12,High,2,Good Loan,0,17.27,D,4,3.59,17991.53,15000,0,536.81,409000000161,27-Nov-17,FDRL/INTERNAL FUND TRANSFE,,500000.00,1005822.00,Wei,684,France,83473.82,1,1,1
163,2011,2,OWN,2,Low,1,10000, 36 months,1,debt_consolidation,6,Low,1,Good Loan,0,9.91,B,2,11.24,11386.43022,10000,0,322.25,409000000162,27-Nov-17,INDO GIBL Indiaforensic STL24117,"19,400.00",,986422.00,Treacy,800,France,47125.11,1,1,1
164,2011,5,MORTGAGE,3,Low,1,10000, 36 months,1,credit_card,1,Low,1,Good Loan,0,6.62,A,1,16.78,10902.91,10000,0,307.04,409000000163,27-Nov-17,INDO GIBL Indiaforensic STL25117,"39,700.00",,946722.00,Hu,721,Spain,106977.80,1,1,1
165,2011,3,RENT,1,Low,1,8000, 36 months,1,car,2,High,2,Good Loan,0,14.65,C,3,12.6,8636.82,8000,0,275.96,409000000164,27-Nov-17,INDO GIBL Indiaforensic STL26117,"42,800.00",,903922.00,Taverner,683,Spain,55582.54,1,1,1
166,2011,2,MORTGAGE,3,Low,1,22000, 36 months,1,debt_consolidation,6,Low,1,Good Loan,0,9.91,B,2,13.22,25521.09572,22000,0,708.95,409000000165,28-Nov-17,INDO GIBL Indiaforensic STL27111,"100,402.00",,803520.00,Sherman,660,Germany,139874.43,1,1,1
167,2011,10,MORTGAGE,3,Low,1,6000, 36 months,1,car,2,High,2,Good Loan,0,14.27,C,3,24.53,7215.05,6000,0,205.86,409000000166,29-Nov-17,INDO GIBL Indiaforensic STL28111,"101,500.00",,702020.00,Taubman,704,Germany,162503.48,1,1,1
168,2011,10,OWN,2,Low,1,16000, 60 months,2,debt_consolidation,6,Low,1,Good Loan,0,9.91,B,2,9.39,16282.75,12138.89,0,339.25,409000000167,30-Nov-17,INDO GIBL Indiaforensic STL29111,"36,961.00",,665059.00,Robinson,615,Spain,196499.96,1,1,1
169,2011,6.05,OWN,2,Low,1,2500, 36 months,1,debt_consolidation,6,Low,1,Bad Loan,1,7.51,A,1,16.3,1838.88,1575.06,10.08,77.78,409000000168,2-Dec-17,INDO GIBL Indiaforensic STL30111,"67,850.00",,597209.00,Pinto,667,Spain,40721.24,1,1,1
170,2011,2,MORTGAGE,3,Low,1,13500, 36 months,1,credit_card,1,Low,1,Good Loan,0,9.91,B,2,22.93,15621.26606,13500,0,435.04,409000000169,2-Dec-17,INDO GIBL Indiaforensic STL01121,"19,800.00",,577409.00,Wood,682,Germany,53134.30,1,1,1
171,2011,2,RENT,1,High,3,25000, 36 months,1,debt_consolidation,6,Low,1,Good Loan,0,12.42,B,2,8.32,30071.72882,25000,0,835.39,409000000170,4-Dec-17,INDO GIBL Indiaforensic STL02121,"10,000.00",,567409.00,Hawkins,484,France,164017.89,1,1,1
172,2011,2,RENT,1,Low,1,10000, 36 months,1,small_business,3,High,2,Good Loan,0,13.49,C,3,24.97,12174.48231,10000,0,339.31,409000000171,4-Dec-17,INDO GIBL Indiaforensic STL03121,"24,500.00",,542909.00,Sun,628,Germany,155996.96,1,1,1
173,2011,4,RENT,1,Low,1,2500, 36 months,1,debt_consolidation,6,High,2,Good Loan,0,13.49,C,3,6.44,3050.276004,2500,0,84.83,409000000172,5-Dec-17,INDO GIBL Indiaforensic STL04121,"41,700.00",,501209.00,Yost,480,Germany,5472.70,1,1,1
174,2011,1,RENT,1,Low,1,7325, 36 months,1,debt_consolidation,6,Low,1,Good Loan,0,12.69,B,2,22.57,8844.700842,7325,0,245.72,409000000173,6-Dec-17,FDRL/INTERNAL FUND TRANSFE,,500000.00,1001209.00,Ting,578,France,112187.11,1,1,1
175,2011,5,RENT,1,Medium,2,4000, 36 months,1,credit_card,1,Low,1,Good Loan,0,12.42,B,2,12.12,4337.11,4000,0,133.67,409000000174,6-Dec-17,INDO GIBL Indiaforensic STL05121,"218,050.00",,783159.00,Rowe,512,France,146457.83,1,1,1
176,2011,5,RENT,1,Low,1,10000, 36 months,1,small_business,3,High,2,Bad Loan,1,13.49,C,3,6.92,9270.84,6799.56,459.53,339.31,409000000175,7-Dec-17,INDO GIBL Indiaforensic STL06121,"186,400.00",,596759.00,Fu,484,Spain,27286.10,1,1,1
177,2011,0.5,RENT,1,Low,1,7750, 36 months,1,debt_consolidation,6,High,2,Bad Loan,1,17.27,D,4,16.1,6934,4935.39,11.91,277.36,409000000176,8-Dec-17,INDO GIBL Indiaforensic STL07121,"171,330.00",,425429.00,Ho,510,France,130553.47,1,1,1
178,2011,6,RENT,1,Low,1,20000, 60 months,2,debt_consolidation,6,High,2,Bad Loan,1,20.89,F,6,16.63,5425.96,1318.27,1073.61,539.84,409000000177,11-Dec-17,INDO GIBL Indiaforensic STL08121,"34,400.00",,391029.00,Okechukwu,606,Germany,179351.89,1,1,1
179,2011,10,RENT,1,Low,1,9600, 36 months,1,debt_consolidation,6,Low,1,Good Loan,0,12.42,B,2,11.65,11337.71,9600,0,320.79,409000000178,11-Dec-17,INDO GIBL Indiaforensic STL09121,"51,199.00",,339830.00,Campbell,597,Spain,94774.12,1,1,1
180,2011,3,RENT,1,Low,1,21000, 60 months,2,debt_consolidation,6,Low,1,Bad Loan,1,11.71,B,2,6.62,3708.24,2142.87,0,464.07,409000000179,11-Dec-17,INDO GIBL Indiaforensic STL10121,"159,150.00",,180680.00,Ashbolt,754,Germany,8080.85,1,1,1
181,2011,3,RENT,1,Low,1,14000, 36 months,1,credit_card,1,Low,1,Good Loan,0,10.65,B,2,15.52,15200.08,14000,0,456.03,409000000180,12-Dec-17,FDRL/INTERNAL FUND TRANSFE,,500000.00,680680.00,Rozier,850,Spain,19482.50,1,1,1
182,2011,10,RENT,1,Low,1,13350, 36 months,1,debt_consolidation,6,Low,1,Good Loan,0,12.42,B,2,20.57,16058.39442,13350,0,446.1,409000000181,12-Dec-17,FDRL/INTERNAL FUND TRANSFE,,500000.00,1180680.00,Hsia,510,France,48071.61,1,1,1
183,2011,10,RENT,1,Low,1,15000, 36 months,1,debt_consolidation,6,High,2,Bad Loan,1,16.77,D,4,19.63,13373.77,8365.66,1084.71,533.08,409000000182,13-Dec-17,INDO GIBL Indiaforensic STL11121,"206,075.00",,974605.00,Ogbonnaya,778,Germany,174531.27,1,1,1
184,2011,8,RENT,1,Low,1,15000, 36 months,1,debt_consolidation,6,High,2,Bad Loan,1,17.27,D,4,16.03,10198.4,6944.85,15.16,536.81,409000000183,13-Dec-17,INDO GIBL Indiaforensic STL12121,"142,000.00",,832605.00,T'ang,636,France,55470.78,1,1,1
185,2011,10,MORTGAGE,3,Medium,2,11000, 60 months,2,debt_consolidation,6,High,2,Good Loan,0,13.49,C,3,10.94,12119.38,8158.5,0,253.06,409000000184,14-Dec-17,INDO GIBL Indiaforensic STL13121,"350,350.00",,482255.00,Cocci,804,France,8546.87,1,1,1
186,2011,2,MORTGAGE,3,Medium,2,35000, 36 months,1,debt_consolidation,6,Low,1,Good Loan,0,10.65,B,2,3.17,38059.76,35000,0,1140.07,409000000185,15-Dec-17,INDO GIBL Indiaforensic STL14121,"343,900.00",,138355.00,Chang,514,France,95857.18,1,1,1
187,2011,9,MORTGAGE,3,Low,1,9000, 36 months,1,credit_card,1,Low,1,Good Loan,0,10.65,B,2,8.89,10552.7928,9000,0,293.16,409000000186,18-Dec-17,FDRL/INTERNAL FUND TRANSFE,,500000.00,638355.00,T'ao,730,France,194945.80,1,1,1
188,2011,7,MORTGAGE,3,Low,1,22475, 60 months,2,debt_consolidation,6,High,2,Good Loan,0,15.27,C,3,15.23,25796.01,16512.33,0,537.87,409000000187,18-Dec-17,FDRL/INTERNAL FUND TRANSFE,,500000.00,1138355.00,Ford,525,Spain,131521.72,1,1,1
189,2011,1,RENT,1,Low,1,16000, 36 months,1,debt_consolidation,6,Low,1,Bad Loan,1,12.69,B,2,20.64,12295.72,9479.47,10.47,536.72,409000000188,18-Dec-17,INDO GIBL Indiaforensic STL15121,"210,500.00",,927855.00,Marshall,616,Spain,196108.51,1,1,1
190,2011,5,RENT,1,Low,1,13500, 36 months,1,debt_consolidation,6,Low,1,Good Loan,0,12.69,B,2,11.97,16301.54517,13500,0,452.86,409000000189,18-Dec-17,INDO GIBL Indiaforensic STL17121,"139,500.00",,788355.00,Tsai,687,Germany,148564.76,1,1,1
191,2011,10,RENT,1,Low,1,24000, 36 months,1,debt_consolidation,6,Low,1,Good Loan,0,12.69,B,2,11.6,28978.67895,24000,0,805.08,409000000190,18-Dec-17,INDO GIBL Indiaforensic STL16121,"92,550.00",,695805.00,Onwumelu,715,France,92982.61,1,1,1
192,2011,5,RENT,1,Low,1,12000, 36 months,1,credit_card,1,Low,1,Good Loan,0,10.65,B,2,10.84,14070.39864,12000,0,390.88,409000000191,19-Dec-17,FDRL/INTERNAL FUND TRANSFE,,500000.00,1195805.00,Graham,512,France,17675.36,1,1,1
193,2011,5,RENT,1,Low,1,8400, 60 months,2,major_purchase,8,High,2,Good Loan,0,16.77,D,4,11.35,9940.54,6104.36,0,207.73,409000000192,19-Dec-17,FDRL/INTERNAL FUND TRANSFE,,500000.00,1695805.00,Golovanov,479,France,114996.43,1,1,1
194,2011,5,MORTGAGE,3,Medium,2,28000, 60 months,2,home_improvement,7,High,2,Good Loan,0,17.58,D,4,12.07,28411.15,28000,0,704.64,409000000193,19-Dec-17,INDO GIBL Indiaforensic STL18121,"654,498.00",,1041307.00,Potts,601,France,86957.42,1,1,1
195,2011,10,RENT,1,Low,1,14000, 36 months,1,debt_consolidation,6,Low,1,Good Loan,0,6.62,A,1,11.15,15450.08422,14000,0,429.86,409000000194,20-Dec-17,INDO GIBL Indiaforensic STL19121,"504,450.00",,536857.00,Crawford,580,Spain,128077.80,1,1,1
196,2011,8,MORTGAGE,3,Low,1,12000, 36 months,1,other,4,High,2,Bad Loan,1,14.27,C,3,8.4,4241.16,2534.26,543.42,411.71,409000000195,20-Dec-17,FDRL/INTERNAL FUND TRANSFE,,500000.00,1036857.00,Aleshire,807,France,600.36,1,1,1
197,2011,10,MORTGAGE,3,Low,1,25000, 36 months,1,debt_consolidation,6,Low,1,Good Loan,0,11.71,B,2,6.88,29277.57384,25000,0,826.9,409000000196,21-Dec-17,INDO GIBL Indiaforensic STL20121,"561,225.00",,475632.00,Moran,616,Spain,43001.46,1,1,1
198,2011,5,RENT,1,Low,1,9000, 36 months,1,debt_consolidation,6,Low,1,Good Loan,0,12.69,B,2,17.81,10867.20998,9000,0,301.91,409000000197,21-Dec-17,FDRL/INTERNAL FUND TRANSFE,,500000.00,975632.00,Samsonova,721,Germany,158591.12,1,1,1
199,2011,4,RENT,1,Low,1,13250, 36 months,1,debt_consolidation,6,Low,1,Good Loan,0,10.65,B,2,24.93,15535.93186,13250,0,431.6,409000000198,21-Dec-17,FDRL/INTERNAL FUND TRANSFE,,500000.00,1475632.00,Jenkins,501,France,47847.19,1,1,1
200,2011,6,RENT,1,Low,1,20000, 36 months,1,debt_consolidation,6,High,2,Good Loan,0,13.49,C,3,22.38,23861.58,20000,0,678.61,409000000199,22-Dec-17,INDO GIBL Indiaforensic STL21121,"146,050.00",,1329582.00,Volkov,521,France,10488.44,1,1,1
201,2011,5,RENT,1,Low,1,3000, 36 months,1,medical,9,High,2,Good Loan,0,14.65,C,3,21.84,3723.936325,3000,0,103.49,409000000200,26-Dec-17,INDO GIBL Indiaforensic STL22121,"100,300.00",,1229282.00,Chiemezie,850,Spain,5978.20,1,1,1
202,2011,10,MORTGAGE,3,Low,1,7350, 36 months,1,debt_consolidation,6,Low,1,Good Loan,0,10.65,B,2,11.93,8616.33002,7350,0,239.42,409000000201,26-Dec-17,INDO GIBL Indiaforensic STL23121,"62,425.00",,1166857.00,Jude,759,France,121409.06,1,1,1
203,2011,5,RENT,1,Low,1,11500, 36 months,1,debt_consolidation,6,High,2,Good Loan,0,15.27,C,3,21.1,14400.49925,11500,0,400.18,409000000202,26-Dec-17,INDO GIBL Indiaforensic STL24121,"365,300.00",,801557.00,He,516,Spain,146145.93,1,1,1
204,2011,10,MORTGAGE,3,Low,1,13650, 36 months,1,debt_consolidation,6,Low,1,Bad Loan,1,12.42,B,2,12.29,8203.29,5810.73,460.64,456.12,409000000203,26-Dec-17,INDO GIBL Indiaforensic STL25121,"23,550.00",,778007.00,Onuora,711,France,14374.86,1,1,1
205,2011,3,RENT,1,Low,1,10500, 36 months,1,debt_consolidation,6,High,2,Bad Loan,1,16.29,D,4,15,2222.16,1414.89,0,370.66,409000000204,27-Dec-17,FDRL/INTERNAL FUND TRANSFE,,500000.00,1278007.00,Ginikanwa,512,Spain,94670.77,1,1,1
206,2011,2,RENT,1,Low,1,12000, 36 months,1,debt_consolidation,6,Low,1,Good Loan,0,9.91,B,2,15.5,13919.41387,12000,0,386.7,409000000205,27-Dec-17,INDO GIBL Indiaforensic STL26121,"259,525.00",,1018482.00,Ku,550,France,179670.31,1,1,1
207,2011,3,RENT,1,Low,1,6000, 36 months,1,credit_card,1,Low,1,Good Loan,0,8.9,A,1,14.51,6857.261151,6000,0,190.52,409000000206,28-Dec-17,INDO GIBL Indiaforensic STL27121,"383,110.00",,635372.00,McDonald,608,Spain,199304.74,1,1,1
208,2011,10,MORTGAGE,3,Low,1,11500, 36 months,1,credit_card,1,High,2,Good Loan,0,15.27,C,3,21.69,13598.01,11500,0,400.18,409000000207,29-Dec-17,INDO GIBL Indiaforensic STL28121,"138,150.00",,497222.00,Collins,618,France,151954.39,1,1,1
209,2011,7,MORTGAGE,3,Low,1,7000, 36 months,1,debt_consolidation,6,Low,1,Good Loan,0,12.42,B,2,12,8290.73,7000,0,233.91,409000000208,29-Dec-17,FDRL/INTERNAL FUND TRANSFE,,500000.00,997222.00,Hackett,643,France,142513.50,1,1,1
210,2011,6,MORTGAGE,3,Low,1,29500, 60 months,2,debt_consolidation,6,High,2,Good Loan,0,20.3,E,5,20.93,45755.22998,29500,0,786.51,409000000209,30-Dec-17,INDO GIBL Indiaforensic STL29121,"285,399.00",,711823.00,Dike,671,France,158264.62,1,1,1
211,2011,2,RENT,1,Low,1,2000, 36 months,1,moving,10,High,2,Good Loan,0,15.27,C,3,17.74,2520.4,2000,0,69.6,409000000210,1-Jan-18,INDO GIBL Indiaforensic STL31121,"14,000.00",,697823.00,Trevisano,689,Germany,169381.90,1,1,1
212,2011,0.5,MORTGAGE,3,Low,1,11625, 36 months,1,credit_card,1,High,2,Good Loan,0,13.49,C,3,19.33,14196.26824,11625,0,394.45,409000000211,1-Jan-18,INDO GIBL Indiaforensic STL30121,"54,250.00",,643573.00,Tan,603,France,169915.02,1,1,1
213,2011,10,RENT,1,Low,1,15075, 36 months,1,debt_consolidation,6,High,2,Bad Loan,1,14.27,C,3,20.16,15502.77,11609.04,519.28,517.21,409000000212,2-Jan-18,INDO GIBL Indiaforensic STL01011,"147,500.00",,496073.00,Glassman,620,France,88852.47,1,1,1
214,2011,1,RENT,1,Low,1,5300, 36 months,1,credit_card,1,High,2,Good Loan,0,15.27,C,3,24.88,6622.546709,5300,0,184.43,409000000213,3-Jan-18,FDRL/INTERNAL FUND TRANSFE,,500000.00,996073.00,Miller,676,France,40645.81,1,1,1
215,2011,0.5,RENT,1,Low,1,8200, 36 months,1,home_improvement,7,Low,1,Good Loan,0,6.62,A,1,11.1,9062.49784,8200,0,251.77,409000000214,3-Jan-18,INDO GIBL Indiaforensic STL02011,"323,500.00",,672573.00,Kornilova,572,Germany,60427.30,1,1,1
216,2011,9,MORTGAGE,3,Medium,2,12000, 36 months,1,credit_card,1,Low,1,Good Loan,0,12.42,B,2,13.98,14431.97856,12000,0,400.99,409000000215,4-Jan-18,INDO GIBL Indiaforensic STL03011,"180,300.00",,492273.00,Watson,668,Germany,157959.02,1,1,1
217,2011,4,MORTGAGE,3,Low,1,8650, 36 months,1,credit_card,1,High,2,Good Loan,0,14.27,C,3,7.6,10678.68477,8650,0,296.78,409000000216,5-Jan-18,FDRL/INTERNAL FUND TRANSFE,,500000.00,992273.00,Marchesi,695,France,133007.34,1,1,1
218,2011,10,MORTGAGE,3,Medium,2,21000, 60 months,2,debt_consolidation,6,High,2,Good Loan,0,17.27,D,4,7.75,14117.18,8549.22,0,294.98,409000000217,5-Jan-18,FDRL/INTERNAL FUND TRANSFE,,500000.00,1492273.00,Millar,730,Spain,176576.62,1,1,1
219,2011,2,RENT,1,Low,1,16000, 60 months,2,debt_consolidation,6,High,2,Good Loan,0,17.27,D,4,11.04,19183.22,11613.1,0,399.97,409000000218,5-Jan-18,INDO GIBL Indiaforensic STL04011,"222,800.00",,1269473.00,Shih,807,France,34888.04,1,1,1
220,2011,2,RENT,1,Low,1,12000, 36 months,1,debt_consolidation,6,Low,1,Good Loan,0,12.42,B,2,11.81,14432.31018,12000,0,400.99,409000000219,6-Jan-18,INDO GIBL Indiaforensic STL05011,"145,450.00",,1124023.00,Fuller,592,France,28737.71,1,1,1
221,2011,0.5,MORTGAGE,3,Low,1,9500, 36 months,1,moving,10,Low,1,Bad Loan,1,12.69,B,2,23.54,7002.16,5366.65,0,318.68,409000000220,9-Jan-18,INDO GIBL Indiaforensic STL06011,"182,000.00",,942023.00,Hay,726,France,98178.57,1,1,1
222,2011,0.5,OWN,2,Low,1,7400, 36 months,1,debt_consolidation,6,High,2,Good Loan,0,13.49,C,3,8.45,9037.69568,7400,0,251.09,409000000221,9-Jan-18,INDO GIBL Indiaforensic STL07011,"205,075.00",,736948.00,Yang,514,Spain,125010.24,1,1,1
223,2011,10,MORTGAGE,3,Low,1,14400, 36 months,1,debt_consolidation,6,High,2,Good Loan,0,13.49,C,3,16.92,15453.51,14400,0,488.6,409000000222,9-Jan-18,INDO GIBL Indiaforensic STL08011,"170,500.00",,566448.00,McIntyre,567,France,167984.61,1,1,1
224,2011,7,MORTGAGE,3,Medium,2,24250, 60 months,2,debt_consolidation,6,High,2,Good Loan,0,23.91,G,7,12.96,22188.25,18100,0,519.76,409000000223,9-Jan-18,FDRL/INTERNAL FUND TRANSFE,,500000.00,1066448.00,Stevenson,850,France,4861.72,1,1,1
225,2011,3,RENT,1,Low,1,7200, 36 months,1,debt_consolidation,6,Low,1,Bad Loan,1,7.9,A,1,7.98,7730.87,6744.17,64.1,225.29,409000000224,10-Jan-18,INDO GIBL Indiaforensic STL09011,"495,252.00",,571196.00,Poole,671,Germany,108872.45,1,1,1
226,2011,10,MORTGAGE,3,Low,1,26000, 60 months,2,home_improvement,7,High,2,Bad Loan,1,16.77,D,4,11.77,9622.45,3946.3,1284.25,642.96,409000000225,11-Jan-18,INDO GIBL Indiaforensic STL10011,"256,600.00",,314596.00,Bagley,670,France,198252.88,1,1,1
227,2011,6,MORTGAGE,3,Low,1,7000, 60 months,2,credit_card,1,Low,1,Bad Loan,1,11.71,B,2,26.22,6126.24,3452.36,883.68,154.69,409000000226,12-Jan-18,FDRL/INTERNAL FUND TRANSFE,,500000.00,814596.00,Ch'ien,694,France,26960.31,1,1,1
228,2011,0.5,RENT,1,Low,1,4000, 36 months,1,major_purchase,8,Low,1,Good Loan,0,7.51,A,1,18.17,4182.25,4000,0,124.45,409000000227,12-Jan-18,FDRL/INTERNAL FUND TRANSFE,,500000.00,1314596.00,Cattaneo,547,Germany,85746.52,1,1,1
229,2011,10,MORTGAGE,3,Medium,2,1500, 36 months,1,debt_consolidation,6,High,2,Good Loan,0,17.27,D,4,8.23,1521.6,1500,0,53.69,409000000228,12-Jan-18,FDRL/INTERNAL FUND TRANSFE,,500000.00,1814596.00,O'Sullivan,751,Germany,77206.25,1,1,1
230,2011,2,RENT,1,Low,1,19600, 36 months,1,credit_card,1,Low,1,Good Loan,0,12.42,B,2,11.62,21993.62,19600,0,654.94,409000000229,12-Jan-18,FDRL/INTERNAL FUND TRANSFE,,500000.00,2314596.00,Lucas,594,Germany,61048.53,1,1,1
231,2011,7,MORTGAGE,3,Low,1,2500, 36 months,1,debt_consolidation,6,Low,1,Good Loan,0,11.71,B,2,18.7,2894.74,2500,0,82.69,409000000230,15-Jan-18,INDO GIBL Indiaforensic STL14011,"5,000.00",,2309596.00,Ringrose,673,France,111981.19,1,1,1
232,2011,2,RENT,1,Low,1,10000, 36 months,1,credit_card,1,Low,1,Bad Loan,1,12.69,B,2,2.69,6351.59,4513.35,333.11,335.45,409000000231,15-Jan-18,INDO GIBL Indiaforensic STL11011,"348,200.00",,1961396.00,Freeman,610,France,62232.60,1,1,1
233,2011,5,RENT,1,Low,1,10000, 36 months,1,credit_card,1,Low,1,Good Loan,0,6.62,A,1,26.85,11051.5238,10000,0,307.04,409000000232,15-Jan-18,INDO GIBL Indiaforensic STL13011,"112,900.00",,1848496.00,Sergeyev,512,France,156105.03,1,1,1
234,2011,5,MORTGAGE,3,Low,1,4225, 36 months,1,other,4,Low,1,Good Loan,0,12.42,B,2,17.61,5081.022961,4225,0,141.18,409000000233,15-Jan-18,INDO GIBL Indiaforensic STL12011,"392,251.00",,1456245.00,Fiore,767,Germany,150135.38,1,1,1
235,2011,7,MORTGAGE,3,Low,1,3500, 36 months,1,vacation,11,Low,1,Good Loan,0,7.9,A,1,6.46,3942.078528,3500,0,109.52,409000000234,16-Jan-18,INDO GIBL Indiaforensic STL15011,"412,300.00",,1043945.00,Smith,585,France,93146.11,1,1,1
236,2011,10,MORTGAGE,3,Low,1,12000, 36 months,1,debt_consolidation,6,Low,1,Good Loan,0,6.62,A,1,13.65,13262.20515,12000,0,368.45,409000000235,17-Jan-18,INDO GIBL Indiaforensic STL16011,"518,375.00",,525570.00,Dumetochukwu,763,Germany,33462.94,1,1,1
237,2011,0.5,RENT,1,Low,1,16500, 36 months,1,debt_consolidation,6,Low,1,Good Loan,0,8.9,A,1,9.06,18856.75782,16500,0,523.93,409000000236,20-Jan-18,INDO GIBL Indiaforensic STL19011,"296,450.00",,229120.00,Pacheco,712,France,144375.00,1,1,1
238,2011,0.5,RENT,1,Low,1,22000, 60 months,2,debt_consolidation,6,High,2,Good Loan,0,21.67,F,6,15.62,25023.2,22000.01,0,603.5,409000000237,22-Jan-18,FDRL/INTERNAL FUND TRANSFE,,500000.00,729120.00,Synnot,539,Germany,55803.96,1,1,1
239,2011,1,RENT,1,Low,1,12000, 36 months,1,credit_card,1,High,2,Good Loan,0,14.65,C,3,14.87,12430.36,12000,0,413.94,409000000238,22-Jan-18,FDRL/INTERNAL FUND TRANSFE,,500000.00,1229120.00,Johnston,668,France,89048.46,1,1,1
240,2011,10,RENT,1,Low,1,15600, 60 months,2,vacation,11,Low,1,Good Loan,0,12.69,B,2,5.78,16894.08,11631.87,0,352.48,409000000239,23-Jan-18,INDO GIBL Indiaforensic STL22011,"274,600.00",,954520.00,Stevens,703,France,162812.16,1,1,1
241,2011,8,RENT,1,Medium,2,10800, 36 months,1,credit_card,1,Low,1,Good Loan,0,12.42,B,2,12.12,13004.14287,10800,0,360.89,409000000240,23-Jan-18,INDO GIBL Indiaforensic STL20011,"159,725.00",,794795.00,Grant,662,Spain,136259.65,1,1,1
242,2011,10,MORTGAGE,3,Low,1,14000, 36 months,1,credit_card,1,Low,1,Good Loan,0,12.42,B,2,7.35,16789.07137,14000,0,467.82,409000000241,23-Jan-18,INDO GIBL Indiaforensic STL21011,"69,000.00",,725795.00,Tsao,725,Germany,124052.97,1,1,1
243,2011,4,MORTGAGE,3,Low,1,18825, 60 months,2,debt_consolidation,6,High,2,Good Loan,0,17.58,D,4,24.98,22698.14,13625.93,0,473.75,409000000242,23-Jan-18,INDO GIBL Indiaforensic STL18011,"244,350.00",,481445.00,Barnes,703,France,74158.80,1,1,1
244,2011,5,MORTGAGE,3,Low,1,6000, 36 months,1,debt_consolidation,6,High,2,Good Loan,0,13.49,C,3,15.58,7325.298968,6000,0,203.59,409000000243,24-Jan-18,INDO GIBL Indiaforensic STL23011,"224,800.00",,256645.00,McIntosh,659,Germany,45071.09,1,1,1
245,2011,5,RENT,1,Low,1,12000, 36 months,1,debt_consolidation,6,Low,1,Good Loan,0,9.91,B,2,14.83,13905.99717,12000,0,386.7,409000000244,29-Jan-18,FDRL/INTERNAL FUND TRANSFE,,500000.00,756645.00,Madison,523,Spain,62030.06,1,1,1
246,2011,4,RENT,1,Low,1,10000, 36 months,1,debt_consolidation,6,Low,1,Good Loan,0,12.42,B,2,10.45,12025.47063,10000,0,334.16,409000000245,29-Jan-18,FDRL/INTERNAL FUND TRANSFE,,500000.00,1256645.00,Ifesinachi,635,France,131953.23,1,1,1
247,2011,2,RENT,1,Low,1,8000, 36 months,1,vacation,11,Low,1,Good Loan,0,7.9,A,1,6.09,8846.24,8000,0,250.33,409000000246,29-Jan-18,FDRL/INTERNAL FUND TRANSFE,,500000.00,1756645.00,Glazkov,772,Germany,79414.00,1,1,1
248,2011,1,RENT,1,Low,1,14125, 36 months,1,debt_consolidation,6,Low,1,Good Loan,0,9.91,B,2,23.13,16055.99,14125,0,455.18,409000000247,29-Jan-18,INDO GIBL Indiaforensic STL25011,"135,050.00",,1621595.00,Dimauro,545,France,199638.56,1,1,1
249,2011,5,RENT,1,Low,1,14000, 36 months,1,debt_consolidation,6,Low,1,Good Loan,0,12.69,B,2,19.24,16897.17981,14000,0,469.63,409000000248,29-Jan-18,INDO GIBL Indiaforensic STL26011,"31,300.00",,1590295.00,Wieck,634,Germany,157577.29,1,1,1
250,2011,3,RENT,1,Low,1,13200, 60 months,2,small_business,3,High,2,Good Loan,0,17.27,D,4,9.64,10200.26,8975,0,224.36,409000000249,29-Jan-18,INDO GIBL Indiaforensic STL27011,"20,500.00",,1569795.00,Liao,739,Germany,134420.75,1,1,1
251,2011,10,MORTGAGE,3,Low,1,4000, 36 months,1,vacation,11,High,2,Good Loan,0,19.03,E,5,20.59,4340.62,4000,0,146.69,409000000250,29-Jan-18,INDO GIBL Indiaforensic STL28011,"5,500.00",,1564295.00,Hughes,771,Germany,99805.99,1,1,1
252,2011,2,RENT,1,Low,1,4000, 36 months,1,debt_consolidation,6,Low,1,Bad Loan,1,12.69,B,2,6.86,2022.66,1373.86,150.58,134.18,409000000251,29-Jan-18,INDO GIBL Indiaforensic STL24011,"204,900.00",,1359395.00,Morrison,587,Spain,97932.68,1,1,1
253,2011,10,MORTGAGE,3,Low,1,10500, 36 months,1,debt_consolidation,6,Low,1,Good Loan,0,6.03,A,1,10.36,11503.77547,10500,0,319.58,409000000252,29-Jan-18,INDO GIBL Indiaforensic STL17011,"563,250.00",,796145.00,Matveyeva,681,France,170968.99,1,1,1
254,2011,10,OWN,2,Low,1,5500, 36 months,1,car,2,Low,1,Good Loan,0,7.9,A,1,6.65,6171.267137,5500,0,172.1,409000000253,30-Jan-18,INDO GIBL Indiaforensic STL29011,"207,100.00",,589045.00,Ku,544,Germany,57558.95,1,1,1
255,2011,1,RENT,1,Low,1,7350, 36 months,1,debt_consolidation,6,Low,1,Good Loan,0,11.71,B,2,22.51,8725.632456,7350,0,243.11,409000000254,31-Jan-18,INDO GIBL Indiaforensic STL30011,"138,250.00",,450795.00,Cheatham,696,Spain,176713.47,1,1,1
256,2011,10,RENT,1,Low,1,10000, 36 months,1,credit_card,1,Low,1,Bad Loan,1,12.42,B,2,18.31,11604.88,9635.96,12.02,334.16,409000000255,1-Feb-18,INDO GIBL Indiaforensic STL31011,"196,150.00",,254645.00,Yao,766,Spain,34283.23,1,1,1
257,2011,10,RENT,1,Low,1,12000, 36 months,1,debt_consolidation,6,Low,1,Good Loan,0,7.51,A,1,10.74,13456.32312,12000,0,373.33,409000000256,2-Feb-18,FDRL/INTERNAL FUND TRANSFE,,500000.00,754645.00,Kirkland,727,France,198637.34,1,1,1
258,2011,5,MORTGAGE,3,Low,1,5000, 60 months,2,home_improvement,7,Low,1,Good Loan,0,11.71,B,2,23.78,6534.43,5000,0,110.5,409000000257,2-Feb-18,FDRL/INTERNAL FUND TRANSFE,,500000.00,1254645.00,Rose,671,Germany,156917.12,1,1,1
259,2011,3,OWN,2,Low,1,8000, 60 months,2,other,4,Low,1,Good Loan,0,11.71,B,2,16.22,8306.47,8000,0,176.79,409000000258,2-Feb-18,FDRL/INTERNAL FUND TRANSFE,,500000.00,1754645.00,Jess,693,France,50457.20,1,1,1
260,2011,10,MORTGAGE,3,Low,1,4500, 36 months,1,other,4,Low,1,Good Loan,0,8.9,A,1,23.43,5050.37,4500,0,142.89,409000000259,3-Feb-18,INDO GIBL Indiaforensic STL02021,"119,675.00",,1634970.00,Welch,850,Germany,140075.55,1,1,1
261,2011,1,OWN,2,Low,1,18000, 36 months,1,credit_card,1,Low,1,Good Loan,0,12.42,B,2,12.51,21629.24351,18000,0,601.48,409000000260,3-Feb-18,INDO GIBL Indiaforensic STL01021,"137,775.00",,1497195.00,Ifeajuna,732,Germany,65323.11,1,1,1
262,2011,2,MORTGAGE,3,Low,1,12300, 60 months,2,debt_consolidation,6,High,2,Good Loan,0,13.49,C,3,12.76,13556.6,9125.24,0,282.96,409000000261,7-Feb-18,INDO GIBL Indiaforensic STL03021,"61,500.00",,1435695.00,Morton,726,Spain,64323.24,1,1,1
263,2011,6,RENT,1,Low,1,12000, 36 months,1,debt_consolidation,6,High,2,Good Loan,0,13.49,C,3,15.72,12761.93,12000,0,407.17,409000000262,7-Feb-18,INDO GIBL Indiaforensic STL05021,"138,350.00",,1297345.00,Rossi,557,France,14956.44,1,1,1
264,2011,10,MORTGAGE,3,Low,1,10000, 36 months,1,credit_card,1,High,2,Good Loan,0,13.49,C,3,5.88,12077.32731,10000,0,339.31,409000000263,7-Feb-18,INDO GIBL Indiaforensic STL06021,"239,400.00",,1057945.00,Reppert,682,France,111879.21,1,1,1
265,2011,7,MORTGAGE,3,Low,1,6000, 36 months,1,other,4,Low,1,Good Loan,0,7.9,A,1,8.87,6633.12,6000,0,187.75,409000000264,8-Feb-18,FDRL/INTERNAL FUND TRANSFE,,500000.00,1557945.00,Kang,738,Spain,18606.23,1,1,1
266,2011,4,RENT,1,Low,1,12000, 36 months,1,debt_consolidation,6,Low,1,Good Loan,0,12.69,B,2,22.2,14006.68,12000,0,402.54,409000000265,8-Feb-18,FDRL/INTERNAL FUND TRANSFE,,500000.00,2057945.00,Ch'iu,531,Spain,123137.01,1,1,1
267,2011,7,RENT,1,Low,1,12000, 36 months,1,other,4,Low,1,Bad Loan,1,8.9,A,1,9.13,10411.4,8330.52,516.32,381.04,409000000266,9-Feb-18,INDO GIBL Indiaforensic STL07021,"271,124.00",,1786821.00,Wallis,498,France,148528.24,1,1,1
268,2011,2,RENT,1,Low,1,7000, 36 months,1,debt_consolidation,6,Low,1,Good Loan,0,11.71,B,2,15.57,8331.940085,7000,0,231.54,409000000267,9-Feb-18,INDO GIBL Indiaforensic STL08021,"300,799.00",,1486022.00,Clark,651,France,13898.31,1,1,1
269,2011,8,MORTGAGE,3,Low,1,35000, 60 months,2,debt_consolidation,6,High,2,Good Loan,0,18.64,E,5,12,28061.33,26825,0,690.56,409000000268,16-Feb-18,INDO GIBL Indiaforensic STL09021,"334,900.00",,1151122.00,Fielding,549,Spain,81259.25,1,1,1
270,2011,1,RENT,1,Low,1,1400, 36 months,1,other,4,Low,1,Good Loan,0,7.9,A,1,10,1478.87,1400,0,43.81,409000000269,16-Feb-18,INDO GIBL Indiaforensic STL10021,"68,250.00",,1082872.00,Zetticci,791,Germany,161051.75,1,1,1
271,2011,10,RENT,1,Low,1,16000, 60 months,2,small_business,3,High,2,Bad Loan,1,13.49,C,3,16.22,10343.32,5147.59,1517.32,368.08,409000000270,16-Feb-18,INDO GIBL Indiaforensic STL13021,"307,125.00",,775747.00,Dulhunty,650,Spain,191599.67,1,1,1
272,2011,9,RENT,1,Low,1,3200, 36 months,1,debt_consolidation,6,Low,1,Good Loan,0,9.91,B,2,2.16,3709.19273,3200,0,103.12,409000000271,16-Feb-18,INDO GIBL Indiaforensic STL14021,"475,300.00",,300447.00,Bevington,733,Germany,48559.19,1,1,1
273,2011,1,RENT,1,Low,1,8000, 36 months,1,medical,9,Low,1,Good Loan,0,7.9,A,1,13.35,8986.263663,8000,0,250.33,409000000272,16-Feb-18,FDRL/INTERNAL FUND TRANSFE,,500000.00,800447.00,Boyle,811,Germany,186339.74,1,1,1
274,2011,0.5,RENT,1,Low,1,11875, 60 months,2,debt_consolidation,6,Low,1,Bad Loan,1,12.69,B,2,23.75,1185.35,285.76,651.01,268.32,409000000273,16-Feb-18,FDRL/INTERNAL FUND TRANSFE,,500000.00,1300447.00,Newton,707,France,33159.37,1,1,1
275,2011,9,MORTGAGE,3,Low,1,5000, 36 months,1,home_improvement,7,Low,1,Good Loan,0,6.03,A,1,3.82,5410.75,5000,0,152.18,409000000274,16-Feb-18,FDRL/INTERNAL FUND TRANSFE,,500000.00,1800447.00,Bowman,712,Germany,93883.53,1,1,1
276,2011,10,RENT,1,Low,1,1800, 36 months,1,small_business,3,Low,1,Good Loan,0,6.62,A,1,23.8,1880.09,1800,0,55.27,409000000275,17-Feb-18,INDO GIBL Indiaforensic STL12021,"594,328.00",,1206119.00,Dubinina,706,Spain,110899.30,1,1,1
277,2011,5,RENT,1,Low,1,35000, 36 months,1,debt_consolidation,6,Low,1,Good Loan,0,8.9,A,1,17.73,37304.76,35000,0,1111.37,409000000276,17-Feb-18,INDO GIBL Indiaforensic STL15021,"387,100.00",,819019.00,Toscani,756,France,11199.04,1,1,1
278,2011,5,RENT,1,Low,1,18000, 36 months,1,credit_card,1,Low,1,Good Loan,0,8.9,A,1,7,19883.16,18000,0,571.56,409000000277,19-Feb-18,FDRL/INTERNAL FUND TRANSFE,,500000.00,1319019.00,Chiazagomekpere,777,France,189992.97,1,1,1
279,2011,10,OWN,2,Low,1,14000, 36 months,1,debt_consolidation,6,Low,1,Bad Loan,1,7.9,A,1,19.74,6130.32,5053.24,0,438.07,409000000278,21-Feb-18,INDO GIBL Indiaforensic STL16021,"710,800.00",,608219.00,Allen,646,France,164255.69,1,1,1
280,2011,2,RENT,1,Low,1,5000, 36 months,1,debt_consolidation,6,Low,1,Good Loan,0,12.42,B,2,20.06,5501.16,5000,0,167.08,409000000279,21-Feb-18,INDO GIBL Indiaforensic STL17021,"385,400.00",,222819.00,K'ung,714,France,152167.79,1,1,1
281,2011,4,RENT,1,Low,1,8000, 36 months,1,credit_card,1,High,2,Good Loan,0,15.96,C,3,14.04,9993.120439,8000,0,281.1,409000000280,22-Feb-18,FDRL/INTERNAL FUND TRANSFE,,500000.00,722819.00,Wilsmore,782,France,33949.67,1,1,1
282,2011,9,MORTGAGE,3,Low,1,10000, 36 months,1,debt_consolidation,6,Low,1,Good Loan,0,6.03,A,1,12.99,10840.08,10000,0,304.36,409000000281,22-Feb-18,FDRL/INTERNAL FUND TRANSFE,,500000.00,1222819.00,Hargreaves,775,Spain,68143.93,1,1,1
283,2011,5,RENT,1,Low,1,10000, 36 months,1,debt_consolidation,6,Low,1,Good Loan,0,7.51,A,1,4.63,11019.26,10000,0,311.11,409000000282,22-Feb-18,INDO GIBL Indiaforensic STL18021,"79,350.00",,1143469.00,Huang,479,Germany,47251.79,1,1,1
284,2011,10,MORTGAGE,3,Low,1,12000, 36 months,1,debt_consolidation,6,Low,1,Good Loan,0,12.42,B,2,18.51,14432.91814,12000,0,400.99,409000000283,22-Feb-18,INDO GIBL Indiaforensic STL19021,"385,200.00",,758269.00,Ch'ien,807,France,25885.72,1,1,1
285,2011,3,MORTGAGE,3,Low,1,23200, 36 months,1,debt_consolidation,6,Low,1,Good Loan,0,7.9,A,1,27.99,24554.42,23199.99,0,725.94,409000000284,22-Feb-18,INDO GIBL Indiaforensic STL20021,"299,950.00",,458319.00,Wallwork,799,France,192633.85,1,1,1
286,2011,1,MORTGAGE,3,Low,1,18000, 60 months,2,credit_card,1,High,2,Good Loan,0,15.27,C,3,11.41,20631.16,13208.94,0,430.78,409000000285,22-Feb-18,FDRL/INTERNAL FUND TRANSFE,,500000.00,958319.00,Chu,675,France,34577.36,1,1,1
287,2011,10,MORTGAGE,3,Low,1,4800, 36 months,1,debt_consolidation,6,High,2,Good Loan,0,15.27,C,3,9.3,6005.123937,4800,0,167.03,409000000286,23-Feb-18,FDRL/INTERNAL FUND TRANSFE,,500000.00,1458319.00,Kang,602,Spain,161229.84,1,1,1
288,2011,6,RENT,1,Low,1,7300, 36 months,1,debt_consolidation,6,Low,1,Good Loan,0,11.71,B,2,16.42,8654.581877,7300,0,241.46,409000000287,26-Feb-18,INDO GIBL Indiaforensic STL21021,"273,500.00",,1184819.00,Davidson,475,France,100816.29,1,1,1
289,2011,6,RENT,1,Low,1,10400, 36 months,1,debt_consolidation,6,Low,1,Good Loan,0,9.91,B,2,11.67,12022.8865,10400,0,335.14,409000000288,26-Feb-18,INDO GIBL Indiaforensic STL22021,"237,500.00",,947319.00,O'Donnell,744,Spain,181694.44,1,1,1
290,2011,1,MORTGAGE,3,Low,1,6600, 36 months,1,house,12,Low,1,Good Loan,0,9.91,B,2,15.53,7274.62,6600,0,212.69,409000000289,26-Feb-18,INDO GIBL Indiaforensic STL23021,"277,753.00",,669566.00,Nnachetam,588,Spain,79078.91,1,1,1
291,2011,7,OWN,2,Low,1,12000, 36 months,1,debt_consolidation,6,Low,1,Good Loan,0,8.9,A,1,9.45,13715.45783,12000,0,381.04,409000000290,26-Feb-18,INDO GIBL Indiaforensic STL24021,"70,300.00",,599266.00,Chidiebele,703,Germany,137316.32,1,1,1
292,2011,10,RENT,1,Low,1,13250, 36 months,1,debt_consolidation,6,High,2,Good Loan,0,17.27,D,4,23.7,15650.39,13250,0,474.19,409000000291,26-Feb-18,INDO GIBL Indiaforensic STL25021,"62,400.00",,536866.00,Ahmed,747,Spain,194926.86,1,1,1
293,2011,3,RENT,1,Low,1,12000, 36 months,1,debt_consolidation,6,Low,1,Good Loan,0,11.71,B,2,15.97,14286.72251,12000,0,396.92,409000000292,26-Feb-18,FDRL/INTERNAL FUND TRANSFE,,500000.00,1036866.00,Booth,583,France,51285.49,1,1,1
294,2011,9,RENT,1,Low,1,25000, 36 months,1,debt_consolidation,6,Low,1,Good Loan,0,9.91,B,2,10.35,29000.83503,25000,0,805.63,409000000293,26-Feb-18,FDRL/INTERNAL FUND TRANSFE,,500000.00,1536866.00,Chuang,750,Spain,150401.53,1,1,1
295,2011,10,RENT,1,Low,1,6000, 36 months,1,other,4,Low,1,Good Loan,0,10.65,B,2,14.43,7033.840265,6000,0,195.44,409000000294,27-Feb-18,INDO GIBL Indiaforensic STL26021,"103,300.00",,1433566.00,Shao,681,France,112491.96,1,1,1
296,2011,10,MORTGAGE,3,Low,1,12000, 36 months,1,credit_card,1,Low,1,Good Loan,0,7.51,A,1,7.08,12554.01,12000,0,373.33,409000000295,28-Feb-18,INDO GIBL Indiaforensic STL27021,"182,450.00",,1251116.00,Tsao,773,France,73656.38,1,1,1
297,2011,1,RENT,1,Low,1,14400, 36 months,1,credit_card,1,Low,1,Good Loan,0,11.71,B,2,16.35,15543.7,14400,0,476.3,409000000296,1-Mar-18,FDRL/INTERNAL FUND TRANSFE,,500000.00,1751116.00,Tien,714,France,106636.89,1,1,1
298,2011,10,RENT,1,Low,1,10000, 36 months,1,credit_card,1,Low,1,Good Loan,0,12.42,B,2,11.58,12026.29966,10000,0,334.16,409000000297,1-Mar-18,FDRL/INTERNAL FUND TRANSFE,,500000.00,2251116.00,Chang,687,Spain,155853.52,1,1,1
299,2011,1,RENT,1,Medium,2,8000, 36 months,1,credit_card,1,Low,1,Good Loan,0,11.71,B,2,2.48,9522.45744,8000,0,264.61,409000000298,5-Mar-18,INDO GIBL Indiaforensic STL03031,"155,500.00",,2095616.00,Johnson,511,France,162599.51,1,1,1
300,2011,5,RENT,1,Low,1,8000, 36 months,1,credit_card,1,High,2,Bad Loan,1,16.29,D,4,13.22,4533.54,2798.78,298.32,282.41,409000000299,7-Mar-18,INDO GIBL Indiaforensic STL28021,"244,350.00",,1851266.00,French,627,France,103737.82,1,1,1
301,2011,3,RENT,1,Low,1,30000, 60 months,2,small_business,3,Low,1,Bad Loan,1,12.42,B,2,0.94,17179.15,8464.18,3001.66,673.72,409000000300,7-Mar-18,INDO GIBL Indiaforensic STL01031,"202,799.00",,1648467.00,Efremov,694,France,160990.27,1,1,1
302,2011,6,OWN,2,Low,1,18000, 60 months,2,home_improvement,7,High,2,Bad Loan,1,16.77,D,4,18.42,11229.37,4677.94,1899.49,445.13,409000000301,7-Mar-18,INDO GIBL Indiaforensic STL03031,"155,500.00",,1492967.00,Hartley,616,Spain,15462.84,1,1,1
303,2011,2,OWN,2,Low,1,13250, 36 months,1,credit_card,1,Low,1,Good Loan,0,11.71,B,2,22.35,15775.48747,13250,0,438.26,409000000302,7-Mar-18,INDO GIBL Indiaforensic STL05031,"153,300.00",,1339667.00,Calabrese,687,France,10334.05,1,1,1
304,2011,6,RENT,1,Low,1,14000, 36 months,1,debt_consolidation,6,High,2,Good Loan,0,14.27,C,3,16.21,17282.30673,14000,0,480.33,409000000303,7-Mar-18,INDO GIBL Indiaforensic STL06031,"350,150.00",,989517.00,Chiu,712,France,190686.16,1,1,1
305,2011,10,OWN,2,Low,1,20000, 60 months,2,debt_consolidation,6,High,2,Bad Loan,1,20.3,E,5,20.91,16063.42,6317.7,1954.88,533.23,409000000304,8-Mar-18,INDO GIBL Indiaforensic STL07031,"371,900.00",,617617.00,Brennan,553,France,94440.45,1,1,1
306,2011,10,RENT,1,Low,1,10000, 36 months,1,credit_card,1,High,2,Good Loan,0,16.29,D,4,24.39,12455.59,10000,0,353.01,409000000305,9-Mar-18,INDO GIBL Indiaforensic STL08031,"345,930.00",,271687.00,Onwuatuegwu,667,France,28257.63,1,1,1
307,2011,5,RENT,1,Low,1,35000, 60 months,2,debt_consolidation,6,High,2,Good Loan,0,20.3,E,5,20.16,36085.55828,23250,0,619.88,409000000306,9-Mar-18,FDRL/INTERNAL FUND TRANSFE,,500000.00,771687.00,Hewitt,731,France,170034.95,1,1,1
308,2011,1,RENT,1,Low,1,4000, 36 months,1,debt_consolidation,6,Low,1,Good Loan,0,6.03,A,1,7.05,4355.443114,4000,0,121.75,409000000307,9-Mar-18,FDRL/INTERNAL FUND TRANSFE,,500000.00,1271687.00,Shih,629,Germany,31824.29,1,1,1
309,2011,6,RENT,1,Medium,2,13000, 36 months,1,debt_consolidation,6,Low,1,Good Loan,0,9.91,B,2,8.38,14957.75365,13000,0,418.93,409000000308,12-Mar-18,INDO GIBL Indiaforensic STL09031,"390,850.00",,880837.00,Balashov,614,France,127166.49,1,1,1
310,2011,5,RENT,1,Low,1,28000, 36 months,1,credit_card,1,Low,1,Good Loan,0,12.69,B,2,12.35,33809.04918,28000,0,939.26,409000000309,12-Mar-18,INDO GIBL Indiaforensic STL1003,"85,800.00",,795037.00,Doyle,438,Germany,44937.01,1,1,1
311,2011,3,RENT,1,Low,1,10000, 36 months,1,debt_consolidation,6,High,2,Good Loan,0,13.49,C,3,11.52,11250.9,10000,0,339.31,409000000310,12-Mar-18,INDO GIBL Indiaforensic STL11031,"45,000.00",,750037.00,Pokrovskii,652,France,188603.07,1,1,1
312,2011,0.5,RENT,1,Low,1,20000, 36 months,1,debt_consolidation,6,Low,1,Good Loan,0,7.9,A,1,9.25,22527.93726,20000,0,625.81,409000000311,12-Mar-18,FDRL/INTERNAL FUND TRANSFE,,500000.00,1250037.00,Collins,729,Germany,145111.37,1,1,1
313,2011,5,RENT,1,Medium,2,18000, 36 months,1,debt_consolidation,6,Low,1,Good Loan,0,9.91,B,2,10,19205.83,18000,0,580.05,409000000312,12-Mar-18,FDRL/INTERNAL FUND TRANSFE,,500000.00,1750037.00,Russo,642,France,171463.83,1,1,1
314,2011,3,RENT,1,Low,1,9000, 60 months,2,credit_card,1,High,2,Bad Loan,1,19.91,E,5,22.56,5227.64,2327.73,0,238,409000000313,13-Mar-18,INDO GIBL Indiaforensic STL12031,"577,493.00",,1172544.00,Skinner,806,Germany,182822.50,1,1,1
315,2011,10,RENT,1,Low,1,25000, 60 months,2,debt_consolidation,6,High,2,Bad Loan,1,18.64,E,5,12.6,25775.38,13993.4,17.68,643.58,409000000314,14-Mar-18,INDO GIBL Indiaforensic STL13031,"556,224.00",,616320.00,Robertson,744,Spain,87213.33,1,1,1
316,2011,3,RENT,1,Low,1,10000, 36 months,1,other,4,Low,1,Good Loan,0,11.71,B,2,8.69,11838.8778,10000,0,330.76,409000000315,14-Mar-18,FDRL/INTERNAL FUND TRANSFE,,500000.00,1116320.00,Atkinson,474,Spain,57175.32,1,1,1
317,2011,3,RENT,1,Low,1,4200, 36 months,1,credit_card,1,Low,1,Good Loan,0,6.03,A,1,8.92,4601.62011,4200,0,127.83,409000000316,14-Mar-18,FDRL/INTERNAL FUND TRANSFE,,500000.00,1616320.00,Doyle,559,France,120540.83,1,1,1
318,2011,10,OWN,2,Low,1,20000, 60 months,2,debt_consolidation,6,High,2,Bad Loan,1,15.27,C,3,10.79,5797.78,2367.51,1024.88,478.64,409000000317,15-Mar-18,INDO GIBL Indiaforensic STL14031,"425,700.00",,1190620.00,Ritchie,706,Spain,28714.34,1,1,1
319,2011,1,MORTGAGE,3,Low,1,18000, 60 months,2,debt_consolidation,6,High,2,Bad Loan,1,17.27,D,4,7.82,19767.48,11594.61,0,449.97,409000000318,16-Mar-18,INDO GIBL Indiaforensic STL15031,"213,463.00",,977157.00,McEncroe,628,Spain,85426.28,1,1,1
320,2011,2,RENT,1,Low,1,24000, 36 months,1,debt_consolidation,6,High,2,Good Loan,0,16.29,D,4,8.83,30497.29156,24000,0,847.21,409000000319,16-Mar-18,FDRL/INTERNAL FUND TRANSFE,,500000.00,1477157.00,Pearson,429,France,46170.75,1,1,1
321,2011,3,RENT,1,Low,1,4475, 36 months,1,credit_card,1,High,2,Good Loan,0,15.27,C,3,18.79,5601.556133,4475,0,155.72,409000000320,17-Mar-18,INDO GIBL Indiaforensic STL16031,"199,983.00",,1277174.00,Gordon,525,Spain,64448.36,1,1,1
322,2011,2,MORTGAGE,3,Low,1,20000, 60 months,2,credit_card,1,High,2,Good Loan,0,14.65,C,3,12.15,22660.12,14758.56,0,472.14,409000000321,19-Mar-18,INDO GIBL Indiaforensic STL17031,"230,510.00",,1046664.00,Ts'ai,680,France,16278.97,1,1,1
323,2011,5,RENT,1,Low,1,12000, 36 months,1,credit_card,1,Low,1,Good Loan,0,12.42,B,2,22.49,14431.5364,12000,0,400.99,409000000322,19-Mar-18,INDO GIBL Indiaforensic STL18031,"10,000.00",,1036664.00,Lung,749,France,182855.42,1,1,1
324,2011,6.05,MORTGAGE,3,Low,1,18000, 60 months,2,debt_consolidation,6,High,2,Good Loan,0,17.58,D,4,21.96,26369.52552,18000,0,452.98,409000000323,20-Mar-18,INDO GIBL Indiaforensic STL19031,"335,250.00",,701414.00,Yuan,763,France,50404.72,1,1,1
325,2011,2,RENT,1,Low,1,5000, 36 months,1,debt_consolidation,6,Low,1,Bad Loan,1,12.42,B,2,23.84,833.7,587.51,0,167.08,409000000324,20-Mar-18,FDRL/INTERNAL FUND TRANSFE,,500000.00,1201414.00,Pardey,734,France,107640.25,1,1,1
326,2011,5,RENT,1,Low,1,3000, 36 months,1,other,4,Low,1,Good Loan,0,6.03,A,1,5.5,3207.71,3000,0,91.31,409000000325,20-Mar-18,Indfor INCM INDO REVREMI0303,,1320.00,1202734.00,Tai,716,France,134132.65,1,1,1
327,2011,10,RENT,1,Low,1,25000, 60 months,2,debt_consolidation,6,High,2,Good Loan,0,19.03,E,5,19.63,31102.15,17938.36,0,648.93,409000000326,20-Mar-18,INDO GIBLOXGN REVSTL03031,,155500.00,1358234.00,Scott,594,France,103480.69,1,1,1
328,2011,3,RENT,1,Low,1,18000, 60 months,2,credit_card,1,High,2,Good Loan,0,19.03,E,5,11.32,22392.2,12914.45,0,467.23,409000000327,20-Mar-18,Indfor INCM INDO REVREMI0103,,202799.00,1561033.00,Hunter,644,France,108761.05,1,1,1
329,2011,10,RENT,1,Low,1,12000, 36 months,1,debt_consolidation,6,Low,1,Bad Loan,1,9.91,B,2,13,5851.68,4244.34,444.88,386.7,409000000328,20-Mar-18,INDO GIBL Indiaforensic STL01031,"200,799.00",,1360234.00,Mazzanti,671,Germany,179012.30,1,1,1
330,2011,10,MORTGAGE,3,Low,1,20000, 36 months,1,other,4,High,2,Good Loan,0,15.27,C,3,4.34,25041.22844,20000,0,695.96,409000000329,22-Mar-18,INDO GIBL Indiaforensic STL20031,"434,450.00",,925784.00,L?,664,Germany,95145.14,1,1,1
331,2011,3,RENT,1,Low,1,10000, 36 months,1,debt_consolidation,6,High,2,Good Loan,0,13.49,C,3,13.87,12155.9177,10000,0,339.31,409000000330,22-Mar-18,INDO GIBL Indiaforensic STL21031,"292,175.00",,633609.00,Beach,656,France,72143.44,1,1,1
332,2011,6,OWN,2,Medium,2,15000, 36 months,1,debt_consolidation,6,Low,1,Good Loan,0,12.42,B,2,17.85,17713.89,15000,0,501.23,409000000331,22-Mar-18,FDRL/INTERNAL FUND TRANSFE,,500000.00,1133609.00,Hsieh,667,Spain,19162.89,1,1,1
333,2011,0.5,MORTGAGE,3,Low,1,12000, 36 months,1,debt_consolidation,6,Low,1,Good Loan,0,7.9,A,1,8.71,13448.7262,12000,0,375.49,409000000332,22-Mar-18,FDRL/INTERNAL FUND TRANSFE,,500000.00,1633609.00,Faulkner,663,Germany,144680.18,1,1,1
334,2011,2,MORTGAGE,3,Medium,2,20000, 60 months,2,debt_consolidation,6,Low,1,Good Loan,0,10.65,B,2,5.23,13903.92,10150.15,0,290.64,409000000333,23-Mar-18,INDO GIBL Indiaforensic STL22031,"301,200.00",,1332409.00,Knowles,584,Germany,177772.03,1,1,1
335,2011,2,RENT,1,Low,1,6300, 36 months,1,credit_card,1,Low,1,Good Loan,0,11.71,B,2,7.2,7499.162449,6300,0,208.38,409000000334,23-Mar-18,FDRL/INTERNAL FUND TRANSFE,,500000.00,1832409.00,Day,626,Spain,5597.94,1,1,1
336,2011,7,RENT,1,Low,1,20000, 60 months,2,credit_card,1,High,2,Good Loan,0,16.77,D,4,22.82,23717.44,14559.42,0,494.59,409000000335,26-Mar-18,INDO GIBL Indiaforensic STL23031,"218,975.00",,1613434.00,Hsueh,485,France,116828.51,1,1,1
337,2011,8,MORTGAGE,3,High,3,35000, 60 months,2,debt_consolidation,6,High,2,Good Loan,0,17.27,D,4,7.94,26012.99,23150,0,578.71,409000000336,26-Mar-18,INDO GIBL Indiaforensic STL24031,"44,800.00",,1568634.00,Tsao,659,Germany,174652.51,1,1,1
338,2011,2,MORTGAGE,3,Low,1,8250, 60 months,2,home_improvement,7,High,2,Good Loan,0,15.96,C,3,15.6,10423.49,8250,0,200.45,409000000337,26-Mar-18,INDO GIBL Indiaforensic STL25031,"12,000.00",,1556634.00,Kennedy,649,France,2010.98,1,1,1
339,2011,7,OWN,2,Low,1,20000, 60 months,2,home_improvement,7,Low,1,Good Loan,0,12.69,B,2,10.21,21660.78,14914.19,0,451.9,409000000338,27-Mar-18,INDO GIBL Indiaforensic STL26031,"259,150.00",,1297484.00,Nwabugwu,805,Spain,14109.85,1,1,1
340,2011,5,RENT,1,Low,1,10000, 36 months,1,credit_card,1,Low,1,Bad Loan,1,11.71,B,2,21.83,1958.97,1186.67,308.22,330.76,409000000339,28-Mar-18,INDO GIBL Indiaforensic STL27031,"139,650.00",,1157834.00,Young,716,Germany,43527.40,1,1,1
341,2011,10,MORTGAGE,3,Medium,2,24000, 36 months,1,car,2,Low,1,Bad Loan,1,8.9,A,1,3.94,8649.71,6036.95,1032.31,762.08,409000000340,31-Mar-18,INDO GIBL Indiaforensic STL28031,"164,600.00",,993234.00,Kerr,642,Germany,86099.23,1,1,1
342,2011,9,MORTGAGE,3,Low,1,14400, 36 months,1,debt_consolidation,6,Low,1,Good Loan,0,12.69,B,2,20.16,17385.83708,14400,0,483.05,409000000341,31-Mar-18,INDO GIBL Indiaforensic STL29031,"81,675.00",,911559.00,Tien,659,France,161574.19,1,1,1
343,2011,7,RENT,1,Low,1,6000, 36 months,1,credit_card,1,High,2,Good Loan,0,14.65,C,3,21.39,7463.193559,6000,0,206.97,409000000342,31-Mar-18,INDO GIBL Indiaforensic STL30031,"85,750.00",,825809.00,Marrero,545,Spain,38970.14,1,1,1
344,2011,5,MORTGAGE,3,Low,1,22000, 36 months,1,debt_consolidation,6,High,2,Good Loan,0,15.96,C,3,22.47,27811.73074,22000,0,773.03,409000000343,31-Mar-18,FDRL/INTERNAL FUND TRANSFE,,500000.00,1325809.00,White,543,France,127587.22,1,1,1
345,2011,10,RENT,1,Low,1,12000, 36 months,1,debt_consolidation,6,Low,1,Bad Loan,1,11.71,B,2,16.36,3564.9,2613.54,0,396.92,409000000344,5-Apr-18,FDRL/INTERNAL FUND TRANSFE,,500000.00,1825809.00,Pisano,718,France,30380.12,1,1,1
346,2011,0.5,MORTGAGE,3,Medium,2,16000, 36 months,1,debt_consolidation,6,High,2,Good Loan,0,16.77,D,4,17.2,20462.90627,16000,0,568.62,409000000345,5-Apr-18,FDRL/INTERNAL FUND TRANSFE,,500000.00,2325809.00,Brown,840,France,90908.95,1,1,1
347,2011,10,MORTGAGE,3,Low,1,10000, 36 months,1,debt_consolidation,6,Low,1,Good Loan,0,10.65,B,2,11.16,11723.71263,10000,0,325.74,409000000346,6-Apr-18,INDO GIBL Indiaforensic STL31031,"150,950.00",,2174859.00,Freeman,630,Germany,138275.01,1,1,1
348,2011,8,MORTGAGE,3,Low,1,16000, 60 months,2,home_improvement,7,High,2,Good Loan,0,19.03,E,5,16.89,14442.38,8333.95,0,301.76,409000000347,6-Apr-18,INDO GIBL Indiaforensic STL01041,"20,000.00",,2154859.00,Russell,643,Germany,32171.79,1,1,1
349,2011,2,RENT,1,Low,1,10000, 36 months,1,debt_consolidation,6,Low,1,Bad Loan,1,12.69,B,2,12.03,7690.46,5358.77,660.29,335.45,409000000348,6-Apr-18,INDO GIBL Indiaforensic STL02041,"26,400.00",,2128459.00,Seleznyov,654,Germany,126143.23,1,1,1
350,2011,7,RENT,1,Low,1,3500, 36 months,1,debt_consolidation,6,High,2,Good Loan,0,13.49,C,3,10.35,3615.21,3500,0,118.76,409000000349,6-Apr-18,INDO GIBL Indiaforensic STL03041,"109,650.00",,2018809.00,Yusupova,582,France,129892.93,1,1,1
351,2011,5,RENT,1,Low,1,9600, 36 months,1,debt_consolidation,6,Low,1,Good Loan,0,9.91,B,2,16.49,11082.04967,9600,0,309.36,409000000350,6-Apr-18,INDO GIBL Indiaforensic STL04041,"318,100.00",,1700709.00,Foley,659,Spain,102416.84,1,1,1
352,2011,10,MORTGAGE,3,Low,1,9875, 36 months,1,debt_consolidation,6,Low,1,Good Loan,0,7.9,A,1,24.03,11122.69106,9875,0,309,409000000351,6-Apr-18,INDO GIBL Indiaforensic STL05041,"309,200.00",,1391509.00,Shih,762,Spain,18719.67,1,1,1
353,2011,2,OWN,2,Low,1,21500, 60 months,2,debt_consolidation,6,High,2,Good Loan,0,17.58,D,4,22.86,19857.78,16975,0,427.19,409000000352,7-Apr-18,INDO GIBL Indiaforensic STL06041,"303,600.00",,1087909.00,Ikedinachukwu,568,Spain,61936.22,1,1,1
354,2011,6,RENT,1,Low,1,4800, 36 months,1,debt_consolidation,6,Low,1,Good Loan,0,7.9,A,1,13,5080.25,4800,0,150.2,409000000353,9-Apr-18,INDO GIBL Indiaforensic STL07041,"48,800.00",,1039109.00,Power,670,Spain,78358.94,1,1,1
355,2011,10,OWN,2,Low,1,7800, 36 months,1,major_purchase,8,Low,1,Good Loan,0,6.03,A,1,0.78,8545.840368,7800,0,237.4,409000000354,9-Apr-18,FDRL/INTERNAL FUND TRANSFE,,500000.00,1539109.00,Amos,613,France,147224.27,1,1,1
356,2011,10,MORTGAGE,3,Low,1,20000, 36 months,1,credit_card,1,High,2,Good Loan,0,14.27,C,3,6.21,23996.94,20000,0,686.18,409000000355,10-Apr-18,INDO GIBL Indiaforensic STL09041,"305,950.00",,1233159.00,Reed,539,France,160979.66,1,1,1
357,2011,4,RENT,1,Low,1,9750, 36 months,1,debt_consolidation,6,Low,1,Bad Loan,1,7.51,A,1,29.04,5150.83,4327.31,0,303.34,409000000356,11-Apr-18,FDRL/INTERNAL FUND TRANSFE,,500000.00,1733159.00,Simmons,850,Spain,132298.49,1,1,1
358,2011,6,MORTGAGE,3,Low,1,18000, 60 months,2,credit_card,1,High,2,Good Loan,0,15.96,C,3,23.41,18879.1,15050,0,365.67,409000000357,11-Apr-18,INDO GIBL Indiaforensic STL10041,"162,600.00",,1570559.00,Ricci,522,Spain,174248.52,1,1,1
359,2011,9,MORTGAGE,3,Low,1,5000, 36 months,1,other,4,Low,1,Good Loan,0,6.03,A,1,16.48,5451.029788,5000,0,152.18,409000000358,12-Apr-18,INDO GIBL Indiaforensic STL11041,"639,700.00",,930859.00,Yen,737,France,123547.28,1,1,1
360,2011,4,RENT,1,Low,1,9000, 36 months,1,debt_consolidation,6,High,2,Good Loan,0,14.65,C,3,17.01,10750.2,9000,0,310.45,409000000359,12-Apr-18,FDRL/INTERNAL FUND TRANSFE,,500000.00,1430859.00,Campbell,520,France,32790.02,1,1,1
361,2011,1,RENT,1,Low,1,7200, 36 months,1,debt_consolidation,6,Low,1,Good Loan,0,7.9,A,1,11.98,8109.259708,7200,0,225.29,409000000360,13-Apr-18,INDO GIBL Indiaforensic STL12041,"363,900.00",,1066959.00,West,706,Spain,181543.67,1,1,1
362,2011,3,RENT,1,Low,1,3000, 60 months,2,other,4,High,2,Good Loan,0,19.03,E,5,10.73,3729.4,2151.55,0,77.88,409000000361,13-Apr-18,FDRL/INTERNAL FUND TRANSFE,,500000.00,1566959.00,Robinson,643,Germany,2319.96,1,1,1
363,2011,10,RENT,1,Low,1,25000, 60 months,2,credit_card,1,High,2,Bad Loan,1,19.42,E,5,20.04,26721.85,11624.71,3842.06,654.31,409000000362,13-Apr-18,FDRL/INTERNAL FUND TRANSFE,,500000.00,2066959.00,Bianchi,648,France,189543.19,1,1,1
364,2011,8,OWN,2,Low,1,25000, 36 months,1,debt_consolidation,6,High,2,Good Loan,0,15.27,C,3,18.5,28094.27,25000,0,869.95,409000000363,16-Apr-18,INDO GIBL Indiaforensic STL13041,"347,950.00",,1719009.00,Chen,443,Germany,10940.40,1,1,1
365,2011,10,RENT,1,Low,1,10000, 36 months,1,debt_consolidation,6,High,2,Good Loan,0,15.96,C,3,13.09,12641.96658,10000,0,351.38,409000000364,16-Apr-18,INDO GIBL Indiaforensic STL14041,"76,900.00",,1642109.00,Madukaego,640,France,199493.38,1,1,1
366,2011,5,MORTGAGE,3,Low,1,8875, 36 months,1,debt_consolidation,6,Low,1,Bad Loan,1,12.69,B,2,23.11,2046.9,1251.86,266.46,297.72,409000000365,16-Apr-18,INDO GIBL Indiaforensic STL15041,"48,000.00",,1594109.00,Ibrahimova,628,Spain,188193.25,1,1,1
367,2011,10,RENT,1,Low,1,15550, 36 months,1,debt_consolidation,6,Low,1,Good Loan,0,11.71,B,2,23.36,18510.72498,15550,0,514.34,409000000366,17-Apr-18,INDO GIBL Indiaforensic STL16041,"555,650.00",,1038459.00,Nolan,540,Germany,172572.64,1,1,1
368,2011,8,RENT,1,Low,1,17000, 60 months,2,debt_consolidation,6,High,2,Good Loan,0,15.27,C,3,16.84,19520.54,12474.13,0,406.85,409000000367,18-Apr-18,FDRL/INTERNAL FUND TRANSFE,,500000.00,1538459.00,Scott,460,Germany,189339.60,1,1,1
369,2011,5,RENT,1,Low,1,7500, 36 months,1,credit_card,1,Low,1,Good Loan,0,12.69,B,2,4.41,9051.843018,7500,0,251.59,409000000368,18-Apr-18,INDO GIBL Indiaforensic STL17041,"574,150.00",,964309.00,Blair,636,Germany,53512.16,1,1,1
370,2011,6,OWN,2,Low,1,8875, 36 months,1,debt_consolidation,6,Low,1,Good Loan,0,8.9,A,1,24.29,10143.38219,8875,0,281.81,409000000369,19-Apr-18,INDO GIBL Indiaforensic STL18041,"388,550.00",,575759.00,Monaldo,593,France,34004.44,1,1,1
371,2011,1,RENT,1,Low,1,4500, 36 months,1,credit_card,1,High,2,Good Loan,0,17.27,D,4,4.34,5505.07469,4500,0,161.05,409000000370,19-Apr-18,FDRL/INTERNAL FUND TRANSFE,,500000.00,1075759.00,Sutherland,801,Spain,10598.29,1,1,1
372,2011,3,RENT,1,Low,1,5800, 36 months,1,debt_consolidation,6,Low,1,Good Loan,0,12.42,B,2,21.67,6975.276078,5800,0,193.81,409000000371,20-Apr-18,INDO GIBL Indiaforensic STL19041,"276,300.00",,799459.00,Cole,640,Germany,113428.77,1,1,1
373,2011,2,RENT,1,Low,1,10000, 36 months,1,debt_consolidation,6,Low,1,Good Loan,0,11.71,B,2,22.26,11816.14343,10000,0,330.76,409000000372,21-Apr-18,INDO GIBL Indiaforensic STL20041,"167,591.00",,631868.00,Briggs,611,Germany,183487.98,1,1,1
374,2011,4,RENT,1,Low,1,10000, 36 months,1,credit_card,1,Low,1,Good Loan,0,9.91,B,2,19.06,11398.55,10000,0,322.25,409000000373,21-Apr-18,FDRL/INTERNAL FUND TRANSFE,,500000.00,1131868.00,Gregory,802,Germany,187658.09,1,1,1
375,2011,1,RENT,1,Low,1,14000, 36 months,1,credit_card,1,Low,1,Good Loan,0,11.71,B,2,12.97,15609.96,14000,0,463.07,409000000374,21-Apr-18,FDRL/INTERNAL FUND TRANSFE,,500000.00,1631868.00,Bianchi,717,Germany,172459.39,1,1,1
376,2011,3,MORTGAGE,3,Low,1,25000, 60 months,2,credit_card,1,High,2,Good Loan,0,19.03,E,5,17.15,31161.59,17943.87,0,648.93,409000000375,25-Apr-18,INDO GIBL Indiaforensic STL21041,"242,700.00",,1389168.00,Angelo,769,France,21016.00,1,1,1
377,2011,3,RENT,1,Low,1,12000, 36 months,1,debt_consolidation,6,Low,1,Bad Loan,1,8.9,A,1,6.75,8740.16,6603.89,745.46,381.04,409000000376,25-Apr-18,INDO GIBL Indiaforensic STL22041,"92,900.00",,1296268.00,Gardiner,745,Germany,122381.02,1,1,1
378,2011,6,OWN,2,Low,1,24000, 36 months,1,debt_consolidation,6,Low,1,Good Loan,0,7.9,A,1,10.58,27033.33153,24000,0,750.97,409000000377,25-Apr-18,INDO GIBL Indiaforensic STL23041,"315,750.00",,980518.00,Kerr,572,Spain,128123.66,1,1,1
379,2011,0.5,RENT,1,Low,1,14000, 36 months,1,credit_card,1,High,2,Good Loan,0,14.27,C,3,3.3,17230.07652,14000,0,480.33,409000000378,25-Apr-18,INDO GIBL Indiaforensic STL24041,"377,300.00",,603218.00,Ko,629,Spain,19570.63,1,1,1
380,2011,7,MORTGAGE,3,Low,1,12000, 36 months,1,credit_card,1,Low,1,Good Loan,0,8.9,A,1,17.08,13736.41119,12000,0,381.04,409000000379,26-Apr-18,FDRL/INTERNAL FUND TRANSFE,,500000.00,1103218.00,Distefano,687,Spain,188150.60,1,1,1
381,2011,3,OWN,2,Low,1,15000, 60 months,2,debt_consolidation,6,Low,1,Bad Loan,1,12.69,B,2,24.76,9543.84,4881.73,1434.48,338.93,409000000380,26-Apr-18,FDRL/INTERNAL FUND TRANSFE,,500000.00,1603218.00,Farrell,483,France,111020.24,1,1,1
382,2011,1,RENT,1,Low,1,8050, 36 months,1,debt_consolidation,6,Low,1,Bad Loan,1,12.69,B,2,14.8,1330.92,748.57,254.92,270.04,409000000381,27-Apr-18,INDO GIBL Indiaforensic STL25041,"414,276.00",,1188942.00,Milano,690,France,123775.15,1,1,1
383,2011,6,RENT,1,Low,1,5600, 36 months,1,debt_consolidation,6,Low,1,Good Loan,0,10.65,B,2,16.36,6564.334175,5600,0,182.42,409000000382,27-Apr-18,INDO GIBL Indiaforensic STL26041,"351,100.00",,837842.00,Ting,492,Germany,146700.22,1,1,1
384,2011,3,RENT,1,Low,1,7500, 36 months,1,credit_card,1,Low,1,Good Loan,0,9.91,B,2,12.35,8548.15,7500,0,241.69,409000000383,27-Apr-18,FDRL/INTERNAL FUND TRANSFE,,500000.00,1337842.00,Boyd,709,Germany,145251.35,1,1,1
385,2011,10,RENT,1,Low,1,7000, 36 months,1,credit_card,1,Low,1,Good Loan,0,11.71,B,2,12.19,8332.097581,7000,0,231.54,409000000384,1-May-18,FDRL/INTERNAL FUND TRANSFE,,500000.00,1837842.00,Onyemaechi,705,Germany,82463.69,1,1,1
386,2011,4,RENT,1,Low,1,5400, 36 months,1,debt_consolidation,6,Low,1,Good Loan,0,7.9,A,1,10.89,6081.934802,5400,0,168.97,409000000385,2-May-18,INDO GIBL Indiaforensic STL27041,"229,949.00",,1607893.00,Black,560,France,15928.49,1,1,1
387,2011,1,RENT,1,Low,1,16000, 36 months,1,credit_card,1,Low,1,Good Loan,0,12.42,B,2,13.67,19242.01988,16000,0,534.65,409000000386,2-May-18,INDO GIBL Indiaforensic STL28041,"160,300.00",,1447593.00,Oliver,611,Spain,45886.33,1,1,1
388,2011,9,MORTGAGE,3,Medium,2,35000, 60 months,2,home_improvement,7,Low,1,Good Loan,0,12.42,B,2,16.53,34439.9758,27575,0,619.26,409000000387,2-May-18,INDO GIBL Indiaforensic STL29041,"76,000.00",,1371593.00,Greco,730,Spain,186489.95,1,1,1
389,2011,0.5,RENT,1,Low,1,6000, 60 months,2,debt_consolidation,6,Low,1,Bad Loan,1,7.9,A,1,1.68,3662.31,2298.98,526.45,121.38,409000000388,2-May-18,INDO GIBL Indiaforensic STL30041,"60,449.00",,1311144.00,Whitehead,709,Spain,162922.65,1,1,1
390,2011,10,MORTGAGE,3,Low,1,4125, 60 months,2,car,2,Low,1,Good Loan,0,12.69,B,2,17.73,4457.96,3070.41,0,93.21,409000000389,2-May-18,INDO GIBL Indiaforensic STL01051,"259,075.00",,1052069.00,Ikemefuna,544,France,9262.77,1,1,1
391,2011,4,RENT,1,Low,1,9800, 36 months,1,credit_card,1,High,2,Good Loan,0,16.29,D,4,21.01,12159.38,9800,0,345.95,409000000390,2-May-18,FDRL/INTERNAL FUND TRANSFE,,500000.00,1552069.00,Morrison,712,Germany,84932.40,1,1,1
392,2011,10,MORTGAGE,3,Low,1,15700, 60 months,2,debt_consolidation,6,High,2,Good Loan,0,18.25,D,4,17.43,19209.98,11319.68,0,400.82,409000000391,3-May-18,INDO GIBL Indiaforensic STL02051,"206,700.00",,1345369.00,Onyeoruru,752,Germany,71557.12,1,1,1
393,2011,1,RENT,1,High,3,5000, 36 months,1,debt_consolidation,6,Low,1,Good Loan,0,6.62,A,1,1.82,5524.936472,5000,0,153.52,409000000392,3-May-18,FDRL/INTERNAL FUND TRANSFE,,500000.00,1845369.00,Cunningham,648,Spain,77405.95,1,1,1
394,2011,6,RENT,1,Low,1,9900, 36 months,1,debt_consolidation,6,Low,1,Good Loan,0,11.71,B,2,14.09,11783.13754,9900,0,327.46,409000000393,4-May-18,INDO GIBL Indiaforensic STL03051,"237,000.00",,1608369.00,Demidov,556,Spain,417.41,1,1,1
395,2011,6.05,RENT,1,Low,1,4000, 36 months,1,home_improvement,7,Low,1,Good Loan,0,11.71,B,2,7.5,4185.93,4000,0,132.31,409000000394,5-May-18,INDO GIBL Indiaforensic STL04051,"272,000.00",,1336369.00,Celis,594,Spain,71405.17,1,1,1
396,2011,3,MORTGAGE,3,Low,1,15000, 36 months,1,debt_consolidation,6,Low,1,Good Loan,0,11.71,B,2,5.7,17857.87991,15000,0,496.14,409000000395,7-May-18,INDO GIBL Indiaforensic STL05051,"387,749.00",,948620.00,Cheng,645,Germany,153400.24,1,1,1
397,2011,1,RENT,1,Low,1,6250, 36 months,1,debt_consolidation,6,High,2,Good Loan,0,15.96,C,3,20.85,7901.704003,6250,0,219.61,409000000396,7-May-18,INDO GIBL Indiaforensic STL06051,"101,050.00",,847570.00,Knight,557,France,371.05,1,1,1
398,2011,0.5,RENT,1,Low,1,6400, 36 months,1,debt_consolidation,6,High,2,Good Loan,0,16.29,D,4,17.97,8131.319493,6400,0,225.93,409000000397,7-May-18,FDRL/INTERNAL FUND TRANSFE,,500000.00,1347570.00,Morin,547,Germany,67789.99,1,1,1
399,2011,10,MORTGAGE,3,Low,1,8850, 60 months,2,major_purchase,8,High,2,Good Loan,0,13.49,C,3,7.67,12021.06002,8850,0,203.6,409000000398,8-May-18,INDO GIBL Indiaforensic STL07051,"392,900.00",,954670.00,Mills,701,France,145894.90,1,1,1
400,2011,4,MORTGAGE,3,Low,1,12000, 36 months,1,debt_consolidation,6,High,2,Good Loan,0,15.27,C,3,17.07,15021.32581,12000,0,417.58,409000000399,9-May-18,INDO GIBL Indiaforensic STL08051,"290,350.00",,664320.00,Outhwaite,616,France,183840.51,1,1,1
401,2011,5,MORTGAGE,3,Low,1,15000, 36 months,1,debt_consolidation,6,Low,1,Good Loan,0,8.9,A,1,6.48,17018.65061,15000,0,476.3,409000000400,9-May-18,FDRL/INTERNAL FUND TRANSFE,,500000.00,1164320.00,Tung,605,France,108887.44,1,1,1
402,2011,4,MORTGAGE,3,Low,1,6500, 36 months,1,credit_card,1,High,2,Good Loan,0,14.27,C,3,10.12,7994.155556,6500,0,223.01,409000000401,9-May-18,FDRL/INTERNAL FUND TRANSFE,,500000.00,1664320.00,Pai,593,Germany,154071.27,1,1,1
403,2011,10,RENT,1,Low,1,8000, 36 months,1,credit_card,1,High,2,Good Loan,0,15.96,C,3,16.34,10113.71096,8000,0,281.1,409000000402,10-May-18,INDO GIBL Indiaforensic STL09051,"365,625.00",,1298695.00,Carpenter,751,Spain,179291.85,1,1,1
404,2011,6,MORTGAGE,3,Low,1,30000, 60 months,2,home_improvement,7,High,2,Good Loan,0,21.28,F,6,17.57,25893,14039.85,0,539.47,409000000403,11-May-18,INDO GIBL Indiaforensic STL10051,"352,850.00",,945845.00,Fennell,443,Spain,56937.43,1,1,1
405,2011,10,MORTGAGE,3,Medium,2,15000, 36 months,1,credit_card,1,High,2,Good Loan,0,14.65,C,3,14.56,16915.33,15000,0,517.42,409000000404,11-May-18,FDRL/INTERNAL FUND TRANSFE,,500000.00,1445845.00,Fontaine,685,France,112239.03,1,1,1
406,2011,3,RENT,1,Low,1,10200, 36 months,1,debt_consolidation,6,High,2,Good Loan,0,14.27,C,3,16.53,12182.11,10200,0,349.96,409000000405,14-May-18,INDO GIBL Indiaforensic STL11051,"345,749.00",,1100096.00,Pratt,718,France,45909.87,1,1,1
407,2011,5,MORTGAGE,3,Low,1,9000, 36 months,1,credit_card,1,Low,1,Good Loan,0,12.42,B,2,19.1,10823.10324,9000,0,300.74,409000000406,14-May-18,INDO GIBL Indiaforensic STL12051,"225,300.00",,874796.00,Mitchell,538,Spain,173779.25,1,1,1
408,2011,3,MORTGAGE,3,Low,1,6500, 36 months,1,debt_consolidation,6,High,2,Good Loan,0,16.29,D,4,21.85,8195.242888,6500,0,229.46,409000000407,14-May-18,INDO GIBL Indiaforensic STL13051,"10,000.00",,864796.00,Franklin,611,Spain,125696.26,1,1,1
409,2011,8,MORTGAGE,3,Low,1,23000, 60 months,2,debt_consolidation,6,High,2,Good Loan,0,21.28,F,6,8.94,30964.69,23000,0,625.86,409000000408,14-May-18,FDRL/INTERNAL FUND TRANSFE,,500000.00,1364796.00,K'ung,668,Germany,159585.61,1,1,1
410,2011,4,RENT,1,Low,1,2000, 36 months,1,credit_card,1,Low,1,Good Loan,0,7.9,A,1,5.09,2252.269997,2000,0,62.59,409000000409,15-May-18,INDO GIBL Indiaforensic STL14051,"823,240.00",,541556.00,Ko,537,Germany,106761.47,1,1,1
411,2011,3,OWN,2,Low,1,8000, 36 months,1,debt_consolidation,6,High,2,Good Loan,0,13.49,C,3,14.48,9767.171008,8000,0,271.45,409000000410,15-May-18,FDRL/INTERNAL FUND TRANSFE,,500000.00,1041556.00,McKenzie,709,Spain,129590.18,1,1,1
412,2011,1,RENT,1,Low,1,8875, 36 months,1,debt_consolidation,6,Low,1,Good Loan,0,7.51,A,1,28.4,9738.77,8875,0,276.11,409000000411,15-May-18,FDRL/INTERNAL FUND TRANSFE,,500000.00,1541556.00,Pino,850,France,80006.65,1,1,1
413,2011,0.5,RENT,1,Low,1,1500, 36 months,1,other,4,High,2,Bad Loan,1,18.64,E,5,4.59,560.69,300.67,68.75,54.72,409000000412,16-May-18,INDO GIBL Indiaforensic STL15051,"785,049.00",,756507.00,Fisk,745,Spain,140451.52,1,1,1
414,2011,3,RENT,1,Low,1,8000, 36 months,1,debt_consolidation,6,Low,1,Good Loan,0,12.42,B,2,20.26,9638.08234,8000,0,267.33,409000000413,17-May-18,FDRL/INTERNAL FUND TRANSFE,,500000.00,1256507.00,Chiang,693,Germany,187929.43,1,1,1
415,2011,10,RENT,1,Low,1,20000, 60 months,2,debt_consolidation,6,High,2,Bad Loan,1,14.65,C,3,16.51,3612.52,1819.26,0,399.55,409000000414,17-May-18,INDO GIBL Indiaforensic STL16051,"403,100.00",,853407.00,Moseley,795,Spain,167155.36,1,1,1
416,2011,4,RENT,1,Low,1,6500, 36 months,1,credit_card,1,Low,1,Good Loan,0,11.71,B,2,6.26,7727.500051,6500,0,215,409000000415,17-May-18,FDRL/INTERNAL FUND TRANSFE,,500000.00,1353407.00,Hsiung,626,Spain,191420.71,1,1,1
417,2011,3,MORTGAGE,3,Low,1,9600, 36 months,1,debt_consolidation,6,High,2,Good Loan,0,13.49,C,3,10.22,11408.78,9600,0,325.74,409000000416,18-May-18,INDO GIBL Indiaforensic STL17051,"459,800.00",,893607.00,Heath,487,Germany,11384.45,1,1,1
418,2011,10,MORTGAGE,3,Medium,2,25975, 60 months,2,debt_consolidation,6,Low,1,Good Loan,0,12.69,B,2,26.13,17850.84,12290.21,0,372.25,409000000417,18-May-18,FDRL/INTERNAL FUND TRANSFE,,500000.00,1393607.00,Dellucci,556,France,94898.10,1,1,1
419,2011,5,MORTGAGE,3,Low,1,10000, 36 months,1,home_improvement,7,Low,1,Good Loan,0,7.9,A,1,10.46,11262.91092,10000,0,312.91,409000000418,19-May-18,INDO GIBL Indiaforensic STL18051,"373,850.00",,1019757.00,Li,643,France,106781.59,1,1,1
420,2011,10,MORTGAGE,3,Low,1,15000, 36 months,1,debt_consolidation,6,Low,1,Good Loan,0,12.42,B,2,5.61,18039.09981,15000,0,501.23,409000000419,21-May-18,INDO GIBL Indiaforensic STL19051,"265,500.00",,754257.00,De Salis,605,France,159508.52,1,1,1
421,2011,3,MORTGAGE,3,Low,1,9000, 36 months,1,debt_consolidation,6,Low,1,Good Loan,0,6.62,A,1,22.05,9929.500417,9000,0,276.34,409000000420,21-May-18,INDO GIBL Indiaforensic STL20051,"25,700.00",,728557.00,T'ang,756,Germany,93524.19,1,1,1
422,2011,2,RENT,1,Low,1,10000, 36 months,1,credit_card,1,Low,1,Good Loan,0,7.9,A,1,27.92,11263.48297,10000,0,312.91,409000000421,21-May-18,FDRL/INTERNAL FUND TRANSFE,,500000.00,1228557.00,Richardson,586,France,87168.46,1,1,1
423,2011,6.05,RENT,1,Low,1,1000, 36 months,1,major_purchase,8,High,2,Bad Loan,1,14.65,C,3,6,91.31,22.24,56.89,34.5,409000000422,22-May-18,INDO GIBL Indiaforensic STL21051,"376,125.00",,852432.00,Fitch,535,Germany,8128.32,1,1,1
424,2011,2,RENT,1,Low,1,14000, 36 months,1,debt_consolidation,6,Low,1,Good Loan,0,7.9,A,1,15.2,15297.94,14000,0,438.07,409000000423,22-May-18,FDRL/INTERNAL FUND TRANSFE,,500000.00,1352432.00,Stevenson,678,France,125518.32,1,1,1
425,2011,9,RENT,1,Low,1,8500, 36 months,1,debt_consolidation,6,High,2,Bad Loan,1,14.27,C,3,8.5,2444.63,1378.65,408.75,291.63,409000000424,23-May-18,INDO GIBL Indiaforensic STL22051,"265,250.00",,1087182.00,Estes,596,France,48963.59,1,1,1
426,2011,9,RENT,1,Low,1,15000, 60 months,2,debt_consolidation,6,High,2,Good Loan,0,19.03,E,5,2.82,22590.20414,15000,0,389.36,409000000425,24-May-18,INDO GIBL Indiaforensic STL23051,"119,100.00",,968082.00,Lattimore,648,France,98368.24,1,1,1
427,2011,5,MORTGAGE,3,Low,1,4500, 36 months,1,other,4,High,2,Good Loan,0,15.96,C,3,14.66,5580.11,4500,0,158.12,409000000426,24-May-18,FDRL/INTERNAL FUND TRANSFE,,500000.00,1468082.00,Chung,492,Germany,148584.61,1,1,1
428,2011,10,MORTGAGE,3,Low,1,3000, 36 months,1,major_purchase,8,Low,1,Good Loan,0,7.51,A,1,27.91,3358.813405,3000,0,93.34,409000000427,25-May-18,INDO GIBL Indiaforensic STL24051,"93,350.00",,1374732.00,Utz,702,France,27474.81,1,1,1
429,2011,4,MORTGAGE,3,Medium,2,10000, 36 months,1,home_improvement,7,Low,1,Good Loan,0,9.91,B,2,7.98,11597.2666,10000,0,322.25,409000000428,28-May-18,INDO GIBL Indiaforensic STL25051,"201,000.00",,1173732.00,Wei,486,Germany,76192.21,1,1,1
430,2011,5,MORTGAGE,3,Low,1,21250, 60 months,2,debt_consolidation,6,High,2,Good Loan,0,16.77,D,4,19.93,30769.89365,21250,0,525.5,409000000429,28-May-18,INDO GIBL Indiaforensic STL26051,"80,475.00",,1093257.00,Boyle,568,Germany,134600.94,1,1,1
431,2011,2,MORTGAGE,3,Low,1,33425, 60 months,2,debt_consolidation,6,High,2,Bad Loan,1,13.49,C,3,25.71,19893.95,13371.26,10.66,475.63,409000000430,28-May-18,INDO GIBL Indiaforensic STL27051,"27,200.00",,1066057.00,Nwachinemelu,619,Germany,72467.99,1,1,1
432,2011,8,RENT,1,Medium,2,35000, 60 months,2,debt_consolidation,6,High,2,Good Loan,0,19.42,E,5,11.72,43947.08,25071.4,0,916.03,409000000431,28-May-18,FDRL/INTERNAL FUND TRANSFE,,500000.00,1566057.00,Kuznetsova,724,Germany,199645.45,1,1,1
433,2011,4,RENT,1,Low,1,7200, 36 months,1,debt_consolidation,6,High,2,Good Loan,0,15.27,C,3,20.95,8948.247644,7200,0,250.55,409000000432,29-May-18,INDO GIBL Indiaforensic STL28051,"364,100.00",,1201957.00,Pisani,548,Germany,42749.85,1,1,1
434,2011,0.5,RENT,1,Low,1,18000, 60 months,2,debt_consolidation,6,Low,1,Bad Loan,1,11.71,B,2,18.18,10850.22,5690.48,1711.17,397.77,409000000433,30-May-18,INDO GIBL Indiaforensic STL29051,"341,200.00",,860757.00,Manna,545,Germany,136050.44,1,1,1
435,2011,2,MORTGAGE,3,Medium,2,23000, 36 months,1,debt_consolidation,6,Low,1,Good Loan,0,7.9,A,1,8.13,23980.67,23000,0,719.68,409000000434,30-May-18,FDRL/INTERNAL FUND TRANSFE,,500000.00,1360757.00,Collier,683,France,73564.44,1,1,1
436,2011,10,RENT,1,Low,1,20000, 60 months,2,debt_consolidation,6,High,2,Bad Loan,1,16.77,D,4,9.46,18799.72,9606.12,1525.73,494.59,409000000435,31-May-18,INDO GIBL Indiaforensic STL30051,"234,600.00",,1126157.00,Ricci,762,France,85578.63,1,1,1
437,2011,3,RENT,1,Low,1,6000, 60 months,2,debt_consolidation,6,High,2,Good Loan,0,17.58,D,4,15.54,7382.84,4486.67,0,151,409000000436,1-Jun-18,FDRL/INTERNAL FUND TRANSFE,,500000.00,1626157.00,Carr,627,Germany,129826.89,1,1,1
438,2011,1,RENT,1,Low,1,7000, 36 months,1,credit_card,1,Low,1,Good Loan,0,8.9,A,1,7.9,7999.847926,7000,0,222.28,409000000437,1-Jun-18,INDO GIBL Indiaforensic STL31051,"78,000.00",,1548157.00,Hs?,516,France,119666.00,1,1,1
439,2011,8,MORTGAGE,3,Medium,2,21000, 36 months,1,debt_consolidation,6,Low,1,Good Loan,0,12.69,B,2,8.52,24283.82,21000.01,0,704.45,409000000438,2-Jun-18,INDO GIBL Indiaforensic STL01061,"353,500.00",,1194657.00,Findlay,800,France,68052.08,1,1,1
440,2011,6.05,MORTGAGE,3,Low,1,8250, 36 months,1,debt_consolidation,6,Low,1,Good Loan,0,7.51,A,1,17.87,9236.369059,8250,0,256.67,409000000439,4-Jun-18,FDRL/INTERNAL FUND TRANSFE,,500000.00,1694657.00,Hughes,464,Germany,164104.74,1,1,1
441,2011,10,RENT,1,Low,1,13000, 36 months,1,credit_card,1,Low,1,Good Loan,0,9.91,B,2,8.82,14817.85,13000,0,418.93,409000000440,4-Jun-18,INDO GIBL Indiaforensic STL02061,"402,850.00",,1291807.00,Chukwuemeka,626,France,80190.36,1,1,1
442,2011,2,MORTGAGE,3,Low,1,18000, 36 months,1,debt_consolidation,6,Low,1,Good Loan,0,6.62,A,1,6.35,19892.95164,18000,0,552.67,409000000441,5-Jun-18,INDO GIBL Indiaforensic STL04061,"578,750.00",,713057.00,Genovese,790,France,84126.75,1,1,1
443,2011,5,MORTGAGE,3,Low,1,7200, 36 months,1,other,4,Low,1,Good Loan,0,6.03,A,1,2.54,7881.924132,7200,0,219.14,409000000442,6-Jun-18,INDO GIBL Indiaforensic STL05061,"251,200.00",,461857.00,Swift,534,France,70179.00,1,1,1
444,2011,10,RENT,1,Low,1,16500, 36 months,1,credit_card,1,Low,1,Good Loan,0,8.9,A,1,13.1,18159.26,16500,0,523.93,409000000443,6-Jun-18,FDRL/INTERNAL FUND TRANSFE,,500000.00,961857.00,Ugoji,745,France,118024.10,1,1,1
445,2011,0.5,RENT,1,Low,1,8125, 36 months,1,debt_consolidation,6,Low,1,Good Loan,0,7.9,A,1,24.34,9151.005343,8125,0,254.24,409000000444,6-Jun-18,FDRL/INTERNAL FUND TRANSFE,,500000.00,1461857.00,Parkinson,553,Spain,145704.19,1,1,1
446,2011,3,MORTGAGE,3,Low,1,18800, 36 months,1,debt_consolidation,6,Low,1,Good Loan,0,7.51,A,1,13.76,21054.18555,18800,0,584.89,409000000445,7-Jun-18,INDO GIBL Indiaforensic STL06061,"217,075.00",,1244782.00,Ross,748,France,183049.41,1,1,1
447,2011,10,MORTGAGE,3,Low,1,26800, 36 months,1,credit_card,1,High,2,Good Loan,0,19.03,E,5,21.59,31277.98,26800,0,982.79,409000000446,8-Jun-18,INDO GIBL Indiaforensic STL07061,"491,005.00",,753777.00,Oleary,722,France,120906.83,1,1,1
448,2011,5,MORTGAGE,3,Low,1,19200, 36 months,1,debt_consolidation,6,Low,1,Good Loan,0,7.9,A,1,19.66,21328.13,19200,0,600.78,409000000447,11-Jun-18,FDRL/INTERNAL FUND TRANSFE,,500000.00,1253777.00,Turnbull,501,France,100433.83,1,1,1
449,2011,3,RENT,1,Low,1,12875, 60 months,2,debt_consolidation,6,High,2,Good Loan,0,17.58,D,4,18.7,11208.86574,8475,0,213.28,409000000448,11-Jun-18,FDRL/INTERNAL FUND TRANSFE,,500000.00,1753777.00,Uspensky,675,France,138777.00,1,1,1
450,2011,5,MORTGAGE,3,Low,1,4000, 36 months,1,credit_card,1,Low,1,Good Loan,0,12.42,B,2,19.64,4300.29,4000,0,133.67,409000000449,11-Jun-18,INDO GIBL Indiaforensic STL08061,"626,600.00",,1127177.00,Cook,778,Spain,124694.99,1,1,1
451,2011,4,RENT,1,Low,1,4000, 36 months,1,debt_consolidation,6,High,2,Good Loan,0,16.29,D,4,9.22,5053.377225,4000,0,141.21,409000000450,11-Jun-18,INDO GIBL Indiaforensic STL09061,"340,074.00",,787103.00,Newbold,494,Germany,40084.32,1,1,1
452,2011,10,OWN,2,Low,1,12000, 36 months,1,credit_card,1,Low,1,Good Loan,0,9.91,B,2,18.8,13871.41876,12000,0,386.7,409000000451,11-Jun-18,INDO GIBL Indiaforensic STL10061,"24,176.00",,762927.00,Uchechukwu,850,France,119232.33,1,1,1
453,2011,10,MORTGAGE,3,Low,1,2625, 36 months,1,medical,9,Low,1,Good Loan,0,11.71,B,2,14.52,3124.737614,2625,0,86.83,409000000452,12-Jun-18,FDRL/INTERNAL FUND TRANSFE,,500000.00,1262927.00,Ch'en,592,Spain,43921.36,1,1,1
454,2011,10,MORTGAGE,3,Low,1,18000, 60 months,2,debt_consolidation,6,High,2,Good Loan,0,13.49,C,3,13.7,19847.2,13358.97,0,414.09,409000000453,12-Jun-18,FDRL/INTERNAL FUND TRANSFE,,500000.00,1762927.00,He,590,Spain,62222.81,1,1,1
455,2011,10,RENT,1,Low,1,7000, 36 months,1,debt_consolidation,6,Low,1,Good Loan,0,9.91,B,2,11.45,8118.350531,7000,0,225.58,409000000454,12-Jun-18,INDO GIBL Indiaforensic STL11061,"793,251.00",,969676.00,Hilton,758,France,56577.00,1,1,1
456,2011,7,MORTGAGE,3,Low,1,11300, 36 months,1,credit_card,1,Low,1,Good Loan,0,12.69,B,2,16.33,12787.19,11300,0,379.06,409000000455,13-Jun-18,FDRL/INTERNAL FUND TRANSFE,,500000.00,1469676.00,Sal,506,France,164253.35,1,1,1
457,2011,10,MORTGAGE,3,Medium,2,4000, 36 months,1,debt_consolidation,6,Low,1,Good Loan,0,9.91,B,2,10.05,4634.246725,4000,0,128.9,409000000456,13-Jun-18,INDO GIBL Indiaforensic STL12061,"717,850.00",,751826.00,Eluemuno,733,France,7666.73,1,1,1
458,2011,10,MORTGAGE,3,Low,1,8000, 36 months,1,debt_consolidation,6,Low,1,Good Loan,0,6.03,A,1,4.72,8517.87,8000,0,243.49,409000000457,13-Jun-18,INDO GIBL Indiaforensic STL27041,"32,000.00",,719826.00,Titus,711,France,68487.51,1,1,1
459,2011,5,RENT,1,Low,1,14400, 36 months,1,debt_consolidation,6,High,2,Bad Loan,1,18.25,D,4,7.82,7869.17,4684.23,571.11,522.41,409000000458,13-Jun-18,FDRL/INTERNAL FUND TRANSFE,,500000.00,1219826.00,Yin,514,Germany,199273.98,1,1,1
460,2011,2,OWN,2,Low,1,4375, 36 months,1,debt_consolidation,6,Low,1,Good Loan,0,12.42,B,2,13.92,5261.081491,4375,0,146.2,409000000459,14-Jun-18,FDRL/INTERNAL FUND TRANSFE,,1000000.00,2219826.00,Lettiere,637,Spain,186062.36,1,1,1
461,2011,9,MORTGAGE,3,Low,1,4100, 36 months,1,credit_card,1,Low,1,Good Loan,0,7.51,A,1,6.58,4582.7503,4100,0,127.56,409000000460,14-Jun-18,INDO GIBL Indiaforensic STL13061,"533,800.00",,1686026.00,Templeman,468,Germany,195711.16,1,1,1
462,2011,7,RENT,1,Low,1,6000, 36 months,1,other,4,Low,1,Good Loan,0,8.9,A,1,14.43,6857.055601,6000,0,190.52,409000000461,15-Jun-18,INDO GIBL Indiaforensic STL14061,"559,730.00",,1126296.00,Chibuzo,539,France,36692.17,1,1,1
463,2011,9,RENT,1,Low,1,4200, 60 months,2,debt_consolidation,6,High,2,Bad Loan,1,17.27,D,4,10.13,4200,2381.46,10.92,105,409000000462,15-Jun-18,FDRL/INTERNAL FUND TRANSFE,,1000000.00,2126296.00,Sun,509,Spain,106920.57,1,1,1
464,2011,6,MORTGAGE,3,Medium,2,4000, 36 months,1,home_improvement,7,Low,1,Good Loan,0,6.62,A,1,3.89,4152.93,4000,0,122.82,409000000463,18-Jun-18,INDO GIBL Indiaforensic STL17061,"52,250.00",,2074046.00,Evans,662,France,48725.68,1,1,1
465,2011,10,MORTGAGE,3,Low,1,3000, 36 months,1,other,4,Low,1,Bad Loan,1,10.65,B,2,13.37,2236.73,1629.41,189.44,97.72,409000000464,18-Jun-18,INDO GIBL Indiaforensic STL16061,"140,750.00",,1933296.00,Ogbonnaya,818,Spain,167036.94,1,1,1
466,2011,10,MORTGAGE,3,Low,1,5400, 36 months,1,car,2,Low,1,Good Loan,0,12.69,B,2,8.8,6273.69,5400,0,181.15,409000000465,18-Jun-18,INDO GIBL Indiaforensic STL15061,"325,200.00",,1608096.00,Enyinnaya,608,France,68777.26,1,1,1
467,2011,1,RENT,1,Medium,2,15000, 36 months,1,small_business,3,High,2,Bad Loan,1,16.29,D,4,21.99,1873.45,655.77,815.11,529.51,409000000466,19-Jun-18,FDRL/INTERNAL FUND TRANSFE,,500000.00,2108096.00,Olisanugo,850,Spain,18924.92,1,1,1
468,2011,3,MORTGAGE,3,Low,1,20000, 60 months,2,debt_consolidation,6,High,2,Good Loan,0,18.64,E,5,23.47,22955.76,20000,0,514.86,409000000467,19-Jun-18,INDO GIBL Indiaforensic STL18061,"709,200.00",,1398896.00,Brookes,816,Germany,71905.77,1,1,1
469,2011,4,RENT,1,Low,1,10400, 36 months,1,credit_card,1,Low,1,Good Loan,0,12.69,B,2,19.91,12551.78312,10400,0,348.87,409000000468,20-Jun-18,FDRL/INTERNAL FUND TRANSFE,,500000.00,1898896.00,Padovano,536,France,64833.28,1,1,1
470,2011,7,MORTGAGE,3,Low,1,4500, 60 months,2,debt_consolidation,6,High,2,Good Loan,0,17.58,D,4,22.63,6287.698131,4500,0,113.25,409000000469,20-Jun-18,INDO GIBL Indiaforensic STL19061,"689,650.00",,1209246.00,Fisk,753,France,184843.77,1,1,1
471,2011,0.5,RENT,1,Low,1,11500, 36 months,1,credit_card,1,Low,1,Good Loan,0,12.42,B,2,13.06,13850.70613,11500,0,384.28,409000000470,21-Jun-18,FDRL/INTERNAL FUND TRANSFE,,500000.00,1709246.00,Shih,631,Spain,176730.02,1,1,1
472,2011,4,RENT,1,Low,1,10000, 36 months,1,home_improvement,7,Low,1,Good Loan,0,6.62,A,1,24.85,10742.42,10000,0,307.04,409000000471,21-Jun-18,INDO GIBL Indiaforensic STL20061,"386,200.00",,1323046.00,Hare,703,France,20629.40,1,1,1
473,2011,10,MORTGAGE,3,Low,1,18225, 60 months,2,debt_consolidation,6,High,2,Good Loan,0,13.49,C,3,20.8,14876.65,13450,0,309.42,409000000472,22-Jun-18,INDO GIBL Indiaforensic STL21061,"434,905.00",,888141.00,Muir,774,France,28415.36,1,1,1
474,2011,10,RENT,1,Low,1,3600, 36 months,1,debt_consolidation,6,Low,1,Good Loan,0,8.9,A,1,5.48,3976.57,3600,0,114.32,409000000473,22-Jun-18,FDRL/INTERNAL FUND TRANSFE,,1000000.00,1888141.00,Fanucci,785,France,77231.27,1,1,1
475,2011,2,RENT,1,Low,1,18500, 60 months,2,major_purchase,8,Low,1,Good Loan,0,11.71,B,2,0.72,16359.11992,13250,0,292.81,409000000474,25-Jun-18,INDO GIBL Indiaforensic STL24061,"6,050.00",,1882091.00,Elewechi,571,France,102750.70,1,1,1
476,2011,10,MORTGAGE,3,Low,1,16800, 60 months,2,credit_card,1,High,2,Good Loan,0,18.25,D,4,21.5,22756.20267,16800,0,428.9,409000000475,25-Jun-18,INDO GIBL Indiaforensic STL23061,"115,051.00",,1767040.00,Johnston,621,Germany,34580.80,1,1,1
477,2011,8,RENT,1,Low,1,10000, 36 months,1,debt_consolidation,6,High,2,Bad Loan,1,17.27,D,4,17.15,8589.12,6067.35,14.7,357.88,409000000476,25-Jun-18,INDO GIBL Indiaforensic STL22061,"242,750.00",,1524290.00,Pisano,605,Germany,183598.77,1,1,1
478,2011,10,MORTGAGE,3,Low,1,15000, 36 months,1,debt_consolidation,6,High,2,Good Loan,0,18.25,D,4,8.49,17725.93,15000,0,544.17,409000000477,25-Jun-18,TRF FROM  Indiaforensic SERVICES,,500000.00,2024290.00,Ankudinov,611,France,147358.27,1,1,1
479,2011,8,RENT,1,Low,1,8000, 36 months,1,major_purchase,8,Low,1,Good Loan,0,11.71,B,2,10.22,8371.65,8000,0,264.61,409000000478,26-Jun-18,INDO GIBL Indiaforensic STL25061,"261,438.00",,1762852.00,Nwokike,569,France,108469.20,1,1,1
480,2011,1,RENT,1,Low,1,25000, 60 months,2,debt_consolidation,6,High,2,Good Loan,0,16.77,D,4,13.66,19643.66,17950,0,443.89,409000000479,27-Jun-18,INDO GIBL Indiaforensic STL26061,"528,175.00",,1234677.00,Smith,658,France,20612.82,1,1,1
481,2011,1,RENT,1,Low,1,16000, 36 months,1,debt_consolidation,6,Low,1,Bad Loan,1,7.9,A,1,24.66,11928.62,9323.14,916.96,500.65,409000000480,28-Jun-18,FDRL/INTERNAL FUND TRANSFE,,500000.00,1734677.00,Atkins,788,Spain,181196.76,1,1,1
482,2011,2,RENT,1,Low,1,8000, 36 months,1,debt_consolidation,6,Low,1,Good Loan,0,10.65,B,2,11.56,8923.71,8000,0,260.59,409000000481,28-Jun-18,GIBLRBL INC INDO REM27061,"2,640.00",,1732037.00,Burns,525,France,160249.10,1,1,1
483,2011,10,MORTGAGE,3,Low,1,7200, 36 months,1,debt_consolidation,6,Low,1,Good Loan,0,7.51,A,1,19.74,8061.52571,7200,0,224,409000000482,28-Jun-18,INDO MFL STL270618,"344,750.00",,1387287.00,Obiuto,798,France,110783.28,1,1,1
484,2011,4,RENT,1,Low,1,12000, 36 months,1,debt_consolidation,6,Low,1,Good Loan,0,7.51,A,1,13.3,13098.35,12000,0,373.33,409000000483,29-Jun-18,Indfor INCOME INDO REMI28061,"2,160.00",,1385127.00,Pirozzi,486,Germany,144995.33,1,1,1
485,2011,10,OWN,2,Low,1,2200, 36 months,1,debt_consolidation,6,High,2,Bad Loan,1,15.27,C,3,5.47,2294,353.21,1758.08,76.56,409000000484,29-Jun-18,INDO GIBL Indiaforensic STL28061,"410,181.00",,974946.00,George,615,Spain,150227.85,1,1,1
486,2011,10,RENT,1,Low,1,20000, 60 months,2,other,4,Low,1,Good Loan,0,12.69,B,2,17.78,21677.94,14924.64,0,451.9,409000000485,29-Jun-18,FDRL/INTERNAL FUND TRANSFE,,500000.00,1474946.00,Lewis,730,France,53718.28,1,1,1
487,2011,4,MORTGAGE,3,Low,1,28000, 60 months,2,debt_consolidation,6,Low,1,Good Loan,0,12.42,B,2,15.87,31960.6,28000,0,628.81,409000000486,30-Jun-18,Indfor INCOME INDO REMI29061,"1,320.00",,1473626.00,Moran,641,France,75248.30,1,1,1
488,2011,2,MORTGAGE,3,Low,1,6000, 36 months,1,debt_consolidation,6,Low,1,Good Loan,0,7.51,A,1,23.86,6717.525779,6000,0,186.67,409000000487,30-Jun-18,INDO GIBL Indiaforensic STL29061,"176,050.00",,1297576.00,Dalrymple,542,France,14353.43,1,1,1
489,2011,10,RENT,1,Medium,2,25000, 60 months,2,credit_card,1,High,2,Good Loan,0,19.42,E,5,21.13,31388.68,17907.3,0,654.31,409000000488,2-Jul-18,FDRL/INTERNAL FUND TRANSFE,,500000.00,1797576.00,Carslaw,692,France,130486.57,1,1,1
490,2011,1,RENT,1,Low,1,8000, 60 months,2,debt_consolidation,6,Low,1,Bad Loan,1,8.9,A,1,25.12,4639.04,3271.74,0,165.68,409000000489,2-Jul-18,Indfor INCOME INDO REMI30061,960,,1796616.00,Kirby,714,Germany,100127.71,1,1,1
491,2011,2,RENT,1,Low,1,14400, 36 months,1,debt_consolidation,6,High,2,Good Loan,0,15.27,C,3,0.98,14762.51,14400,0,501.09,409000000490,2-Jul-18,INDO GIBL Indiaforensic STL30061,"200,250.00",,1596366.00,Houghton,591,Spain,196356.17,1,1,1
492,2011,5,RENT,1,Low,1,20000, 60 months,2,credit_card,1,High,2,Good Loan,0,19.03,E,5,18.06,19721.82536,13700,0,355.62,409000000491,2-Jul-18,Indfor INCOME INDO REMI01071,120,,1596246.00,Martin,710,France,9983.88,1,1,1
493,2011,10,MORTGAGE,3,Low,1,25000, 60 months,2,debt_consolidation,6,High,2,Good Loan,0,14.27,C,3,13.41,22386.62,14739.42,0,467,409000000492,2-Jul-18,INDO GIBL Indiaforensic STL01071,"10,000.00",,1586246.00,Tan,639,France,118974.77,1,1,1
494,2011,3,MORTGAGE,3,Medium,2,14050, 36 months,1,major_purchase,8,Low,1,Good Loan,0,8.9,A,1,2.21,15808.02,14050,0,446.14,409000000493,4-Jul-18,Indfor INCOME INDO REMI02071,"2,280.00",,1583966.00,Hsia,531,France,194998.34,1,1,1
495,2011,10,OWN,2,Low,1,6000, 36 months,1,major_purchase,8,High,2,Good Loan,0,13.49,C,3,3.16,7325.89258,6000,0,203.59,409000000494,4-Jul-18,INDO GIBL Indiaforensic STL02071,"282,208.00",,1301758.00,Westerberg,673,France,134901.34,1,1,1
496,2011,0.5,MORTGAGE,3,Low,1,16100, 60 months,2,debt_consolidation,6,Low,1,Good Loan,0,11.71,B,2,27.8,17071.16,12085.83,0,355.79,409000000495,4-Jul-18,FDRL/INTERNAL FUND TRANSFE,,500000.00,1801758.00,Hale,765,Germany,72924.56,1,1,1
497,2011,3,OWN,2,Low,1,35000, 60 months,2,debt_consolidation,6,High,2,Bad Loan,1,20.3,E,5,16.39,3093.5,1169.59,0,619.88,409000000496,4-Jul-18,Indfor INCOME INDO REMI03071,"2,280.00",,1799478.00,Kryukova,622,France,101057.95,1,1,1
498,2011,4,RENT,1,Low,1,10525, 36 months,1,debt_consolidation,6,Low,1,Good Loan,0,7.9,A,1,7.27,11649.33,10525,0,329.33,409000000497,4-Jul-18,INDO GIBL Indiaforensic STL03071,"323,700.00",,1475778.00,Sopuluchukwu,806,France,142838.64,1,1,1
499,2011,2,RENT,1,Low,1,7200, 36 months,1,debt_consolidation,6,High,2,Good Loan,0,15.96,C,3,5.2,9103.267064,7200,0,252.99,409000000498,5-Jul-18,Indfor INCOME INDO REMI04071,"3,840.00",,1471938.00,Barry,757,Germany,127059.04,1,1,1
500,2011,10,OWN,2,Low,1,18500, 60 months,2,debt_consolidation,6,Low,1,Good Loan,0,10.65,B,2,26.34,18877.39284,15775,0,340.24,409000000499,5-Jul-18,INDO GIBL Indiaforensic STL04071,"528,300.00",,943638.00,Selezneva,570,France,116503.92,1,1,1
501,2011,10,MORTGAGE,3,Low,1,12000, 36 months,1,debt_consolidation,6,High,2,Good Loan,0,13.49,C,3,16.2,13682.96,12000,0,407.17,409000000500,6-Jul-18,Indfor INCOME INDO REMI05071,"2,520.00",,941118.00,Chizuoke,555,Spain,54405.79,1,1,1
502,2011,5,MORTGAGE,3,Low,1,12000, 36 months,1,credit_card,1,Low,1,Good Loan,0,11.71,B,2,6.58,14284.36001,12000,0,396.92,409000000501,6-Jul-18,INDO GIBL Indiaforensic STL05071,"431,899.00",,509219.00,Lueck,692,France,88721.84,1,1,1
503,2011,2,RENT,1,Low,1,3000, 36 months,1,other,4,Low,1,Good Loan,0,11.71,B,2,16.03,3571.612926,3000,0,99.23,409000000502,6-Jul-18,FDRL/INTERNAL FUND TRANSFE,,500000.00,1009219.00,Udinese,774,France,74135.48,1,1,1
504,2011,10,RENT,1,Low,1,9500, 36 months,1,debt_consolidation,6,High,2,Good Loan,0,16.29,D,4,18.51,10658.63,9500,0,335.36,409000000503,7-Jul-18,Indfor INCOME INDO REMI06071,"2,640.00",,1006579.00,Udobata,638,Spain,111346.22,1,1,1
505,2011,2,RENT,1,Low,1,19775, 36 months,1,debt_consolidation,6,Low,1,Good Loan,0,12.42,B,2,17.57,22690.68,19775,0,660.79,409000000504,7-Jul-18,INDO GIBL Indiaforensic STL06071,"295,000.00",,711579.00,Freeman,543,Spain,194902.16,1,1,1
506,2011,0.5,RENT,1,Low,1,12000, 60 months,2,credit_card,1,High,2,Bad Loan,1,14.65,C,3,16.13,7694.4,3606.06,1180.34,283.28,409000000505,7-Jul-18,FDRL/INTERNAL FUND TRANSFE,,500000.00,1211579.00,Outlaw,584,France,31474.27,1,1,1
507,2011,7,MORTGAGE,3,Low,1,28000, 60 months,2,debt_consolidation,6,High,2,Good Loan,0,14.27,C,3,9.46,35909.92524,28000,0,655.44,409000000506,9-Jul-18,Indfor INCOME INDO REMI08071,120,,1211459.00,Obiuto,691,Germany,21198.39,1,1,1
508,2011,2,RENT,1,Low,1,30000, 36 months,1,debt_consolidation,6,Low,1,Good Loan,0,12.42,B,2,22.23,36085.49537,30000,0,1002.46,409000000507,9-Jul-18,INDO GIBL Indiaforensic STL08071,"30,700.00",,1180759.00,Lo,684,Germany,186976.60,1,1,1
509,2011,9,MORTGAGE,3,Low,1,16000, 36 months,1,debt_consolidation,6,Low,1,Good Loan,0,10.65,B,2,13.33,18756.9152,16000,0,521.18,409000000508,9-Jul-18,Indfor INCOME INDO REMI07071,"1,200.00",,1179559.00,Okechukwu,733,France,117202.19,1,1,1
510,2011,8,RENT,1,Low,1,14500, 36 months,1,credit_card,1,High,2,Good Loan,0,14.65,C,3,5.24,18004.14652,14500,0,500.17,409000000509,9-Jul-18,INDO GIBL Indiaforensic STL07071,"213,225.00",,966334.00,King,599,Spain,143739.29,1,1,1
511,2011,3,RENT,1,Low,1,11700, 60 months,2,credit_card,1,High,2,Good Loan,0,14.65,C,3,18.17,14114.88,11700,0,276.2,409000000510,9-Jul-18,FDRL/INTERNAL FUND TRANSFE,,500000.00,1466334.00,Forbes,524,Germany,161811.23,1,1,1
512,2011,4,RENT,1,Low,1,4150, 36 months,1,debt_consolidation,6,Low,1,Good Loan,0,10.65,B,2,1.99,4832.413691,4150,0,135.18,409000000511,10-Jul-18,Indfor INCOME INDO REMI09071,"4,800.00",,1461534.00,Macleod,632,Germany,98090.91,1,1,1
513,2011,10,MORTGAGE,3,Low,1,15000, 60 months,2,debt_consolidation,6,Low,1,Good Loan,0,11.71,B,2,26.48,15888.94,11250.02,0,331.48,409000000512,10-Jul-18,INDO GIBL Indiaforensic STL09071,"809,926.00",,651608.00,Gibbs,735,Spain,71095.41,1,1,1
514,2011,6,RENT,1,Low,1,24000, 36 months,1,credit_card,1,High,2,Good Loan,0,16.77,D,4,12.57,30690.74305,24000,0,852.93,409000000513,10-Jul-18,FDRL/INTERNAL FUND TRANSFE,,500000.00,1151608.00,Isayev,734,France,13107.24,1,1,1
515,2011,5,RENT,1,Low,1,21250, 36 months,1,other,4,Low,1,Bad Loan,1,12.42,B,2,14.27,8880.05,6569.76,43.53,710.08,409000000514,11-Jul-18,Indfor INCOME INDO REMI10071,"2,640.00",,1148968.00,Pisano,605,France,67110.59,1,1,1
516,2011,10,OWN,2,Low,1,10000, 36 months,1,debt_consolidation,6,High,2,Good Loan,0,14.27,C,3,13.46,12347.22348,10000,0,343.09,409000000515,11-Jul-18,INDO GIBL Indiaforensic STL10071,"435,225.00",,713743.00,Belstead,793,Spain,88225.02,1,1,1
517,2011,0.5,MORTGAGE,3,Low,1,25000, 60 months,2,debt_consolidation,6,High,2,Good Loan,0,18.25,D,4,10.58,32063.87,25000,0,638.25,409000000516,11-Jul-18,FDRL/INTERNAL FUND TRANSFE,,500000.00,1213743.00,Vassiliev,468,France,62256.87,1,1,1
518,2011,6,RENT,1,Low,1,4000, 36 months,1,debt_consolidation,6,High,2,Good Loan,0,15.96,C,3,21.91,4926.28934,4000,0,140.55,409000000517,12-Jul-18,FDRL/INTERNAL FUND TRANSFE,,500000.00,1713743.00,Schneider,779,Germany,135925.72,1,1,1
519,2011,0.5,RENT,1,Low,1,15000, 36 months,1,debt_consolidation,6,Low,1,Good Loan,0,11.71,B,2,8.86,17601.66322,15000,0,496.14,409000000518,12-Jul-18,Indfor INCOME INDO REMI11071,"4,560.00",,1709183.00,Mazzanti,698,France,177815.87,1,1,1
520,2011,3,RENT,1,Low,1,20000, 60 months,2,credit_card,1,High,2,Good Loan,0,13.49,C,3,9.09,27154.14,20000,0,460.1,409000000519,12-Jul-18,INDO GIBL Indiaforensic STL11071,"828,988.00",,880195.00,Knipe,707,France,126471.13,1,1,1
521,2011,3,MORTGAGE,3,Medium,2,15000, 60 months,2,home_improvement,7,High,2,Good Loan,0,17.58,D,4,12.36,17833.36,15000,0,377.49,409000000520,12-Jul-18,FDRL/INTERNAL FUND TRANSFE,,500000.00,1380195.00,Macartney,850,France,188574.12,1,1,1
522,2011,3,RENT,1,Low,1,3600, 36 months,1,moving,10,High,2,Good Loan,0,15.96,C,3,12.78,4552.777742,3600,0,126.5,409000000521,13-Jul-18,Indfor INCOME INDO REMI12071,"3,120.00",,1377075.00,Madukwe,850,France,119175.45,1,1,1
523,2011,5,OWN,2,Low,1,6000, 60 months,2,debt_consolidation,6,High,2,Good Loan,0,19.03,E,5,20.13,8933.345858,6000,0,155.75,409000000522,13-Jul-18,INDO GIBL Indiaforensic STL12071,"447,455.00",,929620.00,Watts,527,Spain,139093.73,1,1,1
524,2011,10,RENT,1,Low,1,15000, 36 months,1,debt_consolidation,6,High,2,Bad Loan,1,15.27,C,3,10.72,6379.19,3871.69,654.02,521.97,409000000523,13-Jul-18,FDRL/INTERNAL FUND TRANSFE,,500000.00,1429620.00,Humphreys,696,Germany,115916.55,1,1,1
525,2011,3,RENT,1,Low,1,12000, 60 months,2,credit_card,1,High,2,Good Loan,0,18.25,D,4,15.24,17492.77037,12000,0,306.36,409000000524,13-Jul-18,FDRL/INTERNAL FUND TRANSFE,,200000.00,1629620.00,Wu,661,France,96463.25,1,1,1
526,2011,6,RENT,1,Low,1,12375, 36 months,1,debt_consolidation,6,Low,1,Good Loan,0,7.51,A,1,28.06,13174.14,12375,0,385,409000000525,16-Jul-18,Indfor INCOME INDO REMI15071,360,,1629260.00,Chin,776,France,112349.51,1,1,1
527,2011,6,RENT,1,Low,1,4000, 36 months,1,home_improvement,7,Low,1,Bad Loan,1,12.69,B,2,17.6,2152.95,1481.95,144.45,134.18,409000000526,16-Jul-18,INDO GIBL Indiaforensic STL15071,"69,800.00",,1559460.00,Chesnokova,701,France,165303.79,1,1,1
528,2011,10,MORTGAGE,3,Low,1,13000, 36 months,1,debt_consolidation,6,Low,1,Good Loan,0,10.65,B,2,20.11,15240.3572,13000,0,423.46,409000000527,16-Jul-18,Indfor INCOME INDO REMI14071,840,,1558620.00,Kung,610,France,166031.08,1,1,1
529,2011,1,MORTGAGE,3,Low,1,5000, 36 months,1,home_improvement,7,Low,1,Good Loan,0,6.62,A,1,8.16,5495.24419,5000,0,153.52,409000000528,16-Jul-18,INDO GIBL Indiaforensic STL14071,"121,300.00",,1437320.00,Lu,572,Germany,38411.79,1,1,1
530,2011,7,OWN,2,Low,1,5000, 36 months,1,credit_card,1,High,2,Good Loan,0,15.96,C,3,19.63,6014.59,5000,0,175.69,409000000529,16-Jul-18,Indfor INCOME INDO REMI13071,"3,000.00",,1434320.00,Nkemakolam,673,France,77783.35,1,1,1
531,2011,10,RENT,1,Low,1,26000, 36 months,1,credit_card,1,Low,1,Good Loan,0,11.71,B,2,16.55,30955.56242,26000,0,859.98,409000000530,16-Jul-18,INDO GIBL Indiaforensic STL13071,"505,300.00",,929020.00,Walton,519,Spain,29871.79,1,1,1
532,2011,8,MORTGAGE,3,Low,1,15000, 60 months,2,credit_card,1,High,2,Good Loan,0,18.64,E,5,17.97,22595.34273,15000,0,386.15,409000000531,17-Jul-18,FDRL/INTERNAL FUND TRANSFE,,200000.00,1129020.00,Brookes,702,Spain,59747.63,1,1,1
533,2011,10,RENT,1,Low,1,4000, 60 months,2,house,12,High,2,Bad Loan,1,19.91,E,5,15.2,1775.8,660.29,191.14,105.78,409000000532,17-Jul-18,FDRL/INTERNAL FUND TRANSFE,,500000.00,1629020.00,Baldwin,729,France,79919.13,1,1,1
534,2011,10,RENT,1,Low,1,8000, 36 months,1,debt_consolidation,6,Low,1,Good Loan,0,7.9,A,1,7.56,8976.638447,8000,0,250.33,409000000533,17-Jul-18,Indfor INCOME INDO REMI16071,"4,080.00",,1624940.00,Mai,543,Spain,76773.53,1,1,1
535,2011,6.05,MORTGAGE,3,Low,1,1700, 36 months,1,home_improvement,7,Low,1,Bad Loan,1,7.9,A,1,27,1218.5,940.44,104.03,53.2,409000000534,17-Jul-18,INDO GIBL Indiaforensic STL16071,"717,000.00",,907940.00,Shih,550,France,54018.93,1,1,1
536,2011,10,RENT,1,Low,1,16000, 36 months,1,debt_consolidation,6,Low,1,Good Loan,0,9.91,B,2,15.1,18558.67174,16000,0,515.6,409000000535,17-Jul-18,FDRL/INTERNAL FUND TRANSFE,,200000.00,1107940.00,He,608,France,70649.64,1,1,1
537,2011,10,MORTGAGE,3,Medium,2,20000, 60 months,2,debt_consolidation,6,Low,1,Good Loan,0,9.91,B,2,11.19,23340.52,20000,0,424.06,409000000536,17-Jul-18,FDRL/INTERNAL FUND TRANSFE,,200000.00,1307940.00,Fiorentini,639,Germany,59093.39,1,1,1
538,2011,6,RENT,1,Low,1,12000, 36 months,1,debt_consolidation,6,High,2,Bad Loan,1,14.65,C,3,13.81,11043.04,8359.5,0,413.94,409000000537,18-Jul-18,Indfor INCOME INDO REMI17071,"3,960.00",,1303980.00,Lucciano,686,Spain,127569.80,1,1,1
539,2011,7,MORTGAGE,3,Low,1,7000, 36 months,1,credit_card,1,Low,1,Good Loan,0,11.71,B,2,24.64,8334.521695,7000,0,231.54,409000000538,18-Jul-18,INDO GIBL Indiaforensic STL17071,"581,900.00",,722080.00,Ferreira,564,Germany,18260.98,1,1,1
540,2011,1,RENT,1,Low,1,8000, 60 months,2,debt_consolidation,6,High,2,Bad Loan,1,20.3,E,5,14.23,8505.34,2173.49,2996.25,213.29,409000000539,18-Jul-18,FDRL/INTERNAL FUND TRANSFE,,200000.00,922080.00,Ukaegbunam,745,Germany,73275.96,1,1,1
541,2011,10,RENT,1,Low,1,13000, 60 months,2,debt_consolidation,6,High,2,Good Loan,0,23.52,G,7,11.65,17752.76,9064.08,0,370.38,409000000540,18-Jul-18,FDRL/INTERNAL FUND TRANSFE,,200000.00,1122080.00,De Luca,833,France,136129.49,1,1,1
542,2011,10,RENT,1,Low,1,13000, 36 months,1,debt_consolidation,6,High,2,Bad Loan,1,16.29,D,4,12.9,8768.3,5318.23,441.16,458.91,409000000541,18-Jul-18,FDRL/INTERNAL FUND TRANSFE,,200000.00,1322080.00,Milne,622,France,153237.59,1,1,1
543,2011,2,OWN,2,Medium,2,20000, 60 months,2,debt_consolidation,6,High,2,Good Loan,0,21.28,F,6,16.72,24940.65,20000,0,544.23,409000000542,18-Jul-18,FDRL/INTERNAL FUND TRANSFE,,200000.00,1522080.00,Davide,597,France,106841.12,1,1,1
544,2011,8,MORTGAGE,3,Low,1,18000, 36 months,1,debt_consolidation,6,High,2,Good Loan,0,13.49,C,3,16.4,21978.39591,18000,0,610.75,409000000543,19-Jul-18,FDRL/INTERNAL FUND TRANSFE,,200000.00,1722080.00,Kodilinyechukwu,721,Spain,109078.35,1,1,1
545,2011,3,RENT,1,Low,1,10000, 36 months,1,credit_card,1,High,2,Good Loan,0,16.29,D,4,17.03,11713.05,10000,0,353.01,409000000544,19-Jul-18,FDRL/INTERNAL FUND TRANSFE,,200000.00,1922080.00,Little,504,France,87822.14,1,1,1
546,2011,8,RENT,1,Low,1,22250, 60 months,2,debt_consolidation,6,High,2,Good Loan,0,15.27,C,3,23.07,24929.55,22250,0,532.49,409000000545,19-Jul-18,Indfor INCOME INDO REMI18071,"3,600.00",,1918480.00,Burns,842,Spain,126644.98,1,1,1
547,2011,5,RENT,1,Low,1,24000, 60 months,2,debt_consolidation,6,High,2,Bad Loan,1,17.58,D,4,21.29,4401.18,1567.87,784.14,603.98,409000000546,19-Jul-18,INDO GIBL Indiaforensic STL18071,"663,350.00",,1255130.00,Paterson,587,France,47414.15,1,1,1
548,2011,3,RENT,1,Low,1,11200, 36 months,1,car,2,Low,1,Bad Loan,1,12.42,B,2,22.88,4225.13,2702.91,488.33,374.26,409000000547,20-Jul-18,Indfor INCOME INDO REMI19071,"1,440.00",,1253690.00,Han,479,Germany,41879.99,1,1,1
549,2011,3,RENT,1,Low,1,7000, 36 months,1,other,4,Low,1,Good Loan,0,10.65,B,2,18.16,8206.961483,7000,0,228.02,409000000548,20-Jul-18,INDO GIBL Indiaforensic STL19071,"135,800.00",,1117890.00,Kryukova,508,France,75808.10,1,1,1
550,2011,6,RENT,1,Low,1,8000, 36 months,1,house,12,Low,1,Good Loan,0,6.03,A,1,11.52,8765.098071,8000,0,243.49,409000000549,20-Jul-18,FDRL/INTERNAL FUND TRANSFE,,300000.00,1417890.00,Ijendu,749,France,47911.03,1,1,1
551,2011,4,RENT,1,Low,1,22500, 60 months,2,credit_card,1,High,2,Good Loan,0,16.77,D,4,10.91,31397.80974,22500,0,556.41,409000000550,21-Jul-18,Indfor INCOME INDO REMI20071,"3,600.00",,1414290.00,Reichard,721,Germany,28737.78,1,1,1
552,2011,2,RENT,1,Low,1,12000, 36 months,1,debt_consolidation,6,High,2,Good Loan,0,17.27,D,4,11.1,14495.19,12000,0,429.45,409000000551,21-Jul-18,INDO GIBL Indiaforensic STL20071,"712,099.00",,702191.00,Day,674,Germany,2079.20,1,1,1
553,2011,0.5,RENT,1,Low,1,22000, 36 months,1,debt_consolidation,6,High,2,Good Loan,0,14.65,C,3,12.1,26358.48161,22000,0,758.88,409000000552,21-Jul-18,FDRL/INTERNAL FUND TRANSFE,,1000000.00,1702191.00,Price,685,Spain,121562.33,1,1,1
554,2011,10,MORTGAGE,3,Low,1,6200, 36 months,1,credit_card,1,Low,1,Good Loan,0,10.65,B,2,19.95,6771.26,6200,0,201.96,409000000553,23-Jul-18,FDRL/INTERNAL FUND TRANSFE,,300000.00,2002191.00,Bruce,417,France,55003.79,1,1,1
555,2011,9,MORTGAGE,3,Low,1,15900, 36 months,1,debt_consolidation,6,Low,1,Good Loan,0,9.91,B,2,21.72,18174.06,15900,0,512.38,409000000554,23-Jul-18,Indfor INCOME INDO REMI22071,840,,2001351.00,Sumrall,574,Germany,193131.42,1,1,1
556,2011,6.05,MORTGAGE,3,Low,1,5000, 36 months,1,other,4,Low,1,Good Loan,0,8.9,A,1,16.17,5651.83,5000,0,158.77,409000000555,23-Jul-18,INDO GIBL Indiaforensic STL22071,"145,400.00",,1855951.00,Lu,590,Spain,191932.27,1,1,1
557,2011,3,MORTGAGE,3,Medium,2,16000, 36 months,1,other,4,Low,1,Good Loan,0,6.62,A,1,2.78,17679.88702,16000,0,491.26,409000000556,23-Jul-18,Indfor INCOME INDO REMI21071,"1,920.00",,1854031.00,Lazarev,587,Germany,159418.10,1,1,1
558,2011,4,RENT,1,Low,1,5000, 36 months,1,car,2,Low,1,Good Loan,0,11.71,B,2,4.01,5727.46,5000,0,165.38,409000000557,23-Jul-18,INDO GIBL Indiaforensic STL21071,"240,535.00",,1613496.00,Miller,598,Germany,191468.78,1,1,1
559,2011,5,RENT,1,Low,1,3150, 36 months,1,vacation,11,High,2,Good Loan,0,15.27,C,3,4.37,3945.99,3150,0,109.62,409000000558,24-Jul-18,Indfor INCOME INDO REMI23071,"3,840.00",,1609656.00,Wentworth-Shields,741,Spain,38913.68,1,1,1
560,2011,2,RENT,1,Low,1,12000, 36 months,1,credit_card,1,High,2,Bad Loan,1,14.27,C,3,8.49,5423.3,3441.99,491.18,411.71,409000000559,24-Jul-18,INDO GIBL Indiaforensic STL23071,"610,100.00",,999556.00,Ritchie,850,Spain,705.18,1,1,1
561,2011,4,MORTGAGE,3,Medium,2,28000, 36 months,1,home_improvement,7,Low,1,Bad Loan,1,7.9,A,1,5.29,9959.66,7125.17,1200.06,876.13,409000000560,25-Jul-18,FDRL/INTERNAL FUND TRANSFE,,500000.00,1499556.00,Mackenzie,584,Germany,138490.03,1,1,1
562,2011,0.5,RENT,1,Low,1,5000, 36 months,1,wedding,5,Low,1,Good Loan,0,12.42,B,2,22.59,6013.348274,5000,0,167.08,409000000561,25-Jul-18,Indfor INCOME INDO REMI24071,"3,360.00",,1496196.00,Power,650,Spain,82970.69,1,1,1
563,2011,6.05,MORTGAGE,3,Low,1,3000, 36 months,1,renewable_energy,13,Low,1,Good Loan,0,9.91,B,2,4.29,3479.273807,3000,0,96.68,409000000562,25-Jul-18,INDO GIBL Indiaforensic STL24071,"518,500.00",,977696.00,Tan,607,Spain,76744.72,1,1,1
564,2011,10,MORTGAGE,3,Low,1,3000, 36 months,1,other,4,Low,1,Bad Loan,1,7.9,A,1,4.89,2720.04,2357.46,0,93.88,409000000563,25-Jul-18,FDRL/INTERNAL FUND TRANSFE,,300000.00,1277696.00,Pendergrass,509,France,71244.59,1,1,1
565,2011,2,RENT,1,Low,1,8400, 36 months,1,debt_consolidation,6,Low,1,Good Loan,0,6.62,A,1,11.86,9282.431163,8400,0,257.92,409000000564,25-Jul-18,FDRL/INTERNAL FUND TRANSFE,,300000.00,1577696.00,Evans,689,Spain,12182.15,1,1,1
566,2011,10,MORTGAGE,3,Low,1,7000, 36 months,1,debt_consolidation,6,Low,1,Good Loan,0,10.65,B,2,24,8099.279351,7000,0,228.02,409000000565,26-Jul-18,Indfor INCOME INDO REMI25071,"3,240.00",,1574456.00,Hsia,543,France,141210.50,1,1,1
567,2011,2,RENT,1,Low,1,18550, 60 months,2,debt_consolidation,6,High,2,Good Loan,0,19.42,E,5,21.68,14562.66,8308.2,0,303.6,409000000566,26-Jul-18,INDO GIBL Indiaforensic STL25071,"442,250.00",,1132206.00,Billson,438,Spain,191763.07,1,1,1
568,2011,1,MORTGAGE,3,High,3,2000, 36 months,1,other,4,Low,1,Good Loan,0,9.91,B,2,11.43,2319.607053,2000,0,64.45,409000000567,26-Jul-18,FDRL/INTERNAL FUND TRANSFE,,300000.00,1432206.00,Teng,687,Spain,37938.74,1,1,1
569,2011,3,RENT,1,Low,1,12000, 60 months,2,debt_consolidation,6,High,2,Good Loan,0,14.65,C,3,14.44,10876.42,7083.97,0,226.63,409000000568,27-Jul-18,Indfor INCOME INDO REMI26071,"3,240.00",,1428966.00,Moretti,737,Germany,74890.58,1,1,1
570,2011,6.05,MORTGAGE,3,Low,1,8575, 36 months,1,debt_consolidation,6,High,2,Bad Loan,1,17.58,D,4,22.54,4636.75,2808.63,330.77,308.21,409000000569,27-Jul-18,INDO GIBL Indiaforensic STL26071,"389,600.00",,1039366.00,Jordan,761,France,166698.18,1,1,1
571,2011,8,MORTGAGE,3,Low,1,28000, 60 months,2,debt_consolidation,6,Low,1,Bad Loan,1,12.42,B,2,23.41,14647.04,12259.35,365.49,418.27,409000000570,27-Jul-18,FDRL/INTERNAL FUND TRANSFE,,1000000.00,2039366.00,Ts'ao,601,France,62678.53,1,1,1
572,2011,6,RENT,1,Low,1,10000, 36 months,1,debt_consolidation,6,Low,1,Good Loan,0,7.9,A,1,12.42,11232.7824,10000,0,312.91,409000000571,30-Jul-18,Indfor INCOME INDO REMI27071,"2,760.00",,2036606.00,Osborne,651,France,67740.08,1,1,1
573,2011,2,MORTGAGE,3,Low,1,25000, 36 months,1,credit_card,1,High,2,Good Loan,0,19.42,E,5,21.68,32200.35003,25000,0,921.72,409000000572,30-Jul-18,INDO GIBL Indiaforensic STL27071,"457,875.00",,1578731.00,Carslaw,745,France,161519.77,1,1,1
574,2011,10,RENT,1,Low,1,8000, 36 months,1,credit_card,1,Low,1,Good Loan,0,11.71,B,2,20.21,9522.447926,8000,0,264.61,409000000573,30-Jul-18,Indfor INCOME INDO REMI28071,600,,1578131.00,Ch'ang,648,Spain,159835.78,1,1,1
575,2011,10,MORTGAGE,3,Low,1,16000, 60 months,2,credit_card,1,High,2,Bad Loan,1,18.25,D,4,18.39,8576.66,4035.93,0,408.48,409000000574,30-Jul-18,INDO GIBL Indiaforensic STL28071,"66,800.00",,1511331.00,Hung,848,Spain,30876.84,1,1,1
576,2011,8,MORTGAGE,3,Low,1,25000, 36 months,1,debt_consolidation,6,Low,1,Good Loan,0,11.71,B,2,13.9,29594.09979,25000,0,826.9,409000000575,31-Jul-18,Indfor INCOME INDO REMI30071,"2,280.00",,1509051.00,Gordon,546,France,14858.10,1,1,1
577,2011,10,RENT,1,Low,1,2000, 36 months,1,other,4,Low,1,Good Loan,0,9.91,B,2,13.5,2319.837717,2000,0,64.45,409000000576,31-Jul-18,INDO GIBL Indiaforensic STL30071,"341,400.00",,1167651.00,Obialo,439,Spain,75685.97,1,1,1
578,2011,2,RENT,1,Low,1,16800, 36 months,1,credit_card,1,High,2,Good Loan,0,14.65,C,3,14.52,20858.3257,16800,0,579.51,409000000577,31-Jul-18,FDRL/INTERNAL FUND TRANSFE,,300000.00,1467651.00,Gray,755,France,144183.10,1,1,1
579,2011,3,MORTGAGE,3,Medium,2,8000, 36 months,1,credit_card,1,Low,1,Good Loan,0,8.9,A,1,10.52,8300.5,8000,0,254.03,409000000578,1-Aug-18,Indfor INCOME INDO REMI31071,"2,760.00",,1464891.00,Lin,593,France,65170.66,1,1,1
580,2011,9,MORTGAGE,3,Low,1,12000, 60 months,2,debt_consolidation,6,Low,1,Good Loan,0,12.69,B,2,19.71,15721.21843,12000,0,271.14,409000000579,1-Aug-18,INDO GIBL Indiaforensic STL31071,"372,350.00",,1092541.00,Hopkins,701,France,82526.92,1,1,1
581,2011,4,MORTGAGE,3,Low,1,11000, 36 months,1,credit_card,1,Low,1,Bad Loan,1,7.9,A,1,4.74,3094.2,2508.54,0,344.2,409000000580,1-Aug-18,FDRL/INTERNAL FUND TRANSFE,,300000.00,1392541.00,Dobson,701,Spain,169161.46,1,1,1
582,2011,6,MORTGAGE,3,Low,1,5000, 36 months,1,medical,9,High,2,Bad Loan,1,16.29,D,4,22.81,4056.05,2907.06,0,176.51,409000000581,2-Aug-18,Indfor INCOME INDO REMI01081,"1,080.00",,1391461.00,McKay,607,Spain,109291.39,1,1,1
583,2011,10,OWN,2,Medium,2,18000, 36 months,1,debt_consolidation,6,High,2,Good Loan,0,16.29,D,4,21.8,22871.12809,18000,0,635.41,409000000582,2-Aug-18,INDO GIBL Indiaforensic STL01081,"145,500.00",,1245961.00,Revell,586,Spain,6057.81,1,1,1
584,2011,6,OWN,2,Low,1,10000, 36 months,1,debt_consolidation,6,Low,1,Bad Loan,1,12.69,B,2,15.9,9758.77,7421.06,390.09,335.45,409000000583,2-Aug-18,FDRL/INTERNAL FUND TRANSFE,,300000.00,1545961.00,Rickards,547,Germany,77077.14,1,1,1
585,2011,0.5,RENT,1,Low,1,5000, 36 months,1,credit_card,1,Low,1,Good Loan,0,9.91,B,2,13.92,5799.202075,5000,0,161.13,409000000584,3-Aug-18,Indfor INCOME INDO REMI02081,840,,1545121.00,Begum,647,Germany,54954.51,1,1,1
586,2011,4,RENT,1,Low,1,10000, 36 months,1,credit_card,1,High,2,Good Loan,0,16.29,D,4,16.61,12705.78199,10000,0,353.01,409000000585,3-Aug-18,INDO GIBL Indiaforensic STL02081,"110,550.00",,1434571.00,Onyinyechukwuka,760,France,179614.80,1,1,1
587,2011,4,RENT,1,Medium,2,25000, 36 months,1,vacation,11,Low,1,Good Loan,0,9.91,B,2,4.4,26319.56,25000,0,805.63,409000000586,4-Aug-18,Indfor INCOME INDO REMI03081,"1,200.00",,1433371.00,Zuyev,621,Spain,35588.07,1,1,1
588,2011,4,MORTGAGE,3,Low,1,2400, 36 months,1,medical,9,Low,1,Good Loan,0,12.69,B,2,13.7,2852.34,2400,0,80.51,409000000587,4-Aug-18,INDO GIBL Indiaforensic STL03081,"220,801.00",,1212570.00,Nwankwo,725,France,117356.14,1,1,1
589,2011,4,MORTGAGE,3,Low,1,3000, 36 months,1,other,4,High,2,Bad Loan,1,16.29,D,4,15.16,2704.36,1830.43,164.81,105.91,409000000588,6-Aug-18,Indfor INCOME INDO REMI04081,"1,560.00",,1211010.00,Hao,526,France,160696.72,1,1,1
590,2011,3,RENT,1,Low,1,7700, 36 months,1,other,4,High,2,Bad Loan,1,16.77,D,4,18.58,4911.95,3153.85,271.12,273.65,409000000589,6-Aug-18,INDO GIBL Indiaforensic STL04081,"269,850.00",,941160.00,Ma,519,Spain,147278.43,1,1,1
591,2011,0.5,OWN,2,Low,1,2400, 36 months,1,other,4,High,2,Good Loan,0,13.49,C,3,4.71,2929.343817,2400,0,81.44,409000000590,6-Aug-18,Indfor INCOME INDO REMI05081,240,,940920.00,Okwuadigbo,713,Germany,56594.36,1,1,1
592,2011,10,MORTGAGE,3,Low,1,18500, 60 months,2,debt_consolidation,6,High,2,Good Loan,0,19.03,E,5,20.89,14823.37,8551.94,0,309.54,409000000591,6-Aug-18,INDO GIBL Indiaforensic STL05081,"17,500.00",,923420.00,Mitchell,700,France,1299.75,1,1,1
593,2011,1,OWN,2,Low,1,5000, 36 months,1,credit_card,1,Low,1,Good Loan,0,10.65,B,2,17.11,5481.42,5000,0,162.87,409000000592,7-Aug-18,FDRL/INTERNAL FUND TRANSFE,,500000.00,1423420.00,Chan,666,France,25095.03,1,1,1
594,2011,10,MORTGAGE,3,Low,1,14000, 36 months,1,debt_consolidation,6,High,2,Good Loan,0,17.58,D,4,7.73,16302.86,14000,0,503.19,409000000593,7-Aug-18,Indfor INCOME INDO REMI06081,"3,720.00",,1419700.00,Buchi,630,Spain,146326.45,1,1,1
595,2011,4,RENT,1,Low,1,24500, 60 months,2,credit_card,1,High,2,Bad Loan,1,20.89,F,6,9.09,3994.86,962.75,1353.06,661.3,409000000594,7-Aug-18,INDO GIBL Indiaforensic STL06081,"457,050.00",,962650.00,Greco,779,Spain,38296.21,1,1,1
596,2011,3,MORTGAGE,3,Low,1,2400, 36 months,1,major_purchase,8,Low,1,Good Loan,0,10.65,B,2,15.7,2813.768513,2400,0,78.18,409000000595,7-Aug-18,FDRL/INTERNAL FUND TRANSFE,,300000.00,1262650.00,Lombardi,611,Germany,164061.60,1,1,1
597,2011,7,RENT,1,Medium,2,1800, 36 months,1,other,4,Low,1,Good Loan,0,12.42,B,2,15.86,1993.78,1800,0,60.15,409000000596,7-Aug-18,FDRL/INTERNAL FUND TRANSFE,,300000.00,1562650.00,Uchenna,685,Spain,107811.28,1,1,1
598,2011,2,RENT,1,Medium,2,22200, 36 months,1,debt_consolidation,6,High,2,Bad Loan,1,19.42,E,5,13.33,9174.61,4940.21,991.81,818.49,409000000597,8-Aug-18,Indfor INCOME INDO REMI07081,"3,840.00",,1558810.00,Coffman,646,Germany,30838.51,1,1,1
599,2011,3,RENT,1,Low,1,21400, 60 months,2,credit_card,1,High,2,Good Loan,0,19.42,E,5,19.66,28119.77,21400,0,560.09,409000000598,8-Aug-18,INDO GIBL Indiaforensic STL07081,"662,025.00",,896785.00,Alexandrova,683,Germany,9221.78,1,1,1
600,2011,10,RENT,1,Low,1,13000, 36 months,1,credit_card,1,Low,1,Bad Loan,1,7.9,A,1,16.93,6735.25,5072.35,454.64,406.78,409000000599,8-Aug-18,FDRL/INTERNAL FUND TRANSFE,,500000.00,1396785.00,Fallaci,484,Germany,33738.27,1,1,1
601,2011,5,RENT,1,Low,1,8000, 36 months,1,car,2,Low,1,Good Loan,0,12.69,B,2,15.33,9658.235539,8000,0,268.36,409000000600,9-Aug-18,Indfor INCOME INDO REMI08081,"3,480.00",,1393305.00,Hudson,601,France,110916.15,1,1,1
602,2011,10,MORTGAGE,3,Low,1,3600, 36 months,1,medical,9,Low,1,Bad Loan,1,12.69,B,2,19,3612.83,2785.13,116.22,120.77,409000000601,9-Aug-18,INDO GIBL Indiaforensic STL08081,"556,450.00",,836855.00,Mai,762,Spain,169654.57,1,1,1
603,2011,5,RENT,1,Low,1,12375, 60 months,2,other,4,High,2,Bad Loan,1,23.13,G,7,20.88,8530.26,2444.99,1482.67,349.79,409000000602,9-Aug-18,FDRL/INTERNAL FUND TRANSFE,,500000.00,1336855.00,Stout,687,France,69829.40,1,1,1
604,2011,2,RENT,1,Low,1,9400, 36 months,1,debt_consolidation,6,Low,1,Good Loan,0,9.91,B,2,11.84,10879.1579,9400,0,302.92,409000000603,10-Aug-18,Indfor INCOME INDO REMI09081,"2,280.00",,1334575.00,Burke,566,France,54926.51,1,1,1
605,2011,6,MORTGAGE,3,Medium,2,9600, 36 months,1,home_improvement,7,High,2,Good Loan,0,14.27,C,3,15.54,11852.95669,9600,0,329.37,409000000604,10-Aug-18,INDO GIBL Indiaforensic STL09081,"336,850.00",,997725.00,Chadwick,702,France,94728.49,1,1,1
606,2011,1,RENT,1,Low,1,17000, 36 months,1,debt_consolidation,6,Low,1,Good Loan,0,10.65,B,2,18.63,19932.414,17000,0,553.75,409000000605,10-Aug-18,FDRL/INTERNAL FUND TRANSFE,,1000000.00,1997725.00,Lawrence,601,France,80393.27,1,1,1
607,2011,10,MORTGAGE,3,Low,1,25000, 60 months,2,debt_consolidation,6,High,2,Good Loan,0,19.03,E,5,16.19,21478.1,12388.48,0,448.41,409000000606,13-Aug-18,Indfor INCOME INDO REMI10081,"2,520.00",,1995205.00,Bellucci,699,France,111307.98,1,1,1
608,2011,10,MORTGAGE,3,Low,1,16950, 60 months,2,debt_consolidation,6,High,2,Bad Loan,1,16.77,D,4,14.47,19681.28,11890.62,0,419.16,409000000607,13-Aug-18,INDO GIBL Indiaforensic STL10081,"351,200.00",,1644005.00,Harper,584,France,19834.32,1,1,1
609,2011,10,MORTGAGE,3,Low,1,30000, 60 months,2,credit_card,1,High,2,Good Loan,0,19.03,E,5,26.82,26865.37143,19275,0,500.33,409000000608,13-Aug-18,Indfor INCOME INDO REMI11081,"1,320.00",,1642685.00,Boyle,699,France,78397.24,1,1,1
610,2011,6,MORTGAGE,3,Medium,2,10800, 36 months,1,credit_card,1,High,2,Good Loan,0,14.27,C,3,2.67,12320.73,10800,0,370.54,409000000609,13-Aug-18,INDO GIBL Indiaforensic STL11081,"200,700.00",,1441985.00,Duncan,698,Germany,86410.28,1,1,1
611,2011,10,RENT,1,Low,1,6000, 36 months,1,credit_card,1,Low,1,Good Loan,0,7.9,A,1,19.17,6756.730493,6000,0,187.75,409000000610,13-Aug-18,Indfor INCOME INDO REMI12081,840,,1441145.00,Moss,495,France,172749.65,1,1,1
612,2011,10,MORTGAGE,3,Medium,2,35000, 36 months,1,credit_card,1,Low,1,Good Loan,0,8.9,A,1,12.09,40007.20117,35000,0,1111.37,409000000611,13-Aug-18,INDO GIBL Indiaforensic STL12081,"116,260.00",,1324885.00,Avdeyeva,650,France,1002.39,1,1,1
613,2011,7,RENT,1,Low,1,10000, 36 months,1,debt_consolidation,6,Low,1,Good Loan,0,10.65,B,2,14,10593.37,10000,0,325.74,409000000612,14-Aug-18,Indfor INCOME INDO REMI13081,"3,480.00",,1321405.00,Crawford,605,France,13601.79,1,1,1
614,2011,4,RENT,1,Low,1,15000, 60 months,2,credit_card,1,High,2,Good Loan,0,19.91,E,5,20.85,21051.41025,15000,0,396.66,409000000613,14-Aug-18,INDO GIBL Indiaforensic STL13081,"517,655.00",,803750.00,Lynton,667,Spain,77866.91,1,1,1
615,2011,2,RENT,1,Low,1,5000, 36 months,1,other,4,Low,1,Good Loan,0,12.69,B,2,20.54,6036.059158,5000,0,167.73,409000000614,14-Aug-18,FDRL/INTERNAL FUND TRANSFE,,1000000.00,1803750.00,Duncan,688,Germany,175296.76,1,1,1
616,2011,5,RENT,1,Low,1,3000, 60 months,2,debt_consolidation,6,High,2,Good Loan,0,17.27,D,4,11.42,3593.5,2175.99,0,75,409000000615,16-Aug-18,Indfor INCOME INDO REMI14081,"3,600.00",,1800150.00,Gether,727,Spain,121751.04,1,1,1
617,2011,1,RENT,1,Low,1,7100, 36 months,1,debt_consolidation,6,High,2,Bad Loan,1,14.65,C,3,23.85,3915.2,2774.87,0,244.91,409000000616,16-Aug-18,INDO GIBL Indiaforensic STL14081,"561,995.00",,1238155.00,Davidson,754,Spain,89593.26,1,1,1
618,2011,10,MORTGAGE,3,Low,1,12000, 36 months,1,credit_card,1,High,2,Good Loan,0,16.77,D,4,13.46,15345.77443,12000,0,426.47,409000000617,16-Aug-18,Indfor INCOME INDO REMI15081,"1,320.00",,1236835.00,Larionova,612,Germany,193437.89,1,1,1
619,2011,6,RENT,1,Low,1,22400, 60 months,2,credit_card,1,High,2,Bad Loan,1,22.74,G,7,7.02,26376.52,12893.89,0,628.13,409000000618,16-Aug-18,INDO GIBL Indiaforensic STL15081,"212,000.00",,1024835.00,Loggia,546,Spain,86945.00,1,1,1
620,2011,8,RENT,1,Low,1,5825, 36 months,1,debt_consolidation,6,Low,1,Good Loan,0,10.65,B,2,13.25,6829.179203,5825,0,189.74,409000000619,16-Aug-18,FDRL/INTERNAL FUND TRANSFE,,500000.00,1524835.00,Steinhoff,673,Spain,183318.79,1,1,1
621,2011,2,RENT,1,Low,1,22250, 36 months,1,debt_consolidation,6,Low,1,Bad Loan,1,12.69,B,2,15.63,19580.94,14038,1121.1,746.38,409000000620,17-Aug-18,Indfor INCOME INDO REMI16081,"4,440.00",,1520395.00,Guerra,593,France,71154.10,1,1,1
622,2011,2,RENT,1,Low,1,18000, 60 months,2,debt_consolidation,6,High,2,Good Loan,0,16.77,D,4,21.22,21337.38,13099.11,0,445.13,409000000621,17-Aug-18,INDO GIBL Indiaforensic STL16081,"755,505.00",,764890.00,Pai,656,Spain,151887.16,1,1,1
623,2011,4,RENT,1,Low,1,6000, 36 months,1,credit_card,1,Low,1,Good Loan,0,12.42,B,2,7.2,6690.69,6000,0,200.5,409000000622,17-Aug-18,FDRL/INTERNAL FUND TRANSFE,,400000.00,1164890.00,Craig,535,Germany,75888.65,1,1,1
624,2011,5,RENT,1,Low,1,7650, 36 months,1,debt_consolidation,6,Low,1,Bad Loan,1,11.71,B,2,23.96,3098.5,2056.23,321.33,253.04,409000000623,18-Aug-18,Indfor INCOME INDO REMI17081,"3,960.00",,1160930.00,Lazareva,678,Germany,89566.74,1,1,1
625,2011,2,RENT,1,Medium,2,21000, 60 months,2,credit_card,1,High,2,Good Loan,0,18.25,D,4,13.55,25707.46,15147.22,0,536.13,409000000624,18-Aug-18,INDO GIBL Indiaforensic STL17081,"615,328.00",,545602.00,Ch'iu,477,Spain,26475.79,1,1,1
626,2011,7,RENT,1,Low,1,20675, 60 months,2,other,4,High,2,Bad Loan,1,15.27,C,3,23.31,5928.84,2979.22,0,494.8,409000000625,18-Aug-18,FDRL/INTERNAL FUND TRANSFE,,500000.00,1045602.00,Alderete,850,Spain,126355.80,1,1,1
627,2011,6,MORTGAGE,3,Low,1,13200, 36 months,1,debt_consolidation,6,Low,1,Good Loan,0,7.9,A,1,12.06,14097.72,13200,0,413.04,409000000626,18-Aug-18,FDRL/INTERNAL FUND TRANSFE,,500000.00,1545602.00,Kung,427,France,93839.30,1,1,1
628,2011,0.5,RENT,1,Low,1,12000, 36 months,1,debt_consolidation,6,Low,1,Good Loan,0,7.51,A,1,20.7,13436.27851,12000,0,373.33,409000000627,20-Aug-18,Indfor INCOME INDO REMI18081,"1,920.00",,1543682.00,Palermo,752,France,7698.60,1,1,1
629,2011,6,RENT,1,Medium,2,20000, 60 months,2,debt_consolidation,6,High,2,Good Loan,0,19.03,E,5,9.06,15402.03,12500,0,324.47,409000000628,20-Aug-18,INDO GIBL Indiaforensic STL18081,"262,900.00",,1280782.00,Ts'ai,649,France,145593.85,1,1,1
630,2011,7,RENT,1,Low,1,15000, 36 months,1,house,12,Low,1,Good Loan,0,6.03,A,1,12.78,16434.53801,15000,0,456.54,409000000629,20-Aug-18,Indfor INCOME INDO REMI19081,360,,1280422.00,Rahman,799,Spain,45042.56,1,1,1
631,2011,5,MORTGAGE,3,Low,1,27050, 60 months,2,debt_consolidation,6,High,2,Good Loan,0,18.64,E,5,19.75,40977.76997,27050,0,696.35,409000000630,20-Aug-18,INDO GIBL Indiaforensic STL19081,"18,000.00",,1262422.00,McMillan,589,France,61108.56,1,1,1
632,2011,3,MORTGAGE,3,Low,1,22500, 60 months,2,debt_consolidation,6,High,2,Good Loan,0,17.27,D,4,18.8,28139.25551,22500,0,562.46,409000000631,21-Aug-18,FDRL/INTERNAL FUND TRANSFE,,400000.00,1662422.00,Pickering,583,Germany,57553.98,1,1,1
633,2011,0.5,RENT,1,Low,1,20500, 60 months,2,debt_consolidation,6,Low,1,Bad Loan,1,12.69,B,2,28.32,7896.36,3976.64,959.01,463.2,409000000632,21-Aug-18,Indfor INCOME INDO REMI20081,"4,200.00",,1658222.00,Mirams,839,Spain,62674.42,1,1,1
634,2011,1,MORTGAGE,3,Low,1,12800, 36 months,1,credit_card,1,Low,1,Good Loan,0,12.42,B,2,19.95,15395.57447,12800,0,427.72,409000000633,21-Aug-18,INDO GIBL Indiaforensic STL20081,"554,751.00",,1103471.00,Tsao,540,Germany,12120.79,1,1,1
635,2011,1,MORTGAGE,3,Low,1,27575, 36 months,1,other,4,Low,1,Good Loan,0,10.65,B,2,12.27,32333.82656,27575,0,898.21,409000000634,23-Aug-18,FDRL/INTERNAL FUND TRANSFE,,400000.00,1503471.00,Douglas,850,France,50129.87,1,1,1
636,2011,8,RENT,1,Low,1,7000, 36 months,1,debt_consolidation,6,Low,1,Good Loan,0,12.69,B,2,14.42,8016.9,7000,0,234.82,409000000635,23-Aug-18,FDRL/INTERNAL FUND TRANSFE,,400000.00,1903471.00,Jideofor,696,Spain,55022.43,1,1,1
637,2011,1,RENT,1,Low,1,7600, 60 months,2,other,4,High,2,Good Loan,0,16.77,D,4,16.52,9069.01,5659.08,0,187.95,409000000636,23-Aug-18,Indfor INCOME INDO REMI21081,"5,280.00",,1898191.00,Bell,660,Spain,117834.91,1,1,1
638,2011,10,RENT,1,Low,1,29000, 60 months,2,debt_consolidation,6,Low,1,Bad Loan,1,12.42,B,2,7.22,14318.48,8619.3,0,651.27,409000000637,23-Aug-18,INDO GIBL Indiaforensic STL21081,"912,000.00",,986191.00,Mairinger,682,France,168840.23,1,1,1
639,2011,4,RENT,1,Low,1,10000, 36 months,1,moving,10,High,2,Good Loan,0,14.27,C,3,18.29,12347.05724,10000,0,343.09,409000000638,23-Aug-18,Indfor INCOME INDO REMI22081,"1,800.00",,984391.00,McIntyre,744,France,24234.11,1,1,1
640,2011,5,RENT,1,Low,1,14125, 36 months,1,debt_consolidation,6,Low,1,Good Loan,0,7.9,A,1,22.54,15533.01,14125,0,441.98,409000000639,23-Aug-18,INDO GIBL Indiaforensic STL22081,"335,601.00",,648790.00,Pagnotto,785,France,190627.01,1,1,1
641,2011,0.5,MORTGAGE,3,Low,1,12000, 36 months,1,debt_consolidation,6,Low,1,Good Loan,0,6.62,A,1,4.17,13205.78618,12000,0,368.45,409000000640,23-Aug-18,FDRL/INTERNAL FUND TRANSFE,,400000.00,1048790.00,K'ung,752,Spain,156618.38,1,1,1
642,2011,3,RENT,1,Low,1,9575, 36 months,1,credit_card,1,Low,1,Good Loan,0,6.62,A,1,18.34,10493.86394,9575,0,293.99,409000000641,24-Aug-18,Indfor INCOME INDO REMI23081,"2,400.00",,1046390.00,Feng,706,France,42334.38,1,1,1
643,2011,1,RENT,1,Low,1,12000, 60 months,2,debt_consolidation,6,High,2,Good Loan,0,20.3,E,5,18.76,13908.29001,8900,0,237.29,409000000642,24-Aug-18,INDO GIBL Indiaforensic STL23081,"338,131.00",,708259.00,Donaldson,583,France,110784.42,1,1,1
644,2011,9,MORTGAGE,3,Low,1,12000, 36 months,1,debt_consolidation,6,High,2,Bad Loan,1,15.96,C,3,10.6,4637.54,3074.42,10.94,421.65,409000000643,24-Aug-18,FDRL/INTERNAL FUND TRANSFE,,400000.00,1108259.00,Chambers,660,Germany,173683.00,1,1,1
645,2011,4,RENT,1,Low,1,10000, 36 months,1,credit_card,1,Low,1,Good Loan,0,12.69,B,2,22.61,12070.55506,10000,0,335.45,409000000644,24-Aug-18,FDRL/INTERNAL FUND TRANSFE,,400000.00,1508259.00,Marcelo,819,France,27046.46,1,1,1
646,2011,1,RENT,1,Low,1,10000, 36 months,1,debt_consolidation,6,High,2,Good Loan,0,15.96,C,3,19.46,12644.0203,10000,0,351.38,409000000645,27-Aug-18,Indfor INCOME INDO REMI24081,"1,560.00",,1506699.00,Ejimofor,673,France,20598.59,1,1,1
647,2011,5,MORTGAGE,3,Low,1,25000, 60 months,2,debt_consolidation,6,High,2,Good Loan,0,14.27,C,3,10.77,28074.44,18482.75,0,585.22,409000000646,27-Aug-18,INDO GIBL Indiaforensic STL24081,"230,300.00",,1276399.00,Dale,752,France,104991.28,1,1,1
648,2011,4,RENT,1,Medium,2,24000, 36 months,1,debt_consolidation,6,Low,1,Good Loan,0,9.91,B,2,14.17,27378.86025,24000,0,773.4,409000000647,27-Aug-18,Indfor INCOME INDO REMI25081,720,,1275679.00,Pokrovsky,578,France,8996.97,1,1,1
649,2011,7,RENT,1,Low,1,14575, 36 months,1,credit_card,1,Low,1,Good Loan,0,10.65,B,2,16.46,17088.82229,14575,0,474.76,409000000648,27-Aug-18,INDO GIBL Indiaforensic STL25081,"71,080.00",,1204599.00,Stonebraker,438,France,64420.50,1,1,1
650,2011,0.5,MORTGAGE,3,Low,1,9000, 36 months,1,debt_consolidation,6,Low,1,Good Loan,0,7.51,A,1,4.44,9555.13,9000,0,280,409000000649,27-Aug-18,FDRL/INTERNAL FUND TRANSFE,,400000.00,1604599.00,Liang,652,France,145700.22,1,1,1
651,2011,10,RENT,1,Low,1,10000, 36 months,1,debt_consolidation,6,High,2,Bad Loan,1,13.49,C,3,20.96,4749.77,3411.93,9.79,339.31,409000000650,28-Aug-18,Indfor INCOME INDO REMI27081,"4,320.00",,1600279.00,Anderson,629,France,196335.48,1,1,1
652,2011,7,RENT,1,Low,1,7125, 36 months,1,credit_card,1,High,2,Good Loan,0,17.58,D,4,16.8,9215.105035,7125,0,256.09,409000000651,28-Aug-18,INDO GIBL Indiaforensic STL27081,"518,401.00",,1081878.00,Christian,720,France,14781.12,1,1,1
653,2011,10,RENT,1,Low,1,15000, 60 months,2,debt_consolidation,6,Low,1,Good Loan,0,10.65,B,2,15.14,18733.89878,15000,0,323.53,409000000652,28-Aug-18,FDRL/INTERNAL FUND TRANSFE,,400000.00,1481878.00,Mao,668,France,108139.23,1,1,1
654,2011,6,RENT,1,Low,1,13000, 36 months,1,debt_consolidation,6,High,2,Good Loan,0,13.49,C,3,17.11,14823.19,13000,0,441.1,409000000653,29-Aug-18,Indfor INCOME INDO REMI28081,"2,160.00",,1479718.00,Campbell,459,Germany,19287.06,1,1,1
655,2011,7,RENT,1,Low,1,12000, 60 months,2,debt_consolidation,6,Low,1,Good Loan,0,12.69,B,2,10.44,12998.56,8939.99,0,271.14,409000000654,29-Aug-18,INDO GIBL Indiaforensic STL28081,"254,584.00",,1225134.00,Ginikanwa,729,Spain,9567.39,1,1,1
656,2011,2,RENT,1,Low,1,18000, 60 months,2,credit_card,1,High,2,Good Loan,0,20.3,E,5,17.98,27675.60002,18000,0,479.9,409000000655,29-Aug-18,FDRL/INTERNAL FUND TRANSFE,,400000.00,1625134.00,Toscani,498,Germany,132210.49,1,1,1
657,2011,10,RENT,1,Low,1,30000, 60 months,2,small_business,3,High,2,Good Loan,0,14.27,C,3,19.12,38694.89281,30000,0,702.26,409000000656,30-Aug-18,Indfor INCOME INDO REMI29081,"2,760.00",,1622374.00,Nnachetam,549,Spain,21600.11,1,1,1
658,2011,2,MORTGAGE,3,Low,1,21600, 36 months,1,home_improvement,7,High,2,Bad Loan,1,17.27,D,4,10.85,2724.94,930.13,1180.28,773.01,409000000657,30-Aug-18,INDO GIBL Indiaforensic STL29081,"350,585.00",,1271789.00,Sagese,601,Germany,199661.50,1,1,1
659,2011,5,OWN,2,Low,1,7600, 60 months,2,small_business,3,High,2,Good Loan,0,16.77,D,4,6.29,8982.99,5518.88,0,187.95,409000000658,31-Aug-18,Indfor INCOME INDO REMI30081,"2,280.00",,1269509.00,Fleming,544,France,124341.49,1,1,1
660,2011,10,RENT,1,Low,1,7000, 36 months,1,credit_card,1,Low,1,Good Loan,0,12.42,B,2,15.11,8334.669119,7000,0,233.91,409000000659,31-Aug-18,INDO GIBL Indiaforensic STL30081,"360,425.00",,909084.00,Grubb,751,France,15766.10,1,1,1
661,2011,5,RENT,1,Low,1,7000, 36 months,1,debt_consolidation,6,Low,1,Good Loan,0,8.9,A,1,24.48,8000.341221,7000,0,222.28,409000000660,31-Aug-18,FDRL/INTERNAL FUND TRANSFE,,500000.00,1409084.00,Napolitani,632,Germany,33642.21,1,1,1
662,2011,7,MORTGAGE,3,Low,1,3600, 36 months,1,other,4,High,2,Good Loan,0,17.27,D,4,5.59,4636.867465,3600,0,128.84,409000000661,1-Sep-18,Indfor INCOME INDO REMI31081,"3,000.00",,1406084.00,Anenechi,694,Spain,117704.65,1,1,1
663,2011,10,MORTGAGE,3,Low,1,3500, 36 months,1,major_purchase,8,Low,1,Good Loan,0,12.69,B,2,5.36,4225.278546,3500,0,117.41,409000000662,1-Sep-18,INDO WEIZ STL310818,"414,101.00",,991983.00,Chandler,678,France,58803.28,1,1,1
664,2011,6,RENT,1,Low,1,5000, 36 months,1,medical,9,Low,1,Good Loan,0,8.9,A,1,16.47,5714.713113,5000,0,158.77,409000000663,1-Sep-18,FDRL/INTERNAL FUND TRANSFE,,500000.00,1491983.00,Howells,695,France,137537.22,1,1,1
665,2011,5,MORTGAGE,3,Low,1,10000, 36 months,1,debt_consolidation,6,Low,1,Good Loan,0,11.71,B,2,17.3,11763.73937,10000,0,330.76,409000000664,3-Sep-18,Indfor INCOME INDO REMI01091,"1,440.00",,1490543.00,Akeroyd,661,France,131300.68,1,1,1
666,2011,0.5,OWN,2,Low,1,4500, 36 months,1,credit_card,1,High,2,Good Loan,0,13.49,C,3,19.56,5494.751027,4500,0,152.69,409000000665,3-Sep-18,INDO GIBL Indiaforensic STL01091,"236,300.00",,1254243.00,Onwumelu,661,France,84174.81,1,1,1
667,2011,10,RENT,1,Low,1,12000, 36 months,1,debt_consolidation,6,Low,1,Good Loan,0,11.71,B,2,6.74,14285.98751,12000,0,396.92,409000000666,3-Sep-18,Indfor INCOME INDO REMI02091,120,,1254123.00,Wallace,559,France,160941.78,1,1,1
668,2011,1,RENT,1,Low,1,12000, 60 months,2,debt_consolidation,6,High,2,Good Loan,0,19.03,E,5,10.91,14472.92,12000,0,311.49,409000000667,3-Sep-18,INDO GIBL Indiaforensic STL02091,"9,800.00",,1244323.00,Uwaezuoke,503,France,143954.99,1,1,1
669,2011,4,RENT,1,Low,1,10700, 36 months,1,debt_consolidation,6,Low,1,Good Loan,0,12.42,B,2,16.41,12868.25911,10700,0,357.55,409000000668,4-Sep-18,Indfor INCOME INDO REMI03091,"1,920.00",,1242403.00,Loyau,695,Spain,56297.85,1,1,1
670,2011,1,RENT,1,Low,1,6000, 36 months,1,credit_card,1,Low,1,Good Loan,0,10.65,B,2,19.36,6904.89,6000,0,195.44,409000000669,4-Sep-18,INDO GIBL Indiaforensic STL03091,"228,025.00",,1014378.00,Small,640,France,8404.73,1,1,1
671,2011,10,RENT,1,Low,1,20000, 36 months,1,wedding,5,Low,1,Good Loan,0,7.9,A,1,12.84,22527.90037,20000,0,625.81,409000000670,4-Sep-18,FDRL/INTERNAL FUND TRANSFE,,500000.00,1514378.00,Bledsoe,624,Germany,30020.09,1,1,1
672,2011,2,RENT,1,Low,1,10800, 60 months,2,debt_consolidation,6,High,2,Good Loan,0,16.77,D,4,11.22,11955.52,10800,0,267.08,409000000671,5-Sep-18,Indfor INCOME INDO REMI04091,"2,880.00",,1511498.00,Kao,667,France,58137.42,1,1,1
673,2011,10,RENT,1,Low,1,25000, 60 months,2,debt_consolidation,6,High,2,Good Loan,0,19.03,E,5,20.67,23808.91768,16050,0,416.62,409000000672,5-Sep-18,INDO WEIZ STL040918,"368,300.00",,1143198.00,Wickens,642,France,47472.68,1,1,1
674,2011,5,RENT,1,Medium,2,20000, 60 months,2,debt_consolidation,6,High,2,Good Loan,0,14.27,C,3,10.3,26325.58032,20000,0,468.17,409000000673,6-Sep-18,Indfor INCOME INDO REMI05091,"2,880.00",,1140318.00,Wertheim,640,Spain,19131.71,1,1,1
675,2011,1,RENT,1,Low,1,3600, 36 months,1,vacation,11,High,2,Good Loan,0,13.49,C,3,12.99,4395.549702,3600,0,122.15,409000000674,6-Sep-18,INDO GIBL Indiaforensic STL05091,"406,628.00",,733690.00,He,529,Spain,187288.50,1,1,1
676,2011,10,RENT,1,Low,1,6000, 36 months,1,debt_consolidation,6,Low,1,Good Loan,0,8.9,A,1,17.48,6902.99658,6000,0,190.52,409000000675,6-Sep-18,FDRL/INTERNAL FUND TRANSFE,,500000.00,1233690.00,Jarvis,563,France,17603.81,1,1,1
677,2011,5,RENT,1,Low,1,10375, 36 months,1,credit_card,1,High,2,Good Loan,0,14.27,C,3,22.39,12810.1667,10375,0,355.96,409000000676,7-Sep-18,Indfor INCOME INDO REMI06091,"2,760.00",,1230930.00,P'an,593,Spain,67020.03,1,1,1
678,2011,4,RENT,1,Low,1,25000, 36 months,1,debt_consolidation,6,Low,1,Good Loan,0,8.9,A,1,25.4,28576.74005,25000,0,793.84,409000000677,7-Sep-18,INDO GIBL Indiaforensic STL06091,"377,198.00",,853732.00,Repina,739,Germany,147802.94,1,1,1
679,2011,4,RENT,1,Low,1,10000, 36 months,1,debt_consolidation,6,High,2,Good Loan,0,16.29,D,4,19.98,12427.97,10000,0,353.01,409000000678,10-Sep-18,FDRL/INTERNAL FUND TRANSFE,,500000.00,1353732.00,Pugliesi,788,Spain,41610.62,1,1,1
680,2011,2,RENT,1,Low,1,10000, 60 months,2,small_business,3,Low,1,Good Loan,0,12.42,B,2,10.18,9313.3,6461.88,0,194.26,409000000679,10-Sep-18,Indfor INCOME INDO REMI07091,"3,240.00",,1350492.00,Blakey,684,Spain,44255.65,1,1,1
681,2011,6.05,OWN,2,Low,1,5600, 36 months,1,car,2,Low,1,Good Loan,0,6.03,A,1,3.97,5874.77,5600,0,170.44,409000000680,10-Sep-18,INDO GIBL Indiaforensic STL07091,"441,750.00",,908742.00,Nucci,482,France,78416.14,1,1,1
682,2011,4,RENT,1,Low,1,6000, 36 months,1,car,2,Low,1,Good Loan,0,12.42,B,2,10.6,7216.641117,6000,0,200.5,409000000681,10-Sep-18,Indfor INCOME INDO REMI08091,"2,040.00",,906702.00,Higinbotham,591,Spain,137254.55,1,1,1
683,2011,2,RENT,1,Low,1,8000, 36 months,1,debt_consolidation,6,Low,1,Good Loan,0,7.9,A,1,8.7,9010.490414,8000,0,250.33,409000000682,10-Sep-18,INDO GIBL Indiaforensic STL08091,"274,751.00",,631951.00,Achebe,651,Germany,151303.48,1,1,1
684,2011,10,RENT,1,Low,1,35000, 60 months,2,debt_consolidation,6,Low,1,Good Loan,0,12.42,B,2,26.33,23492.08,16297.65,0,489.57,409000000683,10-Sep-18,Indfor INCOME INDO REMI09091,360,,631591.00,Russo,749,Germany,86333.63,1,1,1
685,2011,4,MORTGAGE,3,Low,1,10000, 36 months,1,debt_consolidation,6,Low,1,Good Loan,0,11.71,B,2,12.48,11903.56989,10000,0,330.76,409000000684,10-Sep-18,INDO GIBL Indiaforensic STL09091,"61,600.00",,569991.00,Trevisani,583,France,89801.90,1,1,1
686,2011,8,RENT,1,Low,1,11000, 36 months,1,debt_consolidation,6,Low,1,Good Loan,0,7.51,A,1,24.1,12223.38333,11000,0,342.22,409000000685,10-Sep-18,FDRL/INTERNAL FUND TRANSFE,,500000.00,1069991.00,Dobie,661,Spain,29358.57,1,1,1
687,2011,6,MORTGAGE,3,Medium,2,5000, 36 months,1,debt_consolidation,6,Low,1,Good Loan,0,9.91,B,2,6.38,5798.794527,5000,0,161.13,409000000686,10-Sep-18,FDRL/INTERNAL FUND TRANSFE,,500000.00,1569991.00,Maccallum,715,France,181600.72,1,1,1
688,2011,0.5,RENT,1,Low,1,6500, 36 months,1,debt_consolidation,6,Low,1,Good Loan,0,10.65,B,2,13.45,7520.309512,6500,0,211.73,409000000687,11-Sep-18,Indfor INCOME INDO REMI10091,"4,200.00",,1565791.00,Watkins,769,Germany,124118.71,1,1,1
689,2011,4,RENT,1,Low,1,20000, 60 months,2,credit_card,1,High,2,Good Loan,0,20.3,E,5,18.02,29399.95287,20000,0,533.23,409000000688,11-Sep-18,INDO GIBL Indiaforensic STL10091,"537,776.00",,1028015.00,Mitchel,625,France,38867.46,1,1,1
690,2011,4,RENT,1,Low,1,12000, 36 months,1,debt_consolidation,6,Low,1,Good Loan,0,12.69,B,2,8.85,14119.2,12000,0,402.54,409000000689,12-Sep-18,FDRL/INTERNAL FUND TRANSFE,,1000000.00,2028015.00,Ferdinand,641,France,31106.67,1,1,1
691,2011,3,RENT,1,Low,1,8250, 60 months,2,wedding,5,High,2,Bad Loan,1,19.91,E,5,20.25,5311.1,1579.15,1607.65,218.17,409000000690,12-Sep-18,Indfor INCOME INDO REMI11091,"5,160.00",,2022855.00,Otitodilinna,716,Germany,67611.36,1,1,1
692,2011,10,MORTGAGE,3,Medium,2,21000, 36 months,1,debt_consolidation,6,Low,1,Good Loan,0,7.9,A,1,3.69,23654.12907,21000,0,657.1,409000000691,12-Sep-18,INDO GIBL Indiaforensic STL11091,"776,577.00",,1246278.00,Mamelu,767,France,77837.63,1,1,1
693,2011,2,RENT,1,Low,1,8400, 36 months,1,credit_card,1,High,2,Good Loan,0,16.77,D,4,16.95,9876.41,8400,0,298.53,409000000692,14-Sep-18,Indfor INCOME INDO REMI12091,"1,800.00",,1244478.00,Beneventi,745,Germany,6078.46,1,1,1
694,2011,5,RENT,1,Low,1,7000, 36 months,1,debt_consolidation,6,Low,1,Good Loan,0,12.69,B,2,21.38,7481.09,7000,0,234.82,409000000693,14-Sep-18,INDO GIBL Indiaforensic STL12091,"252,025.00",,992453.00,Perrodin,589,France,177896.92,1,1,1
695,2011,0.5,RENT,1,Low,1,12000, 36 months,1,car,2,Low,1,Bad Loan,1,12.42,B,2,6.3,9546.76,6788.45,738.84,400.99,409000000694,14-Sep-18,Indfor INCOME INDO REMI13091,"2,520.00",,989933.00,Chinagorom,796,France,123882.73,1,1,1
696,2011,2,RENT,1,Low,1,7200, 36 months,1,credit_card,1,Low,1,Bad Loan,1,11.71,B,2,12.69,7338.4,5810.48,204.3,238.15,409000000695,14-Sep-18,INDO GIBL Indiaforensic STL13091,"395,501.00",,594432.00,Napolitano,664,France,15304.08,1,1,1
697,2011,10,RENT,1,Low,1,12000, 36 months,1,debt_consolidation,6,Low,1,Good Loan,0,10.65,B,2,26.06,13673.71,12000,0,390.88,409000000696,14-Sep-18,FDRL/INTERNAL FUND TRANSFE,,1000000.00,1594432.00,Edgar,445,Spain,76569.64,1,1,1
698,2011,9,RENT,1,Low,1,12800, 60 months,2,credit_card,1,High,2,Good Loan,0,14.27,C,3,16.75,17244.58619,12800,0,299.63,409000000697,15-Sep-18,Indfor INCOME INDO REMI14091,"3,720.00",,1590712.00,Walker,543,Germany,120657.32,1,1,1
699,2011,1,RENT,1,Low,1,3050, 36 months,1,car,2,Low,1,Good Loan,0,9.91,B,2,3.5,3537.37435,3050,0,98.29,409000000698,15-Sep-18,INDO GIBL Indiaforensic STL14091,"543,351.00",,1047361.00,Steele,746,Spain,16436.56,1,1,1
700,2011,1,RENT,1,Low,1,9000, 36 months,1,debt_consolidation,6,High,2,Good Loan,0,14.65,C,3,19.55,10849.55,9000,0,310.45,409000000699,17-Sep-18,FDRL/INTERNAL FUND TRANSFE,,500000.00,1547361.00,Elkins,742,Germany,107667.91,1,1,1
701,2011,5,OWN,2,Low,1,10000, 36 months,1,debt_consolidation,6,Low,1,Bad Loan,1,11.71,B,2,11.79,7293.6,5109.87,694.4,330.76,409000000700,17-Sep-18,FDRL/INTERNAL FUND TRANSFE,,500000.00,2047361.00,Hao,750,France,95611.47,1,1,1
702,2011,0.5,MORTGAGE,3,Low,1,10000, 36 months,1,debt_consolidation,6,Low,1,Good Loan,0,9.91,B,2,18.37,10877.17,10000,0,322.25,409000000701,17-Sep-18,Indfor INCOME INDO REMI15091,"1,200.00",,2046161.00,Toscano,669,France,19799.26,1,1,1
703,2011,10,MORTGAGE,3,Low,1,10000, 36 months,1,credit_card,1,High,2,Bad Loan,1,14.27,C,3,20.05,6884.04,3787.77,850.87,343.09,409000000702,17-Sep-18,INDO GIBL Indiaforensic STL15091,"223,150.00",,1823011.00,Savage,594,Spain,123214.74,1,1,1
704,2011,0.5,RENT,1,Low,1,8500, 36 months,1,debt_consolidation,6,High,2,Good Loan,0,16.29,D,4,11.76,9253.92,8500,0,300.06,409000000703,17-Sep-18,Indfor INCOME INDO REMI16091,120,,1822891.00,Okwuadigbo,574,Spain,71709.12,1,1,1
705,2011,8,RENT,1,Low,1,35000, 60 months,2,debt_consolidation,6,Low,1,Good Loan,0,11.71,B,2,19.42,22552.16,15966.33,0,470.14,409000000704,17-Sep-18,INDO GIBL Indiaforensic STL16091,"12,500.00",,1810391.00,Mordvinova,659,Germany,149066.14,1,1,1
706,2011,10,RENT,1,Low,1,7200, 60 months,2,debt_consolidation,6,High,2,Good Loan,0,13.49,C,3,11.84,9406.39082,7200,0,165.64,409000000705,18-Sep-18,Indfor INCOME INDO REMI17091,"3,960.00",,1806431.00,Welch,750,Germany,20451.99,1,1,1
707,2011,0.5,MORTGAGE,3,Low,1,21000, 60 months,2,credit_card,1,High,2,Good Loan,0,14.27,C,3,8.76,27646.89899,21000,0,491.58,409000000706,18-Sep-18,INDO GIBL Indiaforensic STL17091,"546,674.00",,1259757.00,Kent,626,Germany,32825.50,1,1,1
708,2011,5,OWN,2,Medium,2,27000, 36 months,1,debt_consolidation,6,Low,1,Good Loan,0,9.91,B,2,7.44,31421.50811,27000,0,870.08,409000000707,19-Sep-18,Indfor INCOME INDO REMI18091,"3,720.00",,1256037.00,Campbell,620,France,6232.31,1,1,1
709,2011,6,OWN,2,Low,1,28625, 60 months,2,debt_consolidation,6,High,2,Good Loan,0,20.3,E,5,21.25,36612.62,20390.59,0,763.18,409000000708,19-Sep-18,INDO GIBL Indiaforensic STL18091,"533,052.00",,722985.00,Cooper,580,France,10357.03,1,1,1
710,2011,9,RENT,1,Low,1,4000, 36 months,1,debt_consolidation,6,High,2,Good Loan,0,14.27,C,3,5.41,4938.643698,4000,0,137.24,409000000709,20-Sep-18,FDRL/INTERNAL FUND TRANSFE,,500000.00,1222985.00,Mazzi,686,France,147794.63,1,1,1
711,2011,4,RENT,1,Low,1,7300, 36 months,1,other,4,Low,1,Good Loan,0,11.71,B,2,12.79,7574.8,7300,0,241.46,409000000710,21-Sep-18,Indfor INCOME INDO REMI19091,"2,640.00",,1220345.00,Fisher,540,France,116973.48,1,1,1
712,2011,9,MORTGAGE,3,Low,1,18000, 36 months,1,credit_card,1,Low,1,Good Loan,0,8.9,A,1,17.76,19082.03,18000,0,571.56,409000000711,21-Sep-18,INDO GIBL Indiaforensic STL19091,"497,477.00",,722868.00,Summers,634,Germany,129964.94,1,1,1
713,2011,10,OWN,2,Low,1,5000, 36 months,1,other,4,Low,1,Good Loan,0,11.71,B,2,19.37,5541.16,5000,0,165.38,409000000712,24-Sep-18,FDRL/INTERNAL FUND TRANSFE,,500000.00,1222868.00,Brady,632,Spain,92816.86,1,1,1
714,2011,6.05,MORTGAGE,3,Low,1,6500, 60 months,2,debt_consolidation,6,High,2,Good Loan,0,14.27,C,3,19.06,7302.43,4795.78,0,152.16,409000000713,24-Sep-18,FDRL/INTERNAL FUND TRANSFE,,500000.00,1722868.00,Nicholls,501,France,172114.67,1,1,1
715,2011,4,RENT,1,Low,1,14100, 60 months,2,small_business,3,High,2,Good Loan,0,17.58,D,4,4.83,17015.42,10213.12,0,354.84,409000000714,24-Sep-18,Indfor INCOME INDO REMI20091,"3,120.00",,1719748.00,Yuan,650,Spain,16649.31,1,1,1
716,2011,10,MORTGAGE,3,Medium,2,35000, 60 months,2,small_business,3,High,2,Good Loan,0,19.03,E,5,4.29,27511.89,15774.8,0,572.36,409000000715,24-Sep-18,INDO GIBL Indiaforensic STL20091,"503,006.00",,1216742.00,Robinson,786,France,144517.19,1,1,1
717,2011,10,MORTGAGE,3,Medium,2,10000, 36 months,1,home_improvement,7,High,2,Good Loan,0,14.27,C,3,24.34,11890.1,10000,0,343.09,409000000716,24-Sep-18,Indfor INCOME INDO REMI21091,"1,800.00",,1214942.00,Golubov,554,Germany,182038.60,1,1,1
718,2011,4,RENT,1,Low,1,3000, 36 months,1,debt_consolidation,6,Low,1,Good Loan,0,7.9,A,1,19.39,3378.900433,3000,0,93.88,409000000717,24-Sep-18,INDO GIBL Indiaforensic STL21091,"255,052.00",,959890.00,Chen,701,Spain,24210.56,1,1,1
719,2011,7,RENT,1,Low,1,25000, 60 months,2,debt_consolidation,6,High,2,Good Loan,0,19.03,E,5,15.56,19077.65,11001.84,0,397.8,409000000718,24-Sep-18,Indfor INCOME INDO REMI22091,600,,959290.00,Oldham,474,France,172175.90,1,1,1
720,2011,5,MORTGAGE,3,High,3,28000, 36 months,1,credit_card,1,High,2,Good Loan,0,15.96,C,3,9.08,34725.29396,28000,0,983.85,409000000719,24-Sep-18,INDO GIBL Indiaforensic STL22091,"78,250.00",,881040.00,Kambinachi,621,France,47578.45,1,1,1
721,2011,5,RENT,1,Low,1,10000, 36 months,1,credit_card,1,High,2,Good Loan,0,14.65,C,3,9.6,12419.6075,10000,0,344.95,409000000720,24-Sep-18,Indfor INCOME INDO REMI23091,120,,880920.00,Fleming,672,Spain,150694.42,1,1,1
722,2011,5,RENT,1,Low,1,12000, 36 months,1,credit_card,1,Low,1,Good Loan,0,7.9,A,1,12.83,13516.06909,12000,0,375.49,409000000721,24-Sep-18,INDO GIBL Indiaforensic STL23091,"6,250.00",,874670.00,Cunningham,459,Spain,177683.02,1,1,1
723,2011,3,RENT,1,Low,1,10000, 36 months,1,small_business,3,High,2,Good Loan,0,17.27,D,4,5.73,12874.2358,10000,0,357.88,409000000722,24-Sep-18,FDRL/INTERNAL FUND TRANSFE,,500000.00,1374670.00,Obinna,669,France,66088.83,1,1,1
724,2011,1,RENT,1,Low,1,11000, 36 months,1,debt_consolidation,6,Low,1,Good Loan,0,8.9,A,1,14.09,12458.36047,11000,0,349.29,409000000723,25-Sep-18,Indfor INCOME INDO REMI24091,"2,280.00",,1372390.00,Chinwemma,776,France,169291.70,1,1,1
725,2011,10,RENT,1,Low,1,10000, 36 months,1,small_business,3,High,2,Good Loan,0,15.27,C,3,0.89,12520.02557,10000,0,347.98,409000000724,25-Sep-18,INDO GIBL Indiaforensic STL24091,"345,725.00",,1026665.00,Carpenter,694,France,117140.41,1,1,1
726,2011,5,MORTGAGE,3,Low,1,5000, 36 months,1,debt_consolidation,6,Low,1,Good Loan,0,6.62,A,1,4.12,5525.563209,5000,0,153.52,409000000725,26-Sep-18,FDRL/INTERNAL FUND TRANSFE,,500000.00,1526665.00,Yin,787,France,79510.37,1,1,1
727,2011,3,RENT,1,Low,1,5000, 36 months,1,other,4,Low,1,Good Loan,0,6.03,A,1,0.93,5478.158166,5000,0,152.18,409000000726,26-Sep-18,Indfor INCOME INDO REMI25091,"2,520.00",,1524145.00,Olsen,580,France,77108.66,1,1,1
728,2011,10,RENT,1,Low,1,5000, 36 months,1,debt_consolidation,6,Low,1,Good Loan,0,8.9,A,1,15.47,5714.737829,5000,0,158.77,409000000727,26-Sep-18,INDO GIBL Indiaforensic STL25091,"407,252.00",,1116893.00,Ts'ai,711,France,9679.28,1,1,1
729,2011,7,RENT,1,Low,1,6000, 36 months,1,credit_card,1,High,2,Bad Loan,1,14.27,C,3,15.68,6528.97,4997.41,159.53,205.86,409000000728,27-Sep-18,Indfor INCOME INDO REMI26091,"1,320.00",,1115573.00,Jen,673,France,81753.92,1,1,1
730,2011,4,MORTGAGE,3,Medium,2,5000, 36 months,1,vacation,11,High,2,Good Loan,0,14.27,C,3,20.62,5972.78,5000,0,171.55,409000000729,27-Sep-18,INDO GIBL Indiaforensic STL26091,"256,050.00",,859523.00,Preston,499,France,131372.38,1,1,1
731,2011,7,RENT,1,Low,1,20050, 36 months,1,credit_card,1,High,2,Good Loan,0,17.58,D,4,24.84,25928.6497,20050,0,720.64,409000000730,28-Sep-18,FDRL/INTERNAL FUND TRANSFE,,500000.00,1359523.00,Ozioma,591,France,25310.82,1,1,1
732,2011,0.5,RENT,1,Low,1,7000, 36 months,1,wedding,5,High,2,Bad Loan,1,16.77,D,4,20.31,1582.19,944.53,0,248.77,409000000731,28-Sep-18,Indfor INCOME INDO REMI27091,"2,040.00",,1357483.00,Cody,769,France,187925.75,1,1,1
733,2011,10,RENT,1,Medium,2,25000, 36 months,1,debt_consolidation,6,Low,1,Good Loan,0,10.65,B,2,6.17,29207.43088,25000,0,814.34,409000000732,28-Sep-18,INDO GIBL Indiaforensic STL27091,"327,001.00",,1030482.00,Ponomarev,657,Spain,98820.39,1,1,1
734,2011,10,RENT,1,Low,1,3000, 36 months,1,debt_consolidation,6,Low,1,Bad Loan,1,12.69,B,2,15.4,1134.68,721.02,130.88,100.64,409000000733,29-Sep-18,Indfor INCOME INDO REMI28091,"1,920.00",,1028562.00,Martin,738,Germany,64166.70,1,1,1
735,2011,10,RENT,1,Low,1,8400, 36 months,1,credit_card,1,High,2,Good Loan,0,17.27,D,4,15.07,10826.09106,8400,0,300.62,409000000734,29-Sep-18,INDO GIBL Indiaforensic STL28091,"231,275.00",,797287.00,Milani,545,Germany,176924.21,1,1,1
736,2011,4,RENT,1,Low,1,24925, 60 months,2,credit_card,1,High,2,Good Loan,0,23.91,G,7,17.74,37785.28111,24925,0,715.75,409000000735,1-Oct-18,FDRL/INTERNAL FUND TRANSFE,,500000.00,1297287.00,Tang,497,France,90055.08,1,1,1
737,2011,10,MORTGAGE,3,Low,1,5000, 36 months,1,debt_consolidation,6,Low,1,Good Loan,0,9.91,B,2,18.5,5646.96,5000,0,161.13,409000000736,1-Oct-18,Indfor INCOME INDO REMI29091,"2,040.00",,1295247.00,Romani,816,Spain,72814.31,1,1,1
738,2011,2,RENT,1,Low,1,12000, 60 months,2,credit_card,1,High,2,Good Loan,0,14.27,C,3,6.51,13597.18,11999.99,0,280.91,409000000737,1-Oct-18,INDO GIBL Indiaforensic STL29091,"333,800.00",,961447.00,McIntyre,525,France,168290.06,1,1,1
739,2011,10,RENT,1,Low,1,12000, 36 months,1,credit_card,1,Low,1,Good Loan,0,12.42,B,2,21.49,14432.75233,12000,0,400.99,409000000738,1-Oct-18,Indfor INCOME INDO REMI30091,120,,961327.00,Davis,725,France,161767.38,1,1,1
740,2011,2,MORTGAGE,3,Low,1,13200, 36 months,1,debt_consolidation,6,Low,1,Bad Loan,1,11.71,B,2,9.55,4931.09,3210.7,573.19,436.61,409000000739,1-Oct-18,INDO GIBL Indiaforensic STL30091,"5,000.00",,956327.00,Onyemauchechukwu,692,France,44420.18,1,1,1
741,2011,1,RENT,1,Low,1,6000, 36 months,1,major_purchase,8,Low,1,Good Loan,0,6.03,A,1,15.25,6568.337401,6000,0,182.62,409000000740,3-Oct-18,FDRL/INTERNAL FUND TRANSFE,,500000.00,1456327.00,Gell,618,France,37147.61,1,1,1
742,2011,8,MORTGAGE,3,Low,1,10000, 36 months,1,credit_card,1,Low,1,Good Loan,0,6.62,A,1,13.42,10606.08,10000,0,307.04,409000000741,3-Oct-18,Indfor INCOME INDO REMI01101,"3,720.00",,1452607.00,Rossi,546,France,125381.02,1,1,1
743,2011,4,RENT,1,Low,1,17500, 60 months,2,credit_card,1,Low,1,Good Loan,0,12.42,B,2,16.7,18211.49,17500.01,0,393.01,409000000742,3-Oct-18,INDO GIBL Indiaforensic STL01101,"529,105.00",,923502.00,Chiwetelu,635,France,149853.89,1,1,1
744,2011,2,RENT,1,Low,1,6500, 36 months,1,debt_consolidation,6,Low,1,Good Loan,0,10.65,B,2,20.81,7619.888892,6500,0,211.73,409000000743,3-Oct-18,Indfor INCOME INDO REMI02101,"1,200.00",,922302.00,Kirillova,611,France,161435.02,1,1,1
745,2011,2,MORTGAGE,3,Low,1,10000, 36 months,1,small_business,3,Low,1,Good Loan,0,7.51,A,1,8.55,10942.88,10000,0,311.11,409000000744,3-Oct-18,INDO GIBL Indiaforensic STL02101,"225,300.00",,697002.00,Shaw,650,France,102925.76,1,1,1
746,2011,2,RENT,1,Low,1,12000, 36 months,1,debt_consolidation,6,Low,1,Good Loan,0,9.91,B,2,10.38,13911.01573,12000,0,386.7,409000000745,3-Oct-18,FDRL/INTERNAL FUND TRANSFE,,500000.00,1197002.00,Smith,606,France,70899.27,1,1,1
747,2011,10,RENT,1,Low,1,10000, 36 months,1,debt_consolidation,6,High,2,Good Loan,0,14.27,C,3,22.1,12347.16119,10000,0,343.09,409000000746,3-Oct-18,FDRL/INTERNAL FUND TRANSFE,,500000.00,1697002.00,Hsieh,844,France,145936.28,1,1,1
748,2011,10,RENT,1,Low,1,12375, 36 months,1,credit_card,1,High,2,Good Loan,0,14.27,C,3,23.03,13695.68,12374.99,0,424.58,409000000747,4-Oct-18,Indfor INCOME INDO REMI03101,"3,120.00",,1693882.00,Onyemauchechukwu,450,Spain,54227.06,1,1,1
749,2011,1,RENT,1,Low,1,10000, 36 months,1,debt_consolidation,6,Low,1,Good Loan,0,10.65,B,2,9.78,11723.08493,10000,0,325.74,409000000748,4-Oct-18,INDO GIBL Indiaforensic STL03101,"545,402.00",,1148480.00,Martin,727,Spain,59280.79,1,1,1
750,2011,7,RENT,1,Low,1,20000, 60 months,2,small_business,3,High,2,Bad Loan,1,18.25,D,4,18.41,22954.38,13187.2,0,510.6,409000000749,5-Oct-18,Indfor INCOME INDO REMI04101,"1,440.00",,1147040.00,Okwudilichukwu,460,Germany,126952.50,1,1,1
751,2011,7,RENT,1,Low,1,4400, 36 months,1,small_business,3,High,2,Good Loan,0,19.03,E,5,2.65,5806.34597,4400,0,161.36,409000000750,5-Oct-18,INDO GIBL Indiaforensic STL04101,"156,313.00",,990727.00,Onuoha,649,France,130567.02,1,1,1
752,2011,4,MORTGAGE,3,Low,1,25000, 36 months,1,debt_consolidation,6,High,2,Good Loan,0,13.49,C,3,14.65,27062.01,25000,0,848.27,409000000751,6-Oct-18,Indfor INCOME INDO REMI05101,"1,320.00",,989407.00,Muecke,758,Germany,73294.48,1,1,1
753,2011,6.05,MORTGAGE,3,Low,1,14125, 36 months,1,debt_consolidation,6,Low,1,Bad Loan,1,12.42,B,2,21.93,6600.86,4875.95,0,472,409000000752,6-Oct-18,INDO GIBL Indiaforensic STL05101,"230,751.00",,758656.00,Hsieh,490,France,3937.37,1,1,1
754,2011,2,MORTGAGE,3,Low,1,35000, 60 months,2,wedding,5,High,2,Good Loan,0,20.3,E,5,24.71,28470.38,21825,0,581.88,409000000753,6-Oct-18,FDRL/INTERNAL FUND TRANSFE,,500000.00,1258656.00,Anderson,815,Germany,2383.59,1,1,1
755,2011,1,RENT,1,Low,1,13600, 60 months,2,debt_consolidation,6,Low,1,Good Loan,0,12.69,B,2,11.98,17506.9357,13600,0,307.29,409000000754,8-Oct-18,Indfor INCOME INDO REMI07101,480,,1258176.00,Azubuike,838,Spain,14279.44,1,1,1
756,2011,7,RENT,1,Low,1,20000, 60 months,2,credit_card,1,Low,1,Good Loan,0,12.69,B,2,27.67,25198.37659,20000,0,451.9,409000000755,8-Oct-18,INDO GIBL Indiaforensic STL07101,"56,000.00",,1202176.00,Nnonso,803,France,141300.53,1,1,1
757,2011,0.5,OWN,2,Low,1,18000, 36 months,1,debt_consolidation,6,High,2,Bad Loan,1,13.49,C,3,12.87,13380.5,2950.75,9114.35,610.75,409000000756,8-Oct-18,Indfor INCOME INDO REMI06101,"2,280.00",,1199896.00,Fuller,664,Germany,78140.75,1,1,1
758,2011,10,OWN,2,Low,1,13000, 60 months,2,debt_consolidation,6,High,2,Good Loan,0,16.77,D,4,4.96,18462.04001,13000,0,321.48,409000000757,8-Oct-18,INDO GIBL Indiaforensic STL06101,"282,452.00",,917444.00,Ashley,736,Spain,117431.10,1,1,1
759,2011,7,MORTGAGE,3,Low,1,35000, 36 months,1,debt_consolidation,6,High,2,Good Loan,0,16.77,D,4,19.03,44519.61002,35000,0,1243.85,409000000758,8-Oct-18,FDRL/INTERNAL FUND TRANSFE,,500000.00,1417444.00,Ts'ui,633,France,72008.61,1,1,1
760,2011,1,MORTGAGE,3,Medium,2,35000, 36 months,1,credit_card,1,High,2,Good Loan,0,14.27,C,3,19.34,41998.98,35000,0,1200.82,409000000759,9-Oct-18,Indfor INCOME INDO REMI08101,"4,080.00",,1413364.00,Buccho,664,France,60887.58,1,1,1
761,2011,10,RENT,1,Low,1,12000, 60 months,2,debt_consolidation,6,Low,1,Good Loan,0,11.71,B,2,21.17,12713.56,9001.42,0,265.18,409000000760,9-Oct-18,INDO GIBL Indiaforensic STL08101,"530,352.00",,883012.00,Chidozie,600,France,194764.83,1,1,1
762,2011,9,MORTGAGE,3,Low,1,7200, 36 months,1,debt_consolidation,6,High,2,Good Loan,0,13.49,C,3,22.22,8400.86,7200,0,244.3,409000000761,9-Oct-18,FDRL/INTERNAL FUND TRANSFE,,500000.00,1383012.00,Maclean,693,France,88705.14,1,1,1
763,2011,10,MORTGAGE,3,Medium,2,25000, 60 months,2,small_business,3,High,2,Good Loan,0,15.96,C,3,5.66,22175.02094,15925,0,386.93,409000000762,10-Oct-18,Indfor INCOME INDO REMI09101,"1,920.00",,1381092.00,Burns,663,Germany,35817.97,1,1,1
764,2011,3,RENT,1,Low,1,4000, 36 months,1,other,4,Low,1,Good Loan,0,12.69,B,2,21.66,4828.770623,4000,0,134.18,409000000763,10-Oct-18,INDO GIBL Indiaforensic STL09101,"315,083.00",,1066009.00,Chu,742,Germany,31520.40,1,1,1
765,2011,10,RENT,1,Low,1,7000, 36 months,1,credit_card,1,Low,1,Good Loan,0,7.51,A,1,26.86,7837.832636,7000,0,217.78,409000000764,11-Oct-18,FDRL/INTERNAL FUND TRANSFE,,500000.00,1566009.00,Kenenna,710,Germany,157908.19,1,1,1
766,2011,4,MORTGAGE,3,Low,1,15000, 36 months,1,other,4,High,2,Good Loan,0,13.49,C,3,6.93,18379.50029,15000,0,508.96,409000000765,11-Oct-18,Indfor INCOME INDO REMI10101,"3,720.00",,1562289.00,Beluchi,710,Spain,142200.15,1,1,1
767,2011,1,RENT,1,Low,1,12800, 60 months,2,debt_consolidation,6,Low,1,Good Loan,0,11.71,B,2,21.8,13564.28,9603.54,0,282.86,409000000766,11-Oct-18,INDO GIBL Indiaforensic STL10101,"584,951.00",,977338.00,Williamson,700,France,182055.36,1,1,1
768,2011,10,MORTGAGE,3,Low,1,35000, 60 months,2,debt_consolidation,6,High,2,Bad Loan,1,20.89,F,6,14.79,1151.2,412.29,0,576.27,409000000767,12-Oct-18,FDRL/INTERNAL FUND TRANSFE,,500000.00,1477338.00,Bobrov,720,Germany,157552.08,1,1,1
769,2011,8,RENT,1,Low,1,15000, 60 months,2,credit_card,1,High,2,Good Loan,0,16.77,D,4,15.69,17782.5,10916.56,0,370.94,409000000768,12-Oct-18,Indfor INCOME INDO REMI11101,"4,080.00",,1473258.00,Kerr,684,Spain,120284.67,1,1,1
770,2011,5,RENT,1,Low,1,7200, 36 months,1,debt_consolidation,6,Low,1,Good Loan,0,7.9,A,1,17.51,8111.041493,7200,0,225.29,409000000769,12-Oct-18,INDO GIBL Indiaforensic STL11101,"599,251.00",,874007.00,McKenzie,531,France,24506.95,1,1,1
771,2011,10,RENT,1,Low,1,13000, 36 months,1,debt_consolidation,6,High,2,Good Loan,0,17.27,D,4,10.9,16272.97548,13000,0,465.24,409000000770,15-Oct-18,FDRL/INTERNAL FUND TRANSFE,,500000.00,1374007.00,Pitts,742,Germany,47271.61,1,1,1
772,2011,4,RENT,1,Low,1,28000, 36 months,1,credit_card,1,Low,1,Good Loan,0,7.9,A,1,14.64,31031.65,28000,0,876.13,409000000771,15-Oct-18,FDRL/INTERNAL FUND TRANSFE,,500000.00,1874007.00,Standish,717,France,41176.60,1,1,1
773,2011,8,RENT,1,Low,1,12000, 36 months,1,debt_consolidation,6,Low,1,Good Loan,0,9.91,B,2,15.87,13918.77988,12000,0,386.7,409000000772,15-Oct-18,Indfor INCOME INDO REMI12101,"3,840.00",,1870167.00,Cartwright,589,France,9468.64,1,1,1
774,2011,0.5,RENT,1,Low,1,16000, 60 months,2,debt_consolidation,6,High,2,Bad Loan,1,17.58,D,4,21.14,1698.62,338.39,894.68,402.65,409000000773,15-Oct-18,INDO GIBL Indiaforensic STL12101,"730,425.00",,1139742.00,Johnstone,767,France,123880.19,1,1,1
775,2011,5,RENT,1,Low,1,14000, 36 months,1,other,4,Low,1,Good Loan,0,8.9,A,1,9.08,16001.29787,14000,0,444.55,409000000774,15-Oct-18,Indfor INCOME INDO REMI13101,"1,440.00",,1138302.00,Nikitina,636,Germany,158887.09,1,1,1
776,2011,10,RENT,1,Low,1,11500, 36 months,1,debt_consolidation,6,Low,1,Good Loan,0,11.71,B,2,7.96,13368.85,11500,0,380.38,409000000775,15-Oct-18,INDO GIBL Indiaforensic STL13101,"173,350.00",,964952.00,McElroy,648,France,117036.38,1,1,1
777,2011,1,MORTGAGE,3,Low,1,10500, 36 months,1,debt_consolidation,6,High,2,Good Loan,0,14.65,C,3,10.77,12544.09,10500,0,362.19,409000000776,15-Oct-18,Indfor INCOME INDO REMI14101,360,,964592.00,Shen,622,Germany,120415.61,1,1,1
778,2011,5,OWN,2,Low,1,14400, 36 months,1,credit_card,1,Low,1,Good Loan,0,12.42,B,2,20.68,17352.76502,14400,0,481.18,409000000777,15-Oct-18,INDO GIBL Indiaforensic STL14101,"34,500.00",,930092.00,Archer,692,Spain,16064.25,1,1,1
779,2011,7,RENT,1,Low,1,16000, 36 months,1,debt_consolidation,6,Low,1,Good Loan,0,9.91,B,2,10.36,17991.38,16000.01,0,515.6,409000000778,16-Oct-18,FDRL/INTERNAL FUND TRANSFE,,500000.00,1430092.00,Otutodilinna,754,France,52615.62,1,1,1
780,2011,2,RENT,1,Low,1,5375, 36 months,1,debt_consolidation,6,Low,1,Good Loan,0,9.91,B,2,16.25,6233.763882,5375,0,173.21,409000000779,16-Oct-18,Indfor INCOME INDO REMI15101,"5,160.00",,1424932.00,Shih,679,Spain,121210.09,1,1,1
781,2011,10,MORTGAGE,3,Low,1,12000, 36 months,1,credit_card,1,High,2,Good Loan,0,13.49,C,3,17.67,14559.2163,12000,0,407.17,409000000780,16-Oct-18,INDO GIBL Indiaforensic STL15101,"780,576.00",,644356.00,Denisov,639,France,192247.35,1,1,1
782,2011,0.5,RENT,1,Low,1,12000, 36 months,1,debt_consolidation,6,Low,1,Bad Loan,1,7.51,A,1,8.36,3531.72,2435.23,549.4,373.33,409000000781,17-Oct-18,FDRL/INTERNAL FUND TRANSFE,,200000.00,844356.00,Owens,774,France,68759.57,1,1,1
783,2011,2,MORTGAGE,3,Medium,2,17000, 36 months,1,small_business,3,Low,1,Good Loan,0,6.03,A,1,8.94,18625.72564,17000,0,517.41,409000000782,17-Oct-18,FDRL/INTERNAL FUND TRANSFE,,300000.00,1144356.00,P'eng,517,France,75937.47,1,1,1
784,2011,0.5,RENT,1,Medium,2,30000, 60 months,2,credit_card,1,High,2,Good Loan,0,19.03,E,5,15.72,36983.59,30000,0,778.72,409000000783,17-Oct-18,FDRL/INTERNAL FUND TRANSFE,,200000.00,1344356.00,Verco,571,France,84569.13,1,1,1
785,2011,5,RENT,1,Low,1,13000, 36 months,1,debt_consolidation,6,High,2,Bad Loan,1,20.3,E,5,7.69,6564.2,3536.97,543.27,485.12,409000000784,17-Oct-18,FDRL/INTERNAL FUND TRANSFE,,300000.00,1644356.00,Bergamaschi,747,Germany,190696.35,1,1,1
786,2011,0.5,MORTGAGE,3,Low,1,7125, 36 months,1,debt_consolidation,6,Low,1,Bad Loan,1,7.51,A,1,18.12,3103.49,2306.14,276.61,221.67,409000000785,17-Oct-18,Indfor INCOME INDO REMI16101,"4,080.00",,1640276.00,Lorenzo,792,Spain,67468.67,1,1,1
787,2011,10,RENT,1,Low,1,14000, 60 months,2,wedding,5,High,2,Good Loan,0,18.25,D,4,16.28,17135.62,10096.83,0,357.42,409000000786,17-Oct-18,INDO GIBL Indiaforensic STL16101,"673,628.00",,966648.00,Outtrim,688,France,104435.94,1,1,1
788,2011,1,RENT,1,Low,1,8000, 36 months,1,debt_consolidation,6,High,2,Good Loan,0,14.65,C,3,6.71,8797.75,8000,0,275.96,409000000787,17-Oct-18,FDRL/INTERNAL FUND TRANSFE,,500000.00,1466648.00,Hou,714,Germany,47166.55,1,1,1
789,2011,3,RENT,1,Low,1,12500, 36 months,1,debt_consolidation,6,Low,1,Good Loan,0,11.71,B,2,17.32,14881.19741,12500,0,413.45,409000000788,19-Oct-18,Indfor INCOME INDO REMI17101,"1,200.00",,1465448.00,Galkin,562,Spain,119899.52,1,1,1
790,2011,4,RENT,1,Low,1,10000, 36 months,1,car,2,High,2,Good Loan,0,14.27,C,3,18.69,11154.11,10000,0,343.09,409000000789,19-Oct-18,INDO GIBL Indiaforensic STL17101,"119,200.00",,1346248.00,Pagnotto,704,Spain,173498.45,1,1,1
791,2011,1,RENT,1,Low,1,12000, 60 months,2,other,4,High,2,Good Loan,0,13.49,C,3,23.58,9020.08,6070.97,0,188.07,409000000790,19-Oct-18,Indfor INCOME INDO REMI18101,"1,200.00",,1345048.00,Echezonachukwu,698,France,93249.26,1,1,1
792,2011,3,RENT,1,Low,1,14000, 36 months,1,credit_card,1,Low,1,Good Loan,0,10.65,B,2,21.95,16413.45172,14000,0,456.03,409000000791,19-Oct-18,INDO GIBL Indiaforensic STL18101,"149,802.00",,1195246.00,Young,611,France,142917.54,1,1,1
793,2011,5,RENT,1,Low,1,7500, 36 months,1,debt_consolidation,6,Low,1,Good Loan,0,6.03,A,1,5.08,8213.849094,7500,0,228.27,409000000792,20-Oct-18,Indfor INCOME INDO REMI19101,480,,1194766.00,Summers,850,Germany,111755.80,1,1,1
794,2011,9,MORTGAGE,3,Low,1,19200, 36 months,1,debt_consolidation,6,Low,1,Good Loan,0,9.91,B,2,11.37,21528.19,19200,0,618.72,409000000793,20-Oct-18,INDO GIBL Indiaforensic STL19101,"56,000.00",,1138766.00,Munro,743,Germany,108543.21,1,1,1
795,2011,7,MORTGAGE,3,Medium,2,9000, 36 months,1,debt_consolidation,6,Low,1,Good Loan,0,11.71,B,2,13.06,10714.95251,9000,0,297.69,409000000794,22-Oct-18,Indfor INCOME INDO REMI20101,"1,200.00",,1137566.00,Brennan,654,France,180345.44,1,1,1
796,2011,4,MORTGAGE,3,Low,1,16000, 60 months,2,credit_card,1,High,2,Good Loan,0,17.27,D,4,11.98,19173.08,11608.49,0,399.97,409000000795,22-Oct-18,INDO GIBL Indiaforensic STL20101,"223,600.00",,913966.00,Ball,761,Germany,99444.02,1,1,1
797,2011,3,RENT,1,Low,1,20000, 36 months,1,credit_card,1,Low,1,Good Loan,0,8.9,A,1,14.99,22859.45344,20000,0,635.07,409000000796,22-Oct-18,Indfor INCOME INDO REMI21101,120,,913846.00,Virgo,702,France,109563.28,1,1,1
798,2011,7,MORTGAGE,3,Low,1,9000, 36 months,1,debt_consolidation,6,High,2,Good Loan,0,13.49,C,3,1.99,10990.74867,9000,0,305.38,409000000797,22-Oct-18,INDO GIBL Indiaforensic STL21101,"10,500.00",,903346.00,Trevisani,488,Germany,92568.07,1,1,1
799,2011,10,RENT,1,Low,1,9600, 36 months,1,debt_consolidation,6,Low,1,Bad Loan,1,7.51,A,1,27.34,7120.37,5595.77,564.81,298.67,409000000798,22-Oct-18,FDRL/INTERNAL FUND TRANSFE,,500000.00,1403346.00,Padovano,683,France,37976.36,1,1,1
800,2011,10,MORTGAGE,3,Low,1,12000, 60 months,2,debt_consolidation,6,Low,1,Bad Loan,1,12.69,B,2,20.67,12972.64,886.61,11349.52,271.14,409000000799,23-Oct-18,Indfor INCOME INDO REMI22101,"2,760.00",,1400586.00,Tao,601,Germany,103315.74,1,1,1
801,2011,10,MORTGAGE,3,Medium,2,18000, 60 months,2,home_improvement,7,Low,1,Good Loan,0,11.71,B,2,10.97,13061.8,9247.93,0,272.37,409000000800,23-Oct-18,INDO GIBL Indiaforensic STL22101,"436,678.00",,963908.00,Perez,605,France,173952.50,1,1,1
802,2011,8,RENT,1,Low,1,1000, 36 months,1,small_business,3,High,2,Good Loan,0,13.49,C,3,6.19,1017.55,1000,0,33.94,409000000801,23-Oct-18,FDRL/INTERNAL FUND TRANSFE,,200000.00,1163908.00,Fraser,671,Germany,34673.98,1,1,1
803,2011,6,RENT,1,Low,1,15000, 36 months,1,credit_card,1,High,2,Bad Loan,1,15.27,C,3,13.83,9376.44,6231.02,515.36,521.97,409000000802,24-Oct-18,Indfor INCOME INDO REMI23101,"2,040.00",,1161868.00,Alley,614,Germany,46163.44,1,1,1
804,2011,6,RENT,1,Low,1,12000, 36 months,1,debt_consolidation,6,High,2,Good Loan,0,16.77,D,4,21.32,14107,12000,0,426.47,409000000803,24-Oct-18,INDO GIBL Indiaforensic STL23101,"432,150.00",,729718.00,Howells,511,Spain,140676.98,1,1,1
805,2011,3,RENT,1,Low,1,12000, 60 months,2,medical,9,High,2,Good Loan,0,14.27,C,3,22.77,13474.32,8871.07,0,280.91,409000000804,24-Oct-18,FDRL/INTERNAL FUND TRANSFE,,500000.00,1229718.00,Cameron,850,France,151738.54,1,1,1
806,2011,7,MORTGAGE,3,Medium,2,14000, 36 months,1,credit_card,1,Low,1,Good Loan,0,8.9,A,1,27.86,15713.21,14000,0,444.55,409000000805,25-Oct-18,Indfor INCOME INDO REMI24101,"1,320.00",,1228398.00,Hooper,790,Spain,14679.81,1,1,1
807,2011,0.5,RENT,1,Low,1,15600, 60 months,2,debt_consolidation,6,High,2,Good Loan,0,15.96,C,3,7.56,22125.43418,15600,0,379.04,409000000806,25-Oct-18,INDO GIBL Indiaforensic STL24101,"156,401.00",,1071997.00,Rice,793,France,175544.02,1,1,1
808,2011,4,RENT,1,Low,1,10000, 36 months,1,debt_consolidation,6,Low,1,Good Loan,0,10.65,B,2,11.41,11723.51949,10000,0,325.74,409000000807,26-Oct-18,Indfor INCOME INDO REMI25101,"1,320.00",,1070677.00,Cox,628,France,181964.60,1,1,1
809,2011,1,RENT,1,Low,1,7200, 36 months,1,other,4,Low,1,Good Loan,0,12.69,B,2,20.19,8767.154702,7200,0,241.53,409000000808,26-Oct-18,INDO GIBL Indiaforensic STL25101,"232,683.00",,837994.00,Martin,598,Germany,136886.86,1,1,1
810,2011,2,MORTGAGE,3,Low,1,22250, 60 months,2,debt_consolidation,6,High,2,Bad Loan,1,15.27,C,3,23.76,10060.04,4691.15,1023.52,532.49,409000000809,29-Oct-18,FDRL/INTERNAL FUND TRANSFE,,200000.00,1037994.00,Ikenna,657,France,122218.23,1,1,1
811,2011,0.5,RENT,1,Low,1,13250, 60 months,2,debt_consolidation,6,High,2,Good Loan,0,17.27,D,4,10.89,15885.26,9616.88,0,331.23,409000000810,29-Oct-18,FDRL/INTERNAL FUND TRANSFE,,200000.00,1237994.00,Davide,618,France,180439.75,1,1,1
812,2011,0.5,MORTGAGE,3,Medium,2,26400, 60 months,2,house,12,High,2,Good Loan,0,14.27,C,3,3.23,22493.50057,16725,0,391.51,409000000811,29-Oct-18,FDRL/INTERNAL FUND TRANSFE,,200000.00,1437994.00,Alexander,681,Spain,190419.81,1,1,1
813,2011,4,RENT,1,Low,1,11000, 36 months,1,debt_consolidation,6,Low,1,Good Loan,0,9.91,B,2,23.66,11350.45,11000,0,354.48,409000000812,29-Oct-18,Indfor INCOME INDO REMI26101,"1,560.00",,1436434.00,Piazza,516,Spain,58685.59,1,1,1
814,2011,3,RENT,1,Low,1,9600, 36 months,1,credit_card,1,Low,1,Good Loan,0,8.9,A,1,17.02,10971.81459,9600,0,304.84,409000000813,29-Oct-18,INDO GIBL Indiaforensic STL26101,"224,800.00",,1211634.00,Ni,421,Germany,89017.38,1,1,1
815,2011,4,RENT,1,Low,1,10000, 36 months,1,debt_consolidation,6,High,2,Good Loan,0,16.77,D,4,18.55,12786.89777,10000,0,355.39,409000000814,29-Oct-18,Indfor INCOME INDO REMI27101,"1,200.00",,1210434.00,Black,700,France,50051.42,1,1,1
816,2011,3,OWN,2,Low,1,7000, 60 months,2,other,4,High,2,Good Loan,0,15.96,C,3,21.66,8137.32,5111.01,0,170.08,409000000815,29-Oct-18,INDO GIBL Indiaforensic STL27101,"254,250.00",,956184.00,Harker,745,France,146041.45,1,1,1
817,2011,5,MORTGAGE,3,Low,1,11000, 36 months,1,wedding,5,Low,1,Good Loan,0,9.91,B,2,18.24,12757.78953,11000,0,354.48,409000000816,30-Oct-18,Indfor INCOME INDO REMI29101,"3,360.00",,952824.00,Hughes,696,France,191166.09,1,1,1
818,2011,9,MORTGAGE,3,Low,1,13000, 60 months,2,wedding,5,High,2,Good Loan,0,16.77,D,4,19.13,15411.02,9460.71,0,321.48,409000000817,30-Oct-18,INDO GIBL Indiaforensic STL29101,"364,175.00",,588649.00,Chiabuotu,580,Germany,103516.08,1,1,1
819,2011,8,OWN,2,Low,1,5000, 36 months,1,credit_card,1,Low,1,Good Loan,0,7.51,A,1,18.72,5061.87,5000,0,155.56,409000000818,30-Oct-18,FDRL/INTERNAL FUND TRANSFE,,200000.00,788649.00,Kuo,497,Spain,164825.04,1,1,1
820,2011,1,RENT,1,Low,1,6000, 36 months,1,small_business,3,Low,1,Bad Loan,1,11.71,B,2,6.68,5250.06,3931.16,299.31,198.46,409000000819,30-Oct-18,FDRL/INTERNAL FUND TRANSFE,,300000.00,1088649.00,Gallagher,720,France,172557.77,1,1,1
821,2011,3,RENT,1,Medium,2,3000, 36 months,1,debt_consolidation,6,High,2,Good Loan,0,13.49,C,3,7.25,3652.116062,3000,0,101.8,409000000820,31-Oct-18,Indfor INCOME INDO REMI30101,"2,520.00",,1086129.00,Calabresi,659,Germany,84320.94,1,1,1
822,2011,10,RENT,1,Low,1,8200, 60 months,2,credit_card,1,High,2,Bad Loan,1,16.77,D,4,5.06,3033.4,1240.19,412.99,202.78,409000000821,31-Oct-18,INDO GIBL Indiaforensic STL30101,"274,602.00",,811527.00,Shaw,841,France,122662.98,1,1,1
823,2011,10,OWN,2,Low,1,17000, 36 months,1,credit_card,1,Low,1,Good Loan,0,12.42,B,2,16.65,20445.67305,17000,0,568.06,409000000822,31-Oct-18,FDRL/INTERNAL FUND TRANSFE,,200000.00,1011527.00,Zhirov,642,Spain,72085.10,1,1,1
824,2011,10,MORTGAGE,3,Low,1,5000, 36 months,1,car,2,Low,1,Good Loan,0,10.65,B,2,13.92,5861.566609,5000,0,162.87,409000000823,31-Oct-18,FDRL/INTERNAL FUND TRANSFE,,300000.00,1311527.00,Lloyd,732,Spain,110932.24,1,1,1
825,2011,6,OWN,2,Low,1,6400, 36 months,1,debt_consolidation,6,Low,1,Good Loan,0,8.9,A,1,10.75,7314.625679,6400,0,203.23,409000000824,1-Nov-18,Indfor INCOME INDO REMI31101,"1,920.00",,1309607.00,Palmer,600,Spain,143635.36,1,1,1
826,2011,7,RENT,1,Low,1,13000, 36 months,1,debt_consolidation,6,High,2,Good Loan,0,16.29,D,4,8.33,16518.64979,13000,0,458.91,409000000825,1-Nov-18,INDO GIBL Indiaforensic STL31101,"239,305.00",,1070302.00,Ch'eng,464,Germany,3710.34,1,1,1
827,2011,10,RENT,1,Low,1,18000, 60 months,2,debt_consolidation,6,Low,1,Good Loan,0,11.71,B,2,22.03,19084.38,13511,0,397.77,409000000826,2-Nov-18,Indfor INCOME INDO REMI01111,"1,680.00",,1068622.00,Avent,680,France,179843.33,1,1,1
828,2011,10,MORTGAGE,3,Low,1,16000, 60 months,2,debt_consolidation,6,High,2,Good Loan,0,15.27,C,3,17.7,22114.32585,16000,0,382.92,409000000827,2-Nov-18,INDO GIBL Indiaforensic STL01111,"192,675.00",,875947.00,Huang,758,Spain,10643.38,1,1,1
829,2011,7,RENT,1,Low,1,13200, 60 months,2,credit_card,1,High,2,Good Loan,0,17.27,D,4,24.36,17517.43172,13200,0,329.98,409000000828,3-Nov-18,Indfor INCOME INDO REMI02111,"2,640.00",,873307.00,Shaw,630,Germany,131167.98,1,1,1
830,2011,1,RENT,1,Low,1,10000, 36 months,1,credit_card,1,High,2,Good Loan,0,16.77,D,4,17.09,12787.6669,10000,0,355.39,409000000829,3-Nov-18,INDO GIBL Indiaforensic STL02111,"369,251.00",,504056.00,Yuan,577,France,10553.31,1,1,1
831,2011,8,RENT,1,Low,1,15000, 60 months,2,credit_card,1,High,2,Bad Loan,1,15.96,C,3,20.14,9111.5,4845.58,16.75,364.46,409000000830,3-Nov-18,FDRL/INTERNAL FUND TRANSFE,,500000.00,1004056.00,Hawkins,684,France,130928.22,1,1,1
832,2011,10,RENT,1,Low,1,5000, 36 months,1,debt_consolidation,6,High,2,Good Loan,0,14.27,C,3,10.03,6118.317334,5000,0,171.55,409000000831,5-Nov-18,Indfor INCOME INDO REMI03111,"2,280.00",,1001776.00,Trentini,708,Spain,157003.99,1,1,1
833,2011,0.5,RENT,1,Low,1,7200, 36 months,1,credit_card,1,Low,1,Good Loan,0,7.9,A,1,14.34,7984.64,7200,0,225.29,409000000832,5-Nov-18,INDO GIBL Indiaforensic STL03111,"323,726.00",,678050.00,Cameron,732,Germany,138527.56,1,1,1
834,2011,3,RENT,1,Low,1,15000, 36 months,1,debt_consolidation,6,Low,1,Good Loan,0,7.9,A,1,19.4,16919.69706,15000,0,469.36,409000000833,5-Nov-18,Indfor INCOME INDO REMI04111,840,,677210.00,Koehler,634,Germany,167032.49,1,1,1
835,2011,0.5,MORTGAGE,3,Low,1,15700, 60 months,2,debt_consolidation,6,High,2,Bad Loan,1,19.42,E,5,9.12,257.99,98.47,0,258.46,409000000834,5-Nov-18,INDO GIBL Indiaforensic STL04111,"129,000.00",,548210.00,Wu,633,France,41642.29,1,1,1
836,2011,3,RENT,1,Low,1,5000, 60 months,2,debt_consolidation,6,High,2,Good Loan,0,21.28,F,6,6.1,7280.813661,5000,0,136.06,409000000835,5-Nov-18,FDRL/INTERNAL FUND TRANSFE,,500000.00,1048210.00,Manna,559,France,9677.00,1,1,1
837,2011,2,MORTGAGE,3,Medium,2,9600, 36 months,1,debt_consolidation,6,Low,1,Good Loan,0,11.71,B,2,10.19,10703.16,9600,0,317.53,409000000836,6-Nov-18,FDRL/INTERNAL FUND TRANSFE,,500000.00,1548210.00,Okoli,694,Spain,147012.22,1,1,1
838,2011,5,RENT,1,Medium,2,16000, 60 months,2,debt_consolidation,6,High,2,Good Loan,0,19.91,E,5,6.47,24813.03,16000,0,423.11,409000000837,6-Nov-18,Indfor INCOME INDO REMI05111,"4,920.00",,1543290.00,Ch'eng,686,Germany,80553.87,1,1,1
839,2011,4,MORTGAGE,3,High,3,35000, 60 months,2,credit_card,1,High,2,Bad Loan,1,19.03,E,5,14.08,19075.97,6337.11,5420.08,593.77,409000000838,6-Nov-18,INDO GIBL Indiaforensic STL05111,"807,502.00",,735788.00,Nwokezuike,553,Spain,30730.95,1,1,1
840,2011,4,MORTGAGE,3,Low,1,21000, 60 months,2,credit_card,1,High,2,Good Loan,0,14.65,C,3,20.11,23804.54,15496.83,0,495.74,409000000839,6-Nov-18,FDRL/INTERNAL FUND TRANSFE,,500000.00,1235788.00,Artemiev,507,France,140134.43,1,1,1
841,2011,10,RENT,1,Low,1,12000, 60 months,2,debt_consolidation,6,High,2,Bad Loan,1,17.58,D,4,13.18,6353.86,2820.19,803.37,206.99,409000000840,8-Nov-18,FDRL/INTERNAL FUND TRANSFE,,500000.00,1735788.00,Esposito,732,Germany,91936.10,1,1,1
842,2011,10,RENT,1,Low,1,6000, 36 months,1,debt_consolidation,6,Low,1,Good Loan,0,10.65,B,2,11.75,7034.178269,6000,0,195.44,409000000841,9-Nov-18,Indfor INCOME INDO REMI06111,"4,920.00",,1730868.00,Abbie,818,France,178252.63,1,1,1
843,2011,5,MORTGAGE,3,Low,1,20000, 60 months,2,debt_consolidation,6,High,2,Good Loan,0,20.3,E,5,18.97,25562.28,14238.45,0,533.23,409000000842,9-Nov-18,INDO GIBL Indiaforensic STL06111,"780,026.00",,950842.00,Fanucci,660,Germany,198674.08,1,1,1
844,2011,0.5,MORTGAGE,3,Low,1,6000, 36 months,1,other,4,High,2,Good Loan,0,14.65,C,3,23.42,7449.647199,6000,0,206.97,409000000843,9-Nov-18,Indfor INCOME INDO REMI07111,"1,320.00",,949522.00,Jen,773,Spain,28266.90,1,1,1
845,2011,1,RENT,1,Low,1,7150, 36 months,1,credit_card,1,Low,1,Good Loan,0,12.69,B,2,24.6,8256.97,7150,0,239.85,409000000844,9-Nov-18,INDO GIBL Indiaforensic STL07111,"153,513.00",,796009.00,Moss,640,France,92381.01,1,1,1
846,2011,7,RENT,1,Low,1,13000, 60 months,2,credit_card,1,High,2,Bad Loan,1,19.42,E,5,19.09,7825.52,3576.75,15.41,340.24,409000000845,9-Nov-18,Indfor INCOME INDO REMI08111,600,,795409.00,Lo,505,France,135180.11,1,1,1
847,2011,2,RENT,1,Medium,2,32000, 36 months,1,small_business,3,Low,1,Good Loan,0,6.62,A,1,6.07,35368.03034,32000,0,982.52,409000000846,9-Nov-18,INDO GIBL Indiaforensic STL08111,"102,725.00",,692684.00,Averyanov,714,Germany,27330.59,1,1,1
848,2011,2,OWN,2,Medium,2,8000, 36 months,1,house,12,High,2,Bad Loan,1,15.27,C,3,12.48,3394.06,2064.97,340.57,278.39,409000000847,9-Nov-18,FDRL/INTERNAL FUND TRANSFE,,500000.00,1192684.00,Unaipon,468,France,125305.34,1,1,1
849,2011,4,RENT,1,Low,1,15500, 60 months,2,debt_consolidation,6,High,2,Good Loan,0,13.49,C,3,11.19,17104.66,11511.91,0,356.58,409000000848,12-Nov-18,FDRL/INTERNAL FUND TRANSFE,,200000.00,1392684.00,Clamp,611,Spain,149648.45,1,1,1
850,2011,0.5,RENT,1,Low,1,7000, 36 months,1,credit_card,1,Low,1,Good Loan,0,8.9,A,1,7.97,8000.176789,7000,0,222.28,409000000849,12-Nov-18,FDRL/INTERNAL FUND TRANSFE,,200000.00,1592684.00,Lim,705,France,59887.15,1,1,1
851,2011,10,MORTGAGE,3,Low,1,12000, 36 months,1,debt_consolidation,6,Low,1,Good Loan,0,6.62,A,1,7.76,12961.28,12000,0,368.45,409000000850,12-Nov-18,Indfor INCOME INDO REMI09111,"2,040.00",,1590644.00,Wu,646,Germany,45041.32,1,1,1
852,2011,10,RENT,1,Low,1,10400, 36 months,1,credit_card,1,High,2,Good Loan,0,14.65,C,3,11.31,12912.07214,10400,0,358.74,409000000851,12-Nov-18,INDO GIBL Indiaforensic STL09111,"478,599.00",,1112045.00,Wan,667,Germany,113316.77,1,1,1
853,2011,2,RENT,1,Low,1,12000, 36 months,1,credit_card,1,Low,1,Good Loan,0,12.69,B,2,18.38,14425.38571,12000,0,402.54,409000000852,12-Nov-18,Indfor INCOME INDO REMI11111,120,,1111925.00,Chambers,511,Germany,39087.42,1,1,1
854,2011,3,MORTGAGE,3,Low,1,8000, 60 months,2,wedding,5,Low,1,Good Loan,0,11.71,B,2,3.25,5347.18,3786.23,0,111.6,409000000853,12-Nov-18,INDO GIBL Indiaforensic STL11111,"8,000.00",,1103925.00,Pettit,653,France,7330.59,1,1,1
855,2011,10,MORTGAGE,3,Low,1,16000, 36 months,1,credit_card,1,High,2,Good Loan,0,16.29,D,4,15.84,20218.04262,16000,0,564.81,409000000854,12-Nov-18,Indfor INCOME INDO REMI10111,"2,040.00",,1101885.00,Baresi,675,France,95463.29,1,1,1
856,2011,2,RENT,1,Low,1,4500, 36 months,1,credit_card,1,Low,1,Good Loan,0,10.65,B,2,11.67,5162.43,4500,0,146.58,409000000855,12-Nov-18,INDO GIBL Indiaforensic STL10111,"284,926.00",,816959.00,Newbery,523,Spain,167848.02,1,1,1
857,2011,2,RENT,1,Low,1,5000, 36 months,1,debt_consolidation,6,Low,1,Good Loan,0,12.42,B,2,16.69,6013.514081,5000,0,167.08,409000000856,12-Nov-18,FDRL/INTERNAL FUND TRANSFE,,200000.00,1016959.00,Iheanacho,567,Germany,93953.84,1,1,1
858,2011,6,RENT,1,Low,1,3600, 36 months,1,major_purchase,8,High,2,Good Loan,0,16.29,D,4,22.05,4574.034431,3600,0,127.09,409000000857,13-Nov-18,Indfor INCOME INDO REMI12111,"2,280.00",,1014679.00,Duncan,741,Spain,174227.66,1,1,1
859,2011,8,RENT,1,Low,1,30000, 60 months,2,debt_consolidation,6,High,2,Good Loan,0,20.3,E,5,18.77,23719.86,13211.04,0,494.57,409000000858,13-Nov-18,INDO GIBL Indiaforensic STL12111,"354,000.00",,660679.00,Barry,456,Spain,135399.21,1,1,1
860,2011,10,MORTGAGE,3,Medium,2,21000, 36 months,1,debt_consolidation,6,High,2,Good Loan,0,13.49,C,3,12.41,25505.7397,21000,0,712.54,409000000859,13-Nov-18,FDRL/INTERNAL FUND TRANSFE,,200000.00,860679.00,Landry,598,France,195635.30,1,1,1
861,2011,2,RENT,1,Low,1,7000, 36 months,1,small_business,3,High,2,Good Loan,0,14.27,C,3,11.09,7485.82,7000,0,240.17,409000000860,13-Nov-18,FDRL/INTERNAL FUND TRANSFE,,300000.00,1160679.00,McGregor,667,France,97508.04,1,1,1
862,2011,8,MORTGAGE,3,Low,1,17475, 60 months,2,home_improvement,7,Low,1,Good Loan,0,7.9,A,1,8.44,16924.3,13378.13,0,353.5,409000000861,14-Nov-18,FDRL/INTERNAL FUND TRANSFE,,300000.00,1460679.00,Nucci,548,France,188083.77,1,1,1
863,2011,0.5,MORTGAGE,3,Low,1,27575, 60 months,2,debt_consolidation,6,Low,1,Good Loan,0,12.69,B,2,19.92,23148.63001,17350,0,392.02,409000000862,14-Nov-18,FDRL/INTERNAL FUND TRANSFE,,200000.00,1660679.00,Pirogov,725,France,116704.25,1,1,1
864,2011,6.05,MORTGAGE,3,Low,1,7000, 60 months,2,debt_consolidation,6,Low,1,Good Loan,0,8.9,A,1,15.17,6928.92,5320.57,0,144.97,409000000863,14-Nov-18,Indfor INCOME INDO REMI13111,"4,080.00",,1656599.00,Oguejiofor,717,France,97614.87,1,1,1
865,2011,1,RENT,1,Low,1,15000, 36 months,1,debt_consolidation,6,Low,1,Good Loan,0,7.9,A,1,17.73,16730.08958,15000,0,469.36,409000000864,14-Nov-18,INDO GIBL Indiaforensic STL13111,"800,876.00",,855723.00,Ugochukwu,594,France,186884.04,1,1,1
866,2011,6,RENT,1,Low,1,2250, 36 months,1,credit_card,1,High,2,Good Loan,0,13.49,C,3,18.75,2746.895449,2250,0,76.35,409000000865,15-Nov-18,FDRL/INTERNAL FUND TRANSFE,,300000.00,1155723.00,Rohu,678,Germany,131501.72,1,1,1
867,2011,10,MORTGAGE,3,Low,1,17050, 36 months,1,debt_consolidation,6,Low,1,Good Loan,0,12.42,B,2,23.64,20507.01437,17050,0,569.74,409000000866,15-Nov-18,Indfor INCOME INDO REMI14111,"2,160.00",,1153563.00,Cary,545,France,24302.95,1,1,1
868,2011,2,RENT,1,Medium,2,16500, 36 months,1,debt_consolidation,6,High,2,Good Loan,0,16.77,D,4,10.22,21102.58629,16500,0,586.39,409000000867,15-Nov-18,INDO GIBL Indiaforensic STL14111,"404,700.00",,748863.00,O'Loghlen,636,France,110510.28,1,1,1
869,2011,4,MORTGAGE,3,Low,1,35000, 60 months,2,home_improvement,7,High,2,Good Loan,0,19.91,E,5,9.41,44419.68,25001.66,0,925.54,409000000868,15-Nov-18,FDRL/INTERNAL FUND TRANSFE,,300000.00,1048863.00,Quinn,603,Germany,108488.33,1,1,1
870,2011,0.5,RENT,1,Low,1,3250, 36 months,1,debt_consolidation,6,Low,1,Good Loan,0,12.42,B,2,19.13,3923.835683,3250,0,108.6,409000000869,16-Nov-18,Indfor INCOME INDO REMI15111,"3,000.00",,1045863.00,Page,435,France,197015.20,1,1,1
871,2011,4,MORTGAGE,3,Low,1,7000, 36 months,1,credit_card,1,Low,1,Good Loan,0,7.9,A,1,9.34,7792.28,7000,0,219.04,409000000870,16-Nov-18,INDO GIBL Indiaforensic STL15111,"580,226.00",,465637.00,Evans,535,France,27689.77,1,1,1
872,2011,3,MORTGAGE,3,Low,1,24000, 36 months,1,debt_consolidation,6,Low,1,Good Loan,0,11.71,B,2,13.26,28530.6625,24000,0,793.83,409000000871,16-Nov-18,FDRL/INTERNAL FUND TRANSFE,,500000.00,965637.00,McGregor,629,Germany,9217.55,1,1,1
873,2011,6,RENT,1,Low,1,13200, 36 months,1,credit_card,1,High,2,Good Loan,0,16.77,D,4,12.79,16881.45095,13200,0,469.11,409000000872,17-Nov-18,FDRL/INTERNAL FUND TRANSFE,,300000.00,1265637.00,Andrews,722,France,15068.18,1,1,1
874,2011,6,OWN,2,Low,1,22750, 36 months,1,debt_consolidation,6,Low,1,Good Loan,0,8.9,A,1,10.45,23699.46,22750,0,722.39,409000000873,17-Nov-18,Indfor INCOME INDO REMI16111,"3,000.00",,1262637.00,Stanley,561,France,7797.01,1,1,1
875,2011,10,RENT,1,Low,1,12000, 36 months,1,debt_consolidation,6,Low,1,Good Loan,0,8.9,A,1,6.02,13715.3345,12000,0,381.04,409000000874,17-Nov-18,INDO GIBL Indiaforensic STL16111,"583,076.00",,679561.00,Chiazagomekpere,645,France,4400.32,1,1,1
876,2011,7,MORTGAGE,3,Medium,2,30000, 36 months,1,debt_consolidation,6,Low,1,Good Loan,0,10.65,B,2,17.15,35176.93541,30000,0,977.2,409000000875,17-Nov-18,FDRL/INTERNAL FUND TRANSFE,,400000.00,1079561.00,Chidiebele,501,France,182025.95,1,1,1
877,2011,8,RENT,1,Low,1,1200, 36 months,1,vacation,11,Low,1,Bad Loan,1,12.69,B,2,13.41,240.78,169.31,0,40.26,409000000876,17-Nov-18,FDRL/INTERNAL FUND TRANSFE,,400000.00,1479561.00,Gregory,502,Germany,122763.95,1,1,1
878,2011,0.5,RENT,1,Low,1,4800, 36 months,1,debt_consolidation,6,Low,1,Good Loan,0,8.9,A,1,14.95,5485.78897,4800,0,152.42,409000000877,19-Nov-18,Indfor INCOME INDO REMI18111,360,,1479201.00,Bednall,652,Spain,38152.01,1,1,1
879,2011,10,RENT,1,Low,1,18000, 60 months,2,debt_consolidation,6,High,2,Good Loan,0,20.89,F,6,20.74,23294.02,12767.56,0,485.85,409000000878,19-Nov-18,INDO GIBL Indiaforensic STL18111,"59,700.00",,1419501.00,Jen,574,France,63163.99,1,1,1
880,2011,10,RENT,1,Low,1,7200, 36 months,1,debt_consolidation,6,Low,1,Good Loan,0,8.9,A,1,15.02,8229.372295,7200,0,228.63,409000000879,19-Nov-18,Indfor INCOME INDO REMI17111,"1,320.00",,1418181.00,She,518,France,73418.29,1,1,1
881,2011,2,OWN,2,Low,1,15000, 36 months,1,debt_consolidation,6,Low,1,Good Loan,0,9.91,B,2,15.15,17397.22853,15000,0,483.38,409000000880,19-Nov-18,INDO GIBL Indiaforensic STL17111,"207,463.00",,1210718.00,Simmons,749,France,17978.68,1,1,1
882,2011,10,RENT,1,Low,1,10500, 36 months,1,debt_consolidation,6,High,2,Good Loan,0,15.27,C,3,9.92,13146.49754,10500,0,365.38,409000000881,20-Nov-18,FDRL/INTERNAL FUND TRANSFE,,300000.00,1510718.00,Fraser,679,France,115136.51,1,1,1
883,2011,1,OWN,2,Low,1,15000, 60 months,2,other,4,High,2,Good Loan,0,17.27,D,4,16.21,16459.91,14999.99,0,374.97,409000000882,20-Nov-18,Indfor INCOME INDO REMI19111,"3,600.00",,1507118.00,May,565,France,149575.59,1,1,1
884,2011,0.5,MORTGAGE,3,Low,1,5000, 36 months,1,small_business,3,Low,1,Bad Loan,1,7.9,A,1,7.75,4063.28,3486.91,0,156.46,409000000883,20-Nov-18,INDO GIBL Indiaforensic STL19111,"613,175.00",,893943.00,Seabrook,643,France,60917.24,1,1,1
885,2011,6,RENT,1,Low,1,12800, 60 months,2,debt_consolidation,6,High,2,Good Loan,0,13.49,C,3,8.74,15957.51229,12800,0,294.47,409000000884,20-Nov-18,FDRL/INTERNAL FUND TRANSFE,,400000.00,1293943.00,Herrera,515,France,142548.33,1,1,1
886,2011,3,MORTGAGE,3,Low,1,4000, 36 months,1,small_business,3,Low,1,Good Loan,0,8.9,A,1,13.16,4571.542829,4000,0,127.02,409000000885,22-Nov-18,FDRL/INTERNAL FUND TRANSFE,,400000.00,1693943.00,Kincaid,521,France,157878.67,1,1,1
887,2011,6,MORTGAGE,3,Low,1,14000, 60 months,2,debt_consolidation,6,Low,1,Good Loan,0,12.42,B,2,18.84,11385.68,9350,0,209.98,409000000886,22-Nov-18,Indfor INCOME INDO REMI20111,"3,960.00",,1689983.00,Sleeman,739,Spain,12796.43,1,1,1
888,2011,8,MORTGAGE,3,Medium,2,27000, 36 months,1,debt_consolidation,6,Low,1,Good Loan,0,11.71,B,2,8.13,30277.11,27000,0,893.06,409000000887,22-Nov-18,INDO GIBL Indiaforensic STL20111,"628,403.00",,1061580.00,Hung,585,France,18657.77,1,1,1
889,2011,7,MORTGAGE,3,Low,1,15000, 36 months,1,debt_consolidation,6,Low,1,Good Loan,0,12.42,B,2,17.35,18039.9582,15000,0,501.23,409000000888,22-Nov-18,Indfor INCOME INDO REMI21111,"1,800.00",,1059780.00,Artemieva,733,Germany,134589.58,1,1,1
890,2011,5,RENT,1,Low,1,35000, 60 months,2,debt_consolidation,6,High,2,Bad Loan,1,20.89,F,6,7.93,40669.77,20871.91,14.28,944.71,409000000889,22-Nov-18,INDO GIBL Indiaforensic STL21111,"250,951.00",,808829.00,Barwell,542,France,10350.74,1,1,1
891,2011,1,OWN,2,Low,1,2400, 36 months,1,debt_consolidation,6,High,2,Good Loan,0,14.27,C,3,17.71,2962.84987,2400,0,82.35,409000000890,22-Nov-18,FDRL/INTERNAL FUND TRANSFE,,300000.00,1108829.00,Wright,788,Spain,66013.27,1,1,1
892,2011,2,RENT,1,Low,1,5900, 36 months,1,debt_consolidation,6,Low,1,Good Loan,0,12.42,B,2,6.17,6790.69,5900,0,197.16,409000000891,22-Nov-18,FDRL/INTERNAL FUND TRANSFE,,300000.00,1408829.00,Bellucci,435,Germany,5907.11,1,1,1
893,2011,6,RENT,1,Low,1,5000, 36 months,1,credit_card,1,Low,1,Good Loan,0,11.71,B,2,13.78,5506.83,5000,0,165.38,409000000892,23-Nov-18,FDRL/INTERNAL FUND TRANSFE,,400000.00,1808829.00,Moore,577,France,74077.91,1,1,1
894,2011,4,RENT,1,Low,1,22000, 60 months,2,debt_consolidation,6,High,2,Good Loan,0,19.42,E,5,16.2,27608.28,15751.82,0,575.79,409000000893,26-Nov-18,Indfor INCOME INDO REMI25111,480,,1808349.00,Ball,703,France,77294.56,1,1,1
895,2011,7,RENT,1,Low,1,13250, 36 months,1,debt_consolidation,6,High,2,Bad Loan,1,17.58,D,4,18.55,11325.82,7250.38,864.82,476.24,409000000894,26-Nov-18,INDO GIBL Indiaforensic STL25111,"63,600.00",,1744749.00,Sung,728,Germany,54359.02,1,1,1
896,2011,10,RENT,1,Low,1,12600, 60 months,2,debt_consolidation,6,High,2,Good Loan,0,14.27,C,3,18.61,16421.83814,12600,0,294.95,409000000895,26-Nov-18,Indfor INCOME INDO REMI24111,360,,1744389.00,Mello,728,Germany,156124.93,1,1,1
897,2011,1,MORTGAGE,3,Medium,2,20000, 36 months,1,debt_consolidation,6,Low,1,Good Loan,0,11.71,B,2,14.95,23812.17992,20000,0,661.52,409000000896,26-Nov-18,INDO GIBL Indiaforensic STL24111,"49,700.00",,1694689.00,Mistry,718,France,94820.85,1,1,1
898,2011,10,MORTGAGE,3,Low,1,18000, 36 months,1,credit_card,1,Low,1,Good Loan,0,7.9,A,1,20.05,19846.6,18000,0,563.23,409000000897,26-Nov-18,Indfor INCOME INDO REMI23111,"1,560.00",,1693129.00,T'ien,621,France,155155.25,1,1,1
899,2011,0.5,RENT,1,Low,1,19200, 36 months,1,debt_consolidation,6,High,2,Good Loan,0,16.77,D,4,13.56,23363.59,19200,0,682.34,409000000898,26-Nov-18,INDO GIBL Indiaforensic STL23111,"220,402.00",,1472727.00,Fallaci,523,France,128702.10,1,1,1
900,2011,10,MORTGAGE,3,Low,1,7000, 36 months,1,debt_consolidation,6,Low,1,Good Loan,0,11.71,B,2,17.45,8333.042555,7000,0,231.54,409000000899,26-Nov-18,Indfor INCOME INDO REMI22111,"2,280.00",,1470447.00,Hill,657,Germany,22745.50,1,1,1
901,2011,10,OWN,2,Low,1,25000, 60 months,2,debt_consolidation,6,High,2,Good Loan,0,15.96,C,3,4.71,33909.64734,25000,0,607.43,409000000900,26-Nov-18,INDO GIBL Indiaforensic STL22111,"334,100.00",,1136347.00,Burns,727,Germany,71865.31,1,1,1
902,2011,7,MORTGAGE,3,Low,1,10000, 36 months,1,other,4,Low,1,Good Loan,0,6.03,A,1,12.29,10366.43,10000,0,304.36,409000000901,26-Nov-18,FDRL/INTERNAL FUND TRANSFE,,400000.00,1536347.00,Hunter,643,France,84294.82,1,1,1
903,2011,6.05,MORTGAGE,3,Low,1,2250, 36 months,1,other,4,High,2,Good Loan,0,15.27,C,3,19.5,2836.452457,2250,0,78.3,409000000902,27-Nov-18,Indfor INCOME INDO REMI26111,"4,440.00",,1531907.00,Li,645,France,149139.13,1,1,1
904,2011,9,RENT,1,Low,1,23000, 36 months,1,debt_consolidation,6,Low,1,Good Loan,0,9.91,B,2,19.61,25887.26,23000,0,741.18,409000000903,27-Nov-18,INDO GIBL Indiaforensic STL26111,"615,817.00",,916090.00,Ku,568,France,185489.11,1,1,1
905,2011,2,RENT,1,Low,1,6750, 36 months,1,small_business,3,High,2,Good Loan,0,17.27,D,4,1,8692.951065,6750,0,241.57,409000000904,27-Nov-18,FDRL/INTERNAL FUND TRANSFE,,300000.00,1216090.00,Ch'en,599,France,176407.15,1,1,1
906,2011,6,MORTGAGE,3,Low,1,10000, 36 months,1,credit_card,1,Low,1,Good Loan,0,10.65,B,2,8.78,11570.11819,10000,0,325.74,409000000905,27-Nov-18,FDRL/INTERNAL FUND TRANSFE,,400000.00,1616090.00,Chukwukadibia,672,France,92027.69,1,1,1
907,2011,4,MORTGAGE,3,Low,1,16000, 60 months,2,debt_consolidation,6,Low,1,Good Loan,0,11.71,B,2,10.75,19745.24515,16000,0,353.58,409000000906,28-Nov-18,Indfor INCOME INDO REMI27111,"2,760.00",,1613330.00,Zikoranachidimma,685,France,43932.54,1,1,1
908,2011,0.5,RENT,1,Low,1,5600, 36 months,1,credit_card,1,Low,1,Good Loan,0,8.9,A,1,13.19,6329.734092,5600,0,177.82,409000000907,28-Nov-18,INDO GIBL Indiaforensic STL27111,"508,126.00",,1105204.00,Oluchukwu,516,France,115789.25,1,1,1
909,2011,4,RENT,1,Low,1,12000, 60 months,2,debt_consolidation,6,High,2,Good Loan,0,19.42,E,5,23.15,15061.32,8593.1,0,314.07,409000000908,28-Nov-18,FDRL/INTERNAL FUND TRANSFE,,400000.00,1505204.00,Rivera,685,Spain,125777.28,1,1,1
910,2011,3,OWN,2,Low,1,4800, 36 months,1,other,4,Low,1,Good Loan,0,6.03,A,1,14.61,5203.26,4800,0,146.1,409000000909,29-Nov-18,Indfor INCOME INDO REMI28111,"2,160.00",,1503044.00,Niu,806,Spain,18461.90,1,1,1
911,2011,10,MORTGAGE,3,Low,1,25000, 60 months,2,debt_consolidation,6,High,2,Good Loan,0,14.65,C,3,24.93,17788.42,11585.6,0,370.63,409000000910,29-Nov-18,INDO GIBL Indiaforensic STL28111,"326,783.00",,1176261.00,Bennett,604,France,79633.38,1,1,1
912,2011,5,RENT,1,Low,1,10000, 36 months,1,debt_consolidation,6,Low,1,Bad Loan,1,11.71,B,2,10.41,6944.82,5393.16,14.61,330.76,409000000911,30-Nov-18,Indfor INCOME INDO REMI29111,"1,800.00",,1174461.00,Wollstonecraft,648,Spain,121542.29,1,1,1
913,2011,8,RENT,1,Low,1,2200, 36 months,1,debt_consolidation,6,Low,1,Bad Loan,1,9.91,B,2,14.95,261.47,160.16,0,70.9,409000000912,30-Nov-18,INDO GIBL Indiaforensic STL29111,"247,700.00",,926761.00,Thomsen,545,Spain,94739.20,1,1,1
914,2011,1,RENT,1,Medium,2,24000, 36 months,1,credit_card,1,Low,1,Bad Loan,1,12.69,B,2,13.9,28413.79,23024.99,171.78,805.08,409000000913,30-Nov-18,FDRL/INTERNAL FUND TRANSFE,,400000.00,1326761.00,Palermo,756,Germany,93302.29,1,1,1
915,2011,0.5,MORTGAGE,3,Medium,2,16000, 36 months,1,credit_card,1,Low,1,Good Loan,0,7.9,A,1,8.69,17811.3,16000,0,500.65,409000000914,1-Dec-18,Indfor INCOME INDO REMI30111,"3,360.00",,1323401.00,Chinwendu,569,France,193793.78,1,1,1
916,2011,10,RENT,1,Low,1,10000, 36 months,1,credit_card,1,Low,1,Good Loan,0,9.91,B,2,17.51,11599.07802,10000,0,322.25,409000000915,1-Dec-18,INDO GIBL Indiaforensic STL30111,"510,703.00",,812698.00,McKenzie,596,France,74835.65,1,1,1
917,2011,10,RENT,1,Low,1,10625, 36 months,1,debt_consolidation,6,High,2,Bad Loan,1,14.27,C,3,15.49,3408.15,1983.86,496.07,364.54,409000000916,1-Dec-18,FDRL/INTERNAL FUND TRANSFE,,400000.00,1212698.00,James,475,France,56999.90,1,1,1
918,2011,2,RENT,1,Low,1,9600, 36 months,1,credit_card,1,High,2,Good Loan,0,14.65,C,3,5.2,11879.77566,9600,0,331.15,409000000917,3-Dec-18,Indfor INCOME INDO REMI02121,120,,1212578.00,Lamb,646,France,57236.44,1,1,1
919,2011,0.5,MORTGAGE,3,Low,1,7200, 36 months,1,debt_consolidation,6,High,2,Bad Loan,1,20.89,F,6,20.46,6676.85,4068.87,448.2,270.86,409000000918,3-Dec-18,INDO GIBL Indiaforensic STL02121,"5,000.00",,1207578.00,Olejuru,784,Spain,81483.64,1,1,1
920,2011,6,RENT,1,Low,1,12000, 36 months,1,debt_consolidation,6,Low,1,Good Loan,0,8.9,A,1,12.94,13715.17006,12000,0,381.04,409000000919,3-Dec-18,Indfor INCOME INDO REMI01121,840,,1206738.00,Hay,552,Spain,26752.56,1,1,1
921,2011,3,RENT,1,Low,1,5000, 36 months,1,credit_card,1,Low,1,Good Loan,0,12.42,B,2,4.21,5953.075531,5000,0,167.08,409000000920,3-Dec-18,INDO GIBL Indiaforensic STL01121,"135,500.00",,1071238.00,Lu,729,France,9200.54,1,1,1
922,2011,2,RENT,1,Low,1,30000, 60 months,2,debt_consolidation,6,High,2,Good Loan,0,21.67,F,6,11.44,39477.16,21181.93,0,822.95,409000000921,3-Dec-18,FDRL/INTERNAL FUND TRANSFE,,500000.00,1571238.00,Chiawuotu,609,Spain,22447.85,1,1,1
923,2011,9,RENT,1,Low,1,12000, 36 months,1,credit_card,1,High,2,Good Loan,0,16.29,D,4,14,14526.24,12000,0,423.61,409000000922,4-Dec-18,Indfor INCOME INDO REMI03121,"1,560.00",,1569678.00,Yeates,555,France,189122.89,1,1,1
924,2011,10,RENT,1,Low,1,18000, 36 months,1,debt_consolidation,6,High,2,Good Loan,0,17.27,D,4,21.43,23183.90055,18000,0,644.18,409000000923,4-Dec-18,INDO GIBL Indiaforensic STL03121,"244,750.00",,1324928.00,Gallagher,572,Germany,16161.82,1,1,1
925,2011,3,RENT,1,Low,1,10000, 36 months,1,credit_card,1,Low,1,Good Loan,0,9.91,B,2,9.1,11253.89,10000,0,322.25,409000000924,5-Dec-18,Indfor INCOME INDO REMI04121,"1,920.00",,1323008.00,Heath,785,France,68600.36,1,1,1
926,2011,10,RENT,1,Low,1,10000, 36 months,1,debt_consolidation,6,Low,1,Good Loan,0,9.91,B,2,11.23,11398.21,10000,0,322.25,409000000925,5-Dec-18,INDO GIBL Indiaforensic STL04121,"233,851.00",,1089157.00,Ts'ai,714,Germany,447.73,1,1,1
927,2011,8,MORTGAGE,3,Medium,2,26000, 36 months,1,debt_consolidation,6,Low,1,Good Loan,0,7.51,A,1,15.3,28135.5,26000,0,808.89,409000000926,6-Dec-18,FDRL/INTERNAL FUND TRANSFE,,500000.00,1589157.00,Thurgood,738,Spain,15650.73,1,1,1
928,2011,3,RENT,1,Low,1,17475, 36 months,1,debt_consolidation,6,Low,1,Good Loan,0,9.91,B,2,24.92,20261.3488,17475,0,563.14,409000000927,6-Dec-18,Indfor INCOME INDO REMI05121,"2,760.00",,1586397.00,Pai,639,Germany,149599.62,1,1,1
929,2011,3,MORTGAGE,3,Low,1,10400, 60 months,2,debt_consolidation,6,High,2,Bad Loan,1,22.35,F,6,8.82,3525.35,813.59,1219.67,289.32,409000000928,6-Dec-18,INDO GIBL Indiaforensic STL05121,"437,150.00",,1149247.00,Lorenzo,520,Germany,90304.01,1,1,1
930,2011,3,RENT,1,Low,1,10000, 36 months,1,credit_card,1,Low,1,Good Loan,0,10.65,B,2,9.3,11435.13,10000,0,325.74,409000000929,7-Dec-18,Indfor INCOME INDO REMI06121,"2,640.00",,1146607.00,Knupp,764,France,115676.38,1,1,1
931,2011,4,RENT,1,Low,1,17250, 36 months,1,credit_card,1,High,2,Good Loan,0,19.42,E,5,4.08,22148.87,17250,0,635.99,409000000930,7-Dec-18,INDO GIBL Indiaforensic STL06121,"397,925.00",,748682.00,Baryshnikov,661,Spain,38812.67,1,1,1
932,2011,2,MORTGAGE,3,Low,1,10000, 36 months,1,debt_consolidation,6,Low,1,Good Loan,0,6.62,A,1,7.16,11050.64637,10000,0,307.04,409000000931,7-Dec-18,FDRL/INTERNAL FUND TRANSFE,,500000.00,1248682.00,Azubuike,564,Germany,34338.21,1,1,1
933,2011,9,RENT,1,Low,1,12000, 60 months,2,debt_consolidation,6,High,2,Bad Loan,1,13.49,C,3,14.49,1100.4,572.24,0,276.06,409000000932,7-Dec-18,FDRL/INTERNAL FUND TRANSFE,,500000.00,1748682.00,Shephard,708,Germany,823.36,1,1,1
934,2011,6.05,OWN,2,Low,1,6000, 60 months,2,credit_card,1,Low,1,Good Loan,0,7.9,A,1,12.16,6211.9,5027.16,0,121.38,409000000933,10-Dec-18,Indfor INCOME INDO REMI07121,"1,680.00",,1747002.00,Scott,512,Spain,135482.26,1,1,1
935,2011,0.5,RENT,1,Low,1,19075, 60 months,2,debt_consolidation,6,High,2,Good Loan,0,18.25,D,4,21.2,25893.29337,19075,0,486.98,409000000934,10-Dec-18,INDO GIBL Indiaforensic STL07121,"228,177.00",,1518825.00,Williamson,592,Spain,10656.89,1,1,1
936,2011,2,MORTGAGE,3,Low,1,20000, 36 months,1,credit_card,1,Low,1,Good Loan,0,11.71,B,2,23.89,22774.85,19999.99,0,661.52,409000000935,10-Dec-18,Indfor INCOME INDO REMI08121,"2,160.00",,1516665.00,Avdeeva,619,France,116467.35,1,1,1
937,2011,4,RENT,1,Low,1,24000, 36 months,1,debt_consolidation,6,Low,1,Good Loan,0,7.9,A,1,22.12,27033.33153,24000,0,750.97,409000000936,10-Dec-18,INDO GIBL Indiaforensic STL08121,"240,752.00",,1275913.00,Tang,775,France,96823.32,1,1,1
938,2011,9,MORTGAGE,3,Low,1,17200, 60 months,2,home_improvement,7,High,2,Bad Loan,1,17.27,D,4,23.76,16270.39,9065.54,20.88,429.97,409000000937,10-Dec-18,Indfor INCOME INDO REMI09121,360,,1275553.00,Hsu,850,Germany,171096.20,1,1,1
939,2011,3,MORTGAGE,3,Low,1,15000, 36 months,1,home_improvement,7,Low,1,Good Loan,0,8.9,A,1,21.6,17143.68786,15000,0,476.3,409000000938,10-Dec-18,INDO GIBL Indiaforensic STL09121,"48,000.00",,1227553.00,Buchanan,577,France,79881.39,1,1,1
940,2011,0.5,RENT,1,Low,1,10625, 36 months,1,credit_card,1,Low,1,Bad Loan,1,11.71,B,2,23.2,11441.01,9235.98,216.51,351.44,409000000939,11-Dec-18,FDRL/INTERNAL FUND TRANSFE,,500000.00,1727553.00,Yeh,724,France,157862.82,1,1,1
941,2011,0.5,RENT,1,Low,1,8400, 36 months,1,credit_card,1,High,2,Good Loan,0,14.65,C,3,15.84,10243.60628,8400,0,289.76,409000000940,11-Dec-18,Indfor INCOME INDO REMI10121,"4,560.00",,1722993.00,Palazzi,710,Spain,127951.81,1,1,1
942,2011,2,RENT,1,Medium,2,28000, 60 months,2,credit_card,1,High,2,Good Loan,0,14.65,C,3,11.81,31726.74,20663.21,0,660.99,409000000941,11-Dec-18,INDO GIBL Indiaforensic STL10121,"776,851.00",,946142.00,Y?an,696,France,191074.11,1,1,1
943,2011,10,MORTGAGE,3,Low,1,16000, 36 months,1,home_improvement,7,High,2,Good Loan,0,15.96,C,3,7.7,20229.808,16000,0,562.2,409000000942,12-Dec-18,FDRL/INTERNAL FUND TRANSFE,,500000.00,1446142.00,Lin,376,France,157333.69,1,1,1
944,2011,10,MORTGAGE,3,Low,1,18000, 60 months,2,credit_card,1,High,2,Good Loan,0,16.77,D,4,4.62,16038.55001,11000,0,272.02,409000000943,12-Dec-18,Indfor INCOME INDO REMI11121,"3,360.00",,1442782.00,Schofield,675,Germany,133457.52,1,1,1
945,2011,3,MORTGAGE,3,Low,1,15000, 36 months,1,credit_card,1,High,2,Good Loan,0,14.27,C,3,12.58,17994.33,15000,0,514.64,409000000944,12-Dec-18,INDO GIBL Indiaforensic STL11121,"358,750.00",,1084032.00,Lombardi,745,France,130789.60,1,1,1
946,2011,2,MORTGAGE,3,Low,1,20675, 60 months,2,debt_consolidation,6,High,2,Good Loan,0,13.49,C,3,17.85,13045.5,12625,0,290.44,409000000945,12-Dec-18,FDRL/INTERNAL FUND TRANSFE,,500000.00,1584032.00,Wall,697,Spain,128373.88,1,1,1
947,2011,5,MORTGAGE,3,Low,1,13225, 36 months,1,credit_card,1,Low,1,Good Loan,0,12.69,B,2,23.48,14966.39,13225,0,443.64,409000000946,13-Dec-18,Indfor INCOME INDO REMI12121,"3,360.00",,1580672.00,Milani,599,Spain,194273.20,1,1,1
948,2011,1,RENT,1,Low,1,11775, 36 months,1,credit_card,1,High,2,Good Loan,0,13.49,C,3,13.11,14378.18227,11775,0,399.54,409000000947,13-Dec-18,INDO GIBL Indiaforensic STL12121,"596,375.00",,984297.00,Ejimofor,715,France,5684.17,1,1,1
949,2011,5,RENT,1,Low,1,16400, 60 months,2,credit_card,1,High,2,Bad Loan,1,17.27,D,4,12.51,9953.6,3988.92,1773.4,409.97,409000000948,13-Dec-18,FDRL/INTERNAL FUND TRANSFE,,500000.00,1484297.00,Blackburn,659,France,131043.20,1,1,1
950,2011,2,MORTGAGE,3,Low,1,10075, 36 months,1,credit_card,1,Low,1,Good Loan,0,12.42,B,2,18.63,12115.05119,10075,0,336.66,409000000949,14-Dec-18,Indfor INCOME INDO REMI13121,"2,880.00",,1481417.00,Wickham,684,France,21228.34,1,1,1
951,2011,0.5,RENT,1,Low,1,10000, 36 months,1,debt_consolidation,6,High,2,Good Loan,0,14.27,C,3,20.94,12346.50761,10000,0,343.09,409000000950,14-Dec-18,INDO GIBL Indiaforensic STL13121,"419,450.00",,1061967.00,Bird,635,France,43250.30,1,1,1
952,2011,4,MORTGAGE,3,Low,1,14000, 36 months,1,debt_consolidation,6,Low,1,Good Loan,0,12.42,B,2,9.63,16837.10476,14000,0,467.82,409000000951,14-Dec-18,FDRL/INTERNAL FUND TRANSFE,,500000.00,1561967.00,Ch'en,789,Germany,4389.40,1,1,1
953,2011,10,RENT,1,Low,1,13000, 36 months,1,debt_consolidation,6,Low,1,Bad Loan,1,9.91,B,2,17.3,14358.94,12158.68,132.22,418.93,409000000952,15-Dec-18,Indfor INCOME INDO REMI14121,"2,400.00",,1559567.00,Wood,571,Germany,189271.90,1,1,1
954,2011,6,RENT,1,Low,1,15000, 36 months,1,debt_consolidation,6,Low,1,Good Loan,0,11.71,B,2,11.7,17080.53,15000,0,496.14,409000000953,15-Dec-18,INDO GIBL Indiaforensic STL14121,"423,385.00",,1136182.00,Brizendine,694,Spain,102284.20,1,1,1
955,2011,4,MORTGAGE,3,Low,1,5000, 60 months,2,debt_consolidation,6,High,2,Good Loan,0,16.77,D,4,3.92,5932.63,3632.45,0,123.65,409000000954,17-Dec-18,FDRL/INTERNAL FUND TRANSFE,,400000.00,1536182.00,Ch'in,665,Spain,156774.94,1,1,1
956,2011,5,MORTGAGE,3,Low,1,9350, 36 months,1,credit_card,1,Low,1,Good Loan,0,7.51,A,1,10,10288.47,9350,0,290.89,409000000955,17-Dec-18,FDRL/INTERNAL FUND TRANSFE,,400000.00,1936182.00,Yusupov,706,France,69865.49,1,1,1
957,2011,10,MORTGAGE,3,Medium,2,30000, 60 months,2,small_business,3,High,2,Bad Loan,1,20.3,E,5,23.21,12389.79,4684.97,1957.38,487.24,409000000956,17-Dec-18,Indfor INCOME INDO REMI16121,360,,1935822.00,Jibunoh,807,Spain,85523.24,1,1,1
958,2011,4,RENT,1,Low,1,18225, 36 months,1,debt_consolidation,6,Low,1,Good Loan,0,12.42,B,2,19.65,21920.17272,18225,0,609,409000000957,17-Dec-18,INDO GIBL Indiaforensic STL16121,"33,549.00",,1902273.00,Ts'ui,771,Spain,51219.80,1,1,1
959,2011,2,MORTGAGE,3,Low,1,18000, 60 months,2,debt_consolidation,6,High,2,Good Loan,0,15.27,C,3,15.31,18696.27,18000,0,430.78,409000000958,17-Dec-18,Indfor INCOME INDO REMI15121,"1,680.00",,1900593.00,Ndukaku,531,Spain,7222.92,1,1,1
960,2011,8,MORTGAGE,3,Low,1,3600, 36 months,1,other,4,Low,1,Good Loan,0,6.62,A,1,11.75,3978.323973,3600,0,110.54,409000000959,17-Dec-18,INDO GIBL Indiaforensic STL15121,"288,851.00",,1611742.00,Wilder,629,France,23971.33,1,1,1
961,2011,10,MORTGAGE,3,Medium,2,29000, 60 months,2,debt_consolidation,6,Low,1,Good Loan,0,10.65,B,2,3.9,36276.08515,29000,0,625.49,409000000960,18-Dec-18,Indfor INCOME INDO REMI17121,"4,440.00",,1607302.00,Maclean,850,Germany,132173.31,1,1,1
962,2011,10,OWN,2,Low,1,5000, 36 months,1,car,2,High,2,Good Loan,0,16.29,D,4,9.57,6360.098375,5000,0,176.51,409000000961,18-Dec-18,INDO GIBL Indiaforensic STL17121,"662,777.00",,944525.00,Ch'iu,685,Spain,113639.64,1,1,1
963,2011,10,RENT,1,Low,1,6400, 36 months,1,debt_consolidation,6,High,2,Good Loan,0,16.29,D,4,22.63,8131.946207,6400,0,225.93,409000000962,18-Dec-18,FDRL/INTERNAL FUND TRANSFE,,500000.00,1444525.00,Cox,642,Spain,39768.59,1,1,1
964,2011,6,RENT,1,Low,1,12000, 60 months,2,debt_consolidation,6,High,2,Bad Loan,1,16.77,D,4,18.66,5017.91,2130.09,581.21,296.75,409000000963,19-Dec-18,Indfor INCOME INDO REMI18121,"3,480.00",,1441045.00,Nepean,529,Spain,108732.96,1,1,1
965,2011,3,MORTGAGE,3,Medium,2,35000, 36 months,1,debt_consolidation,6,Low,1,Good Loan,0,8.9,A,1,16.18,40006.9134,35000,0,1111.37,409000000964,19-Dec-18,INDO GIBL Indiaforensic STL18121,"616,950.00",,824095.00,McNess,683,Germany,117349.19,1,1,1
966,2011,6,MORTGAGE,3,Low,1,18000, 36 months,1,credit_card,1,Low,1,Good Loan,0,9.91,B,2,22.51,18909.9,18000.01,0,580.05,409000000965,19-Dec-18,FDRL/INTERNAL FUND TRANSFE,,400000.00,1224095.00,Coles,663,France,78004.50,1,1,1
967,2011,10,MORTGAGE,3,Low,1,8075, 60 months,2,debt_consolidation,6,High,2,Good Loan,0,22.35,F,6,10.73,8226.3,8075,0,224.64,409000000966,20-Dec-18,Indfor INCOME INDO REMI19121,"3,120.00",,1220975.00,Benson,563,France,152417.79,1,1,1
968,2011,10,MORTGAGE,3,Low,1,15625, 36 months,1,debt_consolidation,6,Low,1,Good Loan,0,8.9,A,1,24.64,17805.50663,15625,0,496.15,409000000967,20-Dec-18,INDO GIBL Indiaforensic STL19121,"428,150.00",,792825.00,Gilbert,637,Spain,26057.08,1,1,1
969,2011,10,RENT,1,Low,1,24000, 36 months,1,credit_card,1,High,2,Good Loan,0,13.49,C,3,24.78,29301.28709,24000,0,814.34,409000000968,20-Dec-18,FDRL/INTERNAL FUND TRANSFE,,500000.00,1292825.00,Wilhelm,544,France,79972.09,1,1,1
970,2011,5,MORTGAGE,3,Low,1,5000, 36 months,1,home_improvement,7,High,2,Bad Loan,1,14.27,C,3,21.71,3405.9,2370.47,151.01,171.55,409000000969,21-Dec-18,Indfor INCOME INDO REMI20121,"2,640.00",,1290185.00,Sinclair,649,Germany,107125.79,1,1,1
971,2011,10,MORTGAGE,3,Low,1,14000, 60 months,2,debt_consolidation,6,High,2,Good Loan,0,20.89,F,6,6.83,11892.28,6519.97,0,248.33,409000000970,21-Dec-18,INDO GIBL Indiaforensic STL20121,"425,752.00",,864433.00,L?,638,France,47679.14,1,1,1
972,2011,10,RENT,1,Low,1,6000, 60 months,2,debt_consolidation,6,High,2,Good Loan,0,16.77,D,4,9.09,7099.1,4358.43,0,148.38,409000000971,21-Dec-18,FDRL/INTERNAL FUND TRANSFE,,500000.00,1364433.00,Buckner,723,France,134509.47,1,1,1
973,2011,1,RENT,1,Low,1,7200, 36 months,1,credit_card,1,Low,1,Good Loan,0,9.91,B,2,8.59,7565.86,7200.01,0,232.02,409000000972,24-Dec-18,Indfor INCOME INDO REMI23121,120,,1364313.00,Padovesi,635,Germany,153265.31,1,1,1
974,2011,10,RENT,1,Low,1,5000, 36 months,1,debt_consolidation,6,High,2,Bad Loan,1,14.27,C,3,20.93,1711.9,1180.36,0,171.55,409000000973,24-Dec-18,INDO GIBL Indiaforensic STL23121,"20,000.00",,1344313.00,Gray,750,Spain,179883.04,1,1,1
975,2011,2,RENT,1,Low,1,6600, 36 months,1,credit_card,1,Low,1,Good Loan,0,10.65,B,2,10.11,7737.332072,6600,0,214.99,409000000974,24-Dec-18,Indfor INCOME INDO REMI22121,960,,1343353.00,Lu,730,France,138882.98,1,1,1
976,2011,6.05,MORTGAGE,3,Low,1,7000, 36 months,1,car,2,Low,1,Good Loan,0,6.62,A,1,11.45,7580.27,7000,0,214.93,409000000975,24-Dec-18,INDO GIBL Indiaforensic STL22121,"130,600.00",,1212753.00,Wright,750,Spain,9855.81,1,1,1
977,2011,0.5,RENT,1,Medium,2,20000, 36 months,1,debt_consolidation,6,High,2,Good Loan,0,15.27,C,3,9.67,24112.28775,20000,0,695.96,409000000976,24-Dec-18,Indfor INCOME INDO REMI21121,"2,760.00",,1209993.00,Palerma,586,France,67046.83,1,1,1
978,2011,4,RENT,1,Low,1,8000, 36 months,1,credit_card,1,Low,1,Bad Loan,1,12.42,B,2,23.79,7078.69,5218.11,388.87,267.33,409000000977,24-Dec-18,INDO GIBL Indiaforensic STL21121,"422,577.00",,787416.00,Y?an,520,France,56388.63,1,1,1
979,2011,6,RENT,1,Low,1,12000, 36 months,1,home_improvement,7,Low,1,Good Loan,0,9.91,B,2,10.46,13748.05939,12000,0,386.7,409000000978,24-Dec-18,FDRL/INTERNAL FUND TRANSFE,,500000.00,1287416.00,Wei,652,France,77764.37,1,1,1
980,2011,7,RENT,1,Low,1,20000, 36 months,1,credit_card,1,Low,1,Good Loan,0,11.71,B,2,16.55,23077.53,20000,0,661.52,409000000979,24-Dec-18,FDRL/INTERNAL FUND TRANSFE,,400000.00,1687416.00,Padovesi,550,France,130590.35,1,1,1
981,2011,10,RENT,1,Low,1,10000, 36 months,1,debt_consolidation,6,Low,1,Good Loan,0,8.9,A,1,20.79,11429.14679,10000,0,317.54,409000000980,26-Dec-18,Indfor INCOME INDO REMI25121,"1,320.00",,1686096.00,Tsao,594,France,151912.49,1,1,1
982,2011,7,RENT,1,Low,1,16000, 60 months,2,debt_consolidation,6,Low,1,Bad Loan,1,12.69,B,2,26.11,12207.97,9137.3,27.3,229.91,409000000981,26-Dec-18,INDO GIBL Indiaforensic STL25121,"173,441.00",,1512655.00,Franklin,749,Germany,151083.80,1,1,1
983,2011,5,MORTGAGE,3,Medium,2,10000, 36 months,1,other,4,Low,1,Good Loan,0,11.71,B,2,10.65,11903.04487,10000,0,330.76,409000000982,26-Dec-18,Indfor INCOME INDO REMI24121,"4,680.00",,1507975.00,Clark,668,France,777.37,1,1,1
984,2011,2,RENT,1,Low,1,18000, 36 months,1,credit_card,1,High,2,Good Loan,0,16.29,D,4,15.67,22870.98881,18000,0,635.41,409000000983,26-Dec-18,INDO GIBL Indiaforensic STL24121,"692,917.00",,815058.00,McGregor,614,Germany,69454.24,1,1,1
985,2011,7,RENT,1,Low,1,4000, 36 months,1,credit_card,1,Low,1,Good Loan,0,12.42,B,2,9.6,4804.055761,4000,0,133.67,409000000984,26-Dec-18,FDRL/INTERNAL FUND TRANSFE,,500000.00,1315058.00,Pan,773,France,11723.57,1,1,1
986,2011,6.05,RENT,1,Low,1,15000, 36 months,1,debt_consolidation,6,Low,1,Good Loan,0,12.42,B,2,14.18,18040.97902,15000,0,501.23,409000000985,27-Dec-18,Indfor INCOME INDO REMI26121,"1,320.00",,1313738.00,Kenniff,551,Germany,91565.25,1,1,1
987,2011,5,OWN,2,Low,1,10000, 60 months,2,credit_card,1,High,2,Bad Loan,1,18.64,E,5,12.75,2691,634.12,536.87,257.43,409000000986,27-Dec-18,INDO GIBL Indiaforensic STL26121,"250,849.00",,1062889.00,Spencer,566,France,79616.37,1,1,1
988,2011,10,RENT,1,Low,1,29500, 60 months,2,debt_consolidation,6,High,2,Good Loan,0,14.27,C,3,19.09,24294.64026,17900,0,419.02,409000000987,27-Dec-18,FDRL/INTERNAL FUND TRANSFE,,500000.00,1562889.00,Lees,569,Spain,102299.81,1,1,1
989,2011,10,MORTGAGE,3,Medium,2,20125, 60 months,2,credit_card,1,High,2,Good Loan,0,19.42,E,5,19.7,28424.25261,20125,0,526.72,409000000988,28-Dec-18,Indfor INCOME INDO REMI27121,"4,080.00",,1558809.00,David,659,Spain,104533.51,1,1,1
990,2011,0.5,RENT,1,Medium,2,30000, 60 months,2,debt_consolidation,6,High,2,Good Loan,0,21.28,F,6,8.73,25220.99,18375,0,500.01,409000000989,28-Dec-18,INDO GIBL Indiaforensic STL27121,"625,478.00",,933331.00,Hsing,722,France,140765.57,1,1,1
991,2011,10,OWN,2,Medium,2,24000, 36 months,1,debt_consolidation,6,High,2,Good Loan,0,16.77,D,4,15.34,30692.4333,24000,0,852.93,409000000990,28-Dec-18,FDRL/INTERNAL FUND TRANSFE,,400000.00,1333331.00,Burke,655,France,66214.13,1,1,1
992,2011,3,RENT,1,Low,1,14000, 60 months,2,debt_consolidation,6,High,2,Good Loan,0,15.96,C,3,12.62,19540.25058,14000,0,340.16,409000000991,29-Dec-18,Indfor INCOME INDO REMI28121,"1,320.00",,1332011.00,Watson,615,France,139816.10,1,1,1
993,2011,5,MORTGAGE,3,Low,1,5375, 36 months,1,credit_card,1,Low,1,Good Loan,0,10.65,B,2,17.69,6168.23,5375,0,175.09,409000000992,29-Dec-18,INDO GIBL Indiaforensic STL28121,"153,500.00",,1178511.00,Hawkins,752,Germany,140139.28,1,1,1
994,2011,10,RENT,1,Low,1,8300, 36 months,1,debt_consolidation,6,Low,1,Good Loan,0,8.9,A,1,6.24,8996.03,8300,0,263.56,409000000993,29-Dec-18,FDRL/INTERNAL FUND TRANSFE,,400000.00,1578511.00,Ginn,661,Spain,102297.15,1,1,1
995,2011,5,OWN,2,Low,1,7000, 36 months,1,debt_consolidation,6,Low,1,Good Loan,0,8.9,A,1,16.68,8000.341221,7000,0,222.28,409000000994,31-Dec-18,Indfor INCOME INDO REMI30121,240,,1578271.00,Sozonov,838,Spain,145765.83,1,1,1
996,2011,3,OWN,2,Low,1,2425, 36 months,1,home_improvement,7,High,2,Good Loan,0,15.27,C,3,23.92,3052.79,2424.99,0,84.39,409000000995,31-Dec-18,INDO GIBL Indiaforensic STL30121,"68,700.00",,1509571.00,Sun,610,Spain,83912.24,1,1,1
997,2011,2,RENT,1,Low,1,6950, 36 months,1,credit_card,1,Low,1,Good Loan,0,9.91,B,2,20.51,7349.48,6950.01,0,223.97,409000000996,31-Dec-18,Indfor INCOME INDO REMI29121,"1,200.00",,1508371.00,Hunter,811,Spain,78439.73,1,1,1
998,2011,10,OWN,2,Low,1,12375, 36 months,1,credit_card,1,Low,1,Good Loan,0,9.91,B,2,24.3,13433.96,12375.01,0,398.79,409000000997,31-Dec-18,INDO GIBL Indiaforensic STL29121,"200,550.00",,1307821.00,Manfrin,587,Spain,6776.92,1,1,1
999,2011,10,MORTGAGE,3,Low,1,35000, 60 months,2,debt_consolidation,6,High,2,Good Loan,0,20.3,E,5,12.54,44764.72,24930.6,0,933.14,409000000998,31-Dec-18,FDRL/INTERNAL FUND TRANSFE,,400000.00,1707821.00,Artamonova,811,Germany,9903.42,1,1,1
1000,2011,5,RENT,1,Low,1,14000, 60 months,2,debt_consolidation,6,High,2,Good Loan,0,17.27,D,4,19.95,14401.74,14000,0,349.98,409000000999,1-Jan-19,Indfor INCOME INDO REMI31121,"4,560.00",,1703261.00,Hansen,759,France,91561.91,1,1,1
1001,2011,0.5,RENT,1,Low,1,14000, 36 months,1,debt_consolidation,6,High,2,Good Loan,0,14.27,C,3,8.4,16739.8,14000,0,480.33,409000001000,1-Jan-19,INDO GIBL Indiaforensic STL31121,"776,077.00",,927184.00,Pai,648,Germany,4027.02,1,1,1
1002,2011,5,RENT,1,Low,1,5500, 36 months,1,credit_card,1,High,2,Good Loan,0,14.27,C,3,22.8,6436.21,5500,0,188.7,409000001001,1-Jan-19,FDRL/INTERNAL FUND TRANSFE,,300000.00,1227184.00,Larsen,788,France,116111.51,1,1,1
1003,2011,0.5,RENT,1,Low,1,4800, 36 months,1,credit_card,1,High,2,Good Loan,0,14.65,C,3,15.28,5889.566033,4800,0,165.58,409000001002,1-Jan-19,FDRL/INTERNAL FUND TRANSFE,,300000.00,1527184.00,Owen,725,Germany,184023.54,1,1,1
1004,2011,0.5,RENT,1,Low,1,9000, 36 months,1,debt_consolidation,6,Low,1,Good Loan,0,12.69,B,2,12.88,10864.59454,9000,0,301.91,409000001003,2-Jan-19,Indfor INCOME INDO REMI01011,"2,400.00",,1524784.00,Murphy,646,France,67124.48,1,1,1
1005,2011,2,OWN,2,Low,1,16000, 36 months,1,credit_card,1,Low,1,Good Loan,0,12.69,B,2,12.48,19314.37674,16000,0,536.72,409000001004,2-Jan-19,INDO GIBL Indiaforensic STL01011,"408,376.00",,1116408.00,Ekechukwu,601,Germany,50070.59,1,1,1
1006,2011,2,MORTGAGE,3,Low,1,5000, 36 months,1,debt_consolidation,6,Low,1,Good Loan,0,7.9,A,1,3.37,5554.04,5000,0,156.46,409000001005,2-Jan-19,FDRL/INTERNAL FUND TRANSFE,,400000.00,1516408.00,Ayers,521,Germany,53793.10,1,1,1
1007,2011,3,MORTGAGE,3,Low,1,35000, 60 months,2,debt_consolidation,6,Low,1,Good Loan,0,12.42,B,2,8.96,23858.61,16612.08,0,495.19,409000001006,3-Jan-19,Indfor INCOME INDO REMI02011,"5,160.00",,1511248.00,Johnson,561,Spain,45261.47,1,1,1
1008,2011,8,MORTGAGE,3,Low,1,18500, 36 months,1,debt_consolidation,6,Low,1,Good Loan,0,7.9,A,1,13.63,18740.82,18500,0,578.87,409000001007,3-Jan-19,INDO GIBL Indiaforensic STL02011,"826,831.00",,684417.00,Millar,564,France,36721.40,1,1,1
1009,2011,6,MORTGAGE,3,Low,1,5350, 36 months,1,home_improvement,7,High,2,Bad Loan,1,15.27,C,3,9.46,1855.6,1246.78,0,186.17,409000001008,3-Jan-19,FDRL/INTERNAL FUND TRANSFE,,400000.00,1084417.00,Farrell,444,France,130009.85,1,1,1
1010,2011,2,RENT,1,Low,1,25000, 60 months,2,debt_consolidation,6,Low,1,Good Loan,0,12.69,B,2,18.02,28610.18,25000,0,564.87,409000001009,3-Jan-19,FDRL/INTERNAL FUND TRANSFE,,400000.00,1484417.00,Sanders,650,Spain,175380.77,1,1,1
1011,2011,3,RENT,1,Low,1,10000, 36 months,1,credit_card,1,Low,1,Good Loan,0,10.65,B,2,11.2,11722.56263,10000,0,325.74,409000001010,4-Jan-19,Indfor INCOME INDO REMI03011,"3,240.00",,1481177.00,Herrera,724,France,127847.25,1,1,1
1012,2011,3,RENT,1,Low,1,12000, 36 months,1,debt_consolidation,6,Low,1,Good Loan,0,7.51,A,1,24.1,13054.96,12000,0,373.33,409000001011,4-Jan-19,INDO GIBL Indiaforensic STL03011,"601,604.00",,879573.00,Eberechukwu,719,Spain,138231.70,1,1,1
1013,2011,5,MORTGAGE,3,Low,1,18000, 36 months,1,debt_consolidation,6,Low,1,Good Loan,0,9.91,B,2,11.85,20830.93026,18000,0,580.05,409000001012,4-Jan-19,FDRL/INTERNAL FUND TRANSFE,,400000.00,1279573.00,Bardin,548,France,48673.18,1,1,1
1014,2011,3,MORTGAGE,3,Low,1,3000, 36 months,1,other,4,High,2,Good Loan,0,17.58,D,4,6.78,3879.845928,3000,0,107.83,409000001013,4-Jan-19,FDRL/INTERNAL FUND TRANSFE,,300000.00,1579573.00,Nwankwo,635,Spain,70668.77,1,1,1
1015,2011,0.5,RENT,1,Low,1,6000, 36 months,1,credit_card,1,Low,1,Bad Loan,1,7.9,A,1,12.66,3202.59,2490.27,201.63,187.75,409000001014,5-Jan-19,Indfor INCOME INDO REMI04011,"2,160.00",,1577413.00,Talbot,496,Spain,199505.53,1,1,1
1016,2011,1,RENT,1,Low,1,20000, 60 months,2,credit_card,1,High,2,Good Loan,0,16.77,D,4,16.77,29179.12,20000,0,494.59,409000001015,5-Jan-19,INDO GIBL Indiaforensic STL04011,"218,276.00",,1359137.00,McGregor,676,France,169583.18,1,1,1
1017,2011,10,MORTGAGE,3,Low,1,35000, 60 months,2,home_improvement,7,High,2,Good Loan,0,19.03,E,5,12.07,32710.99253,22600,0,586.63,409000001016,7-Jan-19,Indfor INCOME INDO REMI06011,240,,1358897.00,Onyeorulu,541,Germany,49063.42,1,1,1
1018,2011,2,RENT,1,Low,1,10000, 36 months,1,debt_consolidation,6,Low,1,Good Loan,0,9.91,B,2,13.38,11598.98745,10000,0,322.25,409000001017,7-Jan-19,INDO GIBL Indiaforensic STL06011,"17,500.00",,1341397.00,Goold,778,Germany,63337.19,1,1,1
1019,2011,6.05,RENT,1,Low,1,12000, 60 months,2,debt_consolidation,6,Low,1,Good Loan,0,9.91,B,2,17.45,9846.78,7315.85,0,204.61,409000001018,7-Jan-19,Indfor INCOME INDO REMI05011,"2,760.00",,1338637.00,Zikoranaudodimma,850,Germany,60083.11,1,1,1
1020,2011,4,OWN,2,Low,1,5875, 36 months,1,debt_consolidation,6,Low,1,Good Loan,0,7.9,A,1,14.63,6617.001736,5875,0,183.84,409000001019,7-Jan-19,INDO GIBL Indiaforensic STL05011,"377,441.00",,961196.00,Garner,633,France,48606.71,1,1,1
1021,2011,4,RENT,1,Low,1,10000, 36 months,1,debt_consolidation,6,High,2,Good Loan,0,13.49,C,3,10.1,12210.28968,10000,0,339.31,409000001020,8-Jan-19,FDRL/INTERNAL FUND TRANSFE,,300000.00,1261196.00,Onyinyechukwuka,625,France,165580.93,1,1,1
1022,2011,5,MORTGAGE,3,Medium,2,28000, 36 months,1,debt_consolidation,6,Low,1,Good Loan,0,11.71,B,2,15.01,33337.40992,28000,0,926.13,409000001021,8-Jan-19,FDRL/INTERNAL FUND TRANSFE,,300000.00,1561196.00,Genovese,485,Spain,194010.12,1,1,1
1023,2011,5,RENT,1,Low,1,11200, 36 months,1,other,4,Low,1,Good Loan,0,11.71,B,2,8.68,12812.31,11200,0,370.46,409000001022,8-Jan-19,Indfor INCOME INDO REMI07011,"3,960.00",,1557236.00,Mai,547,France,69263.10,1,1,1
1024,2011,3,RENT,1,Low,1,10000, 36 months,1,credit_card,1,High,2,Good Loan,0,14.27,C,3,6.85,11977.8,10000,0,343.09,409000001023,8-Jan-19,INDO GIBL Indiaforensic STL07011,"613,279.00",,943957.00,Marshall,642,France,88698.83,1,1,1
1025,2011,5,RENT,1,Low,1,20000, 60 months,2,debt_consolidation,6,High,2,Good Loan,0,14.27,C,3,20.61,27732.63,20000,0,468.17,409000001024,8-Jan-19,FDRL/INTERNAL FUND TRANSFE,,300000.00,1243957.00,Naylor,718,France,63030.97,1,1,1
1026,2011,7,RENT,1,Low,1,9450, 36 months,1,credit_card,1,High,2,Good Loan,0,14.27,C,3,18.96,11667.15601,9450,0,324.22,409000001025,9-Jan-19,Indfor INCOME INDO REMI08011,"3,720.00",,1240237.00,Pinto,582,France,59668.81,1,1,1
1027,2011,3,OWN,2,Low,1,19000, 60 months,2,debt_consolidation,6,High,2,Bad Loan,1,16.77,D,4,18.09,18534.22,8164.21,3518.98,469.86,409000001026,9-Jan-19,INDO GIBL Indiaforensic STL08011,"674,030.00",,566207.00,Fulton,628,France,184230.23,1,1,1
1028,2011,10,MORTGAGE,3,Low,1,18825, 60 months,2,debt_consolidation,6,High,2,Good Loan,0,18.64,E,5,14.77,25893.27992,18825,0,484.61,409000001027,9-Jan-19,FDRL/INTERNAL FUND TRANSFE,,400000.00,966207.00,Palerma,737,Germany,64050.19,1,1,1
1029,2011,1,RENT,1,Low,1,20400, 60 months,2,credit_card,1,High,2,Good Loan,0,17.58,D,4,17.86,30057.58315,20400,0,513.38,409000001028,9-Jan-19,FDRL/INTERNAL FUND TRANSFE,,400000.00,1366207.00,McCaffrey,828,Spain,81853.98,1,1,1
1030,2011,6,MORTGAGE,3,Low,1,21650, 36 months,1,debt_consolidation,6,Low,1,Good Loan,0,12.69,B,2,21.28,26125.37397,21650,0,726.25,409000001029,10-Jan-19,Indfor INCOME INDO REMI09011,"1,920.00",,1364287.00,Collins,609,Spain,154642.91,1,1,1
1031,2011,1,MORTGAGE,3,Medium,2,24000, 60 months,2,debt_consolidation,6,High,2,Bad Loan,1,21.67,F,6,9.98,9392.16,3525.72,733.56,434.11,409000001030,10-Jan-19,INDO GIBL Indiaforensic STL09011,"293,700.00",,1070587.00,Zuev,730,France,145679.60,1,1,1
1032,2011,10,RENT,1,Low,1,24500, 60 months,2,debt_consolidation,6,High,2,Good Loan,0,17.27,D,4,13.85,29369.74,17780.49,0,612.46,409000001031,10-Jan-19,FDRL/INTERNAL FUND TRANSFE,,300000.00,1370587.00,Crawford,631,France,30781.77,1,1,1
1033,2011,10,RENT,1,Low,1,9000, 36 months,1,debt_consolidation,6,Low,1,Good Loan,0,10.65,B,2,23.39,10551.11254,9000,0,293.16,409000001032,11-Jan-19,Indfor INCOME INDO REMI10011,"2,400.00",,1368187.00,Genovese,830,Spain,81622.52,1,1,1
1034,2011,3,MORTGAGE,3,Low,1,15000, 60 months,2,credit_card,1,Low,1,Good Loan,0,11.71,B,2,14.05,17873.38,15000,0,331.48,409000001033,11-Jan-19,INDO GIBL Indiaforensic STL10011,"391,453.00",,976734.00,Maclean,645,France,196474.35,1,1,1
1035,2011,10,RENT,1,Low,1,20000, 60 months,2,credit_card,1,High,2,Good Loan,0,18.64,E,5,13.37,24693.26,14393.3,0,514.86,409000001034,11-Jan-19,FDRL/INTERNAL FUND TRANSFE,,400000.00,1376734.00,Fabro,663,France,176276.10,1,1,1
1036,2011,3,RENT,1,Low,1,7100, 60 months,2,credit_card,1,High,2,Good Loan,0,19.42,E,5,23.13,8897.59,5078.16,0,185.83,409000001035,11-Jan-19,FDRL/INTERNAL FUND TRANSFE,,400000.00,1776734.00,Price,678,Spain,35113.08,1,1,1
1037,2011,2,RENT,1,Low,1,6000, 36 months,1,debt_consolidation,6,Low,1,Good Loan,0,10.65,B,2,20.73,6432.45,6000,0,195.44,409000001036,14-Jan-19,Indfor INCOME INDO REMI11011,"4,560.00",,1772174.00,Chatfield,521,France,64299.82,1,1,1
1038,2011,1,RENT,1,Low,1,5600, 36 months,1,credit_card,1,Low,1,Good Loan,0,7.9,A,1,10.9,6322.73293,5600,0,175.23,409000001037,14-Jan-19,INDO GIBL Indiaforensic STL11011,"727,659.00",,1044515.00,Volkova,625,France,180969.55,1,1,1
1039,2011,10,RENT,1,Low,1,7000, 36 months,1,debt_consolidation,6,Low,1,Good Loan,0,10.65,B,2,5.22,8206.237225,7000,0,228.02,409000001038,14-Jan-19,Indfor INCOME INDO REMI12011,"2,520.00",,1041995.00,Archer,523,France,138176.78,1,1,1
1040,2011,0.5,RENT,1,Low,1,20300, 60 months,2,debt_consolidation,6,High,2,Bad Loan,1,14.27,C,3,27.76,20421.38,13018.34,0,475.2,409000001039,14-Jan-19,INDO GIBL Indiaforensic STL12011,"344,650.00",,697345.00,Ch'iu,714,France,86733.61,1,1,1
1041,2011,0.5,RENT,1,Low,1,6000, 36 months,1,credit_card,1,Low,1,Good Loan,0,10.65,B,2,7.99,6253.72,6000,0,195.44,409000001040,14-Jan-19,Indfor INCOME INDO REMI13011,240,,697105.00,McKay,580,Spain,7418.92,1,1,1
1042,2011,10,RENT,1,Low,1,30000, 60 months,2,credit_card,1,High,2,Good Loan,0,14.27,C,3,21.25,33696,22182.97,0,702.26,409000001041,14-Jan-19,INDO GIBL Indiaforensic STL13011,"50,000.00",,647105.00,Craig,722,France,166376.54,1,1,1
1043,2011,5,RENT,1,Medium,2,12000, 36 months,1,debt_consolidation,6,Low,1,Good Loan,0,7.9,A,1,4.85,13515.6265,12000,0,375.49,409000001042,14-Jan-19,FDRL/INTERNAL FUND TRANSFE,,300000.00,947105.00,Abramovich,630,Spain,140881.20,1,1,1
1044,2011,5,RENT,1,Low,1,13650, 36 months,1,credit_card,1,Low,1,Good Loan,0,10.65,B,2,24.57,16002.68373,13650,0,444.63,409000001043,14-Jan-19,FDRL/INTERNAL FUND TRANSFE,,300000.00,1247105.00,Chien,579,France,4460.20,1,1,1
1045,2011,9,MORTGAGE,3,Low,1,24000, 60 months,2,debt_consolidation,6,Low,1,Good Loan,0,12.69,B,2,21.65,24248.96123,18500,0,418.01,409000001044,15-Jan-19,Indfor INCOME INDO REMI14011,"3,600.00",,1243505.00,Timms,670,France,110472.12,1,1,1
1046,2011,9,MORTGAGE,3,Low,1,6200, 60 months,2,credit_card,1,High,2,Good Loan,0,18.64,E,5,10.61,8199.59,6200,0,159.61,409000001045,15-Jan-19,INDO GIBL Indiaforensic STL14011,"473,626.00",,769879.00,Williford,588,Spain,86460.28,1,1,1
1047,2011,4,MORTGAGE,3,Medium,2,25000, 60 months,2,credit_card,1,High,2,Good Loan,0,14.65,C,3,7.15,28940.15,25000,0,590.17,409000001046,15-Jan-19,FDRL/INTERNAL FUND TRANSFE,,300000.00,1069879.00,Hamilton,807,Spain,16500.66,1,1,1
1048,2011,4,RENT,1,Low,1,12000, 36 months,1,debt_consolidation,6,High,2,Good Loan,0,13.49,C,3,12.66,12134.86,12000,0,407.17,409000001047,16-Jan-19,Indfor INCOME INDO REMI15011,960,,1068919.00,Cheng,726,France,114020.06,1,1,1
1049,2011,0.5,MORTGAGE,3,Low,1,2300, 36 months,1,other,4,Low,1,Bad Loan,1,7.51,A,1,10.23,983.05,748.15,89.06,71.56,409000001048,16-Jan-19,INDO GIBL Indiaforensic STL15011,"108,200.00",,960719.00,Su,812,Germany,131660.31,1,1,1
1050,2011,0.5,RENT,1,Low,1,8875, 36 months,1,debt_consolidation,6,Low,1,Good Loan,0,10.65,B,2,18.21,10409.1525,8875,0,289.09,409000001049,16-Jan-19,FDRL/INTERNAL FUND TRANSFE,,500000.00,1460719.00,McKenzie,631,Germany,52449.62,1,1,1
1051,2011,7,RENT,1,Low,1,18800, 60 months,2,debt_consolidation,6,High,2,Bad Loan,1,21.28,F,6,11.73,5085.23,1516.88,993.39,511.57,409000001050,17-Jan-19,Indfor INCOME INDO REMI16011,"3,000.00",,1457719.00,Akobundu,682,France,161465.31,1,1,1
1052,2011,4,RENT,1,Low,1,12000, 60 months,2,home_improvement,7,Low,1,Good Loan,0,11.71,B,2,12.08,12710.18,8999.28,0,265.18,409000001051,17-Jan-19,INDO GIBL Indiaforensic STL16011,"446,201.00",,1011518.00,Ko,625,Spain,20018.79,1,1,1
1053,2011,2,RENT,1,Low,1,9000, 36 months,1,credit_card,1,Low,1,Good Loan,0,7.9,A,1,7.93,10018.67,9000,0,281.62,409000001052,17-Jan-19,FDRL/INTERNAL FUND TRANSFE,,400000.00,1411518.00,Marcelo,607,Germany,176318.27,1,1,1
1054,2011,9,OWN,2,Low,1,7600, 36 months,1,debt_consolidation,6,Low,1,Good Loan,0,8.9,A,1,16.26,8529.39,7600,0,241.33,409000001053,18-Jan-19,Indfor INCOME INDO REMI17011,"3,600.00",,1407918.00,Chukwuebuka,600,Spain,50488.91,1,1,1
1055,2011,1,RENT,1,Low,1,16000, 60 months,2,debt_consolidation,6,Low,1,Good Loan,0,11.71,B,2,19.68,17227.00345,13950,0,308.27,409000001054,18-Jan-19,INDO GIBL Indiaforensic STL17011,"628,628.00",,779290.00,MacDonald,602,Spain,30379.60,1,1,1
1056,2011,3,RENT,1,Low,1,12000, 60 months,2,credit_card,1,High,2,Good Loan,0,18.25,D,4,11.8,17541.91608,12000,0,306.36,409000001055,18-Jan-19,FDRL/INTERNAL FUND TRANSFE,,500000.00,1279290.00,Lampungmeiua,545,Spain,161326.73,1,1,1
1057,2011,3,RENT,1,Low,1,22500, 60 months,2,major_purchase,8,High,2,Good Loan,0,20.89,F,6,7.65,28913.29,22500,0,607.31,409000001056,19-Jan-19,Indfor INCOME INDO REMI18011,"1,440.00",,1277850.00,Tai,675,Spain,45348.08,1,1,1
1058,2011,9,RENT,1,Medium,2,20000, 60 months,2,debt_consolidation,6,High,2,Good Loan,0,18.25,D,4,12.74,23684.56,20000,0,510.6,409000001057,19-Jan-19,INDO GIBL Indiaforensic STL18011,"229,800.00",,1048050.00,Enyinnaya,581,France,180251.68,1,1,1
1059,2011,2,MORTGAGE,3,Low,1,6000, 36 months,1,debt_consolidation,6,High,2,Good Loan,0,13.49,C,3,9.82,6494.82,6000,0,203.59,409000001058,19-Jan-19,FDRL/INTERNAL FUND TRANSFE,,300000.00,1348050.00,McKenzie,640,Germany,34925.56,1,1,1
1060,2011,4,OWN,2,Low,1,7200, 36 months,1,credit_card,1,Low,1,Good Loan,0,9.91,B,2,16.14,8189.622649,7200,0,232.02,409000001059,19-Jan-19,FDRL/INTERNAL FUND TRANSFE,,300000.00,1648050.00,Kline,850,France,126555.74,1,1,1
1061,2011,0.5,RENT,1,Low,1,8000, 36 months,1,debt_consolidation,6,Low,1,Good Loan,0,10.65,B,2,6.53,9344.668982,8000,0,260.59,409000001060,21-Jan-19,Indfor INCOME INDO REMI19011,960,,1647090.00,Ma,490,Spain,187921.30,1,1,1
1062,2011,10,MORTGAGE,3,Low,1,24575, 60 months,2,credit_card,1,High,2,Bad Loan,1,19.03,E,5,19.75,25480.07,11473.69,3198.18,637.9,409000001061,21-Jan-19,INDO GIBL Indiaforensic STL19011,"98,900.00",,1548190.00,Wood,710,Spain,136390.88,1,1,1
1063,2011,7,MORTGAGE,3,Low,1,18000, 60 months,2,debt_consolidation,6,High,2,Good Loan,0,14.65,C,3,18.63,20394.6,13282.76,0,424.92,409000001062,21-Jan-19,Indfor INCOME INDO REMI20011,480,,1547710.00,Riggs,613,Germany,78566.64,1,1,1
1064,2011,10,MORTGAGE,3,Low,1,19000, 36 months,1,debt_consolidation,6,Low,1,Good Loan,0,7.51,A,1,5.28,20848.47,19000,0,591.11,409000001063,21-Jan-19,INDO GIBL Indiaforensic STL20011,"96,200.00",,1451510.00,Capon,812,France,166038.27,1,1,1
1065,2011,10,RENT,1,Low,1,14400, 36 months,1,credit_card,1,High,2,Good Loan,0,15.27,C,3,12.88,18033.16295,14400,0,501.09,409000001064,21-Jan-19,FDRL/INTERNAL FUND TRANSFE,,300000.00,1751510.00,Smith,723,France,140385.33,1,1,1
1066,2011,1,RENT,1,Low,1,8400, 36 months,1,wedding,5,Low,1,Good Loan,0,12.69,B,2,3.81,10139.2098,8400,0,281.78,409000001065,22-Jan-19,Indfor INCOME INDO REMI21011,"4,080.00",,1747430.00,Davison,512,France,38629.30,1,1,1
1067,2011,2,RENT,1,Low,1,7500, 36 months,1,debt_consolidation,6,Low,1,Good Loan,0,12.69,B,2,13.82,9055.390651,7500,0,251.59,409000001066,22-Jan-19,INDO GIBL Indiaforensic STL21011,"602,930.00",,1144500.00,Ingram,731,France,24998.75,1,1,1
1068,2011,4,MORTGAGE,3,Low,1,30000, 60 months,2,debt_consolidation,6,High,2,Good Loan,0,20.89,F,6,17.6,38966.85,30000,0,809.75,409000001067,22-Jan-19,FDRL/INTERNAL FUND TRANSFE,,400000.00,1544500.00,Dilke,650,Germany,128815.33,1,1,1
1069,2011,2,RENT,1,Low,1,12375, 60 months,2,credit_card,1,High,2,Good Loan,0,15.96,C,3,23.74,14411.32,9049.44,0,300.68,409000001068,23-Jan-19,Indfor INCOME INDO REMI22011,"3,720.00",,1540780.00,Gibson,594,France,19376.56,1,1,1
1070,2011,2,MORTGAGE,3,Low,1,10000, 36 months,1,debt_consolidation,6,Low,1,Good Loan,0,7.51,A,1,17.37,11197.46049,10000,0,311.11,409000001069,23-Jan-19,INDO GIBL Indiaforensic STL22011,"589,137.00",,951643.00,Iadanza,844,France,31904.31,1,1,1
1071,2011,2,RENT,1,Low,1,22000, 60 months,2,debt_consolidation,6,High,2,Good Loan,0,17.27,D,4,7.91,30871.76906,22000,0,549.96,409000001070,23-Jan-19,FDRL/INTERNAL FUND TRANSFE,,500000.00,1451643.00,Hebert,686,Germany,173179.79,1,1,1
1072,2011,10,RENT,1,Medium,2,12000, 36 months,1,debt_consolidation,6,Low,1,Good Loan,0,12.69,B,2,6.61,13496.99,12000,0,402.54,409000001071,24-Jan-19,Indfor INCOME INDO REMI23011,"2,880.00",,1448763.00,Pinto,695,Germany,22485.64,1,1,1
1073,2011,1,MORTGAGE,3,Medium,2,5000, 36 months,1,other,4,Low,1,Good Loan,0,12.69,B,2,20.02,5343.62,5000,0,167.73,409000001072,24-Jan-19,INDO GIBL Indiaforensic STL23011,"388,327.00",,1060436.00,Dumetochukwu,624,Spain,196668.51,1,1,1
1074,2011,2,RENT,1,Low,1,21000, 36 months,1,debt_consolidation,6,High,2,Good Loan,0,16.29,D,4,19.79,26413.61181,21000,0,741.31,409000001073,24-Jan-19,FDRL/INTERNAL FUND TRANSFE,,500000.00,1560436.00,Ross,503,Spain,136506.86,1,1,1
1075,2011,2,MORTGAGE,3,Low,1,24000, 36 months,1,home_improvement,7,Low,1,Good Loan,0,8.9,A,1,1.77,27131,24000,0,762.08,409000001074,25-Jan-19,Indfor INCOME INDO REMI24011,"2,040.00",,1558396.00,Jamieson,535,France,36278.89,1,1,1
1076,2011,0.5,RENT,1,Low,1,6000, 36 months,1,medical,9,High,2,Good Loan,0,13.49,C,3,10.8,6924.23,6000,0,203.59,409000001075,25-Jan-19,INDO GIBL Indiaforensic STL24011,"245,413.00",,1312983.00,Chiganu,743,Germany,163254.39,1,1,1
1077,2011,2,RENT,1,Low,1,4800, 36 months,1,other,4,Low,1,Good Loan,0,6.03,A,1,5.89,5274.08811,4800,0,146.1,409000001076,25-Jan-19,FDRL/INTERNAL FUND TRANSFE,,300000.00,1612983.00,Burgess,702,Spain,99654.13,1,1,1
1078,2011,5,RENT,1,Low,1,5000, 36 months,1,other,4,High,2,Bad Loan,1,20.89,F,6,7.14,5802.34,3936.53,160.64,188.1,409000001077,28-Jan-19,Indfor INCOME INDO REMI25011,"1,920.00",,1611063.00,Cheng,658,France,20207.02,1,1,1
1079,2011,1,RENT,1,Low,1,5850, 36 months,1,credit_card,1,High,2,Good Loan,0,14.65,C,3,23.59,6951.6,5850,0,201.8,409000001078,28-Jan-19,INDO GIBL Indiaforensic STL25011,"466,124.00",,1144939.00,Woods,677,Germany,4195.84,1,1,1
1080,2011,10,MORTGAGE,3,Low,1,17000, 60 months,2,debt_consolidation,6,High,2,Good Loan,0,18.64,E,5,14.65,20991.42,12235.3,0,437.63,409000001079,28-Jan-19,Indfor INCOME INDO REMI26011,360,,1144579.00,Liang,664,France,112340.20,1,1,1
1081,2011,2,RENT,1,Low,1,21000, 60 months,2,credit_card,1,Low,1,Good Loan,0,11.71,B,2,8.88,25563.75471,21000,0,464.07,409000001080,28-Jan-19,INDO GIBL Indiaforensic STL26011,"17,500.00",,1127079.00,Bluett,766,Germany,2035.94,1,1,1
1082,2011,10,RENT,1,Low,1,17475, 60 months,2,other,4,High,2,Bad Loan,1,17.27,D,4,24.84,12457.55,5459.21,1520.58,404.35,409000001081,28-Jan-19,FDRL/INTERNAL FUND TRANSFE,,400000.00,1527079.00,Chapman,461,Spain,132295.95,1,1,1
1083,2011,2,OWN,2,Low,1,4750, 36 months,1,home_improvement,7,Low,1,Good Loan,0,8.9,A,1,10.07,5428.515614,4750,0,150.83,409000001082,29-Jan-19,Indfor INCOME INDO REMI28011,"2,520.00",,1524559.00,Andrejew,688,Spain,177383.68,1,1,1
1084,2011,3,MORTGAGE,3,Low,1,12000, 60 months,2,debt_consolidation,6,High,2,Good Loan,0,20.89,F,6,13.76,16247.26,12000,0,323.9,409000001083,29-Jan-19,INDO GIBL Indiaforensic STL28011,"299,125.00",,1225434.00,Udobata,678,France,90284.47,1,1,1
1085,2011,5,OWN,2,Low,1,5275, 36 months,1,other,4,Low,1,Good Loan,0,7.51,A,1,6.79,5371.67,5275,0,164.11,409000001084,29-Jan-19,FDRL/INTERNAL FUND TRANSFE,,300000.00,1525434.00,Ejimofor,796,France,61349.37,1,1,1
1086,2011,0.5,RENT,1,Low,1,9175, 36 months,1,debt_consolidation,6,Low,1,Good Loan,0,12.69,B,2,19.03,11075.03355,9175,0,307.78,409000001085,30-Jan-19,Indfor INCOME INDO REMI29011,"3,360.00",,1522074.00,Spyer,803,France,196466.83,1,1,1
1087,2011,5,RENT,1,Low,1,9600, 36 months,1,credit_card,1,High,2,Good Loan,0,16.77,D,4,19.62,12275.48691,9600,0,341.17,409000001086,30-Jan-19,INDO GIBL Indiaforensic STL29011,"401,052.00",,1121022.00,Walker,712,France,70758.37,1,1,1
1088,2011,8,RENT,1,Low,1,34475, 60 months,2,debt_consolidation,6,High,2,Bad Loan,1,14.27,C,3,20.02,21233.89,9008.49,3490.18,807.01,409000001087,31-Jan-19,Indfor INCOME INDO REMI30011,"1,200.00",,1119822.00,Palermo,498,France,13892.57,1,1,1
1089,2011,7,RENT,1,Low,1,22500, 36 months,1,debt_consolidation,6,High,2,Good Loan,0,14.27,C,3,12.07,26174.98,22500,0,771.96,409000001088,31-Jan-19,INDO GIBL Indiaforensic STL30011,"224,051.00",,895771.00,Philip,850,Spain,9684.52,1,1,1
1090,2011,1,RENT,1,Low,1,12000, 60 months,2,medical,9,High,2,Good Loan,0,22.06,F,6,8.54,12440.3,12000,0,331.84,409000001089,31-Jan-19,FDRL/INTERNAL FUND TRANSFE,,300000.00,1195771.00,Fallaci,628,France,40546.15,1,1,1
1091,2011,6.05,OWN,2,Low,1,12000, 36 months,1,credit_card,1,Low,1,Good Loan,0,6.03,A,1,18.75,13147.69037,12000,0,365.23,409000001090,1-Feb-19,Indfor INCOME INDO REMI31011,720,,1195051.00,Perry,539,Germany,136603.42,1,1,1
1092,2011,10,MORTGAGE,3,Low,1,10050, 60 months,2,home_improvement,7,High,2,Bad Loan,1,17.27,D,4,17.54,6445.26,2508.29,1096.45,251.23,409000001091,1-Feb-19,INDO GIBL Indiaforensic STL31011,"132,851.00",,1062200.00,Henderson,732,France,133172.48,1,1,1
1093,2011,2,RENT,1,Low,1,21000, 60 months,2,debt_consolidation,6,High,2,Good Loan,0,19.91,E,5,8.09,26756.72,15076.16,0,555.33,409000001092,8-Feb-19,FDRL/INTERNAL FUND TRANSFE,"600,000.00",,462200.00,Bergamaschi,715,France,152821.12,1,1,1
1094,2011,6.05,OWN,2,Low,1,15000, 36 months,1,debt_consolidation,6,High,2,Good Loan,0,17.27,D,4,12.08,19317.72151,15000,0,536.81,409000001093,5-Sep-16,TRF FROM  Indiaforensic SERVICES,,500000.00,962200.00,Fokine,651,France,147715.83,1,1,1
1095,2011,0.5,RENT,1,Low,1,19400, 36 months,1,credit_card,1,Low,1,Good Loan,0,12.69,B,2,17.66,21071.34,19400,0,650.77,409000001094,6-Sep-16,BBPS SETTLEMENT DT 30/08/,802.77,,961397.23,Mackay,813,France,43169.15,1,1,1
1096,2011,0.5,RENT,1,Low,1,10000, 36 months,1,credit_card,1,High,2,Bad Loan,1,15.27,C,3,16.37,2384.66,1363.97,301.76,347.98,409000001095,6-Sep-16,BBPS SETTLEMENT DT 31/08/,239.89,,961157.34,Wu,692,France,76755.99,1,1,1
1097,2011,1,OWN,2,Low,1,10000, 36 months,1,credit_card,1,High,2,Good Loan,0,15.27,C,3,13.77,10931.1,10000,0,347.98,409000001096,6-Sep-16,BBPS SETTLEMENT DT 01/09/,"1,193.54",,959963.80,Maslova,756,Germany,73406.04,1,1,1
1098,2011,6,RENT,1,Low,1,4800, 36 months,1,debt_consolidation,6,Low,1,Good Loan,0,10.65,B,2,8.07,5539.9,4800,0,156.36,409000001097,18-Oct-16,BBPS SETTLEMENT DTD 17.10,32.99,,959930.81,Wei,543,France,176728.28,1,1,1
1099,2011,3,MORTGAGE,3,Low,1,35000, 60 months,2,small_business,3,Low,1,Bad Loan,1,11.71,B,2,8.07,4831.72,2075.61,1222.17,516,409000001098,19-Oct-16,BBPS SETTLEMENT DTD 18.10,16.3,,959914.51,McLean,790,France,98309.27,1,1,1
1100,2011,10,RENT,1,Low,1,18200, 36 months,1,debt_consolidation,6,Low,1,Bad Loan,1,11.71,B,2,20.37,8427.23,6324.99,10.57,601.99,409000001099,19-Oct-16,BBPS SETTLEMENT DTD 19.10,18.04,,959896.47,Sung,494,Spain,6203.66,1,1,1
1101,2011,3,RENT,1,Low,1,6400, 36 months,1,credit_card,1,Low,1,Good Loan,0,12.69,B,2,14.33,7727.414831,6400,0,214.69,409000001100,20-Oct-16,BBPS SETTLEMENT DTD 20.10,22.99,,959873.48,Paterson,850,France,176791.27,1,1,1
1102,2011,10,MORTGAGE,3,Low,1,13000, 60 months,2,debt_consolidation,6,High,2,Good Loan,0,16.77,D,4,16,15375.4,9442.19,0,321.48,409000001101,21-Oct-16,BBPS SETTLEMENT DTD 21.10,14.85,,959858.63,Fanucci,703,Spain,50679.48,1,1,1
1103,2011,6,RENT,1,Low,1,2500, 36 months,1,debt_consolidation,6,High,2,Good Loan,0,15.27,C,3,15.27,2531.91,2500,0,87,409000001102,27-Oct-16,BBPS SETTLEMENT FOR DT 27,198.15,,959660.48,Thompson,432,Spain,150580.88,1,1,1
1104,2011,10,RENT,1,Low,1,6300, 36 months,1,credit_card,1,Low,1,Good Loan,0,9.91,B,2,12.61,7139.66,6300,0,203.02,409000001103,1-Nov-16,BBPS SETTLEMENT FOR DT 31,"1,015.71",,958644.77,Tisdall,512,Germany,80120.19,1,1,1
1105,2011,5,RENT,1,Low,1,4400, 36 months,1,credit_card,1,Low,1,Good Loan,0,11.71,B,2,7.86,5183.466117,4400,0,145.54,409000001104,3-Nov-16,BBPS SETTLEMENT FOR DT 03,"1,925.33",,956719.44,Onochie,589,France,151645.96,1,1,1
1106,2011,8,MORTGAGE,3,Medium,2,6000, 36 months,1,credit_card,1,Low,1,Good Loan,0,12.69,B,2,11.5,6465.24,6000,0,201.27,409000001105,4-Nov-16,BBPS SETTLEMENT FOR DT 04,"2,284.09",,954435.35,Mironova,514,France,55072.32,1,1,1
1107,2011,9,MORTGAGE,3,Low,1,20500, 60 months,2,debt_consolidation,6,High,2,Good Loan,0,20.89,F,6,18.02,16341.36,8956.45,0,340.77,409000001106,5-Nov-16,BBPS SETTLEMENT FOR DT 05,689.3,,953746.05,Ndubueze,678,France,115068.99,1,1,1
1108,2011,10,RENT,1,Medium,2,8800, 60 months,2,vacation,11,High,2,Good Loan,0,20.3,E,5,8.77,11228.74,6256.38,0,234.62,409000001107,7-Nov-16,BBPS SETTLEMENT FOR DTD 0,199.3,,953546.75,Stephenson,420,Germany,149471.13,1,1,1
1109,2011,9,RENT,1,Low,1,17000, 60 months,2,debt_consolidation,6,High,2,Bad Loan,1,13.49,C,3,21.03,5077.41,2778.78,0,391.08,409000001108,17-Nov-16,BBPS SETTLEMENT FOR DT 17,"1,938.02",,951608.73,Golubev,679,Germany,46522.68,1,1,1
1110,2011,10,MORTGAGE,3,Low,1,18000, 36 months,1,debt_consolidation,6,Low,1,Good Loan,0,7.9,A,1,21.22,20275.14791,18000,0,563.23,409000001109,18-Nov-16,BBPS SETTLEMENT FOR DTD 1,579.3,,951029.43,Liao,595,France,189995.86,1,1,1
1111,2011,3,MORTGAGE,3,Medium,2,20000, 60 months,2,credit_card,1,High,2,Good Loan,0,19.42,E,5,8.84,25198.16,14389.15,0,523.45,409000001110,23-Nov-16,BBPS SETTLEMENT FOR DT 23,899.17,,950130.26,Mullan,713,France,46369.57,1,1,1
1112,2011,4,MORTGAGE,3,Low,1,10000, 36 months,1,debt_consolidation,6,Low,1,Good Loan,0,12.69,B,2,14.56,12071.68131,10000,0,335.45,409000001111,24-Nov-16,BBPS SETTLEMENT FOR DT 24,"3,927.50",,946202.76,Glover,833,Germany,30722.52,1,1,1
1113,2011,5,MORTGAGE,3,Low,1,16000, 60 months,2,credit_card,1,Low,1,Good Loan,0,11.71,B,2,19.73,19842.30428,16000,0,353.58,409000001112,21-Dec-16,BBPS SETTLEMENT FOR DT 21,8.15,,946194.61,Northey,690,France,70810.60,1,1,1
1114,2011,4,RENT,1,Low,1,34000, 36 months,1,debt_consolidation,6,High,2,Good Loan,0,17.58,D,4,16.87,40274.1,34000,0,1222.03,409000001113,22-Dec-16,BBPS SETTLEMENT FOR DT 22,98.15,,946096.46,Paterson,731,Germany,106663.46,1,1,1
1115,2011,3,RENT,1,Low,1,16000, 60 months,2,credit_card,1,High,2,Good Loan,0,13.49,C,3,13.65,21579.78518,16000,0,368.08,409000001114,23-Dec-16,BBPS SETTLEMENT FOR DT 23,499.17,,945597.29,Maclean,608,France,175836.03,1,1,1
1116,2011,6,RENT,1,Low,1,11100, 36 months,1,debt_consolidation,6,High,2,Bad Loan,1,15.27,C,3,4.64,5091.02,3145.84,469.22,386.26,409000001115,30-Dec-16,BBPS SETTLEMENT DTD 30DEC,8.15,,945589.14,Howarde,479,Spain,85646.41,1,1,1
1117,2011,4,MORTGAGE,3,Low,1,21000, 60 months,2,home_improvement,7,High,2,Good Loan,0,13.49,C,3,11.34,23175.28,15597.21,0,483.1,409000001116,3-Jan-17,BBPS SETTLEMENT FOR DT 03,8.15,,945580.99,Teng,519,France,101485.72,1,1,1
1118,2011,2,RENT,1,Low,1,12000, 60 months,2,debt_consolidation,6,High,2,Bad Loan,1,19.42,E,5,6.15,13190.94,7120.04,20.8,314.07,409000001117,4-Jan-17,BBPS SETTLEMENT FOR DT 04,"1,758.02",,943822.97,Colman,731,France,191734.67,1,1,1
1119,2011,0.5,OWN,2,Low,1,5000, 36 months,1,credit_card,1,Low,1,Good Loan,0,11.71,B,2,11.4,5951.369931,5000,0,165.38,409000001118,16-Jan-17,BBPS SETTLEMENT FOR 16JAN,"4,320.41",,939502.56,Johnson,617,Spain,101839.77,1,1,1
1120,2011,7,OWN,2,Low,1,21000, 60 months,2,debt_consolidation,6,High,2,Bad Loan,1,17.27,D,4,15.8,17572.11,8278.98,1839.41,524.96,409000001119,17-Jan-17,BBPS SETTLEMENT DTD 17JAN,"3,875.00",,935627.56,Butcher,756,Spain,4888.91,1,1,1
1121,2011,0.5,RENT,1,Low,1,10625, 36 months,1,debt_consolidation,6,Low,1,Good Loan,0,11.71,B,2,15.12,12646.78502,10625,0,351.44,409000001120,18-Jan-17,BBPS SETTLEMENT DTD 18JAN,"1,387.44",,934240.12,Stanley,848,Germany,193132.98,1,1,1
1122,2011,1,RENT,1,Medium,2,18500, 36 months,1,debt_consolidation,6,Low,1,Bad Loan,1,7.51,A,1,9.02,5480.17,3749.41,856.08,575.56,409000001121,19-Jan-17,BBPS SETTLEMENT DTD 19JAN,"10,379.49",,923860.63,Jackson,809,France,193518.76,1,1,1
1123,2011,5,MORTGAGE,3,Low,1,3600, 36 months,1,debt_consolidation,6,Low,1,Good Loan,0,12.42,B,2,16.44,4329.60519,3600,0,120.3,409000001122,20-Jan-17,BBPS SETTLEMENT DTD 20JAN,"3,234.87",,920625.76,Hu,698,Germany,93982.02,1,1,1
1124,2011,6.05,RENT,1,Low,1,8500, 36 months,1,credit_card,1,High,2,Bad Loan,1,15.96,C,3,10.25,3937.28,2218.92,360.75,298.67,409000001123,23-Jan-17,BBPS SETTLEMENT DTD 21JAN,884.87,,919740.89,Hill,779,Germany,197000.92,1,1,1
1125,2011,5,MORTGAGE,3,Low,1,12000, 36 months,1,credit_card,1,Low,1,Good Loan,0,8.9,A,1,10.35,13581.88465,12000,0,381.04,409000001124,23-Jan-17,BBPS SETTLEMENT DTD 23JAN,47.44,,919693.45,Pan,606,Spain,106837.06,1,1,1
1126,2011,6,RENT,1,Low,1,11700, 36 months,1,credit_card,1,Low,1,Good Loan,0,11.71,B,2,22.48,13499.51,11700,0,386.99,409000001125,24-Jan-17,BBPS SETTLEMENT DTD 24JAN,190,,919503.45,Han,612,Germany,115161.28,1,1,1
1127,2011,2,RENT,1,Low,1,15000, 36 months,1,debt_consolidation,6,High,2,Good Loan,0,14.27,C,3,15.05,17450.36,15000,0,514.64,409000001126,27-Jan-17,BBPS SETTLEMENT DTD 27JAN,"15,009.49",,904493.96,Wilkie,663,Spain,196260.30,1,1,1
1128,2011,10,MORTGAGE,3,Medium,2,13000, 36 months,1,debt_consolidation,6,Low,1,Good Loan,0,9.91,B,2,14.96,14112.47,13000,0,418.93,409000001127,30-Jan-17,BBPS SETTLEMENT FOR DT 30,"41,386.19",,863107.77,Bray,549,Germany,96404.38,1,1,1
1129,2011,5,MORTGAGE,3,Low,1,9500, 36 months,1,debt_consolidation,6,Low,1,Bad Loan,1,12.69,B,2,18.95,7889.73,5629.47,565.15,318.68,409000001128,31-Jan-17,BBPS SETTLEMENT FOR DT 31,"2,232.44",,860875.33,Ann,675,France,97658.66,1,1,1
1130,2011,2,RENT,1,Medium,2,20000, 60 months,2,credit_card,1,High,2,Good Loan,0,16.77,D,4,13.5,23722.9,14562.26,0,494.59,409000001129,1-Feb-17,BBPS SETTLEMENT FOR DT 01,"4,642.19",,856233.14,Souter,669,France,49108.23,1,1,1
1131,2011,4,MORTGAGE,3,Low,1,1800, 60 months,2,other,4,High,2,Good Loan,0,14.27,C,3,20.9,2218.08,1668.56,0,42.14,409000001130,2-Feb-17,BBPS SETTLEMENT FOR DT 02,"2,442.44",,853790.70,Greco,571,Germany,195651.66,1,1,1
1132,2011,6,MORTGAGE,3,Low,1,20000, 36 months,1,home_improvement,7,High,2,Good Loan,0,13.49,C,3,19.86,24419.59056,20000,0,678.61,409000001131,3-Feb-17,BBPS SETTLEMENT FOR DT 03,"2,338.45",,851452.25,Mao,500,Spain,111698.00,1,1,1
1133,2011,5,RENT,1,Low,1,6000, 36 months,1,credit_card,1,Low,1,Good Loan,0,8.9,A,1,11.55,6857.795581,6000,0,190.52,409000001132,4-Feb-17,BBPS SETTLEMENT FOR DT 04,7.57,,851444.68,Anderson,628,France,171707.93,1,1,1
1134,2011,6,RENT,1,Low,1,13000, 36 months,1,debt_consolidation,6,High,2,Good Loan,0,17.27,D,4,20.61,16742.52288,13000,0,465.24,409000001133,6-Feb-17,BBPS SETTLEMENT FOR DT 06,"10,449.24",,840995.44,Ma,559,France,66721.98,1,1,1
1135,2011,4,RENT,1,Low,1,14400, 36 months,1,debt_consolidation,6,Low,1,Good Loan,0,6.62,A,1,25.1,15913.67901,14400,0,442.14,409000001134,7-Feb-17,BBPS SETTLEMENT FOR DT 07,"2,852.05",,838143.39,Black,769,France,57876.05,1,1,1
1136,2011,5,MORTGAGE,3,Low,1,5000, 36 months,1,debt_consolidation,6,Low,1,Good Loan,0,7.9,A,1,28.07,5503.57,5000,0,156.46,409000001135,8-Feb-17,BBPS SETTLEMENT FOR DT 08,"6,777.18",,831366.21,Medvedeva,733,Germany,177994.81,1,1,1
1137,2011,5,RENT,1,Medium,2,12000, 60 months,2,debt_consolidation,6,High,2,Bad Loan,1,18.25,D,4,6.27,9988.47,4459.15,1110.29,306.36,409000001136,9-Feb-17,BBPS SETTLEMENT FOR DT 09,2.1,,831364.11,Benson,750,France,105125.65,1,1,1
1138,2011,10,RENT,1,Low,1,25000, 36 months,1,debt_consolidation,6,Low,1,Good Loan,0,11.71,B,2,17.14,29760.12725,25000,0,826.9,409000001137,10-Feb-17,BBPS SETTLEMENT FOR DT 10,,0.90,831365.01,Duncan,583,France,17439.66,1,1,1
1139,2011,7,OWN,2,Low,1,21650, 60 months,2,debt_consolidation,6,High,2,Good Loan,0,19.03,E,5,17.19,29280.86,21650,0,561.98,409000001138,13-Feb-17,BBPS SETTLEMENT FOR DT 13,4.7,,831360.31,Onwudiwe,468,Germany,172668.39,1,1,1
1140,2011,10,MORTGAGE,3,Low,1,19500, 60 months,2,debt_consolidation,6,High,2,Good Loan,0,16.77,D,4,20.04,23903.44,19500,0,482.22,409000001139,15-Feb-17,BBPS SETTLEMENT FOR DT 15,"3,238.66",,828121.65,Mitchell,727,Spain,753.37,1,1,1
1141,2011,6.05,RENT,1,Low,1,5000, 36 months,1,other,4,Low,1,Bad Loan,1,7.51,A,1,14.14,3092.94,2492.53,143.86,155.56,409000001140,16-Feb-17,BBPS SETTLEMENT FOR DT 16,4.7,,828116.95,Ferrari,618,France,98686.40,1,1,1
1142,2011,10,RENT,1,Low,1,5200, 36 months,1,debt_consolidation,6,High,2,Good Loan,0,14.65,C,3,23.47,6455.908675,5200,0,179.37,409000001141,17-Feb-17,BBPS SETTLEMENT FOR DT 17,"14,823.01",,813293.94,Russo,617,France,107047.92,1,1,1
1143,2011,8,MORTGAGE,3,Low,1,6000, 36 months,1,debt_consolidation,6,High,2,Good Loan,0,13.49,C,3,23.86,6751.3,6000,0,203.59,409000001142,18-Feb-17,BBPS SETTLEMENT 18.02.201,302.48,,812991.46,Hazon,793,Spain,152153.74,1,1,1
1144,2011,10,RENT,1,Low,1,4000, 36 months,1,other,4,High,2,Bad Loan,1,18.64,E,5,12.94,2335.22,1387.62,149.72,145.9,409000001143,21-Feb-17,BBPS SETTLEMENT FOR DT 21,523.18,,812468.28,Henderson,630,France,34338.04,1,1,1
1145,2011,4,RENT,1,Low,1,15000, 36 months,1,debt_consolidation,6,Low,1,Bad Loan,1,12.69,B,2,18.77,13126.6,9487.75,750.28,503.18,409000001144,22-Feb-17,BBPS SETTLEMENT FOR DT 22,"3,201.71",,809266.57,Hardy,765,Germany,173878.87,1,1,1
1146,2011,2,RENT,1,Medium,2,8000, 36 months,1,credit_card,1,Low,1,Good Loan,0,11.71,B,2,2.07,9522.089934,8000,0,264.61,409000001145,23-Feb-17,BBPS SETTLEMENT FOR DT 23,"6,859.36",,802407.21,Piccio,546,France,159254.29,1,1,1
1147,2011,10,MORTGAGE,3,Low,1,16500, 36 months,1,credit_card,1,High,2,Bad Loan,1,17.27,D,4,7.97,17109.13,11018.19,1776.39,590.49,409000001146,24-Feb-17,BBPS SETTLEMENT FOR DT 24,"12,674.80",,789732.41,Dickson,614,Germany,54776.64,1,1,1
1148,2011,4,RENT,1,Low,1,11900, 60 months,2,vacation,11,Low,1,Good Loan,0,12.42,B,2,7.67,12385.52,11900,0,267.25,409000001147,27-Feb-17,BBPS SETTLEMENT FOR DT 27,"87,395.82",,702336.59,Holden,593,Germany,134594.99,1,1,1
1149,2011,6.05,MORTGAGE,3,Low,1,20000, 60 months,2,home_improvement,7,High,2,Good Loan,0,13.49,C,3,6.68,14232.74,9579.38,0,296.77,409000001148,28-Feb-17,BBPS SETTLEMENT FOR DT 28,"15,225.89",,687110.70,Hsieh,613,Spain,41724.72,1,1,1
1150,2011,6.05,OWN,2,Low,1,4000, 36 months,1,debt_consolidation,6,High,2,Bad Loan,1,15.27,C,3,12.62,1191.34,621.34,194,139.2,409000001149,1-Mar-17,BBPS SETTLEMENT FOR DT 01,"20,337.85",,666772.85,Doherty,655,France,110527.71,1,1,1
1151,2011,10,RENT,1,Low,1,12000, 36 months,1,debt_consolidation,6,Low,1,Good Loan,0,9.91,B,2,24.27,13917.4666,12000,0,386.7,409000001150,2-Mar-17,BBPS SETTLEMENT FOR DT 02,"21,616.66",,645156.19,Page,700,France,8996.79,1,1,1
1152,2011,10,MORTGAGE,3,Low,1,10200, 36 months,1,debt_consolidation,6,Low,1,Good Loan,0,6.03,A,1,10.1,11016.24,10200,0,310.45,409000001151,3-Mar-17,BBPS SETTLEMENT FOR DT 03,"8,082.01",,637074.18,Samuel,826,Spain,190200.53,1,1,1
1153,2011,6,RENT,1,Low,1,12000, 36 months,1,debt_consolidation,6,Low,1,Good Loan,0,11.71,B,2,19.73,14115.67012,12000,0,396.92,409000001152,4-Mar-17,BBPS SETTLEMENT 04032017,"12,695.55",,624378.63,Malloy,652,Germany,115333.43,1,1,1
1154,2011,3,RENT,1,Low,1,3000, 36 months,1,credit_card,1,Low,1,Bad Loan,1,11.71,B,2,9.75,2232.2,1558.1,198.18,99.23,409000001153,6-Mar-17,BBPS SETTLEMENT 06032017,"68,860.48",,555518.15,Fitts,755,Germany,143619.52,1,1,1
1155,2011,10,MORTGAGE,3,Medium,2,3500, 36 months,1,medical,9,Low,1,Bad Loan,1,10.65,B,2,16.49,566.2,335.85,110.68,114.01,409000001154,7-Mar-17,BBPS SETTLEMENT 07032017,"73,209.78",,482308.37,Iadanza,538,Spain,58467.08,1,1,1
1156,2011,10,RENT,1,Low,1,11000, 36 months,1,credit_card,1,Low,1,Good Loan,0,6.62,A,1,18.78,11966.66,11000,0,337.75,409000001155,9-Mar-17,TRF FROM  Indiaforensic SERVICES,,500000.00,982308.37,Wu,729,France,12128.69,1,1,1
1157,2011,6,OWN,2,Low,1,17000, 36 months,1,debt_consolidation,6,Low,1,Good Loan,0,12.42,B,2,17.91,18432.33,17000,0,568.06,409000001156,9-Mar-17,BBPS SETTLEMENT  OX01 09.,"35,996.01",,946312.36,Yefimova,615,France,49872.33,1,1,1
1158,2011,10,OWN,2,Low,1,15000, 36 months,1,credit_card,1,High,2,Good Loan,0,15.96,C,3,19.52,18966.05174,15000,0,527.06,409000001157,9-Mar-17,BBPS SETTLEMENT FOR OX01,"73,844.12",,872468.24,Pan,700,Spain,139735.54,1,1,1
1159,2011,7,RENT,1,Low,1,12000, 36 months,1,credit_card,1,Low,1,Good Loan,0,7.51,A,1,24.16,13437.12357,12000,0,373.33,409000001158,10-Mar-17,BBPS SETTLEMENT 10032017,"71,365.62",,801102.62,Ts'ui,434,Germany,60891.80,1,1,1
1160,2011,0.5,RENT,1,Low,1,29100, 60 months,2,debt_consolidation,6,High,2,Good Loan,0,23.91,G,7,16.41,40044.23,29100.01,0,835.63,409000001159,13-Mar-17,BBPS SETTLEMENT 13032017,"108,914.09",,692188.53,Liang,729,Spain,100862.54,1,1,1
1161,2011,6.05,MORTGAGE,3,Low,1,5000, 36 months,1,home_improvement,7,High,2,Good Loan,0,14.65,C,3,19.57,6207.724668,5000,0,172.48,409000001160,14-Mar-17,BBPS SETTLEMENT FOR DT 14,"1,059.13",,691129.40,Tsao,513,France,76640.29,1,1,1
1162,2011,10,MORTGAGE,3,Low,1,25850, 36 months,1,credit_card,1,Low,1,Good Loan,0,7.9,A,1,8.86,29117.46284,25850,0,808.86,409000001161,15-Mar-17,BBPS SETTLEMENT 15032017,"83,102.87",,608026.53,Abramov,755,France,126013.58,1,1,1
1163,2011,6,OWN,2,Medium,2,16400, 36 months,1,credit_card,1,High,2,Good Loan,0,15.96,C,3,12.71,20734.26678,16400,0,576.26,409000001162,15-Mar-17,TRF FROM  Indiaforensic SERVICES,,67000.00,675026.53,Millar,615,France,87347.82,1,1,1
1164,2011,2,MORTGAGE,3,Low,1,12000, 36 months,1,credit_card,1,Low,1,Good Loan,0,12.69,B,2,14.97,14063.98,12000,0,402.54,409000001163,16-Mar-17,BBPS SETTLEMENT 16032017,"89,537.25",,585489.28,Demuth,747,Germany,77370.37,1,1,1
1165,2011,9,MORTGAGE,3,Low,1,9600, 36 months,1,credit_card,1,High,2,Good Loan,0,15.96,C,3,18.69,12138.15863,9600,0,337.32,409000001164,16-Mar-17,TRF FRM  Indiaforensic SERVICES,,117000.00,702489.28,Genovese,850,France,62722.44,1,1,1
1166,2011,0.5,RENT,1,Low,1,8000, 36 months,1,debt_consolidation,6,Low,1,Good Loan,0,7.51,A,1,19.46,8957.470518,8000,0,248.89,409000001165,17-Mar-17,BBPS SETTLEMENT 17032017,"117,674.17",,584815.11,Lawless,712,Germany,196257.68,1,1,1
1167,2011,10,RENT,1,Low,1,17500, 60 months,2,debt_consolidation,6,Low,1,Bad Loan,1,10.65,B,2,22.01,11691.41,6726.93,1500.26,377.45,409000001166,17-Mar-17,TRF FRM  Indiaforensic SERVICES,,150000.00,734815.11,Brooks,622,Germany,81723.80,1,1,1
1168,2011,1,RENT,1,Low,1,16000, 60 months,2,debt_consolidation,6,High,2,Good Loan,0,19.91,E,5,10.71,11160.18,10475,0,277,409000001167,18-Mar-17,BBPS OX01 SETTLEMENT 1803,"93,646.00",,641169.11,Ignatyeva,548,France,31299.71,1,1,1
1169,2011,7,MORTGAGE,3,Medium,2,35000, 60 months,2,other,4,High,2,Bad Loan,1,19.91,E,5,16.33,5156.46,2053.76,0,573.18,409000001168,20-Mar-17,TRF FRM  Indiaforensic SERVICES,,150000.00,791169.11,Balmain,607,France,63495.86,1,1,1
1170,2011,5,RENT,1,Low,1,4000, 36 months,1,credit_card,1,Low,1,Good Loan,0,7.9,A,1,17.33,4443.31,4000,0,125.17,409000001169,20-Mar-17,BBPS SETTLEMENT FOR DT 20,"87,337.96",,703831.15,Millar,653,France,166520.96,1,1,1
1171,2011,1,RENT,1,Low,1,1500, 36 months,1,major_purchase,8,High,2,Good Loan,0,14.27,C,3,9.45,1850.761717,1500,0,51.47,409000001170,21-Mar-17,BBPS SETTLEMENT 21032017,"183,235.55",,520595.60,Ecuyer,699,Spain,150242.44,1,1,1
1172,2011,1,RENT,1,Low,1,14000, 60 months,2,debt_consolidation,6,Low,1,Good Loan,0,8.9,A,1,14.48,13888.26,10662.59,0,289.94,409000001171,21-Mar-17,T FRM  Indiaforensic SERVICES IN,,200000.00,720595.60,Parkhill,693,Germany,27345.18,1,1,1
1173,2011,2,RENT,1,Low,1,8000, 36 months,1,debt_consolidation,6,Low,1,Good Loan,0,12.42,B,2,13.28,9225.07,8000,0,267.33,409000001172,22-Mar-17,TRF FROM  Indiaforensic SERVICES,,100000.00,820595.60,Li Fonti,647,Germany,87000.39,1,1,1
1174,2011,5,RENT,1,Low,1,8000, 36 months,1,debt_consolidation,6,Low,1,Good Loan,0,10.65,B,2,16.83,9380.007726,8000,0,260.59,409000001173,22-Mar-17,BBPS OX01 SETTLEMENT 22.0,"78,583.40",,742012.20,Beneventi,478,Spain,44912.70,1,1,1
1175,2011,6,RENT,1,Low,1,25000, 60 months,2,vacation,11,High,2,Good Loan,0,13.49,C,3,3.65,19972,16300,0,374.98,409000001174,23-Mar-17,TRF FRM  Indiaforensic SERVICES,,100000.00,842012.20,Despeissis,705,Spain,179978.68,1,1,1
1176,2011,10,MORTGAGE,3,Low,1,4000, 36 months,1,home_improvement,7,Low,1,Good Loan,0,8.9,A,1,22.63,4384.6,4000,0,127.02,409000001175,23-Mar-17,BBPS OX01 SETTLEMENT 23.0,"146,774.90",,695237.30,Atkins,719,Spain,145759.70,1,1,1
1177,2011,6.05,RENT,1,Low,1,20400, 60 months,2,debt_consolidation,6,Low,1,Good Loan,0,11.71,B,2,10.94,21627.7,15311.79,0,450.81,409000001176,24-Mar-17,BBPS XO01 SETTLEMENT 24.0,"81,047.31",,614189.99,Williams,726,France,14121.61,1,1,1
1178,2011,5,RENT,1,Low,1,10000, 36 months,1,credit_card,1,Low,1,Good Loan,0,11.71,B,2,14.13,10611.41,10000,0,330.76,409000001177,24-Mar-17,TRF FROM  Indiaforensic SERVICES,,200000.00,814189.99,Wright,626,France,66232.23,1,1,1
1179,2011,2,RENT,1,Low,1,10000, 36 months,1,debt_consolidation,6,Low,1,Good Loan,0,12.42,B,2,23.07,12026.07859,10000,0,334.16,409000001178,26-Mar-17,BBPS SETTLEMENT 26032017,"169,846.16",,644343.83,Hancock,552,France,190296.76,1,1,1
1180,2011,1,RENT,1,Low,1,6000, 36 months,1,credit_card,1,Low,1,Good Loan,0,8.9,A,1,21.47,6857.261151,6000,0,190.52,409000001179,27-Mar-17,TRF FROM  Indiaforensic SERVICES,,100000.00,744343.83,Hsieh,807,Germany,172782.69,1,1,1
1181,2011,0.5,MORTGAGE,3,Medium,2,35000, 60 months,2,home_improvement,7,High,2,Good Loan,0,20.89,F,6,5.32,45328.14,24841.1,0,944.71,409000001180,27-Mar-17,BBPS SETTLEMENT DTD 27MAR,"27,509.12",,716834.71,Wilkins,621,France,99128.13,1,1,1
1182,2011,10,MORTGAGE,3,Low,1,18000, 36 months,1,debt_consolidation,6,Low,1,Good Loan,0,7.9,A,1,15.05,20265.9988,18000,0,563.23,409000001181,28-Mar-17,TRF FRM  Indiaforensic SERVICES,,200000.00,916834.71,Longo,651,Germany,178341.33,1,1,1
1183,2011,2,RENT,1,Low,1,3300, 36 months,1,debt_consolidation,6,Low,1,Good Loan,0,11.71,B,2,7.21,3774.04,3300,0,109.16,409000001182,28-Mar-17,TRF FRM  Indiaforensic SERVICES,,400000.00,1316834.71,Mancini,673,France,146992.24,1,1,1
1184,2011,3,RENT,1,Low,1,15000, 36 months,1,debt_consolidation,6,High,2,Bad Loan,1,15.27,C,3,8.25,1852.91,664.53,811.91,521.97,409000001183,28-Mar-17,BBPS SETTLEMENT 28032017,"391,248.80",,925585.91,Madukaego,652,France,151314.98,1,1,1
1185,2011,10,MORTGAGE,3,Medium,2,6000, 36 months,1,other,4,Low,1,Good Loan,0,9.91,B,2,18.77,6958.959728,6000,0,193.35,409000001184,29-Mar-17,BBPS SETTLEMENT 29032017,"149,362.11",,776223.80,Winter-Irving,584,Germany,92915.84,1,1,1
1186,2011,3,MORTGAGE,3,Low,1,35000, 60 months,2,debt_consolidation,6,High,2,Bad Loan,1,19.42,E,5,19.17,37094.11,17517.39,3216.34,916.03,409000001185,30-Mar-17,BBPS SETTLEMENT 30032017,"192,834.72",,583389.08,Stewart,756,France,58974.00,1,1,1
1187,2011,2,RENT,1,Low,1,20000, 60 months,2,debt_consolidation,6,High,2,Good Loan,0,18.25,D,4,20.83,16738.57447,12250,0,312.74,409000001186,30-Mar-17,TRF FRM  Indiaforensic SERVICES,,100000.00,683389.08,Grant,670,France,174627.06,1,1,1
1188,2011,8,MORTGAGE,3,Low,1,12200, 60 months,2,debt_consolidation,6,High,2,Bad Loan,1,14.27,C,3,13.13,7027,3435.2,990.25,242.28,409000001187,31-Mar-17,BBPS SETTLEMENT FOR DT 31,"145,409.67",,537979.41,Brennan,765,France,79579.94,1,1,1
1189,2011,6,RENT,1,Low,1,4200, 36 months,1,moving,10,High,2,Good Loan,0,13.49,C,3,8.74,4338.31,4200,0,142.51,409000001188,31-Mar-17,FDRL/INTERNAL FUND TRANSFE,,150000.00,687979.41,She,528,France,50771.16,1,1,1
1190,2011,10,RENT,1,Low,1,25000, 60 months,2,credit_card,1,High,2,Bad Loan,1,16.77,D,4,12.62,14097.34,6696.67,1485.34,420.4,409000001189,3-Apr-17,TRF FROM  Indiaforensic SERVICES,,200000.00,887979.41,Murray,701,France,153537.55,1,1,1
1191,2011,3,OWN,2,Low,1,22575, 60 months,2,debt_consolidation,6,High,2,Good Loan,0,21.28,F,6,12.99,20539.91827,13900,0,378.24,409000001190,3-Apr-17,BBPS SETTLEMENT 03042017,"348,756.64",,539222.77,Rischbieth,797,France,132975.39,1,1,1
1192,2011,4,MORTGAGE,3,Low,1,20000, 36 months,1,credit_card,1,High,2,Good Loan,0,14.65,C,3,18.17,24831.3013,20000,0,689.89,409000001191,3-Apr-17,TRF FRM  Indiaforensic SERVICES,,100000.00,639222.77,Lung,639,Germany,85208.93,1,1,1
1193,2011,3,RENT,1,Low,1,18000, 60 months,2,debt_consolidation,6,High,2,Good Loan,0,15.27,C,3,9.6,19005.03441,13750,0,329.07,409000001192,4-Apr-17,BBPS SETTLEMENT 04042017,"58,178.96",,581043.81,Otutodilichukwu,785,Spain,170214.82,1,1,1
1194,2011,10,MORTGAGE,3,Low,1,10000, 36 months,1,major_purchase,8,Low,1,Good Loan,0,12.42,B,2,12.31,12026.67813,10000,0,334.16,409000001193,4-Apr-17,TRF FRM  Indiaforensic SERVICES,,100000.00,681043.81,Thomas,363,Spain,100615.14,1,1,1
1195,2011,8,MORTGAGE,3,Low,1,12000, 36 months,1,credit_card,1,Low,1,Good Loan,0,9.91,B,2,16.48,13852.70926,12000,0,386.7,409000001194,5-Apr-17,BBPS OX01 SETTLEMENT 05.0,"72,560.62",,608483.19,Fiorentini,764,France,186105.99,1,1,1
1196,2011,8,OWN,2,Low,1,8000, 36 months,1,debt_consolidation,6,Low,1,Good Loan,0,10.65,B,2,20.53,9413.761251,8000,0,260.59,409000001195,5-Apr-17,TRF FRM  Indiaforensic SERVICES,,50000.00,658483.19,Hughes,676,France,55119.53,1,1,1
1197,2011,4,RENT,1,Low,1,7175, 36 months,1,small_business,3,Low,1,Bad Loan,1,7.9,A,1,7.9,3615.59,2782.12,251.69,224.51,409000001196,6-Apr-17,BBPS SETTLEMENT FOR DT 06,"92,843.96",,565639.23,Whitworth,718,Germany,28760.99,1,1,1
1198,2011,5,RENT,1,Low,1,15000, 36 months,1,credit_card,1,Low,1,Good Loan,0,12.69,B,2,6.55,18105.22123,15000,0,503.18,409000001197,6-Apr-17,TRF FRM  Indiaforensic SERVICES,,100000.00,665639.23,McIntosh,590,Spain,171021.44,1,1,1
1199,2011,4,MORTGAGE,3,Low,1,22500, 60 months,2,other,4,Low,1,Good Loan,0,12.69,B,2,11.04,24378.8,16784.89,0,508.39,409000001198,7-Apr-17,BBPS OX01 SETTLEMENT 07.0,"77,750.54",,587888.69,Ayers,584,France,176678.72,1,1,1
1200,2011,10,MORTGAGE,3,Medium,2,35000, 60 months,2,small_business,3,High,2,Good Loan,0,14.27,C,3,22.5,37422.94,35000,0,819.3,409000001199,7-Apr-17,TRF FRM  Indiaforensic SERVICES,,50000.00,637888.69,Trentino,645,France,28667.56,1,1,1
1201,2011,10,RENT,1,Low,1,12000, 36 months,1,debt_consolidation,6,Low,1,Good Loan,0,12.69,B,2,9.73,14473.98187,12000,0,402.54,409000001200,7-Apr-17,TRF FROM  Indiaforensic SERVICES,,500000.00,1137888.69,Boyd,772,Germany,197238.03,1,1,1
1202,2011,10,MORTGAGE,3,Medium,2,35000, 60 months,2,debt_consolidation,6,High,2,Good Loan,0,18.64,E,5,16.4,49153.11941,35000,0,901.01,409000001201,10-Apr-17,BBPS OX01 SETTLEMENT 10.0,"70,821.90",,1067066.79,McMasters,399,Germany,139994.68,1,1,1
1203,2011,6,OWN,2,Low,1,18250, 60 months,2,debt_consolidation,6,High,2,Good Loan,0,23.52,G,7,19.2,25468.19,13146.6,0,519.95,409000001202,11-Apr-17,BBPS OX01 SETTLEMENT 11.0,"105,418.35",,961648.44,Alekseyeva,529,France,151169.83,1,1,1
1204,2011,4,MORTGAGE,3,Low,1,20000, 60 months,2,other,4,High,2,Good Loan,0,18.64,E,5,9.91,24303.47,19999.99,0,514.86,409000001203,11-Apr-17,WAIVE SWITCHING FEES 31.0,,665.49,962313.93,Miller,463,France,118113.64,1,1,1
1205,2011,3,OWN,2,Medium,2,15000, 36 months,1,home_improvement,7,Low,1,Good Loan,0,6.03,A,1,10.94,16434.50928,15000,0,456.54,409000001204,12-Apr-17,BBPS SETTLEMENT 12042017,"127,317.40",,834996.53,Baranova,630,France,34453.17,1,1,1
1206,2011,5,RENT,1,Low,1,12500, 36 months,1,credit_card,1,Low,1,Good Loan,0,11.71,B,2,5.86,14485.39904,12500,0,413.45,409000001205,13-Apr-17,BBPS SETTLEMENT DTD 13APR,"57,483.14",,777513.39,Mitchell,780,France,64872.33,1,1,1
1207,2011,10,RENT,1,Low,1,15000, 36 months,1,credit_card,1,High,2,Good Loan,0,13.49,C,3,7.8,18407.74638,15000,0,508.96,409000001206,15-Apr-17,BBPS SETTLEMENT FOR DT 15,"103,667.55",,673845.84,Yobachi,584,Spain,10956.82,1,1,1
1208,2011,0.5,RENT,1,Low,1,16750, 36 months,1,debt_consolidation,6,High,2,Good Loan,0,17.58,D,4,15.68,19674.42,16750,0,602.03,409000001207,17-Apr-17,BBPS OX01 SETTLEMENT 17.0,"102,737.16",,571108.68,Huang,752,Germany,36885.85,1,1,1
1209,2011,9,RENT,1,Low,1,8000, 36 months,1,debt_consolidation,6,Low,1,Good Loan,0,7.51,A,1,15.12,8903.642641,8000,0,248.89,409000001208,17-Apr-17,TRF FRM  Indiaforensic SERVICES,,500000.00,1071108.68,Genovese,697,France,168053.40,1,1,1
1210,2011,3,OWN,2,Low,1,10400, 36 months,1,credit_card,1,Low,1,Good Loan,0,11.71,B,2,13.06,12401.31754,10400,0,344,409000001209,18-Apr-17,BBPS OX01 SETTLEMENT 18.0,"75,758.03",,995350.65,Sorokina,850,France,155227.00,1,1,1
1211,2011,5,RENT,1,Low,1,6000, 36 months,1,major_purchase,8,Low,1,Good Loan,0,12.42,B,2,16.66,7205.227251,6000,0,200.5,409000001210,19-Apr-17,BBPS OX01 SETTLEMENT 19.0,"145,936.93",,849413.72,Gray,711,France,38409.79,1,1,1
1212,2011,4,RENT,1,Low,1,7000, 36 months,1,debt_consolidation,6,Low,1,Good Loan,0,8.9,A,1,7.07,8000.587869,7000,0,222.28,409000001211,20-Apr-17,BBPS OX01 SETTLEMENT 20.0,"47,216.93",,802196.79,Ervin,452,France,75279.39,1,1,1
1213,2011,2,RENT,1,Low,1,10000, 36 months,1,debt_consolidation,6,High,2,Good Loan,0,15.96,C,3,24.71,12597.75931,10000,0,351.38,409000001212,21-Apr-17,BBPS OX01 SETTLEMENT 21.0,"51,735.72",,750461.07,Vance,610,Spain,158302.59,1,1,1
1214,2011,6,MORTGAGE,3,High,3,12000, 36 months,1,medical,9,Low,1,Good Loan,0,6.03,A,1,6.45,13147.59205,12000,0,365.23,409000001213,24-Apr-17,BBPS SETTLMENT OX01 24.04,"89,131.66",,661329.41,Noble,694,France,11525.72,1,1,1
1215,2011,9,MORTGAGE,3,Low,1,12000, 60 months,2,credit_card,1,High,2,Good Loan,0,15.27,C,3,10.37,15016.97,12000,0,287.19,409000001214,25-Apr-17,BBPS SETTLEMENT FOR DT 25,"118,834.97",,542494.44,Milanesi,579,Spain,94993.04,1,1,1
1216,2011,5,MORTGAGE,3,Low,1,17000, 60 months,2,home_improvement,7,High,2,Bad Loan,1,20.89,F,6,10.19,1950.3,496.37,576.33,458.86,409000001215,26-Apr-17,TRF FROM  Indiaforensic SERVICES,,500000.00,1042494.44,Parkin,745,Spain,173912.29,1,1,1
1217,2011,1,RENT,1,Low,1,12950, 60 months,2,house,12,Low,1,Good Loan,0,10.65,B,2,3.46,13646.93,10009.29,0,279.31,409000001216,26-Apr-17,BBPS SETTLEMENT FOR DT 26,"107,909.86",,934584.58,Cremonesi,572,France,41139.05,1,1,1
1218,2011,7,MORTGAGE,3,Low,1,16000, 36 months,1,debt_consolidation,6,High,2,Bad Loan,1,14.65,C,3,4.99,9273.78,5731.93,589.61,551.91,409000001217,28-Apr-17,BBPS SETTLEMENT 28042017,"78,121.88",,856462.70,Burns,505,Germany,58019.95,1,1,1
1219,2011,1,RENT,1,Low,1,10000, 60 months,2,debt_consolidation,6,High,2,Bad Loan,1,15.96,C,3,18.84,4858.86,2484,0,242.97,409000001218,29-Apr-17,BBPS SETTLEMENT 29042017,"73,483.43",,782979.27,Docherty,706,France,164128.41,1,1,1
1220,2011,10,OWN,2,Low,1,8000, 36 months,1,credit_card,1,Low,1,Bad Loan,1,6.62,A,1,12.33,6133,5378.64,0,245.63,409000001219,1-May-17,BBPS SETTLEMENT 01052017,"36,802.24",,746177.03,Ugonna,693,Germany,46998.13,1,1,1
1221,2011,7,RENT,1,Medium,2,24000, 60 months,2,debt_consolidation,6,High,2,Good Loan,0,20.3,E,5,13.28,32195.85,24000,0,639.87,409000001220,2-May-17,BBPS SETTLEMENT 02052017,"27,621.17",,718555.86,L?,725,Germany,177279.41,1,1,1
1222,2011,2,RENT,1,Low,1,7700, 36 months,1,debt_consolidation,6,Low,1,Good Loan,0,12.42,B,2,13.96,8742.73,7700,0,257.3,409000001221,3-May-17,BBPS SETTLEMENT 03052017,"36,178.03",,682377.83,Bevan,791,France,75832.53,1,1,1
1223,2011,7,RENT,1,Low,1,15000, 36 months,1,credit_card,1,Low,1,Good Loan,0,7.9,A,1,17.36,16831.62481,15000,0,469.36,409000001222,4-May-17,BBPS SETTLEMENT 04052017,"44,830.92",,637546.91,Hsia,536,France,61094.53,1,1,1
1224,2011,10,OWN,2,Medium,2,30000, 60 months,2,credit_card,1,High,2,Bad Loan,1,18.64,E,5,9.17,24439.43,9986.78,2815.31,772.29,409000001223,5-May-17,BBPS SETTLEMENT 05052017,"54,274.88",,583272.03,O'Neill,699,Spain,30117.44,1,1,1
1225,2011,6,MORTGAGE,3,Low,1,12000, 36 months,1,credit_card,1,Low,1,Good Loan,0,11.71,B,2,10.15,14285.56751,12000,0,396.92,409000001224,5-May-17,FDRL/INTERNAL FUND TRANSFE,,100000.00,683272.03,Johnstone,500,Spain,179227.12,1,1,1
1226,2011,10,MORTGAGE,3,Low,1,1200, 36 months,1,home_improvement,7,Low,1,Good Loan,0,7.9,A,1,29.26,1351.436335,1200,0,37.55,409000001225,6-May-17,BBPS SETTLEMENT 06052017,"56,535.19",,626736.84,Pham,707,Spain,52110.45,1,1,1
1227,2011,4,RENT,1,Low,1,9000, 36 months,1,debt_consolidation,6,Low,1,Good Loan,0,7.51,A,1,11.34,10077.43529,9000,0,280,409000001226,8-May-17,BBPS SETTLEMENT FOR DT 08,"76,276.17",,550460.67,Bergamaschi,531,Germany,75248.75,1,1,1
1228,2011,10,RENT,1,Low,1,12000, 60 months,2,debt_consolidation,6,High,2,Good Loan,0,13.49,C,3,12.62,14929.98233,12000,0,276.06,409000001227,8-May-17,FDRL/INTERNAL FUND TRANSFE,,100000.00,650460.67,Murphy,557,France,184317.74,1,1,1
1229,2011,6.05,RENT,1,Low,1,5000, 36 months,1,debt_consolidation,6,Low,1,Good Loan,0,7.9,A,1,12.64,5631.472383,5000,0,156.46,409000001228,9-May-17,BBPS SETTLEMENT 09052017,"92,354.75",,558105.92,Osinachi,659,France,158553.10,1,1,1
1230,2011,4,MORTGAGE,3,Low,1,10400, 36 months,1,debt_consolidation,6,High,2,Good Loan,0,14.27,C,3,21.87,12779.73952,10400,0,356.82,409000001229,9-May-17,BBPS OX01 SETTLEMENT 20.0,"60,288.54",,497817.38,Muravyov,575,Spain,95686.42,1,1,1
1231,2011,10,MORTGAGE,3,Low,1,30000, 60 months,2,home_improvement,7,Low,1,Good Loan,0,9.91,B,2,1.07,31167.63,23337.57,0,636.09,409000001230,9-May-17,REV BBPS OX01 SETTLEMENT,,47216.93,545034.31,Igwebuike,775,Germany,71682.54,1,1,1
1232,2011,5,RENT,1,Medium,2,7200, 60 months,2,debt_consolidation,6,High,2,Good Loan,0,17.27,D,4,10.53,8795.85,5369.22,0,179.99,409000001231,10-May-17,FDRL/INTERNAL FUND TRANSFE,,100000.00,645034.31,Zack,772,Spain,1790.48,1,1,1
1233,2011,10,MORTGAGE,3,Low,1,3500, 36 months,1,small_business,3,Low,1,Good Loan,0,10.65,B,2,12.4,3776.39,3500,0,114.01,409000001232,10-May-17,FDRL/INTERNAL FUND TRANSFE,,50000.00,695034.31,Crawford,587,Germany,139431.00,1,1,1
1234,2011,4,RENT,1,Low,1,19500, 60 months,2,debt_consolidation,6,High,2,Good Loan,0,18.25,D,4,17.56,24360.91,14476.41,0,497.83,409000001233,10-May-17,FDRL/INTERNAL FUND TRANSFE,,100000.00,795034.31,Chidiegwu,667,Germany,118358.54,1,1,1
1235,2011,4,RENT,1,Low,1,6350, 60 months,2,car,2,Low,1,Good Loan,0,11.71,B,2,4.71,6862.91,4885.15,0,140.33,409000001234,10-May-17,BBPS SETTLEMENT 10052017,"93,277.36",,701756.95,Lucchesi,771,France,130827.88,1,1,1
1236,2011,1,RENT,1,Low,1,15000, 36 months,1,debt_consolidation,6,Low,1,Bad Loan,1,12.42,B,2,11.2,13198.91,5180.49,6183.34,501.23,409000001235,11-May-17,BBPS SETTLEMENT 11052017,"53,444.53",,648312.42,Pan,523,Germany,119404.63,1,1,1
1237,2011,10,MORTGAGE,3,Low,1,10000, 36 months,1,debt_consolidation,6,Low,1,Good Loan,0,6.03,A,1,10.66,10794.36009,10000,0,304.36,409000001236,12-May-17,BBPS SETTLEMENT 12052017,"93,913.00",,554399.42,Trevisani,662,Germany,162703.00,1,1,1
1238,2011,10,RENT,1,Low,1,8400, 36 months,1,debt_consolidation,6,Low,1,Bad Loan,1,7.51,A,1,20.75,1052.85,628.48,271.02,261.34,409000001237,12-May-17,FDRL/INTERNAL FUND TRANSFE,,100000.00,654399.42,Yudin,717,France,172665.21,1,1,1
1239,2011,4,RENT,1,Low,1,12000, 36 months,1,debt_consolidation,6,Low,1,Good Loan,0,9.91,B,2,4.84,13917.60246,12000,0,386.7,409000001238,15-May-17,BBPS SETTLEMENT 15052017,"171,720.19",,482679.23,Wade,746,France,170142.09,1,1,1
1240,2011,0.5,MORTGAGE,3,Low,1,22750, 60 months,2,debt_consolidation,6,High,2,Bad Loan,1,20.3,E,5,19.31,15201.76,5527.65,2479.33,606.54,409000001239,15-May-17,FDRL/INTERNAL FUND TRANSFE,,200000.00,682679.23,Chung,569,France,73977.23,1,1,1
1241,2011,8,OWN,2,Low,1,20000, 60 months,2,debt_consolidation,6,High,2,Good Loan,0,20.3,E,5,11.32,30674.37215,20000,0,533.23,409000001240,16-May-17,BBPS SETTLEMENT 16052017,"195,767.92",,486911.31,Septimus,579,France,60906.12,1,1,1
1242,2011,10,MORTGAGE,3,Low,1,8875, 36 months,1,debt_consolidation,6,Low,1,Good Loan,0,8.9,A,1,28.84,10041.14323,8875,0,281.81,409000001241,16-May-17,FDRL/INTERNAL FUND TRANSFE,,200000.00,686911.31,Hargraves,519,France,194867.27,1,1,1
1243,2011,0.5,RENT,1,Low,1,5000, 60 months,2,major_purchase,8,High,2,Bad Loan,1,14.27,C,3,12.85,1418.37,605.5,252.17,117.05,409000001242,17-May-17,BBPS SETTLEMENT 17052017,"106,620.67",,580290.64,Chukwukadibia,696,Germany,193716.56,1,1,1
1244,2011,10,OWN,2,Low,1,11200, 36 months,1,debt_consolidation,6,Low,1,Good Loan,0,6.62,A,1,18.64,11380.45,11200,0,343.89,409000001243,18-May-17,FDRL/INTERNAL FUND TRANSFE,,200000.00,780290.64,Sidorov,693,Germany,14633.35,1,1,1
1245,2011,0.5,RENT,1,Low,1,4000, 36 months,1,other,4,High,2,Good Loan,0,13.49,C,3,12.79,4338,4000,0,135.73,409000001244,18-May-17,BBPS SETTLEMENT 18052017,"131,020.40",,649270.24,Bunton,587,Germany,31730.32,1,1,1
1246,2011,5,RENT,1,Low,1,15000, 36 months,1,debt_consolidation,6,Low,1,Good Loan,0,12.69,B,2,7.97,18109.14826,15000,0,503.18,409000001245,19-May-17,BBPS SETTLEMENT 19052017,"83,209.48",,566060.76,Cameron,626,France,20063.63,1,1,1
1247,2011,8,MORTGAGE,3,Low,1,14750, 60 months,2,debt_consolidation,6,High,2,Good Loan,0,16.77,D,4,17.32,17482.74,10733.15,0,364.76,409000001246,19-May-17,FDRL/INTERNAL FUND TRANSFE,,50000.00,616060.76,Kung,666,France,99792.82,1,1,1
1248,2011,10,OWN,2,Medium,2,15000, 36 months,1,house,12,Low,1,Good Loan,0,7.9,A,1,10.64,16894.90271,15000,0,469.36,409000001247,20-May-17,BBPS SETTLEMENT 20052017,"97,156.51",,518904.25,Hay,512,France,37654.31,1,1,1
1249,2011,5,RENT,1,Low,1,2500, 36 months,1,debt_consolidation,6,Low,1,Good Loan,0,12.69,B,2,10.61,2793.58,2500,0,83.87,409000001248,22-May-17,FDRL/INTERNAL FUND TRANSFE,,100000.00,618904.25,Conti,689,Spain,192449.02,1,1,1
1250,2011,3,RENT,1,Low,1,13475, 60 months,2,debt_consolidation,6,Low,1,Good Loan,0,8.9,A,1,27.27,13643.23,10515.88,0,279.07,409000001249,22-May-17,BBPS SETTLEMENT 22052017,"56,789.04",,562115.21,Sims,803,France,181208.47,1,1,1
1251,2011,10,OWN,2,Low,1,14000, 60 months,2,debt_consolidation,6,High,2,Bad Loan,1,13.49,C,3,13.68,12560.73,7994.65,18.72,322.07,409000001250,23-May-17,BBPS SETTLEMENT 23052017,"75,945.44",,486169.77,Carter,548,Germany,155165.61,1,1,1
1252,2011,10,RENT,1,Low,1,6625, 36 months,1,other,4,Low,1,Good Loan,0,6.03,A,1,20.29,7258.571779,6625,0,201.64,409000001251,24-May-17,FDRL/INTERNAL FUND TRANSFE,,200000.00,686169.77,McGregor,588,Germany,121504.18,1,1,1
1253,2011,2,RENT,1,Low,1,10000, 36 months,1,debt_consolidation,6,Low,1,Good Loan,0,6.62,A,1,24.24,11051.33578,10000,0,307.04,409000001252,24-May-17,BBPS SETTLEMENT 24052017,"147,938.81",,538230.96,Lo,693,France,61569.07,1,1,1
1254,2011,9,RENT,1,Low,1,12000, 60 months,2,debt_consolidation,6,High,2,Good Loan,0,19.03,E,5,9.01,16497.61833,12000,0,311.49,409000001253,25-May-17,FDRL/INTERNAL FUND TRANSFE,,200000.00,738230.96,Chu,499,Germany,123269.71,1,1,1
1255,2011,4,RENT,1,Low,1,20000, 60 months,2,debt_consolidation,6,High,2,Good Loan,0,18.64,E,5,9.31,24735.87,14399.59,0,514.86,409000001254,25-May-17,FDRL/INTERNAL FUND TRANSFE,,200000.00,938230.96,Dumetolisa,628,France,31272.14,1,1,1
1256,2011,6,RENT,1,Low,1,14000, 36 months,1,credit_card,1,High,2,Good Loan,0,14.65,C,3,5.55,17382.32105,14000,0,482.92,409000001255,25-May-17,BBPS SETTLEMENT 25052017,"181,189.40",,757041.56,Peng,624,Spain,62825.03,1,1,1
1257,2011,3,MORTGAGE,3,Low,1,35000, 36 months,1,debt_consolidation,6,Low,1,Good Loan,0,8.9,A,1,2.47,39480.03,35000,0,1111.37,409000001256,26-May-17,BBPS SETTLEMENT 26052017,"62,213.14",,694828.42,Drake-Brockman,733,France,184056.45,1,1,1
1258,2011,10,RENT,1,Low,1,4800, 60 months,2,debt_consolidation,6,High,2,Good Loan,0,18.25,D,4,13.81,5989.09,3560.11,0,122.55,409000001257,26-May-17,FDRL/INTERNAL FUND TRANSFE,,100000.00,794828.42,Wan,628,France,48924.73,1,1,1
1259,2011,4,MORTGAGE,3,Low,1,12875, 36 months,1,credit_card,1,Low,1,Good Loan,0,7.9,A,1,23.16,14501.2665,12875,0,402.87,409000001258,29-May-17,BBPS SETTLEMENT 29052017,"187,145.89",,607682.53,Cameron,633,France,191111.02,1,1,1
1260,2011,6.05,MORTGAGE,3,Low,1,1400, 36 months,1,debt_consolidation,6,Low,1,Bad Loan,1,8.9,A,1,20.29,980.51,729.45,94.11,44.46,409000001259,30-May-17,TRF FRM  Indiaforensic SERVICES,,400000.00,1007682.53,Tretiakov,559,Germany,54184.06,1,1,1
1261,2011,9,MORTGAGE,3,Low,1,22000, 36 months,1,credit_card,1,High,2,Good Loan,0,17.58,D,4,18.7,26266.71,22000,0,790.73,409000001260,30-May-17,BBPS SETTLEMENT 30052017,"128,069.51",,879613.02,Ball,704,Germany,64381.33,1,1,1
1262,2011,10,RENT,1,Low,1,12000, 36 months,1,debt_consolidation,6,High,2,Good Loan,0,16.29,D,4,22.26,15246.99415,12000,0,423.61,409000001261,30-May-17,FDRL/INTERNAL FUND TRANSFE,,100000.00,979613.02,Sal,744,Germany,78770.86,1,1,1
1263,2011,5,RENT,1,Low,1,9000, 36 months,1,debt_consolidation,6,Low,1,Good Loan,0,8.9,A,1,17.67,10286.76559,9000,0,285.78,409000001262,30-May-17,FDRL/INTERNAL FUND TRANSFE,,200000.00,1179613.02,Chung,665,Spain,116766.79,1,1,1
1264,2011,10,RENT,1,Low,1,12000, 36 months,1,credit_card,1,High,2,Good Loan,0,14.65,C,3,8.76,14333.58,12000,0,413.94,409000001263,31-May-17,BBPS SETTLEMENT 31052017,"74,751.37",,1104861.65,Lai,638,France,32916.29,1,1,1
1265,2011,10,RENT,1,Low,1,17000, 60 months,2,debt_consolidation,6,High,2,Good Loan,0,19.03,E,5,8.72,21603.16,17000,0,441.28,409000001264,1-Jun-17,BBPS SETTLEMENT 01062017,"76,825.54",,1028036.11,Gether,837,Spain,50972.60,1,1,1
1266,2011,2,MORTGAGE,3,Low,1,18000, 60 months,2,debt_consolidation,6,High,2,Good Loan,0,16.77,D,4,11.67,24790.59664,18000,0,445.13,409000001265,2-Jun-17,BBPS STMT FOR DTD 01JUN17,"98,256.42",,929779.69,Davidson,534,France,122066.50,1,1,1
1267,2011,1,RENT,1,Low,1,2000, 36 months,1,major_purchase,8,Low,1,Good Loan,0,6.03,A,1,11.42,2184.913378,2000,0,60.88,409000001266,3-Jun-17,BBPS SETMNT FOR DT 020620,"99,989.44",,829790.25,Justice,548,France,65996.90,1,1,1
1268,2011,10,MORTGAGE,3,Low,1,8000, 36 months,1,debt_consolidation,6,Low,1,Good Loan,0,12.42,B,2,6.57,9619.294534,8000,0,267.33,409000001267,5-Jun-17,FDRL/INTERNAL FUND TRANSFE,,200000.00,1029790.25,Osonduagwuike,837,Germany,79577.38,1,1,1
1269,2011,6,RENT,1,Low,1,10000, 36 months,1,credit_card,1,Low,1,Good Loan,0,12.42,B,2,23.93,12026.13386,10000,0,334.16,409000001268,5-Jun-17,BBPS SETMNT FOR DT 030620,"77,700.46",,952089.79,Ewing,658,France,130529.13,1,1,1
1270,2011,7,MORTGAGE,3,Low,1,6900, 36 months,1,debt_consolidation,6,Low,1,Good Loan,0,12.42,B,2,23.83,8298.21977,6900,0,230.57,409000001269,6-Jun-17,BBPS SETMNT FOR DT 050620,"54,678.20",,897411.59,Chin,554,France,172629.67,1,1,1
1271,2011,10,MORTGAGE,3,Low,1,6000, 36 months,1,debt_consolidation,6,Low,1,Good Loan,0,7.9,A,1,11.81,6692.044041,6000,0,187.75,409000001270,7-Jun-17,BBPS SETMNT FOR DT 060620,"89,160.28",,808251.31,Chiang,724,Germany,15216.53,1,1,1
1272,2011,0.5,RENT,1,Medium,2,13000, 36 months,1,other,4,Low,1,Good Loan,0,12.42,B,2,9.41,15634.63686,13000,0,434.4,409000001271,8-Jun-17,BBPS SETMNT FOR DT 070620,"53,804.99",,754446.32,Ahmed,723,France,17512.53,1,1,1
1273,2011,0.5,MORTGAGE,3,Low,1,18650, 36 months,1,debt_consolidation,6,Low,1,Good Loan,0,9.91,B,2,21.31,21632.64006,18650,0,601,409000001272,9-Jun-17,BBPS SETMNT FOR DT 080620,"92,193.60",,662252.72,Marshall,585,Germany,131852.01,1,1,1
1274,2011,8,RENT,1,Low,1,2400, 36 months,1,debt_consolidation,6,Low,1,Bad Loan,1,10.65,B,2,21.67,1031.05,713.72,96.33,78.18,409000001273,12-Jun-17,TRF FROM  Indiaforensic SERVICES,,750000.00,1412252.72,Tsou,474,France,181945.52,1,1,1
1275,2011,3,RENT,1,Low,1,8000, 36 months,1,debt_consolidation,6,Low,1,Good Loan,0,12.42,B,2,22.02,9621.273997,8000,0,267.33,409000001274,12-Jun-17,BBPS SETTLEMENT DATED 12.,"856,588.64",,555664.08,Chien,562,Spain,91482.50,1,1,1
1276,2011,8,MORTGAGE,3,Low,1,25975, 60 months,2,debt_consolidation,6,High,2,Good Loan,0,19.03,E,5,21.7,33006.3,19203.57,0,674.24,409000001275,13-Jun-17,BBPS SETMNT FOR DT 130620,"54,089.18",,501574.90,Ubanwa,719,France,77119.45,1,1,1
1277,2011,3,OWN,2,Low,1,5000, 36 months,1,other,4,Low,1,Bad Loan,1,6.62,A,1,16.32,919.08,764.42,0,153.52,409000001276,14-Jun-17,FDRL/INTERNAL FUND TRANSFE,,100000.00,601574.90,Kapustin,635,Germany,95611.74,1,1,1
1278,2011,2,MORTGAGE,3,Low,1,12500, 60 months,2,credit_card,1,High,2,Good Loan,0,13.49,C,3,12.64,14057.42,9520.81,0,287.56,409000001277,14-Jun-17,FDRL/INTERNAL FUND TRANSFE,,100000.00,701574.90,Calabresi,743,France,80428.42,1,1,1
1279,2011,2,MORTGAGE,3,Low,1,20000, 60 months,2,debt_consolidation,6,High,2,Good Loan,0,17.58,D,4,8.91,27897.5731,20000,0,503.32,409000001278,14-Jun-17,BBPS SETMNT FOR DT 140620,"119,587.27",,581987.63,Hsiao,681,Spain,163714.92,1,1,1
1280,2011,6,MORTGAGE,3,Low,1,4800, 36 months,1,major_purchase,8,Low,1,Good Loan,0,6.03,A,1,5.52,4994.93,4800,0,146.1,409000001279,15-Jun-17,FDRL/INTERNAL FUND TRANSFE,,100000.00,681987.63,Grant,521,France,27375.15,1,1,1
1281,2011,10,RENT,1,Low,1,30000, 36 months,1,debt_consolidation,6,Low,1,Good Loan,0,9.91,B,2,13.37,32289.86,30000,0,966.75,409000001280,15-Jun-17,FDRL/INTERNAL FUND TRANSFE,,100000.00,781987.63,H?,741,Spain,73873.65,1,1,1
1282,2011,5,MORTGAGE,3,Low,1,25000, 60 months,2,credit_card,1,High,2,Good Loan,0,22.06,F,6,10.84,32918.2,25000,0,691.33,409000001281,15-Jun-17,FDRL/INTERNAL FUND TRANSFE,,100000.00,881987.63,Chia,790,Spain,139266.48,1,1,1
1283,2011,6.05,OWN,2,Low,1,9250, 36 months,1,debt_consolidation,6,Low,1,Good Loan,0,10.65,B,2,9.18,10268.31,9250,0,301.31,409000001282,15-Jun-17,BBPS SETMNT FOR DT 150620,"227,030.51",,654957.12,Ugoji,622,France,131772.51,1,1,1
1284,2011,10,MORTGAGE,3,Low,1,2400, 36 months,1,wedding,5,Low,1,Bad Loan,1,9.91,B,2,17.38,308.96,232.64,0,77.34,409000001283,16-Jun-17,BBPS SETMNT FOR DT 160620,"119,516.51",,535440.61,Gregory,669,France,173454.07,1,1,1
1285,2011,10,MORTGAGE,3,Low,1,12000, 60 months,2,debt_consolidation,6,High,2,Good Loan,0,18.25,D,4,17.2,17634.45815,12000,0,306.36,409000001284,16-Jun-17,FDRL/INTERNAL FUND TRANSFE,,200000.00,735440.61,Mackay,583,France,67552.71,1,1,1
1286,2011,10,MORTGAGE,3,Low,1,3000, 36 months,1,car,2,High,2,Good Loan,0,13.49,C,3,15.17,3663.054805,3000,0,101.8,409000001285,17-Jun-17,BBPS SETMNT FOR DT 170620,"98,749.92",,636690.69,Nnamutaezinwa,520,Spain,34765.33,1,1,1
1287,2011,5,MORTGAGE,3,Low,1,12000, 36 months,1,debt_consolidation,6,High,2,Good Loan,0,13.49,C,3,13.65,14071.33,12000,0,407.17,409000001286,19-Jun-17,FDRL/INTERNAL FUND TRANSFE,,200000.00,836690.69,Findlay,579,Spain,120219.14,1,1,1
1288,2011,10,RENT,1,Low,1,10000, 36 months,1,credit_card,1,High,2,Bad Loan,1,17.58,D,4,16.56,2510.2,1554.04,0,359.43,409000001287,19-Jun-17,BBPS SETMNT FOR DT 190620,"175,151.51",,661539.18,Ferri,698,Spain,90212.38,1,1,1
1289,2011,0.5,RENT,1,Low,1,10000, 36 months,1,debt_consolidation,6,High,2,Bad Loan,1,13.49,C,3,13.95,2525.96,1397.52,494,339.31,409000001288,20-Jun-17,BBPS SETMNT FOR DT 200620,"155,678.63",,505860.55,Ku,548,Spain,164975.82,1,1,1
1290,2011,3,MORTGAGE,3,Low,1,20000, 36 months,1,debt_consolidation,6,High,2,Good Loan,0,16.77,D,4,10.43,25573.40371,20000,0,710.77,409000001289,20-Jun-17,FDRL/INTERNAL FUND TRANSFE,,200000.00,705860.55,Amechi,672,Germany,1285.81,1,1,1
1291,2011,9,MORTGAGE,3,Low,1,16000, 36 months,1,home_improvement,7,Low,1,Good Loan,0,7.9,A,1,9,17088.2,16000,0,500.65,409000001290,21-Jun-17,BBPS SETMNT FOR DT 210620,"100,834.49",,605026.06,Kirk,653,Germany,83679.46,1,1,1
1292,2011,8,RENT,1,Low,1,22800, 60 months,2,credit_card,1,High,2,Bad Loan,1,17.27,D,4,10.02,18005.4,7198.55,3757.29,569.96,409000001291,21-Jun-17,FDRL/INTERNAL FUND TRANSFE,,200000.00,805026.06,Andrews,734,Spain,34548.74,1,1,1
1293,2011,10,RENT,1,Low,1,18000, 36 months,1,debt_consolidation,6,High,2,Good Loan,0,14.65,C,3,21.37,22273.93747,18000,0,620.9,409000001292,22-Jun-17,BBPS SETMNT FOR DT 220620,"127,130.39",,677895.67,Murray,794,France,74275.08,1,1,1
1294,2011,10,OWN,2,Low,1,3500, 36 months,1,home_improvement,7,Low,1,Good Loan,0,6.62,A,1,0.76,3538.1,3500,0,107.47,409000001293,22-Jun-17,FDRL/INTERNAL FUND TRANSFE,,200000.00,877895.67,Griffin,641,France,7278.57,1,1,1
1295,2011,10,OWN,2,Low,1,20000, 60 months,2,debt_consolidation,6,Low,1,Good Loan,0,10.65,B,2,24.02,22955.89,20000,0,431.37,409000001294,23-Jun-17,BBPS SETMNT FOR DT 230620,"135,857.04",,742038.63,Longstaff,824,France,162053.92,1,1,1
1296,2011,1,RENT,1,Low,1,3000, 36 months,1,small_business,3,Low,1,Bad Loan,1,11.71,B,2,24.27,836.5,487.63,144.2,99.23,409000001295,27-Jun-17,TRF FROM  Indiaforensic SERVICES,,500000.00,1242038.63,McWilliam,534,Spain,199336.63,1,1,1
1297,2011,2,RENT,1,Low,1,27300, 60 months,2,debt_consolidation,6,Low,1,Good Loan,0,10.65,B,2,25.7,33812.95997,27300,0,588.82,409000001296,27-Jun-17,BBPS SETTLEMENT DATED 270,"540,324.73",,701713.90,Coffee,653,Spain,62347.71,1,1,1
1298,2011,0.5,MORTGAGE,3,Low,1,12250, 60 months,2,debt_consolidation,6,High,2,Good Loan,0,15.27,C,3,13.34,14315.67,9231.33,0,293.17,409000001297,28-Jun-17,FDRL/INTERNAL FUND TRANSFE,,100000.00,801713.90,Hancock,498,France,91711.66,1,1,1
1299,2011,5,RENT,1,Medium,2,20000, 36 months,1,credit_card,1,High,2,Good Loan,0,13.49,C,3,7.89,24418.20009,20000,0,678.61,409000001298,28-Jun-17,FDRL/INTERNAL FUND TRANSFE,,200000.00,1001713.90,Clark,683,France,79240.90,1,1,1
1300,2011,0.5,RENT,1,Low,1,4350, 36 months,1,credit_card,1,High,2,Good Loan,0,16.29,D,4,20.7,5474.080084,4350,0,153.56,409000001299,28-Jun-17,BBPS SETTLEMENT FOR DT 28,"241,548.23",,760165.67,Creswell,618,Germany,76679.60,1,1,1
1301,2011,10,MORTGAGE,3,Low,1,21200, 60 months,2,credit_card,1,High,2,Good Loan,0,17.58,D,4,24.05,25597.68,15351.88,0,533.51,409000001300,29-Jun-17,TRF FROM  Indiaforensic SERVICES,,500000.00,1260165.67,Dodds,538,France,162511.55,1,1,1
1302,2011,2,RENT,1,Low,1,2700, 36 months,1,credit_card,1,Low,1,Good Loan,0,9.91,B,2,10.16,3116.767259,2700,0,87.01,409000001301,29-Jun-17,BBPS SETMNT FOR DT 290620,"66,778.43",,1193387.24,Ewen,643,Spain,21360.88,1,1,1
1303,2011,0.5,RENT,1,Low,1,8000, 36 months,1,credit_card,1,High,2,Good Loan,0,14.27,C,3,18.6,9876.664533,8000,0,274.48,409000001302,30-Jun-17,BBPS SETMNT FOR DT 300620,"88,020.44",,1105366.80,Carter,428,France,54487.43,1,1,1
1304,2011,0.5,OWN,2,Low,1,6000, 36 months,1,debt_consolidation,6,High,2,Good Loan,0,14.27,C,3,18.02,7404.149682,6000,0,205.86,409000001303,1-Jul-17,BBPS SETMNT FOR DT 010720,"79,105.87",,1026260.93,Ch'iu,593,Germany,53931.05,1,1,1
1305,2011,10,MORTGAGE,3,Low,1,7000, 36 months,1,credit_card,1,Low,1,Good Loan,0,9.91,B,2,16.78,7227.82,7000,0,225.58,409000001304,3-Jul-17,BBPS SETMNT FOR DT 030720,"129,069.18",,897191.75,Tsao,718,France,103165.15,1,1,1
1306,2011,2,RENT,1,Low,1,7000, 36 months,1,credit_card,1,Low,1,Good Loan,0,7.9,A,1,18.06,7648.95,7000,0,219.04,409000001305,3-Jul-17,REV SWITCHING FEE + SERVI,,1671.63,898863.38,Burgess,811,Germany,146359.81,1,1,1
1307,2011,0.5,RENT,1,Low,1,6025, 36 months,1,credit_card,1,Low,1,Good Loan,0,11.71,B,2,11.13,7172.030061,6025,0,199.29,409000001306,4-Jul-17,BBPS SETMNT FOR DT 040720,"131,864.31",,766999.07,Fanucci,823,Spain,28370.95,1,1,1
1308,2011,3,RENT,1,Low,1,15000, 36 months,1,debt_consolidation,6,High,2,Good Loan,0,18.25,D,4,21.87,19583.58003,15000,0,544.17,409000001307,5-Jul-17,BBPS SETMNT FOR DT 050720,"64,350.32",,702648.75,Blackburn,645,Spain,10023.15,1,1,1
1309,2011,7,MORTGAGE,3,Medium,2,18000, 36 months,1,debt_consolidation,6,High,2,Good Loan,0,17.27,D,4,9.75,22995.23739,18000,0,644.18,409000001308,6-Jul-17,BBPS SETMNT FOR DT 060720,"158,111.18",,544537.57,Bennett,710,France,192928.82,1,1,1
1310,2011,7,RENT,1,Low,1,20250, 60 months,2,credit_card,1,High,2,Good Loan,0,15.27,C,3,23.08,23707.35,15283.55,0,484.63,409000001309,7-Jul-17,BBPS SETMNT FOR DT 070720,"39,166.52",,505371.05,Boniwell,591,Spain,50485.70,1,1,1
1311,2011,2,RENT,1,Low,1,3825, 36 months,1,credit_card,1,High,2,Good Loan,0,14.27,C,3,23.12,4722.775211,3825,0,131.24,409000001310,7-Jul-17,FDRL/INTERNAL FUND TRANSFE,,200000.00,705371.05,Vasilieva,748,Germany,131662.47,1,1,1
1312,2011,0.5,RENT,1,Low,1,10000, 36 months,1,debt_consolidation,6,Low,1,Good Loan,0,6.03,A,1,23.55,10730.38,10000,0,304.36,409000001311,10-Jul-17,BBPS SETMNT FOR DT 100720,"182,353.53",,523017.52,Longo,850,France,152235.30,1,1,1
1313,2011,9,RENT,1,Low,1,6000, 36 months,1,major_purchase,8,Low,1,Good Loan,0,12.42,B,2,20.92,7216.25832,6000,0,200.5,409000001312,10-Jul-17,FDRL/INTERNAL FUND TRANSFE,,200000.00,723017.52,Kwemto,542,France,68093.23,1,1,1
1314,2011,3,MORTGAGE,3,Low,1,2400, 36 months,1,other,4,High,2,Good Loan,0,14.27,C,3,19.68,2791.4,2400,0,82.35,409000001313,10-Jul-17,FDRL/INTERNAL FUND TRANSFE,,200000.00,923017.52,Lawrence,809,France,80061.31,1,1,1
1315,2011,6.05,MORTGAGE,3,Low,1,7200, 36 months,1,credit_card,1,Low,1,Good Loan,0,12.69,B,2,11.39,8194.63,7200,0,241.53,409000001314,11-Jul-17,BBPS SETMNT FOR DT 110720,"227,142.83",,695874.69,Duncan,675,France,149583.67,1,1,1
1316,2011,5,OWN,2,Low,1,14000, 36 months,1,credit_card,1,Low,1,Good Loan,0,9.91,B,2,22.48,16238.02888,14000,0,451.15,409000001315,11-Jul-17,FDRL/INTERNAL FUND TRANSFE,,200000.00,895874.69,Bocharova,607,Spain,7631.27,1,1,1
1317,2011,6,RENT,1,Low,1,8400, 60 months,2,car,2,High,2,Good Loan,0,14.65,C,3,8.14,9730.14,6369.61,0,198.3,409000001316,11-Jul-17,FDRL/INTERNAL FUND TRANSFE,,100000.00,995874.69,Morres,850,France,33082.81,1,1,1
1318,2011,10,MORTGAGE,3,Low,1,13000, 36 months,1,debt_consolidation,6,Low,1,Good Loan,0,10.65,B,2,12.69,14026.71,13000.01,0,423.46,409000001317,11-Jul-17,FDRL/INTERNAL FUND TRANSFE,,200000.00,1195874.69,Shih,789,France,121883.87,1,1,1
1319,2011,10,RENT,1,Low,1,4200, 36 months,1,debt_consolidation,6,Low,1,Bad Loan,1,6.62,A,1,21.91,3294.53,2702.55,204.29,128.96,409000001318,12-Jul-17,BBPS SETMNT FOR DT 120720,"128,509.50",,1067365.19,Vogel,598,France,100722.72,1,1,1
1320,2011,9,RENT,1,Low,1,20000, 60 months,2,debt_consolidation,6,Low,1,Good Loan,0,11.71,B,2,18.96,21635.99,15398.83,0,441.97,409000001319,13-Jul-17,BBPS SETMNT FOR DT 130720,"138,813.76",,928551.43,T'an,756,Germany,47093.11,1,1,1
1321,2011,5,RENT,1,Low,1,7000, 60 months,2,credit_card,1,High,2,Bad Loan,1,22.06,F,6,11.76,6082.53,2345.53,670.35,193.58,409000001320,14-Jul-17,BBPS SETMNT FOR DT 140720,"129,618.64",,798932.79,Wisdom,687,France,177624.01,1,1,1
1322,2011,6,RENT,1,Low,1,13250, 36 months,1,credit_card,1,High,2,Good Loan,0,13.49,C,3,23.26,15913.23,13250,0,449.58,409000001321,14-Jul-17,FDRL/INTERNAL FUND TRANSFE,,100000.00,898932.79,Lorenzo,724,France,106149.48,1,1,1
1323,2011,1,RENT,1,Low,1,3600, 60 months,2,debt_consolidation,6,High,2,Bad Loan,1,18.25,D,4,17.25,3287.82,1392.13,545.34,91.91,409000001322,14-Jul-17,FDRL/INTERNAL FUND TRANSFE,,200000.00,1098932.79,Shahan,700,France,16874.92,1,1,1
1324,2011,10,MORTGAGE,3,Low,1,14000, 60 months,2,small_business,3,High,2,Bad Loan,1,13.49,C,3,10.78,5598.66,2522.21,657.78,322.07,409000001323,15-Jul-17,BBPS SETMNT FOR DT 150720,"130,451.90",,968480.89,Bryant,635,Spain,54560.79,1,1,1
1325,2011,5,RENT,1,Low,1,6000, 36 months,1,debt_consolidation,6,Low,1,Good Loan,0,6.62,A,1,7.2,6274.73,6000,0,184.23,409000001324,17-Jul-17,BBPS SETMNT FOR DT 170720,"125,047.30",,843433.59,Liang,687,Germany,153605.75,1,1,1
1326,2011,7,RENT,1,Low,1,9000, 36 months,1,credit_card,1,Low,1,Good Loan,0,7.9,A,1,12.48,10137.30701,9000,0,281.62,409000001325,18-Jul-17,BBPS SETMNT FOR DT 180720,"252,733.40",,590700.19,Chidozie,613,France,44390.38,1,1,1
1327,2011,10,MORTGAGE,3,Low,1,15000, 36 months,1,debt_consolidation,6,Low,1,Good Loan,0,12.42,B,2,11.67,17453.59,15000,0,501.23,409000001326,19-Jul-17,BBPS SETMNT FOR DT 190720,"97,236.56",,493463.63,Hayward,781,France,63218.85,1,1,1
1328,2011,4,MORTGAGE,3,Low,1,10000, 36 months,1,credit_card,1,High,2,Good Loan,0,14.65,C,3,7.36,10596.28,10000,0,344.95,409000001327,19-Jul-17,FDRL/INTERNAL FUND TRANSFE,,200000.00,693463.63,Liu,703,Spain,41626.78,1,1,1
1329,2011,2,RENT,1,Low,1,9000, 36 months,1,debt_consolidation,6,High,2,Good Loan,0,14.27,C,3,15.93,11112.02368,9000,0,308.79,409000001328,20-Jul-17,BBPS SETMNT FOR DT 200720,"95,441.08",,598022.55,Alexeeva,593,Germany,24765.53,1,1,1
1330,2011,6.05,RENT,1,Low,1,5325, 36 months,1,credit_card,1,Low,1,Bad Loan,1,12.42,B,2,12.55,4617.6,3636.02,0,177.94,409000001329,20-Jul-17,FDRL/INTERNAL FUND TRANSFE,,100000.00,698022.55,Calabresi,743,France,28280.80,1,1,1
1331,2011,0.5,RENT,1,Low,1,12000, 36 months,1,major_purchase,8,Low,1,Good Loan,0,6.03,A,1,8.06,13147.59205,12000,0,365.23,409000001330,20-Jul-17,FDRL/INTERNAL FUND TRANSFE,,100000.00,798022.55,Lettiere,640,Spain,89043.19,1,1,1
1332,2011,2,OWN,2,Low,1,14000, 36 months,1,debt_consolidation,6,Low,1,Bad Loan,1,10.65,B,2,13.44,6035.49,4174.14,572.85,456.03,409000001331,21-Jul-17,BBPS SETMNT FOR DT 210720,"84,080.38",,713942.17,Chou,849,Germany,17294.12,1,1,1
1333,2011,10,MORTGAGE,3,Low,1,20000, 36 months,1,debt_consolidation,6,High,2,Bad Loan,1,17.27,D,4,3.02,26149.35,19675.8,311.89,715.75,409000001332,21-Jul-17,FDRL/INTERNAL FUND TRANSFE,,200000.00,913942.17,Nnamutaezinwa,778,France,126702.41,1,1,1
1334,2011,4,RENT,1,Low,1,16000, 36 months,1,credit_card,1,High,2,Bad Loan,1,14.65,C,3,19.44,4963.5,3367.95,0,551.91,409000001333,21-Jul-17,FDRL/INTERNAL FUND TRANSFE,,200000.00,1113942.17,Nnamutaezinwa,539,Germany,13123.41,1,1,1
1335,2011,10,OWN,2,Low,1,35000, 60 months,2,other,4,High,2,Good Loan,0,17.27,D,4,14.77,41951.46,35000,0,874.93,409000001334,24-Jul-17,BBPS SETMNT FOR DT 240720,"202,879.78",,911062.39,Greece,489,Germany,167973.63,1,1,1
1336,2011,2,RENT,1,Low,1,11000, 36 months,1,credit_card,1,Low,1,Good Loan,0,12.42,B,2,18.72,13229.84228,11000,0,367.57,409000001335,25-Jul-17,BBPS SETMNT FOR DT 250720,"137,149.60",,773912.79,Yin,568,Spain,125870.79,1,1,1
1337,2011,0.5,RENT,1,Low,1,5000, 36 months,1,car,2,Low,1,Good Loan,0,12.42,B,2,2.91,5575.75,5000,0,167.08,409000001336,25-Jul-17,FDRL/INTERNAL FUND TRANSFE,,200000.00,973912.79,Larionova,618,Spain,91972.49,1,1,1
1338,2011,1,RENT,1,Low,1,20000, 60 months,2,wedding,5,High,2,Good Loan,0,13.49,C,3,19.22,20226.34,20000,0,460.1,409000001337,26-Jul-17,BBPS SETMNT FOR DT 260720,"89,718.90",,884193.89,Golubev,710,Germany,155593.74,1,1,1
1339,2011,4,RENT,1,Low,1,35000, 60 months,2,debt_consolidation,6,Low,1,Good Loan,0,12.69,B,2,17.09,38724.44,26813.3,0,790.82,409000001338,27-Jul-17,BBPS SETMNT FOR DT 270720,"109,103.60",,775090.29,Norman,625,France,67788.49,1,1,1
1340,2011,10,RENT,1,Low,1,12000, 60 months,2,debt_consolidation,6,High,2,Good Loan,0,18.25,D,4,15.16,14671.78,8634.95,0,306.36,409000001339,27-Jul-17,FDRL/INTERNAL FUND TRANSFE,,100000.00,875090.29,Capon,682,Spain,62615.35,1,1,1
1341,2011,6.05,MORTGAGE,3,Low,1,12000, 36 months,1,debt_consolidation,6,Low,1,Good Loan,0,7.51,A,1,5.66,13433.62556,12000,0,373.33,409000001340,27-Jul-17,FDRL/INTERNAL FUND TRANSFE,,100000.00,975090.29,Chukwudi,727,Spain,107415.02,1,1,1
1342,2011,3,RENT,1,Low,1,14150, 36 months,1,debt_consolidation,6,Low,1,Good Loan,0,12.69,B,2,13.35,15813.16,14150,0,474.66,409000001341,28-Jul-17,BBPS SETMNT FOR DT 280720,"128,572.30",,846517.99,Fedorov,794,France,166526.26,1,1,1
1343,2011,10,MORTGAGE,3,Low,1,4000, 36 months,1,medical,9,Low,1,Good Loan,0,12.42,B,2,17.69,4810.524172,4000,0,133.67,409000001342,28-Jul-17,FDRL/INTERNAL FUND TRANSFE,,50000.00,896517.99,Avdeeva,652,Spain,120107.10,1,1,1
1344,2011,6,MORTGAGE,3,Low,1,12000, 60 months,2,other,4,Low,1,Good Loan,0,8.9,A,1,9.3,13781.9,12000,0,248.52,409000001343,28-Jul-17,FDRL/INTERNAL FUND TRANSFE,,100000.00,996517.99,Reid,670,Spain,188227.80,1,1,1
1345,2011,10,RENT,1,Low,1,6000, 36 months,1,other,4,Low,1,Good Loan,0,10.65,B,2,9.43,6105.36,6000,0,195.44,409000001344,28-Jul-17,FDRL/INTERNAL FUND TRANSFE,,50000.00,1046517.99,Kennedy,460,Germany,91560.63,1,1,1
1346,2011,3,RENT,1,Low,1,17000, 60 months,2,credit_card,1,High,2,Bad Loan,1,17.58,D,4,19.73,18368.44,10589.61,0,427.82,409000001345,28-Jul-17,FDRL/INTERNAL FUND TRANSFE,,100000.00,1146517.99,Chan,568,Spain,166495.20,1,1,1
1347,2011,3,OWN,2,Low,1,15000, 36 months,1,debt_consolidation,6,Low,1,Good Loan,0,7.51,A,1,26.75,15445.6,15000,0,466.67,409000001346,28-Jul-17,FDRL/INTERNAL FUND TRANSFE,,100000.00,1246517.99,Wofford,643,France,165614.40,1,1,1
1348,2011,10,MORTGAGE,3,Low,1,4200, 60 months,2,major_purchase,8,Low,1,Bad Loan,1,11.71,B,2,10.48,3449.54,2074.12,299.9,92.82,409000001347,28-Jul-17,FDRL/INTERNAL FUND TRANSFE,,100000.00,1346517.99,Mai,521,France,86372.24,1,1,1
1349,2011,2,MORTGAGE,3,Low,1,15000, 36 months,1,home_improvement,7,Low,1,Good Loan,0,6.03,A,1,9.12,16421.00071,15000,0,456.54,409000001348,29-Jul-17,BBPS SETMNT FOR DT 290720,"125,092.78",,1221425.21,King,615,France,2755.53,1,1,1
1350,2011,1,RENT,1,Low,1,18000, 36 months,1,debt_consolidation,6,Low,1,Good Loan,0,12.42,B,2,23.45,20756.19,18000,0,601.48,409000001349,31-Jul-17,BBPS SETMNT FOR DT 310720,"191,881.30",,1029543.91,T'ao,575,Spain,83594.51,1,1,1
1351,2011,1,RENT,1,Low,1,19000, 60 months,2,debt_consolidation,6,High,2,Bad Loan,1,17.58,D,4,22.34,18594.87,9365.96,1416.83,478.15,409000001350,1-Aug-17,BBPS SETMNT FOR DT 010820,"99,288.60",,930255.31,Hsu,717,France,103706.41,1,1,1
1352,2011,10,MORTGAGE,3,Medium,2,30000, 60 months,2,debt_consolidation,6,High,2,Good Loan,0,13.49,C,3,5.74,40163.86284,30000,0,690.15,409000001351,2-Aug-17,BBPS SETMNT FOR DT 020820,"158,804.40",,771450.91,White,648,France,5924.38,1,1,1
1353,2011,0.5,MORTGAGE,3,High,3,35000, 36 months,1,home_improvement,7,Low,1,Good Loan,0,7.9,A,1,2.45,39417.8779,35000,0,1095.16,409000001352,2-Aug-17,FDRL/INTERNAL FUND TRANSFE,,200000.00,971450.91,Stephens,535,Germany,58203.67,1,1,1
1354,2011,0.5,OWN,2,Low,1,16000, 36 months,1,credit_card,1,Low,1,Good Loan,0,7.9,A,1,20.59,18021.53713,16000,0,500.65,409000001353,3-Aug-17,BBPS SETMNT FOR DT 030820,"52,393.37",,919057.54,Frolov,626,Spain,49361.84,1,1,1
1355,2011,6,RENT,1,Low,1,4000, 60 months,2,debt_consolidation,6,High,2,Bad Loan,1,18.64,E,5,19.15,1230.96,532.21,0,102.98,409000001354,4-Aug-17,BBPS SETMNT FOR DT 040820,"109,234.48",,809823.06,Lombardi,611,Spain,73585.18,1,1,1
1356,2011,4,MORTGAGE,3,Low,1,7000, 36 months,1,debt_consolidation,6,Low,1,Good Loan,0,7.51,A,1,16.33,7833.019522,7000,0,217.78,409000001355,4-Aug-17,FDRL/INTERNAL FUND TRANSFE,,50000.00,859823.06,Munro,734,Spain,95135.27,1,1,1
1357,2011,2,MORTGAGE,3,Low,1,12000, 60 months,2,debt_consolidation,6,High,2,Good Loan,0,15.96,C,3,26.11,17192.08999,12000,0,291.57,409000001356,4-Aug-17,FDRL/INTERNAL FUND TRANSFE,,50000.00,909823.06,Hayward,709,France,38794.57,1,1,1
1358,2011,4,RENT,1,Low,1,12000, 60 months,2,small_business,3,Low,1,Good Loan,0,12.69,B,2,9.23,13272.34,9190.38,0,271.14,409000001357,4-Aug-17,FDRL/INTERNAL FUND TRANSFE,,50000.00,959823.06,Fields,591,France,198926.36,1,1,1
1359,2011,6,RENT,1,Low,1,7000, 36 months,1,other,4,Low,1,Good Loan,0,6.03,A,1,8.15,7669.462608,7000,0,213.05,409000001358,4-Aug-17,FDRL/INTERNAL FUND TRANSFE,,50000.00,1009823.06,Onwumelu,664,France,56099.86,1,1,1
1360,2011,5,RENT,1,Low,1,10000, 36 months,1,credit_card,1,High,2,Bad Loan,1,13.49,C,3,17.18,6446.45,4766.08,13.24,339.31,409000001359,4-Aug-17,FDRL/INTERNAL FUND TRANSFE,,50000.00,1059823.06,Suffolk,431,France,117023.08,1,1,1
1361,2011,8,RENT,1,Low,1,1600, 36 months,1,debt_consolidation,6,High,2,Good Loan,0,16.29,D,4,16.84,1955.19,1600,0,56.49,409000001360,4-Aug-17,FDRL/INTERNAL FUND TRANSFE,,50000.00,1109823.06,Tsao,647,Germany,62083.00,1,1,1
1362,2011,10,RENT,1,Low,1,17200, 60 months,2,house,12,High,2,Good Loan,0,20.89,F,6,7.06,22260.98,12201.38,0,464.26,409000001361,4-Aug-17,FDRL/INTERNAL FUND TRANSFE,,50000.00,1159823.06,Judd,578,France,141822.80,1,1,1
1363,2011,2,MORTGAGE,3,Low,1,12000, 60 months,2,debt_consolidation,6,Low,1,Good Loan,0,11.71,B,2,17.87,13517,12000,0,265.18,409000001362,4-Aug-17,FDRL/INTERNAL FUND TRANSFE,,50000.00,1209823.06,Hamilton,555,Germany,185387.14,1,1,1
1364,2011,8,MORTGAGE,3,Low,1,7200, 36 months,1,debt_consolidation,6,Low,1,Good Loan,0,11.71,B,2,7.57,8571.127477,7200,0,238.15,409000001363,4-Aug-17,FDRL/INTERNAL FUND TRANSFE,,50000.00,1259823.06,T'ang,775,Spain,57461.13,1,1,1
1365,2011,1,RENT,1,Low,1,12000, 36 months,1,debt_consolidation,6,High,2,Good Loan,0,14.27,C,3,19.94,14817.06978,12000,0,411.71,409000001364,4-Aug-17,FDRL/INTERNAL FUND TRANSFE,,50000.00,1309823.06,Degtyarev,850,Germany,120380.12,1,1,1
1366,2011,7,MORTGAGE,3,Low,1,5000, 36 months,1,debt_consolidation,6,Low,1,Good Loan,0,7.51,A,1,16.7,5595.957702,5000,0,155.56,409000001365,4-Aug-17,FDRL/INTERNAL FUND TRANSFE,,50000.00,1359823.06,Kang,625,France,133020.90,1,1,1
1367,2011,10,MORTGAGE,3,Low,1,27300, 60 months,2,debt_consolidation,6,Low,1,Good Loan,0,12.42,B,2,20.19,30032.31,20951.58,0,613.09,409000001366,4-Aug-17,FDRL/INTERNAL FUND TRANSFE,,50000.00,1409823.06,Hudson,645,Spain,13589.93,1,1,1
1368,2011,0.5,MORTGAGE,3,Low,1,8200, 36 months,1,small_business,3,Low,1,Good Loan,0,6.62,A,1,2.09,9062.215803,8200,0,251.77,409000001367,4-Aug-17,FDRL/INTERNAL FUND TRANSFE,,50000.00,1459823.06,Jibunoh,608,Germany,77830.36,1,1,1
1369,2011,7,OWN,2,Low,1,6000, 36 months,1,credit_card,1,Low,1,Good Loan,0,12.42,B,2,26.68,7216.037251,6000,0,200.5,409000001368,4-Aug-17,FDRL/INTERNAL FUND TRANSFE,,50000.00,1509823.06,Kinlaw,689,Spain,136610.02,1,1,1
1370,2011,10,OWN,2,Low,1,8000, 36 months,1,home_improvement,7,Low,1,Good Loan,0,8.9,A,1,6.41,8333.79,8000,0,254.03,409000001369,4-Aug-17,FDRL/INTERNAL FUND TRANSFE,,50000.00,1559823.06,Chizuoke,652,Germany,17160.94,1,1,1
1371,2011,10,MORTGAGE,3,High,3,20000, 36 months,1,debt_consolidation,6,Low,1,Good Loan,0,9.91,B,2,17.86,21831.89,20000,0,644.5,409000001370,4-Aug-17,FDRL/INTERNAL FUND TRANSFE,,50000.00,1609823.06,Lucciano,769,France,176843.53,1,1,1
1372,2011,5,MORTGAGE,3,Low,1,10400, 60 months,2,home_improvement,7,High,2,Good Loan,0,16.77,D,4,9.86,12574.23,7780.44,0,257.19,409000001371,5-Aug-17,BBPS SETTMT DTD 050817,"174,658.14",,1435164.92,Omeokachie,611,France,114996.33,1,1,1
1373,2011,2,RENT,1,Low,1,3600, 36 months,1,other,4,Low,1,Good Loan,0,12.42,B,2,14.17,3810.46,3600,0,120.3,409000001372,7-Aug-17,BBPS SETMNT FOR DT 070820,"126,978.66",,1308186.26,Gorbunova,489,France,196990.79,1,1,1
1374,2011,10,MORTGAGE,3,Low,1,5000, 36 months,1,debt_consolidation,6,Low,1,Good Loan,0,6.03,A,1,4.21,5443.369714,5000,0,152.18,409000001373,8-Aug-17,BBPS SETMNT FOR DT 080820,"12,646.88",,1295539.38,Tikhonov,528,Germany,133146.03,1,1,1
1375,2011,3,MORTGAGE,3,Medium,2,8000, 36 months,1,other,4,Low,1,Good Loan,0,11.71,B,2,9.84,9522.299937,8000,0,264.61,409000001374,9-Aug-17,BBPS SETMNT FOR DT 090820,"234,382.52",,1061156.86,Campa,632,France,185667.72,1,1,1
1376,2011,10,MORTGAGE,3,Medium,2,16000, 36 months,1,debt_consolidation,6,Low,1,Good Loan,0,12.42,B,2,10.14,18832.46,16000,0,534.65,409000001375,10-Aug-17,BBPS SETMNT FOR DT 100820,"106,384.13",,954772.73,Mancini,429,France,24020.49,1,1,1
1377,2011,10,MORTGAGE,3,Medium,2,35000, 60 months,2,debt_consolidation,6,High,2,Good Loan,0,22.35,F,6,17.24,44637.99,35000.01,0,973.64,409000001376,11-Aug-17,BBPS SETMNT FOR DT 110820,"137,544.04",,817228.69,Donoghue,457,France,185750.02,1,1,1
1378,2011,6,RENT,1,Low,1,5000, 36 months,1,debt_consolidation,6,Low,1,Bad Loan,1,12.69,B,2,23.36,1090.18,585.26,253.38,167.73,409000001377,11-Aug-17,FDRL/INTERNAL FUND TRANSFE,,50000.00,867228.69,Tuan,768,Spain,178045.97,1,1,1
1379,2011,10,MORTGAGE,3,Low,1,12000, 36 months,1,home_improvement,7,Low,1,Good Loan,0,6.62,A,1,1.43,13261.20238,12000,0,368.45,409000001378,11-Aug-17,FDRL/INTERNAL FUND TRANSFE,,50000.00,917228.69,Johnstone,715,Spain,199857.47,1,1,1
1380,2011,3,RENT,1,Low,1,2800, 36 months,1,other,4,Low,1,Bad Loan,1,7.51,A,1,13.2,1042.68,862.23,0,87.12,409000001379,11-Aug-17,FDRL/INTERNAL FUND TRANSFE,,50000.00,967228.69,Romani,668,Germany,43595.90,1,1,1
1381,2011,8,RENT,1,Low,1,12000, 36 months,1,other,4,Low,1,Good Loan,0,12.69,B,2,6.81,14485.04452,12000,0,402.54,409000001380,11-Aug-17,FDRL/INTERNAL FUND TRANSFE,,50000.00,1017228.69,Fuller,625,Germany,122810.53,1,1,1
1382,2011,2,RENT,1,Low,1,4000, 36 months,1,debt_consolidation,6,Low,1,Bad Loan,1,6.03,A,1,17.53,3643.22,3163.54,114.03,121.75,409000001381,11-Aug-17,FDRL/INTERNAL FUND TRANSFE,,50000.00,1067228.69,Baxter,846,France,3440.47,1,1,1
1383,2011,2,MORTGAGE,3,Low,1,7000, 36 months,1,debt_consolidation,6,Low,1,Good Loan,0,8.9,A,1,6,7990.691892,7000,0,222.28,409000001382,11-Aug-17,FDRL/INTERNAL FUND TRANSFE,,50000.00,1117228.69,Pirozzi,661,Spain,35989.41,1,1,1
1384,2011,6,MORTGAGE,3,Low,1,5600, 36 months,1,credit_card,1,Low,1,Good Loan,0,10.65,B,2,13.69,6565.58951,5600,0,182.42,409000001383,11-Aug-17,FDRL/INTERNAL FUND TRANSFE,,50000.00,1167228.69,Sung,571,France,17163.75,1,1,1
1385,2011,9,RENT,1,Low,1,12000, 60 months,2,credit_card,1,High,2,Bad Loan,1,19.91,E,5,17.72,13010.53,6859.77,11.44,317.33,409000001384,11-Aug-17,FDRL/INTERNAL FUND TRANSFE,,50000.00,1217228.69,Rogers,582,Spain,44506.09,1,1,1
1386,2011,5,RENT,1,Low,1,18975, 60 months,2,debt_consolidation,6,High,2,Good Loan,0,19.91,E,5,24.53,24616.66,18975,0,501.78,409000001385,11-Aug-17,FDRL/INTERNAL FUND TRANSFE,,50000.00,1267228.69,Mills,716,France,17848.30,1,1,1
1387,2011,10,MORTGAGE,3,Medium,2,5000, 36 months,1,debt_consolidation,6,Low,1,Good Loan,0,6.62,A,1,1.49,5134.29,5000,0,153.52,409000001386,11-Aug-17,FDRL/INTERNAL FUND TRANSFE,,50000.00,1317228.69,Osonduagwuike,758,France,76209.56,1,1,1
1388,2011,2,RENT,1,Low,1,12000, 36 months,1,debt_consolidation,6,High,2,Good Loan,0,16.77,D,4,19.5,13372.6,12000,0,426.47,409000001387,11-Aug-17,FDRL/INTERNAL FUND TRANSFE,,50000.00,1367228.69,Byrne,725,France,141476.56,1,1,1
1389,2011,7,MORTGAGE,3,Low,1,35000, 60 months,2,debt_consolidation,6,Low,1,Good Loan,0,11.71,B,2,16.63,37883.74,26960.83,0,773.44,409000001388,11-Aug-17,FDRL/INTERNAL FUND TRANSFE,,50000.00,1417228.69,McIntyre,630,France,60032.46,1,1,1
1390,2011,3,OWN,2,Low,1,5500, 36 months,1,home_improvement,7,Low,1,Good Loan,0,10.65,B,2,22.3,6447.914936,5500,0,179.16,409000001389,14-Aug-17,BBPS SETMNT FOR DT 110820,"393,022.08",,1024206.61,Aitken,627,France,100686.11,1,1,1
1391,2011,7,MORTGAGE,3,Low,1,6500, 36 months,1,other,4,Low,1,Good Loan,0,8.9,A,1,23.82,6999.01,6500,0,206.4,409000001390,16-Aug-17,BBPS SETMNT FOR DT 160820,"320,215.84",,703990.77,Macintyre,653,France,96429.29,1,1,1
1392,2011,10,RENT,1,Low,1,12000, 36 months,1,debt_consolidation,6,Low,1,Good Loan,0,10.65,B,2,23.33,14067.91196,12000,0,390.88,409000001391,16-Aug-17,FDRL/INTERNAL FUND TRANSFE,,50000.00,753990.77,Simpson,775,Germany,15795.88,1,1,1
1393,2011,4,RENT,1,Low,1,12000, 36 months,1,small_business,3,Low,1,Good Loan,0,7.9,A,1,1.03,12520.52,12000,0,375.49,409000001392,16-Aug-17,FDRL/INTERNAL FUND TRANSFE,,100000.00,853990.77,Simpson,794,Spain,116547.31,1,1,1
1394,2011,6,MORTGAGE,3,Low,1,4000, 36 months,1,debt_consolidation,6,Low,1,Bad Loan,1,12.69,B,2,23.23,3881.86,3091.94,0,134.18,409000001393,16-Aug-17,FDRL/INTERNAL FUND TRANSFE,,50000.00,903990.77,Metcalfe,831,France,191260.74,1,1,1
1395,2011,2,RENT,1,Low,1,1000, 36 months,1,major_purchase,8,High,2,Good Loan,0,13.49,C,3,18.52,1220.588405,1000,0,33.94,409000001394,16-Aug-17,FDRL/INTERNAL FUND TRANSFE,,50000.00,953990.77,Lees,561,France,173870.39,1,1,1
1396,2011,6,MORTGAGE,3,Low,1,25000, 36 months,1,debt_consolidation,6,Low,1,Good Loan,0,12.42,B,2,11.78,30154.5565,25000,0,835.39,409000001395,17-Aug-17,BBPS SETMNT FOR DT 170820,"284,668.24",,669322.53,Zetticci,705,Spain,117273.35,1,1,1
1397,2011,10,OWN,2,Low,1,9000, 36 months,1,debt_consolidation,6,Low,1,Good Loan,0,12.69,B,2,6.92,9991.09,9000,0,301.91,409000001396,17-Aug-17,TRF FRM  Indiaforensic SERVICES,,300000.00,969322.53,Dale,636,Spain,92277.47,1,1,1
1398,2011,10,RENT,1,Low,1,8575, 36 months,1,debt_consolidation,6,High,2,Good Loan,0,15.27,C,3,24.58,9377.28,8575,0,298.4,409000001397,18-Aug-17,BBPS SETMNT FOR DT 180820,"173,738.94",,795583.59,Byrne,487,Germany,44244.49,1,1,1
1399,2011,5,MORTGAGE,3,Low,1,5400, 36 months,1,medical,9,Low,1,Good Loan,0,7.9,A,1,17.31,5984.15,5400,0,168.97,409000001398,18-Aug-17,TRF FROM  Indiaforensic SERVICES,,700000.00,1495583.59,Praed,693,France,78133.48,1,1,1
1400,2011,5,RENT,1,Low,1,10000, 36 months,1,debt_consolidation,6,High,2,Good Loan,0,17.27,D,4,12.62,12878.87163,10000,0,357.88,409000001399,19-Aug-17,BBPS SETMNT FOR DT 190820,"312,417.98",,1183165.61,Laurens,517,Spain,103402.88,1,1,1
1401,2011,1,RENT,1,Low,1,6000, 36 months,1,debt_consolidation,6,High,2,Bad Loan,1,13.49,C,3,17.81,4048.28,2854.22,190.67,203.59,409000001400,21-Aug-17,BBPS SETMNT FOR DT 210820,"192,034.74",,991130.87,Woods,684,France,137835.82,1,1,1
1402,2011,4,RENT,1,Low,1,10000, 36 months,1,debt_consolidation,6,High,2,Good Loan,0,14.65,C,3,16.44,12416.05656,10000,0,344.95,409000001401,22-Aug-17,BBPS SETMNT FOR DT 220820,"197,829.48",,793301.39,Bykov,620,Spain,20670.10,1,1,1
1403,2011,0.5,RENT,1,Low,1,2575, 36 months,1,debt_consolidation,6,High,2,Bad Loan,1,15.96,C,3,19.67,1101.48,659.04,109.72,90.48,409000001402,22-Aug-17,TRF FROM  Indiaforensic SERVICES,,300000.00,1093301.39,Vorobyova,757,France,77469.38,1,1,1
1404,2011,0.5,MORTGAGE,3,Low,1,10000, 36 months,1,debt_consolidation,6,Low,1,Good Loan,0,9.91,B,2,5.34,11599.24761,10000,0,322.25,409000001403,23-Aug-17,BBPS SETMNT FOR DT 230820,"196,623.90",,896677.49,Pirogova,739,France,57572.38,1,1,1
1405,2011,6.05,RENT,1,Low,1,8000, 36 months,1,home_improvement,7,Low,1,Bad Loan,1,9.91,B,2,19.9,4387.49,3257.79,272.13,257.8,409000001404,24-Aug-17,BBPS SETMNT FOR DT 240820,"238,134.06",,658543.43,Sturt,662,Spain,75884.65,1,1,1
1406,2011,1,RENT,1,Low,1,12000, 60 months,2,small_business,3,High,2,Good Loan,0,18.64,E,5,14.37,17874.34292,12000,0,308.92,409000001405,24-Aug-17,TRF FROM  Indiaforensic SERVICES,,1000000.00,1658543.43,Panicucci,359,France,146955.71,1,1,1
1407,2011,2,OWN,2,Low,1,12000, 36 months,1,major_purchase,8,High,2,Good Loan,0,13.49,C,3,16.73,13502.07,12000,0,407.17,409000001406,25-Aug-17,BBPS SETMNT FOR DT 250820,"110,264.22",,1548279.21,Cook,572,Spain,67040.12,1,1,1
1408,2011,10,MORTGAGE,3,Low,1,10000, 36 months,1,debt_consolidation,6,Low,1,Good Loan,0,8.9,A,1,16.11,11429.10568,10000,0,317.54,409000001407,28-Aug-17,BBPS SETMNT FOR DT 280820,"292,705.76",,1255573.45,Hardy,721,France,178418.35,1,1,1
1409,2011,10,MORTGAGE,3,Low,1,6000, 36 months,1,debt_consolidation,6,High,2,Bad Loan,1,15.96,C,3,24.85,2587.54,1532.7,256.34,210.83,409000001408,29-Aug-17,BBPS SETMNT FOR DT 290820,"162,675.20",,1092898.25,Chu,707,France,30807.02,1,1,1
1410,2011,3,MORTGAGE,3,Low,1,12600, 60 months,2,home_improvement,7,High,2,Good Loan,0,14.27,C,3,16.87,16581.10087,12600,0,294.95,409000001409,30-Aug-17,BBPS SETMNT FOR DT 300820,"163,053.01",,929845.24,Franklin,444,France,143835.76,1,1,1
1411,2011,6.05,OWN,2,Low,1,10000, 36 months,1,credit_card,1,Low,1,Good Loan,0,6.03,A,1,17.42,10953.65655,10000,0,304.36,409000001410,31-Aug-17,BBPS SETMNT FOR DT 310820,"135,399.38",,794445.86,P'eng,523,France,130883.90,1,1,1
1412,2011,1,RENT,1,Low,1,14000, 60 months,2,car,2,High,2,Bad Loan,1,17.27,D,4,5.35,14349.18,8209.42,18.2,349.98,409000001411,31-Aug-17,TRF FROM  Indiaforensic SERVICES,,300000.00,1094445.86,Chiang,685,Germany,194343.72,1,1,1
1413,2011,2,RENT,1,Low,1,5000, 36 months,1,vacation,11,Low,1,Good Loan,0,12.69,B,2,18.98,5428.66,5000,0,167.73,409000001412,1-Sep-17,BBPS SETMNT FOR DT 010920,"95,113.98",,999331.88,Grant,673,Germany,9796.69,1,1,1
1414,2011,10,RENT,1,Low,1,10000, 36 months,1,credit_card,1,Low,1,Good Loan,0,9.91,B,2,14.98,11598.30817,10000,0,322.25,409000001413,1-Sep-17,TRF FROM  Indiaforensic SERVICES,,300000.00,1299331.88,Udobata,503,Germany,47310.24,1,1,1
1415,2011,7,MORTGAGE,3,Low,1,15000, 60 months,2,credit_card,1,Low,1,Good Loan,0,11.71,B,2,4.52,17666.13,14999.99,0,331.48,409000001414,4-Sep-17,BBPS SETMNT FOR DT 040920,"215,378.07",,1083953.81,Siciliani,485,Germany,141148.21,1,1,1
1416,2011,5,RENT,1,Low,1,6000, 36 months,1,car,2,High,2,Good Loan,0,15.27,C,3,2.77,6904.51,6000,0,208.79,409000001415,5-Sep-17,BBPS SETMNT FOR DT 050920,"139,586.04",,944367.77,Evans,799,Germany,111138.25,1,1,1
1417,2011,7,RENT,1,Low,1,5450, 36 months,1,debt_consolidation,6,Low,1,Good Loan,0,7.9,A,1,7.42,6138.345492,5450,0,170.54,409000001416,5-Sep-17,TRF FROM  Indiaforensic SERVICES,,200000.00,1144367.77,Young,585,Spain,114182.07,1,1,1
1418,2011,10,MORTGAGE,3,Low,1,13500, 36 months,1,debt_consolidation,6,Low,1,Good Loan,0,9.91,B,2,20.34,15298.22,13500,0,435.04,409000001417,6-Sep-17,BBPS SETMNT FOR DT 060920,"51,906.35",,1092461.42,Mitchell,607,Germany,127560.77,1,1,1
1419,2011,4,RENT,1,Low,1,20000, 60 months,2,debt_consolidation,6,High,2,Bad Loan,1,14.27,C,3,10.16,6219.3,2471.52,1006.13,468.17,409000001418,7-Sep-17,BBPS SETMNT FOR DT 070920,"103,643.52",,988817.90,Lucchese,521,Germany,18082.06,1,1,1
1420,2011,0.5,RENT,1,Low,1,3000, 60 months,2,other,4,Low,1,Good Loan,0,12.42,B,2,18.23,3180.64,3000,0,67.38,409000001419,8-Sep-17,BBPS SETMNT FOR DT 080920,"103,607.47",,885210.43,Hewitt,535,France,136330.26,1,1,1
1421,2011,10,RENT,1,Low,1,5000, 36 months,1,other,4,Low,1,Good Loan,0,9.91,B,2,9.45,5484.24,5000,0,161.13,409000001420,8-Sep-17,TRF FROM  Indiaforensic SERVICES,,700000.00,1585210.43,K'ung,724,Spain,34121.81,1,1,1
1422,2011,9,MORTGAGE,3,Low,1,7000, 36 months,1,small_business,3,Low,1,Good Loan,0,6.62,A,1,5.89,7735.523825,7000,0,214.93,409000001421,11-Sep-17,BBPS SETMNT FOR DT 110920,"248,270.54",,1336939.89,Swaim,520,Germany,56246.69,1,1,1
1423,2011,6.05,OWN,2,Low,1,16000, 60 months,2,credit_card,1,High,2,Good Loan,0,17.58,D,4,12.83,19298.6,11584.24,0,402.65,409000001422,12-Sep-17,BBPS SETMNT FOR DT 120920,"198,397.74",,1138542.15,Quinones,696,Spain,191417.42,1,1,1
1424,2011,4,OWN,2,Low,1,3800, 36 months,1,other,4,Low,1,Good Loan,0,6.03,A,1,21.32,4104.1,3800,0,115.66,409000001423,13-Sep-17,BBPS SETMNT FOR DT 130920,"185,118.88",,953423.27,Kennedy,657,Germany,23317.88,1,1,1
1425,2011,10,RENT,1,Medium,2,28000, 36 months,1,debt_consolidation,6,Low,1,Good Loan,0,8.9,A,1,19.28,32002.71788,28000,0,889.09,409000001424,14-Sep-17,BBPS SETMNT FOR DT 140920,"153,981.32",,799441.95,Endrizzi,603,Spain,144675.30,1,1,1
1426,2011,7,MORTGAGE,3,Low,1,15000, 60 months,2,debt_consolidation,6,High,2,Bad Loan,1,15.27,C,3,24.58,15755.34,9811.07,0,358.98,409000001425,15-Sep-17,BBPS SETMNT FOR DT 150920,"135,500.36",,663941.59,Ludowici,726,France,175161.05,1,1,1
1427,2011,5,RENT,1,Low,1,6000, 36 months,1,debt_consolidation,6,High,2,Good Loan,0,14.27,C,3,1.27,7392.290712,6000,0,205.86,409000001426,15-Sep-17,TRF FROM  Indiaforensic SERVICES,,500000.00,1163941.59,Larson,591,France,14928.80,1,1,1
1428,2011,3,RENT,1,Low,1,4000, 36 months,1,medical,9,Low,1,Good Loan,0,12.42,B,2,19.35,4825.255774,4000,0,133.67,409000001427,16-Sep-17,BBPS SETMNT FOR DT 160920,"136,074.51",,1027867.08,Chigolum,792,Germany,161479.19,1,1,1
1429,2011,6.05,OWN,2,Low,1,15000, 36 months,1,debt_consolidation,6,High,2,Good Loan,0,17.58,D,4,19.1,19144.49772,15000,0,539.14,409000001428,18-Sep-17,BBPS SETMNT FOR DT 180920,"249,806.20",,778060.88,Maclean,550,France,133501.94,1,1,1
1430,2011,6,RENT,1,Low,1,7500, 36 months,1,debt_consolidation,6,High,2,Good Loan,0,14.27,C,3,16,9258.646088,7500,0,257.32,409000001429,18-Sep-17,TRF FRM  Indiaforensic SERVICES,,300000.00,1078060.88,Lu,601,France,23703.52,1,1,1
1431,2011,3,RENT,1,Low,1,12000, 36 months,1,debt_consolidation,6,Low,1,Good Loan,0,6.03,A,1,16.63,13109.59476,12000,0,365.23,409000001430,19-Sep-17,BBPS SETMNT FOR DT 190920,"209,833.19",,868227.69,Tuan,820,France,115985.38,1,1,1
1432,2011,6.05,RENT,1,Low,1,2125, 36 months,1,credit_card,1,Low,1,Good Loan,0,8.9,A,1,21.6,2428.481592,2125,0,67.48,409000001431,20-Sep-17,BBPS SETMNT FOR DT 200920,"128,161.28",,740066.41,Glover,667,France,43229.20,1,1,1
1433,2011,10,RENT,1,Low,1,25000, 60 months,2,credit_card,1,High,2,Bad Loan,1,21.28,F,6,19.25,8162.16,3137.29,0,680.28,409000001432,20-Sep-17,TRF FROM  Indiaforensic SERVICES,,300000.00,1040066.41,Landman,573,Spain,94862.93,1,1,1
1434,2011,0.5,RENT,1,Low,1,7200, 36 months,1,debt_consolidation,6,Low,1,Bad Loan,1,11.71,B,2,22.06,2235.36,1387.04,334.08,238.15,409000001433,21-Sep-17,BBPS SETMNT FOR DT 210920,"162,881.70",,877184.71,Trevisano,755,France,142377.69,1,1,1
1435,2011,10,MORTGAGE,3,Medium,2,10000, 36 months,1,debt_consolidation,6,Low,1,Good Loan,0,12.69,B,2,18.88,12019.75633,10000,0,335.45,409000001434,22-Sep-17,BBPS SETMNT FOR DT 220920,"144,857.19",,732327.52,Longo,552,France,135635.25,1,1,1
1436,2011,10,RENT,1,Low,1,7000, 36 months,1,debt_consolidation,6,High,2,Good Loan,0,16.77,D,4,17.42,8938.220419,7000,0,248.77,409000001435,22-Sep-17,TRF FRM  Indiaforensic SERVICES,,500000.00,1232327.52,K?,598,Spain,148487.90,1,1,1
1437,2011,3,RENT,1,Low,1,14000, 36 months,1,debt_consolidation,6,Low,1,Good Loan,0,10.65,B,2,15.38,16414.03115,14000,0,456.03,409000001436,25-Sep-17,BBPS SETMNT FOR DT 250920,"364,716.38",,867611.14,Muir,576,Germany,58976.85,1,1,1
1438,2011,10,MORTGAGE,3,Medium,2,6000, 36 months,1,house,12,Low,1,Good Loan,0,7.9,A,1,4.07,6757.848607,6000,0,187.75,409000001437,25-Sep-17,NEFT/FDRL666621043/ONE 97,,2624.66,870235.80,Alexeyeva,670,France,76254.83,1,1,1
1439,2011,1,OWN,2,Low,1,8000, 36 months,1,debt_consolidation,6,Low,1,Good Loan,0,7.9,A,1,15.78,9010.746084,8000,0,250.33,409000001438,25-Sep-17,TRF FRM  Indiaforensic SERVICES,,300000.00,1170235.80,Norman,504,Germany,55857.48,1,1,1
1440,2011,0.5,MORTGAGE,3,Low,1,3000, 36 months,1,credit_card,1,Low,1,Good Loan,0,8.9,A,1,12.22,3142.5,3000,0,95.26,409000001439,26-Sep-17,BBPS SETMNT FOR DT 260920,"182,120.07",,988115.73,Simmons,778,France,77867.23,1,1,1
1441,2011,10,RENT,1,Low,1,22000, 60 months,2,debt_consolidation,6,Low,1,Good Loan,0,12.69,B,2,15.81,24319.2,16842.97,0,497.09,409000001440,27-Sep-17,BBPS SETMNT FOR DT 270920,"234,319.90",,753795.83,Chukwualuka,558,Germany,22878.16,1,1,1
1442,2011,3,RENT,1,Low,1,10000, 36 months,1,debt_consolidation,6,Low,1,Good Loan,0,12.42,B,2,9.51,12026.13386,10000,0,334.16,409000001441,27-Sep-17,TRF FRM  Indiaforensic SERVICES,,500000.00,1253795.83,McCall,627,Spain,114469.55,1,1,1
1443,2011,2,MORTGAGE,3,Low,1,5000, 36 months,1,debt_consolidation,6,High,2,Bad Loan,1,14.27,C,3,19.54,5135.57,3841.27,178.04,171.55,409000001442,28-Sep-17,BBPS SETMNT FOR DT 280920,"245,871.02",,1007924.81,Moore,683,France,96754.80,1,1,1
1444,2011,0.5,MORTGAGE,3,Low,1,6000, 36 months,1,credit_card,1,Low,1,Good Loan,0,9.91,B,2,21.64,6943.207895,6000,0,193.35,409000001443,29-Sep-17,BBPS SETMNT FOR DT 290920,"157,424.01",,850500.80,Ingram,556,France,125154.57,1,1,1
1445,2011,2,RENT,1,Low,1,5500, 36 months,1,debt_consolidation,6,Low,1,Bad Loan,1,7.51,A,1,16.73,1616.88,1114.76,251.68,171.11,409000001444,29-Sep-17,FDRL/INTERNAL FUND TRANSFE,,200000.00,1050500.80,Okeke,583,France,113597.64,1,1,1
1446,2011,10,MORTGAGE,3,Low,1,6000, 36 months,1,debt_consolidation,6,Low,1,Good Loan,0,6.62,A,1,4.23,6033.4,6000,0,184.23,409000001445,29-Sep-17,FDRL/INTERNAL FUND TRANSFE,,200000.00,1250500.80,Shao,705,France,121408.55,1,1,1
1447,2011,5,RENT,1,Low,1,10000, 36 months,1,debt_consolidation,6,Low,1,Good Loan,0,12.42,B,2,19.33,12027.01816,10000,0,334.16,409000001446,29-Sep-17,FDRL/INTERNAL FUND TRANSFE,,200000.00,1450500.80,Iloabuchi,637,France,109219.43,1,1,1
1448,2011,3,RENT,1,Low,1,5000, 36 months,1,other,4,Low,1,Good Loan,0,9.91,B,2,7.49,5367.13,5000,0,161.13,409000001447,29-Sep-17,FDRL/INTERNAL FUND TRANSFE,,200000.00,1650500.80,Nebechukwu,697,Spain,50230.31,1,1,1
1449,2011,6,RENT,1,Low,1,4000, 36 months,1,home_improvement,7,Low,1,Good Loan,0,11.71,B,2,15.12,4759.225165,4000,0,132.31,409000001448,29-Sep-17,FDRL/INTERNAL FUND TRANSFE,,200000.00,1850500.80,Diribe,555,Germany,177719.88,1,1,1
1450,2011,10,RENT,1,Low,1,8000, 36 months,1,credit_card,1,Low,1,Good Loan,0,7.9,A,1,8.5,9010.453531,8000,0,250.33,409000001449,3-Oct-17,BBPS SETMNT FOR DT 031020,"270,162.95",,1580337.85,Macgroarty,594,Germany,131211.86,1,1,1
1451,2011,3,MORTGAGE,3,Low,1,6000, 60 months,2,debt_consolidation,6,Low,1,Bad Loan,1,11.71,B,2,21.99,2514.92,1358.51,266.5,132.59,409000001450,4-Oct-17,BBPS SETMNT FOR DT 041020,"181,195.86",,1399141.99,Artemova,632,Spain,82152.83,1,1,1
1452,2011,10,OWN,2,Low,1,12000, 36 months,1,debt_consolidation,6,Low,1,Good Loan,0,6.03,A,1,4.35,13147.62077,12000,0,365.23,409000001451,5-Oct-17,BBPS SETMNT FOR DT 051020,"161,169.73",,1237972.26,McDonald,551,France,216.27,1,1,1
1453,2011,5,MORTGAGE,3,Low,1,9500, 36 months,1,credit_card,1,Low,1,Good Loan,0,7.51,A,1,21.83,10638.14474,9500,0,295.56,409000001452,6-Oct-17,BBPS SETMNT FOR DT 061020,"89,091.32",,1148880.94,Mazzanti,687,France,1713.10,1,1,1
1454,2011,10,RENT,1,Low,1,15600, 60 months,2,credit_card,1,High,2,Bad Loan,1,14.27,C,3,11.54,17510.18,11528.6,0,365.18,409000001453,7-Oct-17,BBPS SETMNT FOR DT 071020,"178,893.40",,969987.54,Kelly,672,France,136910.18,1,1,1
1455,2011,3,RENT,1,Low,1,10000, 36 months,1,other,4,High,2,Good Loan,0,18.25,D,4,20.64,10446.04,10000,0,362.78,409000001454,9-Oct-17,BBPS SETMNT FOR DT 091020,"214,144.33",,755843.21,Davison,521,Spain,20243.97,1,1,1
1456,2011,7,RENT,1,Low,1,12000, 36 months,1,credit_card,1,High,2,Good Loan,0,14.65,C,3,15.98,14182.91,12000,0,413.94,409000001455,9-Oct-17,FDRL/INTERNAL FUND TRANSFE,,300000.00,1055843.21,Reilly,686,Germany,86043.27,1,1,1
1457,2011,4,RENT,1,Low,1,10000, 60 months,2,debt_consolidation,6,High,2,Good Loan,0,18.25,D,4,20.46,12112.78,10000,0,255.3,409000001456,10-Oct-17,BBPS SETMNT FOR DT 101020,"282,299.66",,773543.55,Ojiofor,639,Spain,126561.07,1,1,1
1458,2011,10,MORTGAGE,3,Low,1,25000, 60 months,2,debt_consolidation,6,High,2,Good Loan,0,18.64,E,5,17.5,28341.74,25000,0,643.58,409000001457,11-Oct-17,FDRL/INTERNAL FUND TRANSFE,,300000.00,1073543.55,Shelton,850,France,64350.80,1,1,1
1459,2011,0.5,RENT,1,Low,1,5300, 36 months,1,debt_consolidation,6,High,2,Good Loan,0,15.27,C,3,21.96,6533.974863,5300,0,184.43,409000001458,11-Oct-17,BBPS SETMNT FOR DT 111020,"114,192.42",,959351.13,Lange,465,France,10472.31,1,1,1
1460,2011,5,MORTGAGE,3,Low,1,8000, 36 months,1,debt_consolidation,6,High,2,Good Loan,0,13.49,C,3,9.5,9606.64343,8000,0,271.45,409000001459,12-Oct-17,BBPS SETMNT FOR DT 121020,"115,110.46",,844240.67,Trentini,817,France,95941.55,1,1,1
1461,2011,3,OWN,2,Low,1,1000, 36 months,1,other,4,High,2,Good Loan,0,15.27,C,3,21.91,1252.69,999.99,0,34.8,409000001460,13-Oct-17,BBPS SETMNT FOR DT 131020,"176,862.77",,667377.90,Gardiner,578,France,125222.36,1,1,1
1462,2011,3,MORTGAGE,3,Low,1,3800, 36 months,1,car,2,Low,1,Good Loan,0,6.62,A,1,12.07,4185.576407,3800,0,116.68,409000001461,13-Oct-17,FDRL/INTERNAL FUND TRANSFE,,300000.00,967377.90,Wan,611,Spain,170950.58,1,1,1
1463,2011,7,RENT,1,Low,1,20000, 36 months,1,debt_consolidation,6,Low,1,Good Loan,0,7.9,A,1,10.7,22527.42088,20000,0,625.81,409000001462,13-Oct-17,FDRL/INTERNAL FUND TRANSFE,,300000.00,1267377.90,Hsu,616,Germany,236.45,1,1,1
1464,2011,7,MORTGAGE,3,Low,1,4200, 36 months,1,car,2,Low,1,Good Loan,0,6.62,A,1,19.84,4640.468526,4200,0,128.96,409000001463,16-Oct-17,BBPS SETMNT FOR DT 161020,"338,660.26",,928717.64,Hovell,517,France,31517.16,1,1,1
1465,2011,10,MORTGAGE,3,Low,1,3500, 36 months,1,credit_card,1,Low,1,Good Loan,0,6.03,A,1,10.66,3834.599645,3500,0,106.53,409000001464,17-Oct-17,BBPS SETMNT FOR DT 171020,"197,665.59",,731052.05,Zhirov,637,Spain,181610.60,1,1,1
1466,2011,2,RENT,1,Low,1,6000, 36 months,1,other,4,Low,1,Bad Loan,1,12.69,B,2,19.04,1501.91,847.91,295.97,201.27,409000001465,17-Oct-17,FDRL/INTERNAL FUND TRANSFE,,200000.00,931052.05,Espinosa,806,France,156593.09,1,1,1
1467,2011,10,MORTGAGE,3,Medium,2,15000, 60 months,2,home_improvement,7,Low,1,Good Loan,0,12.42,B,2,6.79,19091.13848,15000,0,336.86,409000001466,17-Oct-17,FDRL/INTERNAL FUND TRANSFE,,300000.00,1231052.05,Wallace,633,France,4272.00,1,1,1
1468,2011,0.5,MORTGAGE,3,High,3,30000, 60 months,2,other,4,High,2,Bad Loan,1,20.3,E,5,8.5,5780.42,1828.29,985.64,799.84,409000001467,18-Oct-17,BBPS SETMNT FOR DT 181020,"147,757.43",,1083294.62,Barbour,624,Germany,163587.90,1,1,1
1469,2011,10,OWN,2,Low,1,18000, 60 months,2,debt_consolidation,6,High,2,Good Loan,0,15.27,C,3,28.83,25432.12003,18000,0,430.78,409000001468,18-Oct-17,FDRL/INTERNAL FUND TRANSFE,,200000.00,1283294.62,Ozerova,691,France,175843.68,1,1,1
1470,2011,1,RENT,1,Low,1,10000, 36 months,1,credit_card,1,Low,1,Good Loan,0,10.65,B,2,13.47,11351.74,10000.01,0,325.74,409000001469,18-Oct-17,FDRL/INTERNAL FUND TRANSFE,,300000.00,1583294.62,Wright,819,Germany,166164.30,1,1,1
1471,2011,9,MORTGAGE,3,Low,1,6500, 36 months,1,credit_card,1,Low,1,Good Loan,0,8.9,A,1,26.68,7239.04,6500,0,206.4,409000001470,19-Oct-17,BBPS SETMNT FOR DT 191020,"118,763.54",,1464531.08,Ulyanova,568,Germany,61796.64,1,1,1
1472,2011,4,RENT,1,Low,1,25000, 60 months,2,moving,10,Low,1,Good Loan,0,11.71,B,2,1.66,27050.26,19251.79,0,552.46,409000001471,20-Oct-17,BBPS SETMNT FOR DT 201020,"36,239.71",,1428291.37,Steiner,806,France,21439.49,1,1,1
1473,2011,1,RENT,1,Low,1,15000, 60 months,2,credit_card,1,High,2,Bad Loan,1,13.49,C,3,18.46,8449.63,3922.42,1566.03,345.08,409000001472,21-Oct-17,BBPS SETMNT FOR DT 211020,"61,013.30",,1367278.07,Akabueze,726,Spain,19225.85,1,1,1
1474,2011,3,RENT,1,Low,1,22000, 60 months,2,credit_card,1,High,2,Good Loan,0,16.77,D,4,20.79,27456.92,22000.01,0,544.04,409000001473,23-Oct-17,BBPS SETMNT FOR DT 231020,"154,823.14",,1212454.93,Aleksandrova,552,France,132547.02,1,1,1
1475,2011,3,RENT,1,Low,1,9600, 36 months,1,other,4,High,2,Bad Loan,1,17.27,D,4,24.09,3195.91,1725.63,451.83,343.56,409000001474,24-Oct-17,BBPS SETMNT FOR DT 241020,"201,777.25",,1010677.68,Pinto,755,Germany,62688.55,1,1,1
1476,2011,10,RENT,1,Low,1,14650, 60 months,2,debt_consolidation,6,High,2,Good Loan,0,22.35,F,6,22.58,19929.06,10612.73,0,407.54,409000001475,25-Oct-17,FDRL/INTERNAL FUND TRANSFE,,200000.00,1210677.68,Griffiths,634,France,21760.96,1,1,1
1477,2011,10,RENT,1,Low,1,11250, 60 months,2,wedding,5,Low,1,Good Loan,0,12.69,B,2,16.27,14365.26439,11250,0,254.2,409000001476,25-Oct-17,BBPS SETMNT FOR DT 251020,"289,604.87",,921072.81,McNeil,756,France,154460.68,1,1,1
1478,2011,2,MORTGAGE,3,Medium,2,31000, 36 months,1,credit_card,1,High,2,Good Loan,0,19.42,E,5,13.47,41141.10814,31000,0,1142.94,409000001477,26-Oct-17,BBPS SETMNT FOR DT 261020,"203,242.03",,717830.78,Bruno,776,France,8065.00,1,1,1
1479,2011,4,MORTGAGE,3,Low,1,14000, 36 months,1,credit_card,1,High,2,Good Loan,0,17.58,D,4,14.75,18108.18913,14000,0,503.19,409000001478,26-Oct-17,FDRL/INTERNAL FUND TRANSFE,,300000.00,1017830.78,Johnson,649,France,173365.90,1,1,1
1480,2011,8,RENT,1,Low,1,9000, 36 months,1,debt_consolidation,6,Low,1,Good Loan,0,10.65,B,2,19.76,10550.96769,9000,0,293.16,409000001479,27-Oct-17,BBPS SETMNT FOR DT 271020,"98,594.43",,919236.35,Okorie,595,Germany,69428.79,1,1,1
1481,2011,5,MORTGAGE,3,Low,1,6500, 36 months,1,small_business,3,Low,1,Good Loan,0,10.65,B,2,15.41,7620.758021,6500,0,211.73,409000001480,27-Oct-17,FDRL/INTERNAL FUND TRANSFE,,200000.00,1119236.35,Moen,646,France,12757.14,1,1,1
1482,2011,1,MORTGAGE,3,Low,1,16500, 36 months,1,credit_card,1,Low,1,Good Loan,0,12.69,B,2,12.28,19939.73602,16500,0,553.49,409000001481,27-Oct-17,FDRL/INTERNAL FUND TRANSFE,,300000.00,1419236.35,McGuigan,592,Spain,180426.20,1,1,1
1483,2011,10,MORTGAGE,3,Low,1,14000, 36 months,1,credit_card,1,Low,1,Good Loan,0,10.65,B,2,8.58,16374.55453,14000,0,456.03,409000001482,27-Oct-17,FDRL/INTERNAL FUND TRANSFE,,300000.00,1719236.35,Fancher,574,France,43093.67,1,1,1
1484,2011,4,MORTGAGE,3,Low,1,25000, 60 months,2,other,4,Low,1,Good Loan,0,12.69,B,2,0.32,26190.82,25000,0,564.87,409000001483,30-Oct-17,BBPS SETMNT FOR DT 301020,"322,374.79",,1396861.56,Matthews,850,France,68594.00,1,1,1
1485,2011,0.5,RENT,1,Low,1,5600, 36 months,1,debt_consolidation,6,High,2,Good Loan,0,13.49,C,3,24.04,6748.182212,5600,0,190.02,409000001484,31-Oct-17,BBPS SETMNT FOR DT 311020,"148,633.99",,1248227.57,Kaeppel,850,Spain,197996.65,1,1,1
1486,2011,5,RENT,1,Low,1,10000, 36 months,1,debt_consolidation,6,High,2,Good Loan,0,13.49,C,3,12.95,12212.78293,10000,0,339.31,409000001485,1-Nov-17,BBPS SETMNT FOR DT 011120,"131,475.17",,1116752.40,Shih,475,France,122953.00,1,1,1
1487,2011,10,RENT,1,Low,1,25000, 60 months,2,debt_consolidation,6,High,2,Good Loan,0,21.28,F,6,19.11,27174.64,25000,0,680.28,409000001486,2-Nov-17,BBPS SETMNT FOR DT 021120,"126,718.38",,990034.02,Yudina,642,France,76821.24,1,1,1
1488,2011,3,RENT,1,Low,1,5000, 36 months,1,moving,10,Low,1,Good Loan,0,10.65,B,2,8.16,5861.939896,4999.99,0,162.87,409000001487,2-Nov-17,FDRL/INTERNAL FUND TRANSFE,,300000.00,1290034.02,Akabueze,710,Spain,141400.51,1,1,1
1489,2011,1,RENT,1,Low,1,3600, 36 months,1,debt_consolidation,6,Low,1,Bad Loan,1,6.62,A,1,21.54,2321.34,2004.17,10.29,110.54,409000001488,3-Nov-17,BBPS SETMNT FOR DT 031120,"111,962.51",,1178071.51,Kornilova,596,Spain,41921.75,1,1,1
1490,2011,3,RENT,1,Low,1,10800, 36 months,1,credit_card,1,High,2,Good Loan,0,14.27,C,3,15.58,13268.87456,10800,0,370.54,409000001489,3-Nov-17,FDRL/INTERNAL FUND TRANSFE,,300000.00,1478071.51,Ozioma,609,France,175664.25,1,1,1
1491,2011,4,RENT,1,Low,1,4800, 36 months,1,debt_consolidation,6,High,2,Good Loan,0,14.65,C,3,11.59,5961.100639,4800,0,165.58,409000001490,4-Nov-17,BBPS SETMNT FOR DT 041120,"110,902.77",,1367168.74,Su,797,Spain,117916.63,1,1,1
1492,2011,1,RENT,1,Low,1,6075, 60 months,2,small_business,3,High,2,Good Loan,0,17.27,D,4,5.97,7285.93,4405.99,0,151.87,409000001491,6-Nov-17,BBPS SETMNT FOR DT 061120,"150,019.78",,1217148.96,Jamison,504,Germany,194690.77,1,1,1
1493,2011,4,RENT,1,Low,1,9600, 36 months,1,other,4,Low,1,Good Loan,0,7.9,A,1,20.91,10813.19505,9600,0,300.39,409000001492,7-Nov-17,BBPS SETMNT FOR DT 071120,"147,817.96",,1069331.00,Esposito,735,Spain,166677.35,1,1,1
1494,2011,3,OWN,2,Medium,2,5200, 36 months,1,debt_consolidation,6,High,2,Good Loan,0,14.65,C,3,14.54,6470.890278,5200,0,179.37,409000001493,8-Nov-17,BBPS SETMNT FOR DT 081120,"159,473.08",,909857.92,Hardiman,680,Spain,160131.58,1,1,1
1495,2011,10,RENT,1,Low,1,11000, 36 months,1,credit_card,1,Low,1,Good Loan,0,7.51,A,1,15.16,12342.09573,11000,0,342.22,409000001494,9-Nov-17,BBPS SETMNT FOR DT 091120,"131,508.96",,778348.96,Woodard,449,France,123622.00,1,1,1
1496,2011,3,MORTGAGE,3,Medium,2,35000, 60 months,2,debt_consolidation,6,High,2,Good Loan,0,14.27,C,3,22.06,46605.80997,35000,0,819.3,409000001495,9-Nov-17,FDRL/INTERNAL FUND TRANSFE,,300000.00,1078348.96,Chienezie,685,Germany,113483.96,1,1,1
1497,2011,10,MORTGAGE,3,Low,1,11000, 36 months,1,debt_consolidation,6,Low,1,Good Loan,0,6.03,A,1,15.33,12052.12415,11000,0,334.8,409000001496,10-Nov-17,BBPS SETMNT FOR DT 101120,"156,605.52",,921743.44,Okwuadigbo,569,Spain,79618.79,1,1,1
1498,2011,10,OWN,2,Low,1,20500, 60 months,2,small_business,3,Low,1,Bad Loan,1,10.65,B,2,2.29,21181.83,15461.81,0,442.15,409000001497,10-Nov-17,FDRL/INTERNAL FUND TRANSFE,,300000.00,1221743.44,Chineze,631,France,24472.23,1,1,1
1499,2011,3,RENT,1,Low,1,15000, 60 months,2,debt_consolidation,6,High,2,Good Loan,0,18.25,D,4,13.41,22523.20004,15000,0,382.95,409000001498,13-Nov-17,BBPS SETMNT FOR DT 131120,"367,421.58",,854321.86,O'Brien,595,Germany,177025.79,1,1,1
1500,2011,10,RENT,1,Low,1,8475, 36 months,1,debt_consolidation,6,Low,1,Bad Loan,1,12.69,B,2,22.27,9616.14,7735.31,115.58,284.3,409000001499,13-Nov-17,FDRL/INTERNAL FUND TRANSFE,,300000.00,1154321.86,Tao,461,France,103349.74,1,1,1
1501,2011,0.5,RENT,1,Low,1,9250, 36 months,1,credit_card,1,High,2,Good Loan,0,14.65,C,3,24.96,11316.56813,9250,0,319.08,409000001500,14-Nov-17,BBPS SETMNT FOR DT 141120,"231,316.89",,923004.97,Mao,630,France,63606.22,1,1,1
1502,2011,3,RENT,1,Low,1,6000, 36 months,1,credit_card,1,Low,1,Good Loan,0,8.9,A,1,13.9,6878.247751,6000,0,190.52,409000001501,15-Nov-17,FDRL/INTERNAL FUND TRANSFE,,200000.00,1123004.97,Buckland,661,France,14490.79,1,1,1
1503,2011,0.5,MORTGAGE,3,Low,1,9400, 60 months,2,other,4,High,2,Good Loan,0,15.27,C,3,0.74,12085.51338,9400,0,224.96,409000001502,15-Nov-17,FDRL/INTERNAL FUND TRANSFE,,200000.00,1323004.97,Flannery,796,Germany,105080.53,1,1,1
1504,2011,7,MORTGAGE,3,Low,1,5000, 36 months,1,debt_consolidation,6,Low,1,Good Loan,0,6.62,A,1,1.54,5081.06,5000,0,153.52,409000001503,15-Nov-17,BBPS SETMNT FOR DT 151120,"209,879.95",,1113125.02,Jamieson,710,France,83499.89,1,1,1
1505,2011,6,RENT,1,Low,1,3500, 36 months,1,debt_consolidation,6,Low,1,Good Loan,0,7.9,A,1,13.76,3941.889732,3500,0,109.52,409000001504,16-Nov-17,BBPS SETMNT FOR DT 151120,"134,194.84",,978930.18,Swift,741,France,143598.70,1,1,1
1506,2011,2,RENT,1,Low,1,7500, 36 months,1,debt_consolidation,6,Low,1,Good Loan,0,6.62,A,1,24.04,8288.973498,7500,0,230.28,409000001505,17-Nov-17,BBPS SETMNT FOR DT 171120,"92,084.66",,886845.52,Doherty,606,Germany,36091.91,1,1,1
1507,2011,10,RENT,1,Low,1,3625, 36 months,1,other,4,High,2,Good Loan,0,16.29,D,4,20.85,4605.871286,3625,0,127.97,409000001506,17-Nov-17,FDRL/INTERNAL FUND TRANSFE,,200000.00,1086845.52,Payne,747,France,13007.89,1,1,1
1508,2011,7,RENT,1,Low,1,4000, 36 months,1,debt_consolidation,6,Low,1,Bad Loan,1,7.51,A,1,15.63,2607.36,2218.55,0,124.45,409000001507,17-Nov-17,FDRL/INTERNAL FUND TRANSFE,,200000.00,1286845.52,Genovese,549,Germany,6101.41,1,1,1
1509,2011,3,RENT,1,Low,1,18825, 60 months,2,debt_consolidation,6,High,2,Good Loan,0,13.49,C,3,25.03,21205.61,14359.24,0,433.07,409000001508,18-Nov-17,BBPS SETMNT FOR DT 181120,"196,560.06",,1090285.46,Lucciano,576,France,48314.00,1,1,1
1510,2011,10,OWN,2,Low,1,5500, 36 months,1,home_improvement,7,Low,1,Good Loan,0,7.9,A,1,17.62,6194.900923,5500,0,172.1,409000001509,20-Nov-17,BBPS SETMNT FOR DT 201120,"212,645.91",,877639.55,Rowley,528,France,197111.99,1,1,1
1511,2011,10,MORTGAGE,3,Low,1,31300, 60 months,2,debt_consolidation,6,High,2,Good Loan,0,20.3,E,5,21.84,33385.44,31300,0,834.5,409000001510,20-Nov-17,FDRL/INTERNAL FUND TRANSFE,,300000.00,1177639.55,Hsing,535,France,110299.78,1,1,1
1512,2011,10,RENT,1,Low,1,26000, 60 months,2,debt_consolidation,6,Low,1,Bad Loan,1,12.69,B,2,21.92,23514.32,15442.23,29.9,587.47,409000001511,20-Nov-17,FDRL/INTERNAL FUND TRANSFE,,200000.00,1377639.55,Vincent,575,Spain,30114.32,1,1,1
1513,2011,6,RENT,1,Low,1,12000, 36 months,1,credit_card,1,Low,1,Good Loan,0,11.71,B,2,11,14260.39235,12000,0,396.92,409000001512,20-Nov-17,BBPS CERTIFICATE FEE,"472,000.00",,905639.55,Pearce,656,France,98894.64,1,1,1
1514,2011,7,RENT,1,Low,1,4250, 60 months,2,credit_card,1,High,2,Good Loan,0,13.49,C,3,18.12,4780.85,3237.84,0,97.77,409000001513,21-Nov-17,BBPS SETMNT FOR DT 211120,"128,651.14",,776988.41,Lamb,440,France,49826.68,1,1,1
1515,2011,10,MORTGAGE,3,Low,1,6000, 36 months,1,credit_card,1,Low,1,Good Loan,0,12.69,B,2,15.31,7242.188621,6000,0,201.27,409000001514,21-Nov-17,FDRL/INTERNAL FUND TRANSFE,,300000.00,1076988.41,Riley,539,Spain,10074.05,1,1,1
1516,2011,10,RENT,1,Low,1,18000, 36 months,1,debt_consolidation,6,Low,1,Good Loan,0,10.65,B,2,6.55,20878.28559,18000,0,586.32,409000001515,22-Nov-17,BBPS SETMNT FOR DT 221120,"146,827.17",,930161.24,Honore,850,Spain,20769.88,1,1,1
1517,2011,8,MORTGAGE,3,Low,1,20000, 60 months,2,debt_consolidation,6,High,2,Good Loan,0,16.77,D,4,20.73,24189.24,14966.77,0,494.59,409000001516,23-Nov-17,BBPS SETMNT FOR DT 231120,"171,906.20",,758255.04,Blackburn,646,France,163427.18,1,1,1
1518,2011,6,RENT,1,Low,1,3250, 36 months,1,moving,10,High,2,Good Loan,0,16.29,D,4,15.17,4128.991702,3250,0,114.73,409000001517,24-Nov-17,FDRL/INTERNAL FUND TRANSFE,,200000.00,958255.04,Endrizzi,744,France,140068.77,1,1,1
1519,2011,2,MORTGAGE,3,Low,1,22000, 60 months,2,credit_card,1,High,2,Good Loan,0,13.49,C,3,9.46,24769.75,16773.72,0,506.11,409000001518,24-Nov-17,FDRL/INTERNAL FUND TRANSFE,,200000.00,1158255.04,Duncan,710,Spain,83206.19,1,1,1
1520,2011,6,MORTGAGE,3,Low,1,8000, 60 months,2,car,2,High,2,Good Loan,0,14.27,C,3,16.56,9159.85,6070.53,0,187.27,409000001519,24-Nov-17,BBPS SETMNT FOR DT 241120,"75,972.29",,1082282.75,Macarthur,544,France,111402.97,1,1,1
1521,2011,2,RENT,1,Low,1,12650, 60 months,2,credit_card,1,High,2,Good Loan,0,17.27,D,4,12.86,17450.29498,12650,0,316.23,409000001520,27-Nov-17,BBPS SETMNT FOR DT 271120,"402,695.51",,679587.24,Gould,723,Germany,92873.50,1,1,1
1522,2011,10,MORTGAGE,3,Low,1,8875, 36 months,1,major_purchase,8,Low,1,Good Loan,0,10.65,B,2,23.75,10405.53657,8875,0,289.09,409000001521,27-Nov-17,FDRL/INTERNAL FUND TRANSFE,,300000.00,979587.24,Medvedev,507,Spain,94780.90,1,1,1
1523,2011,10,MORTGAGE,3,Medium,2,20000, 60 months,2,home_improvement,7,High,2,Good Loan,0,15.96,C,3,10.53,23786.88,15045.06,0,485.94,409000001522,28-Nov-17,BBPS SETMNT FOR DT 281120,"256,117.48",,723469.76,Sholes,787,France,16607.15,1,1,1
1524,2011,6.05,MORTGAGE,3,Low,1,20000, 60 months,2,credit_card,1,High,2,Good Loan,0,17.27,D,4,17.52,23731.05,19999.99,0,499.96,409000001523,28-Nov-17,FDRL/INTERNAL FUND TRANSFE,,300000.00,1023469.76,Shaw,598,Spain,161954.43,1,1,1
1525,2011,10,MORTGAGE,3,Low,1,27600, 60 months,2,debt_consolidation,6,Low,1,Good Loan,0,10.65,B,2,25.06,28086.55,27600,0,595.29,409000001524,29-Nov-17,BBPS SETMNT FOR DT 291120,"112,778.71",,910691.05,Ts'ai,796,France,194733.28,1,1,1
1526,2011,6.05,RENT,1,Low,1,23000, 60 months,2,other,4,High,2,Bad Loan,1,19.91,E,5,18.68,9632.66,3537.29,1120.24,608.21,409000001525,30-Nov-17,BBPS SETMNT FOR DT 301120,"82,700.97",,827990.08,Rolon,569,Spain,163524.70,1,1,1
1527,2011,4,MORTGAGE,3,Low,1,20000, 60 months,2,credit_card,1,Low,1,Good Loan,0,12.42,B,2,20.12,21542.45,14944.56,0,449.15,409000001526,1-Dec-17,BBPS SETMNT FOR DT 011220,"97,833.76",,730156.32,Reid,711,France,48260.19,1,1,1
1528,2011,0.5,MORTGAGE,3,Low,1,15000, 60 months,2,other,4,Low,1,Good Loan,0,10.65,B,2,23.13,15816.55,11600.61,0,323.53,409000001527,2-Dec-17,BBPS SETMNT FOR DT 021220,"100,187.20",,629969.12,Chinwendu,661,Germany,86678.48,1,1,1
1529,2011,9,MORTGAGE,3,Medium,2,18000, 60 months,2,credit_card,1,High,2,Good Loan,0,18.64,E,5,11.29,22687.16,13339.32,0,463.38,409000001528,2-Dec-17,FDRL/INTERNAL FUND TRANSFE,,200000.00,829969.12,Fu,415,France,3064.65,1,1,1
1530,2011,10,MORTGAGE,3,Low,1,12000, 36 months,1,debt_consolidation,6,Low,1,Good Loan,0,9.91,B,2,10.57,13887.81309,12000,0,386.7,409000001529,2-Dec-17,FDRL/INTERNAL FUND TRANSFE,,200000.00,1029969.12,Mackenzie,578,Spain,112124.98,1,1,1
1531,2011,10,MORTGAGE,3,Low,1,6000, 36 months,1,other,4,Low,1,Good Loan,0,6.03,A,1,15.06,6573.822355,6000,0,182.62,409000001530,4-Dec-17,BBPS SETMNT FOR DT 041220,"138,532.32",,891436.80,Bligh,611,France,120801.65,1,1,1
1532,2011,7,MORTGAGE,3,Low,1,7500, 36 months,1,home_improvement,7,Low,1,Good Loan,0,7.51,A,1,8.18,7915.41,7500,0,233.34,409000001531,5-Dec-17,FDRL/INTERNAL FUND TRANSFE,,300000.00,1191436.80,Davidson,600,France,52193.23,1,1,1
1533,2011,1,RENT,1,Low,1,10000, 36 months,1,debt_consolidation,6,Low,1,Good Loan,0,12.42,B,2,17.62,10584.71,10000,0,334.16,409000001532,5-Dec-17,BBPS SETMNT FOR DT 051220,"144,026.13",,1047410.67,Lamble,661,Germany,56636.28,1,1,1
1534,2011,2,MORTGAGE,3,Medium,2,35000, 36 months,1,debt_consolidation,6,Low,1,Good Loan,0,8.9,A,1,17.02,40007.03673,35000,0,1111.37,409000001533,5-Dec-17,FDRL/INTERNAL FUND TRANSFE,,300000.00,1347410.67,Moore,850,France,69372.88,1,1,1
1535,2011,6,MORTGAGE,3,Low,1,12000, 36 months,1,debt_consolidation,6,Low,1,Good Loan,0,6.03,A,1,9.65,13147.79314,12000,0,365.23,409000001534,6-Dec-17,BBPS SETMNT FOR DT 061220,"119,401.28",,1228009.39,Jose,573,Germany,164038.07,1,1,1
1536,2011,2,OWN,2,Low,1,13150, 36 months,1,debt_consolidation,6,Low,1,Good Loan,0,6.03,A,1,15.52,14075.47,13150,0,400.23,409000001535,7-Dec-17,BBPS SETMNT FOR DT 071220,"127,675.25",,1100334.14,Trevisani,764,Spain,118982.51,1,1,1
1537,2011,4,MORTGAGE,3,Low,1,1200, 36 months,1,home_improvement,7,High,2,Good Loan,0,13.49,C,3,22.4,1213.78,1200,0,40.72,409000001536,8-Dec-17,BBPS SETMNT FOR DT 081220,"209,118.73",,891215.41,Schofield,838,France,27472.07,1,1,1
1538,2011,0.5,RENT,1,Low,1,5000, 36 months,1,moving,10,High,2,Good Loan,0,13.49,C,3,11.94,6076.565203,5000,0,169.66,409000001537,8-Dec-17,FDRL/INTERNAL FUND TRANSFE,,200000.00,1091215.41,Stewart,821,France,36754.13,1,1,1
1539,2011,2,MORTGAGE,3,Low,1,12000, 60 months,2,debt_consolidation,6,High,2,Bad Loan,1,19.03,E,5,12.14,7895.07,2485.89,2289.81,311.49,409000001538,8-Dec-17,FDRL/INTERNAL FUND TRANSFE,,200000.00,1291215.41,Jamieson,607,Spain,46416.36,1,1,1
1540,2011,4,MORTGAGE,3,Low,1,20000, 36 months,1,credit_card,1,Low,1,Good Loan,0,11.71,B,2,9.58,23747.54835,20000,0,661.52,409000001539,11-Dec-17,BBPS SETMNT FOR DT 111220,"472,783.03",,818432.38,Howard,558,France,152872.39,1,1,1
1541,2011,5,MORTGAGE,3,Low,1,4300, 36 months,1,credit_card,1,Low,1,Good Loan,0,12.69,B,2,4.13,5184.519181,4300,0,144.25,409000001540,12-Dec-17,BBPS SETMNT FOR DT 121220,"237,356.27",,581076.11,Onwuamaeze,530,Germany,165227.23,1,1,1
1542,2011,10,RENT,1,Low,1,5375, 60 months,2,debt_consolidation,6,High,2,Good Loan,0,18.25,D,4,11.56,6703.73,3985.18,0,137.23,409000001541,12-Dec-17,FDRL/INTERNAL FUND TRANSFE,,300000.00,881076.11,D'Albertis,654,Germany,75927.35,1,1,1
1543,2011,4,MORTGAGE,3,Low,1,2200, 36 months,1,home_improvement,7,Low,1,Bad Loan,1,8.9,A,1,21.65,1024.4,708.82,85.43,69.86,409000001542,13-Dec-17,BBPS SETMNT FOR DT 131220,"186,908.67",,694167.44,Brooks,530,France,172930.28,1,1,1
1544,2011,6,RENT,1,Low,1,28000, 60 months,2,small_business,3,Low,1,Good Loan,0,9.91,B,2,14.33,29089.54,21781.46,0,593.68,409000001543,14-Dec-17,BBPS SETMNT FOR DT 141220,"182,323.36",,511844.08,Gordon,656,Spain,36108.50,1,1,1
1545,2011,7,MORTGAGE,3,Low,1,5300, 36 months,1,debt_consolidation,6,Low,1,Good Loan,0,10.65,B,2,7.13,5852.47,5300,0,172.64,409000001544,14-Dec-17,FDRL/INTERNAL FUND TRANSFE,,200000.00,711844.08,Nwachukwu,520,Spain,36202.74,1,1,1
1546,2011,0.5,RENT,1,Low,1,7500, 36 months,1,major_purchase,8,Low,1,Good Loan,0,7.9,A,1,4.26,7799.31,7500,0,234.68,409000001545,14-Dec-17,FDRL/INTERNAL FUND TRANSFE,,200000.00,911844.08,Chinweike,602,Germany,131886.46,1,1,1
1547,2011,1,OWN,2,Low,1,12600, 60 months,2,debt_consolidation,6,High,2,Good Loan,0,14.27,C,3,4.41,13747.7,12600,0,294.95,409000001546,15-Dec-17,BBPS SETMNT FOR DT 151220,"184,047.01",,727797.07,Simpkinson,701,Germany,133992.36,1,1,1
1548,2011,7,RENT,1,Low,1,9250, 36 months,1,major_purchase,8,Low,1,Good Loan,0,9.91,B,2,10.09,10728.14301,9250,0,298.09,409000001547,15-Dec-17,FDRL/INTERNAL FUND TRANSFE,,300000.00,1027797.07,Walker,653,Spain,96658.26,1,1,1
1549,2011,2,RENT,1,Low,1,7000, 36 months,1,debt_consolidation,6,Low,1,Good Loan,0,8.9,A,1,17.89,8000.505653,7000,0,222.28,409000001548,15-Dec-17,FDRL/INTERNAL FUND TRANSFE,,200000.00,1227797.07,Diribe,668,Spain,135112.09,1,1,1
1550,2011,10,MORTGAGE,3,Low,1,20000, 60 months,2,debt_consolidation,6,High,2,Good Loan,0,15.96,C,3,24.92,28646,20000,0,485.94,409000001549,16-Dec-17,BBPS SETMNT FOR DT 161220,"118,422.18",,1109374.89,Trentini,652,France,163944.18,1,1,1
1551,2011,0.5,RENT,1,Medium,2,24000, 60 months,2,debt_consolidation,6,High,2,Bad Loan,1,18.25,D,4,6.96,7407.5,2637.79,1226.97,612.72,409000001550,18-Dec-17,FDRL/INTERNAL FUND TRANSFE,,200000.00,1309374.89,Conway,639,Spain,53843.71,1,1,1
1552,2011,5,RENT,1,Low,1,10275, 36 months,1,debt_consolidation,6,Low,1,Bad Loan,1,6.62,A,1,27.78,3151.1,2650.07,0,315.49,409000001551,18-Dec-17,FDRL/INTERNAL FUND TRANSFE,,200000.00,1509374.89,Maslow,730,Spain,122398.84,1,1,1
1553,2011,1,RENT,1,Low,1,10000, 36 months,1,debt_consolidation,6,Low,1,Good Loan,0,11.71,B,2,19.82,11790.68515,10000,0,330.76,409000001552,18-Dec-17,BBPS SETMNT FOR DT 181220,"216,222.65",,1293152.24,Clark,780,France,64804.04,1,1,1
1554,2011,10,MORTGAGE,3,Low,1,24250, 60 months,2,debt_consolidation,6,High,2,Good Loan,0,18.64,E,5,21.32,27150.11,24250,0,624.27,409000001553,19-Dec-17,BBPS SETMNT FOR DT 191220,"250,413.01",,1042739.23,L?,592,France,19370.73,1,1,1
1555,2011,10,MORTGAGE,3,Low,1,12000, 60 months,2,debt_consolidation,6,High,2,Good Loan,0,17.58,D,4,16.27,14434.59,8670.23,0,301.99,409000001554,20-Dec-17,BBPS SETMNT FOR DT 201220,"169,273.67",,873465.56,Swadling,628,France,126192.54,1,1,1
1556,2011,0.5,MORTGAGE,3,Low,1,12000, 36 months,1,debt_consolidation,6,Low,1,Good Loan,0,7.9,A,1,4.8,13429.37785,12000,0,375.49,409000001555,21-Dec-17,BBPS SETMNT FOR DT 211220,"256,321.71",,617143.85,Gallo,658,France,135459.02,1,1,1
1557,2011,2,RENT,1,Low,1,7400, 36 months,1,debt_consolidation,6,High,2,Good Loan,0,16.77,D,4,19.91,9462.580504,7400,0,262.99,409000001556,22-Dec-17,FDRL/INTERNAL FUND TRANSFE,,200000.00,817143.85,Onyemachukwu,850,Spain,94815.04,1,1,1
1558,2011,7,OWN,2,Low,1,12000, 36 months,1,credit_card,1,Low,1,Good Loan,0,6.62,A,1,26.16,13262.23649,12000,0,368.45,409000001557,22-Dec-17,FDRL/INTERNAL FUND TRANSFE,,300000.00,1117143.85,Samoylova,515,Germany,188366.04,1,1,1
1559,2011,10,MORTGAGE,3,Low,1,10000, 36 months,1,major_purchase,8,Low,1,Good Loan,0,6.03,A,1,14.84,10518.1,10000,0,304.36,409000001558,22-Dec-17,BBPS SETMNT FOR DT 211220,"183,516.69",,933627.16,Dickson,571,France,178512.52,1,1,1
1560,2011,3,RENT,1,Low,1,13200, 60 months,2,debt_consolidation,6,Low,1,Good Loan,0,12.69,B,2,22.93,17543.65747,13200,0,298.25,409000001559,26-Dec-17,FDRL/INTERNAL FUND TRANSFE,,300000.00,1233627.16,He,760,Germany,97906.38,1,1,1
1561,2011,2,RENT,1,Low,1,10000, 60 months,2,debt_consolidation,6,High,2,Good Loan,0,13.49,C,3,25.51,11253.9,7619.32,0,230.05,409000001560,26-Dec-17,FDRL/INTERNAL FUND TRANSFE,,300000.00,1533627.16,P'an,720,Germany,72861.94,1,1,1
1562,2011,8,MORTGAGE,3,Low,1,20000, 36 months,1,debt_consolidation,6,High,2,Good Loan,0,16.77,D,4,18.09,25576.35473,20000,0,710.77,409000001561,26-Dec-17,BBPS SETMNT FOR DT 261220,"487,006.45",,1046620.71,Leak,632,Germany,195978.86,1,1,1
1563,2011,10,MORTGAGE,3,Low,1,20400, 60 months,2,debt_consolidation,6,Low,1,Good Loan,0,11.71,B,2,11.52,22097.66,20400,0,450.81,409000001562,27-Dec-17,FDRL/INTERNAL FUND TRANSFE,,200000.00,1246620.71,Artemieva,694,Germany,19448.93,1,1,1
1564,2011,3,MORTGAGE,3,Low,1,7500, 36 months,1,debt_consolidation,6,Low,1,Good Loan,0,7.51,A,1,3.21,8398.164782,7500,0,233.34,409000001563,27-Dec-17,FDRL/INTERNAL FUND TRANSFE,,200000.00,1446620.71,Frost,559,Spain,32635.54,1,1,1
1565,2011,2,MORTGAGE,3,Low,1,23600, 60 months,2,wedding,5,High,2,Bad Loan,1,21.67,F,6,7.94,24396.79,908.03,21810.31,647.39,409000001564,27-Dec-17,BBPS SETMNT FOR DT 271220,"175,551.70",,1271069.01,Warner,773,Germany,171733.22,1,1,1
1566,2011,3,MORTGAGE,3,Low,1,13000, 60 months,2,small_business,3,Low,1,Good Loan,0,11.71,B,2,6.33,14829.01,13000,0,287.28,409000001565,28-Dec-17,BBPS SETMNT FOR DT 281201,"171,619.00",,1099450.01,Kennedy,581,France,46176.22,1,1,1
1567,2011,6.05,RENT,1,Low,1,25000, 60 months,2,credit_card,1,High,2,Good Loan,0,14.65,C,3,18.14,34886.45,25000,0,590.17,409000001566,29-Dec-17,BBPS SETMNT FOR DT 291220,"140,789.63",,958660.38,Ifeatu,524,Germany,179634.69,1,1,1
1568,2011,5,RENT,1,Low,1,3000, 36 months,1,credit_card,1,Low,1,Good Loan,0,8.9,A,1,6.8,3427.746711,3000,0,95.26,409000001567,29-Dec-17,FDRL/INTERNAL FUND TRANSFE,,200000.00,1158660.38,Evans,713,France,191521.32,1,1,1
1569,2011,10,MORTGAGE,3,Low,1,10000, 36 months,1,moving,10,Low,1,Good Loan,0,6.03,A,1,12.08,10913.99313,10000,0,304.36,409000001568,29-Dec-17,FDRL/INTERNAL FUND TRANSFE,,300000.00,1458660.38,Chu,676,France,67998.45,1,1,1
1570,2011,10,MORTGAGE,3,Low,1,12000, 36 months,1,credit_card,1,Low,1,Bad Loan,1,12.42,B,2,14,6005.4,4459.55,0,400.99,409000001569,29-Dec-17,FDRL/INTERNAL FUND TRANSFE,,200000.00,1658660.38,Hsueh,651,Germany,44731.80,1,1,1
1571,2011,6.05,RENT,1,Low,1,4800, 36 months,1,debt_consolidation,6,Low,1,Good Loan,0,12.42,B,2,22.88,5772.507824,4800,0,160.4,409000001570,30-Dec-17,BBPS SETMNT FOR DT 301220,"82,142.95",,1576517.43,Shih,717,Spain,124532.90,1,1,1
1572,2011,8,MORTGAGE,3,Low,1,15000, 36 months,1,credit_card,1,Low,1,Bad Loan,1,10.65,B,2,16.34,2928.24,2178.24,0,488.6,409000001571,1-Jan-18,BBPS SETMNT FOR DT 010120,"199,758.22",,1376759.21,Fan,594,France,160968.44,1,1,1
1573,2011,10,RENT,1,Medium,2,24000, 60 months,2,small_business,3,Low,1,Good Loan,0,12.69,B,2,10.25,26546.5,18381.87,0,542.28,409000001572,2-Jan-18,BBPS SETMNT FOR DT 020120,"61,493.58",,1315265.63,Whiddon,716,France,27341.63,1,1,1
1574,2011,10,MORTGAGE,3,Medium,2,20000, 36 months,1,debt_consolidation,6,High,2,Good Loan,0,14.65,C,3,5.62,24617.69737,20000,0,689.89,409000001573,2-Jan-18,FDRL/INTERNAL FUND TRANSFE,,200000.00,1515265.63,Onyekachukwu,668,France,53994.64,1,1,1
1575,2011,0.5,RENT,1,Low,1,25000, 60 months,2,debt_consolidation,6,High,2,Bad Loan,1,14.27,C,3,20.68,20699.61,11110.47,1985.89,585.22,409000001574,2-Jan-18,FDRL/INTERNAL FUND TRANSFE,,200000.00,1715265.63,Ermakova,678,Germany,91633.53,1,1,1
1576,2011,10,MORTGAGE,3,Low,1,3000, 36 months,1,other,4,Low,1,Good Loan,0,12.42,B,2,23.65,3606.775113,3000,0,100.25,409000001575,3-Jan-18,BBPS SETMNT FOR DT 030120,"131,874.52",,1583391.11,Marino,545,France,189613.12,1,1,1
1577,2011,6,OWN,2,Low,1,7875, 60 months,2,car,2,High,2,Bad Loan,1,17.27,D,4,10.28,2158.31,984.57,0,196.86,409000001576,4-Jan-18,BBPS SETMNT FOR DT 040120,"107,971.83",,1475419.28,Niu,613,France,60706.33,1,1,1
1578,2011,10,MORTGAGE,3,Low,1,35000, 60 months,2,debt_consolidation,6,Low,1,Good Loan,0,11.71,B,2,20.02,41705.93,35000,0,773.44,409000001577,5-Jan-18,BBPS SETMNT FOR DT 050120,"119,145.09",,1356274.19,Manna,687,Spain,154767.34,1,1,1
1579,2011,5,RENT,1,Low,1,10000, 36 months,1,debt_consolidation,6,Low,1,Good Loan,0,11.71,B,2,10.48,11663.96,10000,0,330.76,409000001578,6-Jan-18,BBPS SETMNT FOR DT 060120,"115,908.12",,1240366.07,Onyemere,715,France,196853.11,1,1,1
1580,2011,10,RENT,1,Low,1,5600, 36 months,1,debt_consolidation,6,Low,1,Good Loan,0,7.51,A,1,20.51,6070.15,5600,0,174.23,409000001579,8-Jan-18,BBPS SETMNT FOR DT 080120,"174,434.50",,1065931.57,Archer,618,Germany,195775.48,1,1,1
1581,2011,6.05,MORTGAGE,3,Low,1,21000, 36 months,1,credit_card,1,Low,1,Good Loan,0,7.51,A,1,27.02,23043.77,21000,0,653.33,409000001580,8-Jan-18,FDRL/INTERNAL FUND TRANSFE,,200000.00,1265931.57,Mitchell,721,France,3086.89,1,1,1
1582,2011,7,RENT,1,Low,1,12300, 36 months,1,debt_consolidation,6,Low,1,Bad Loan,1,7.51,A,1,22.29,12125.52,10411.99,274.71,382.67,409000001581,8-Jan-18,FDRL/INTERNAL FUND TRANSFE,,200000.00,1465931.57,Everingham,445,Germany,70618.00,1,1,1
1583,2011,6,OWN,2,Low,1,6000, 36 months,1,debt_consolidation,6,Low,1,Good Loan,0,10.65,B,2,24.57,7034.612845,6000,0,195.44,409000001582,9-Jan-18,BBPS SETMNT FOR DT 090012,"165,694.99",,1300236.58,Huie,690,France,55034.02,1,1,1
1584,2011,10,MORTGAGE,3,Low,1,14550, 36 months,1,credit_card,1,Low,1,Good Loan,0,11.71,B,2,15.6,17320.44493,14550,0,481.26,409000001583,10-Jan-18,BBPS SETMNT FOR DT 100120,"187,584.02",,1112652.56,Crowther,709,France,168035.62,1,1,1
1585,2011,2,RENT,1,Medium,2,25600, 36 months,1,debt_consolidation,6,High,2,Good Loan,0,15.96,C,3,18.01,31849.93583,25600,0,899.52,409000001584,11-Jan-18,BBPS SETMNT FOR DT 110120,"124,081.29",,988571.27,Swift,671,Spain,128449.33,1,1,1
1586,2011,1,MORTGAGE,3,Low,1,22000, 60 months,2,debt_consolidation,6,High,2,Good Loan,0,14.65,C,3,6.93,25446.59,16683.87,0,519.35,409000001585,12-Jan-18,BBPS SETMNT FOR DT 120120,"175,473.28",,813097.99,Skelton,538,France,199249.29,1,1,1
1587,2011,10,MORTGAGE,3,Low,1,35000, 60 months,2,debt_consolidation,6,High,2,Bad Loan,1,15.96,C,3,15.04,31879.87,8325.72,13377.81,850.39,409000001586,12-Jan-18,FDRL/INTERNAL FUND TRANSFE,,300000.00,1113097.99,White,735,France,149474.69,1,1,1
1588,2011,4,MORTGAGE,3,Low,1,7000, 60 months,2,other,4,High,2,Bad Loan,1,14.27,C,3,12.18,1511.74,583.15,368.08,163.86,409000001587,12-Jan-18,FDRL/INTERNAL FUND TRANSFE,,300000.00,1413097.99,Giordano,592,France,126726.33,1,1,1
1589,2011,5,MORTGAGE,3,Low,1,9000, 36 months,1,debt_consolidation,6,Low,1,Good Loan,0,7.9,A,1,12.26,10136.79288,9000,0,281.62,409000001588,15-Jan-18,BBPS SETMNT FOR DT 150120,"239,083.95",,1174014.04,Bateson,747,France,147554.26,1,1,1
1590,2011,10,RENT,1,Low,1,8000, 36 months,1,debt_consolidation,6,High,2,Good Loan,0,16.29,D,4,15.53,9293.11,8000,0,282.41,409000001589,16-Jan-18,BBPS SETMNT FOR DT 160120,"199,639.98",,974374.06,Hu,675,Germany,149399.70,1,1,1
1591,2011,1,MORTGAGE,3,Low,1,6500, 36 months,1,debt_consolidation,6,High,2,Good Loan,0,14.27,C,3,11.36,7995.332703,6500,0,223.01,409000001590,17-Jan-18,BBPS SETMNT FOR DT 170120,"184,162.48",,790211.58,Day,632,Spain,93536.38,1,1,1
1592,2011,1,RENT,1,Low,1,4000, 36 months,1,debt_consolidation,6,High,2,Good Loan,0,14.27,C,3,1.37,4937.460259,4000,0,137.24,409000001591,17-Jan-18,FDRL/INTERNAL FUND TRANSFE,,300000.00,1090211.58,Beneventi,621,France,58883.91,1,1,1
1593,2011,10,MORTGAGE,3,Low,1,14000, 60 months,2,debt_consolidation,6,High,2,Good Loan,0,19.91,E,5,11.31,18128.04,10300.12,0,370.22,409000001592,18-Jan-18,BBPS SETMNT FOR DT 180120,"164,097.27",,926114.31,Elizabeth,521,Spain,154271.41,1,1,1
1594,2011,0.5,RENT,1,Low,1,7000, 36 months,1,debt_consolidation,6,Low,1,Good Loan,0,6.62,A,1,9.27,7735.335806,7000,0,214.93,409000001593,19-Jan-18,BBPS SETMNT FOR DT 190120,"160,649.42",,765464.89,Atkins,591,Spain,122022.89,1,1,1
1595,2011,6,RENT,1,Low,1,15000, 36 months,1,credit_card,1,High,2,Good Loan,0,15.96,C,3,14.78,18966.4625,15000,0,527.06,409000001594,19-Jan-18,FDRL/INTERNAL FUND TRANSFE,,200000.00,965464.89,Serrano,706,Germany,50299.14,1,1,1
1596,2011,0.5,RENT,1,Low,1,9925, 36 months,1,debt_consolidation,6,Low,1,Good Loan,0,6.62,A,1,20.95,10968.61382,9925,0,304.74,409000001595,19-Jan-18,FDRL/INTERNAL FUND TRANSFE,,300000.00,1265464.89,Willis,677,France,187800.63,1,1,1
1597,2011,0.5,RENT,1,Low,1,15850, 60 months,2,credit_card,1,High,2,Bad Loan,1,17.27,D,4,15.9,14375.26,6468.14,1616.47,396.22,409000001596,20-Jan-18,BBPS SETMNT FOR DT 200120,"193,939.03",,1071525.86,Stevenson,769,Germany,171344.09,1,1,1
1598,2011,6.05,MORTGAGE,3,Low,1,9000, 36 months,1,credit_card,1,High,2,Good Loan,0,16.29,D,4,12.18,11435.03164,9000,0,317.71,409000001597,22-Jan-18,BBPS SETMNT FOR DT 220120,"153,880.37",,917645.49,Ch'ien,771,France,40920.59,1,1,1
1599,2011,10,OWN,2,Low,1,1325, 36 months,1,other,4,Low,1,Good Loan,0,6.62,A,1,26.22,1464.097222,1325,0,40.69,409000001598,23-Jan-18,BBPS SETMNT FOR DT 230120,"104,333.66",,813311.83,Cunningham,601,Germany,63940.68,1,1,1
1600,2011,3,RENT,1,Low,1,35000, 60 months,2,small_business,3,Low,1,Bad Loan,1,12.42,B,2,10.34,9427.32,5382.07,0,786.01,409000001599,23-Jan-18,FDRL/INTERNAL FUND TRANSFE,,300000.00,1113311.83,Stephens,670,France,29483.87,1,1,1
1601,2011,6,RENT,1,Low,1,6000, 36 months,1,credit_card,1,Low,1,Good Loan,0,7.51,A,1,22.12,6037.78,6000,0,186.67,409000001600,24-Jan-18,BBPS SETMNT FOR DT 240120,"137,310.84",,976000.99,Gordon,517,France,179056.23,1,1,1
1602,2011,1,MORTGAGE,3,Medium,2,15000, 36 months,1,credit_card,1,High,2,Good Loan,0,15.96,C,3,6.86,18186.84,15000,0,527.06,409000001601,25-Jan-18,BBPS SETMNT FOR DT 250120,"108,268.42",,867732.57,Bevan,834,France,129273.94,1,1,1
1603,2011,10,RENT,1,Low,1,35000, 60 months,2,small_business,3,Low,1,Bad Loan,1,12.69,B,2,1.5,15265.65,7784.06,1832.08,790.82,409000001602,25-Jan-18,FDRL/INTERNAL FUND TRANSFE,,300000.00,1167732.57,Mashman,571,France,55558.51,1,1,1
1604,2011,0.5,RENT,1,Low,1,10000, 36 months,1,debt_consolidation,6,High,2,Good Loan,0,15.27,C,3,3.64,12517.38569,10000,0,347.98,409000001603,25-Jan-18,FDRL/INTERNAL FUND TRANSFE,,300000.00,1467732.57,Tu,576,Germany,23305.85,1,1,1
1605,2011,3,OWN,2,Low,1,3000, 36 months,1,debt_consolidation,6,Low,1,Good Loan,0,7.9,A,1,15.7,3203.95,3000,0,93.88,409000001604,29-Jan-18,BBPS SETMNT FOR DT 290120,"252,550.92",,1215181.65,Milanesi,718,France,17128.64,1,1,1
1606,2011,7,MORTGAGE,3,Low,1,12000, 60 months,2,debt_consolidation,6,High,2,Bad Loan,1,19.03,E,5,13.41,1638.7,493.24,400.7,311.49,409000001605,30-Jan-18,BBPS SETMNT FOR DT 300120,"117,287.45",,1097894.20,Romano,636,Germany,74641.90,1,1,1
1607,2011,5,RENT,1,Low,1,6325, 36 months,1,debt_consolidation,6,Low,1,Good Loan,0,10.65,B,2,3.77,7409.979787,6325,0,206.03,409000001606,31-Jan-18,BBPS SETMNT FOR DT 310120,"82,482.93",,1015411.27,Goliwe,566,Germany,154486.01,1,1,1
1608,2011,10,MORTGAGE,3,Low,1,10000, 36 months,1,debt_consolidation,6,Low,1,Good Loan,0,6.03,A,1,12.21,10956.31633,10000,0,304.36,409000001607,1-Feb-18,BBPS SETMNT FOR DT 010220,"78,571.00",,936840.27,Hsueh,711,France,3185.67,1,1,1
1609,2011,5,RENT,1,Low,1,12000, 36 months,1,wedding,5,Low,1,Good Loan,0,8.9,A,1,10.28,12500.66,12000,0,381.04,409000001608,2-Feb-18,BBPS SETMNT FOR DT 020220,"87,199.44",,849640.83,Gray,574,France,88463.63,1,1,1
1610,2011,0.5,RENT,1,Low,1,4000, 36 months,1,other,4,Low,1,Good Loan,0,10.65,B,2,8.9,4676.048397,4000,0,130.3,409000001609,2-Feb-18,FDRL/INTERNAL FUND TRANSFE,,200000.00,1049640.83,Wright,619,France,65682.93,1,1,1
1611,2011,10,MORTGAGE,3,Low,1,6500, 36 months,1,debt_consolidation,6,Low,1,Good Loan,0,12.42,B,2,11.66,7816.074839,6500,0,217.2,409000001610,2-Feb-18,FDRL/INTERNAL FUND TRANSFE,,300000.00,1349640.83,Chiemeka,588,France,140586.08,1,1,1
1612,2011,5,RENT,1,Low,1,29700, 60 months,2,small_business,3,High,2,Bad Loan,1,17.27,D,4,11.49,9651.58,4462.18,12.73,742.45,409000001611,3-Feb-18,BBPS SETMNT FOR DT 030220,"38,505.91",,1311134.92,Chung,760,Germany,117232.90,1,1,1
1613,2011,5,MORTGAGE,3,Low,1,4000, 36 months,1,debt_consolidation,6,Low,1,Good Loan,0,11.71,B,2,22.07,4347.64,4000,0,132.31,409000001612,5-Feb-18,BBPS SETMNT FOR DT 050220,"70,066.41",,1241068.51,Pinto,665,France,116137.01,1,1,1
1614,2011,6,MORTGAGE,3,Medium,2,15000, 36 months,1,home_improvement,7,Low,1,Good Loan,0,7.9,A,1,22.07,16895.75103,15000,0,469.36,409000001613,6-Feb-18,BBPS DT 06022018,"87,969.60",,1153098.91,Kellway,739,Germany,105533.96,1,1,1
1615,2011,0.5,MORTGAGE,3,Low,1,35000, 60 months,2,debt_consolidation,6,High,2,Good Loan,0,14.27,C,3,23.8,40126.98,26588.49,0,819.3,409000001614,7-Feb-18,BBPS DT 07022018,"91,827.28",,1061271.63,Sopuluchi,641,France,81514.06,1,1,1
1616,2011,4,MORTGAGE,3,Low,1,20000, 36 months,1,small_business,3,Low,1,Good Loan,0,6.62,A,1,5.04,22103.94637,20000,0,614.08,409000001615,8-Feb-18,BBPS DT 08022018,"55,919.43",,1005352.20,Spitzer,685,Germany,164966.27,1,1,1
1617,2011,10,MORTGAGE,3,High,3,24000, 60 months,2,credit_card,1,Low,1,Bad Loan,1,12.69,B,2,8.05,20788.45,15040.91,0,542.28,409000001616,9-Feb-18,BBPS DT 09022018,"153,450.94",,851901.26,Potter,594,France,23631.55,1,1,1
1618,2011,8,OWN,2,Low,1,6500, 36 months,1,other,4,High,2,Good Loan,0,13.49,C,3,21.89,7805.52,6500,0,220.55,409000001617,9-Feb-18,FDRL/INTERNAL FUND TRANSFE,,200000.00,1051901.26,Matthews,557,Spain,105433.53,1,1,1
1619,2011,10,MORTGAGE,3,Low,1,19750, 60 months,2,credit_card,1,High,2,Bad Loan,1,13.49,C,3,8.8,5975.66,2694.08,996.51,454.35,409000001618,9-Feb-18,FDRL/INTERNAL FUND TRANSFE,,300000.00,1351901.26,Nicholls,697,France,90591.15,1,1,1
1620,2011,5,MORTGAGE,3,Low,1,9000, 36 months,1,credit_card,1,Low,1,Good Loan,0,12.69,B,2,18.38,10816.63292,9000,0,301.91,409000001619,12-Feb-18,BBPS DT 12022018,"171,840.28",,1180060.98,McDonald,656,France,127014.32,1,1,1
1621,2011,10,MORTGAGE,3,Low,1,14400, 60 months,2,car,2,Low,1,Good Loan,0,11.71,B,2,10.5,18679.1941,14400,0,318.22,409000001620,13-Feb-18,BBPS DT 13022018,"37,837.59",,1142223.39,Fiorentini,712,Germany,90905.26,1,1,1
1622,2011,4,RENT,1,High,3,10000, 36 months,1,credit_card,1,High,2,Good Loan,0,15.96,C,3,6.27,12641.48737,10000,0,351.38,409000001621,14-Feb-18,BBPS DT 14022018,"29,484.10",,1112739.29,Kovalyova,689,Spain,8651.92,1,1,1
1623,2011,4,MORTGAGE,3,Low,1,35000, 60 months,2,credit_card,1,High,2,Bad Loan,1,19.03,E,5,13.06,10877.29,3789.3,1812.59,908.5,409000001622,15-Feb-18,BBPS DT 15022018,"61,110.96",,1051628.33,Miah,697,France,15467.98,1,1,1
1624,2011,1,MORTGAGE,3,Medium,2,24250, 60 months,2,credit_card,1,High,2,Good Loan,0,24.11,G,7,12.27,35617.80106,24250,0,699.18,409000001623,16-Feb-18,BBPS DT 16022018,"102,212.77",,949415.56,Builder,589,France,79915.28,1,1,1
1625,2011,10,MORTGAGE,3,High,3,7800, 36 months,1,home_improvement,7,High,2,Good Loan,0,13.49,C,3,5.1,9561.611531,7800,0,264.66,409000001624,16-Feb-18,FDRL/INTERNAL FUND TRANSFE,,300000.00,1249415.56,Baddeley,525,Spain,69361.95,1,1,1
1626,2011,10,RENT,1,Low,1,16000, 60 months,2,debt_consolidation,6,Low,1,Good Loan,0,12.42,B,2,12.39,17594.98,12275.39,0,359.32,409000001625,17-Feb-18,BBPS DT 17022018,"107,049.16",,1142366.40,Hu,680,France,86935.08,1,1,1
1627,2011,7,OWN,2,Low,1,15000, 60 months,2,debt_consolidation,6,High,2,Good Loan,0,13.49,C,3,18.84,16889.16,11437.21,0,345.08,409000001626,19-Feb-18,BBPS DT 19022018,"88,031.13",,1054335.27,Hs?,617,France,7597.83,1,1,1
1628,2011,6.05,MORTGAGE,3,Low,1,24000, 60 months,2,debt_consolidation,6,High,2,Bad Loan,1,21.28,F,6,12.27,22856.2,10882.04,0,653.07,409000001627,20-Feb-18,BBPS DT 20022018,"80,144.06",,974191.21,Ford,680,France,116957.60,1,1,1
1629,2011,10,MORTGAGE,3,Low,1,10000, 36 months,1,debt_consolidation,6,High,2,Good Loan,0,13.49,C,3,4.85,12216.65113,10000,0,339.31,409000001628,21-Feb-18,BBPS DT 21022018,"134,293.53",,839897.68,Todd,662,Spain,157884.83,1,1,1
1630,2011,5,RENT,1,Low,1,12000, 36 months,1,debt_consolidation,6,Low,1,Good Loan,0,12.69,B,2,18.34,14486.05815,12000,0,402.54,409000001629,22-Feb-18,BBPS DT 22022018,"100,015.35",,739882.33,Johnston,736,Germany,77981.54,1,1,1
1631,2011,1,RENT,1,Low,1,5500, 36 months,1,debt_consolidation,6,Low,1,Good Loan,0,12.69,B,2,21.3,6631.858568,5500,0,184.5,409000001630,22-Feb-18,FDRL/INTERNAL FUND TRANSFE,,300000.00,1039882.33,Obiajulu,657,Germany,126369.55,1,1,1
1632,2011,1,RENT,1,Low,1,4000, 36 months,1,debt_consolidation,6,Low,1,Good Loan,0,12.42,B,2,15.13,4808.914256,4000,0,133.67,409000001631,22-Feb-18,FDRL/INTERNAL FUND TRANSFE,,200000.00,1239882.33,Azubuike,350,Spain,191973.49,1,1,1
1633,2011,1,RENT,1,Low,1,8000, 36 months,1,debt_consolidation,6,Low,1,Good Loan,0,7.51,A,1,1.77,8903.850482,8000,0,248.89,409000001632,23-Feb-18,BBPS DT 23022018,"110,202.40",,1129679.93,Padovesi,617,France,142940.39,1,1,1
1634,2011,2,MORTGAGE,3,Low,1,25975, 60 months,2,debt_consolidation,6,High,2,Bad Loan,1,18.64,E,5,11.8,12564.87,5110.14,1207.34,668.68,409000001633,26-Feb-18,BBPS DT 26022018,"94,909.73",,1034770.20,Farmer,562,France,48869.67,1,1,1
1635,2011,10,RENT,1,Low,1,25000, 60 months,2,credit_card,1,High,2,Good Loan,0,17.58,D,4,18.85,33335.10601,25000,0,629.14,409000001634,27-Feb-18,BBPS DT 27022018,"83,883.09",,950887.11,Ignatieff,705,Spain,73131.73,1,1,1
1636,2011,1,MORTGAGE,3,Low,1,30000, 60 months,2,debt_consolidation,6,High,2,Good Loan,0,14.27,C,3,17.98,34394.62,22790.28,0,702.26,409000001635,28-Feb-18,BBPS DT 28022018,"53,685.02",,897202.09,Lu,516,France,120037.36,1,1,1
1637,2011,2,RENT,1,Low,1,13000, 60 months,2,other,4,Low,1,Good Loan,0,9.91,B,2,1.8,16347.65998,13000,0,275.64,409000001636,1-Mar-18,BBPS DT 01032018,"92,260.68",,804941.41,Artemiev,573,France,193995.37,1,1,1
1638,2011,5,MORTGAGE,3,Low,1,15200, 36 months,1,other,4,High,2,Bad Loan,1,15.27,C,3,22.19,1582.59,1016.69,0,528.93,409000001637,1-Mar-18,FDRL/INTERNAL FUND TRANSFE,,300000.00,1104941.41,Okonkwo,538,Spain,179453.66,1,1,1
1639,2011,0.5,MORTGAGE,3,Low,1,16000, 60 months,2,home_improvement,7,Low,1,Good Loan,0,11.71,B,2,6.56,18249.66,16000,0,353.58,409000001638,1-Mar-18,FDRL/INTERNAL FUND TRANSFE,,200000.00,1304941.41,Dore,699,France,80963.92,1,1,1
1640,2011,0.5,RENT,1,Low,1,10000, 36 months,1,debt_consolidation,6,Low,1,Good Loan,0,10.65,B,2,12.16,11723.36501,10000,0,325.74,409000001639,2-Mar-18,BBPS DT 02032018,"22,018.40",,1282923.01,T'ang,504,Germany,15658.99,1,1,1
1641,2011,5,RENT,1,Low,1,28100, 60 months,2,debt_consolidation,6,High,2,Good Loan,0,17.58,D,4,23.1,40327.13583,28100,0,707.16,409000001640,3-Mar-18,BBPS DT 03032018,,35851.19,1318774.20,Ashbolt,583,Spain,92708.10,1,1,1
1642,2011,6,RENT,1,Low,1,15000, 36 months,1,debt_consolidation,6,High,2,Good Loan,0,16.77,D,4,7.29,16207.07,15000.01,0,533.08,409000001641,5-Mar-18,BBPS DT 05032018,"77,952.12",,1240822.08,Bazarova,712,Spain,26542.17,1,1,1
1643,2011,5,RENT,1,Low,1,12000, 36 months,1,debt_consolidation,6,Low,1,Good Loan,0,11.71,B,2,8.85,14283.93171,12000,0,396.92,409000001642,6-Mar-18,BBPS DT 06032018,"78,194.25",,1162627.83,Buccho,626,Spain,65010.74,1,1,1
1644,2011,10,OWN,2,Low,1,6000, 36 months,1,credit_card,1,Low,1,Good Loan,0,7.51,A,1,21.22,6718.399442,6000,0,186.67,409000001643,7-Mar-18,BBPS SETTELET DTD 07.03.2,"133,276.73",,1029351.10,Burn,631,France,106892.91,1,1,1
1645,2011,0.5,MORTGAGE,3,Low,1,20000, 60 months,2,debt_consolidation,6,High,2,Bad Loan,1,14.27,C,3,9.17,22033.57,14295.13,0,468.17,409000001644,8-Mar-18,BBPS DT 08032018,"208,169.53",,821181.57,Andreyev,663,France,185210.63,1,1,1
1646,2011,6.05,RENT,1,Low,1,5000, 36 months,1,wedding,5,Low,1,Good Loan,0,8.9,A,1,23.19,5644.86667,5000,0,158.77,409000001645,9-Mar-18,BBPS DT 09032018,"205,372.21",,615809.36,Endrizzi,506,Germany,4035.46,1,1,1
1647,2011,10,MORTGAGE,3,Low,1,30000, 60 months,2,debt_consolidation,6,High,2,Good Loan,0,19.91,E,5,4.31,45091.6076,30000,0,793.32,409000001646,9-Mar-18,FDRL/INTERNAL FUND TRANSFE,,200000.00,815809.36,Brown,570,Germany,177805.44,1,1,1
1648,2011,10,MORTGAGE,3,Low,1,8000, 36 months,1,car,2,Low,1,Good Loan,0,6.03,A,1,7.32,8752.87417,8000,0,243.49,409000001647,9-Mar-18,FDRL/INTERNAL FUND TRANSFE,,200000.00,1015809.36,Nock,703,France,68831.72,1,1,1
1649,2011,2,RENT,1,Low,1,5000, 36 months,1,debt_consolidation,6,High,2,Good Loan,0,14.27,C,3,9.58,6021.9,5000,0,171.55,409000001648,12-Mar-18,FDRL/INTERNAL FUND TRANSFE,,200000.00,1215809.36,Okeke,698,Germany,114732.62,1,1,1
1650,2011,3,MORTGAGE,3,Low,1,15250, 60 months,2,debt_consolidation,6,Low,1,Good Loan,0,12.69,B,2,26.62,16865.47,11678.43,0,344.57,409000001649,12-Mar-18,BBPS DT 12032018,"587,655.98",,628153.38,Cunningham,731,Spain,22299.27,1,1,1
1651,2011,0.5,RENT,1,Low,1,22000, 36 months,1,debt_consolidation,6,Low,1,Good Loan,0,7.9,A,1,16.14,24780.27541,22000,0,688.39,409000001650,12-Mar-18,FDRL/INTERNAL FUND TRANSFE,,200000.00,828153.38,Kelley,625,France,197283.20,1,1,1
1652,2011,10,OWN,2,Low,1,21000, 60 months,2,debt_consolidation,6,Low,1,Good Loan,0,12.42,B,2,8.84,25275.91,21000,0,471.61,409000001651,12-Mar-18,FDRL/INTERNAL FUND TRANSFE,,300000.00,1128153.38,Wilson,634,Spain,179485.96,1,1,1
1653,2011,9,MORTGAGE,3,Low,1,5000, 36 months,1,debt_consolidation,6,Low,1,Good Loan,0,7.51,A,1,28.21,5546.25,5000,0,155.56,409000001652,13-Mar-18,BBPS DT 13032018,"232,615.36",,895538.02,Woods,616,France,17699.48,1,1,1
1654,2011,7,OWN,2,Low,1,6250, 36 months,1,debt_consolidation,6,Low,1,Good Loan,0,12.69,B,2,23.26,7544.760297,6250,0,209.66,409000001653,14-Mar-18,BBPS DT 14032018,"169,248.39",,726289.63,McFarland,500,France,118490.80,1,1,1
1655,2011,8,MORTGAGE,3,Medium,2,28000, 36 months,1,debt_consolidation,6,Low,1,Good Loan,0,7.9,A,1,9.81,31538.42382,28000,0,876.13,409000001654,14-Mar-18,FDRL/INTERNAL FUND TRANSFE,,300000.00,1026289.63,Cisneros,446,France,133292.94,1,1,1
1656,2011,0.5,RENT,1,Low,1,6800, 36 months,1,credit_card,1,Low,1,Good Loan,0,10.65,B,2,18.63,7903.452992,6800,0,221.5,409000001655,15-Mar-18,BBPS DT 15032018,"181,965.87",,844323.76,Borchgrevink,669,France,58170.24,1,1,1
1657,2011,6,RENT,1,Low,1,12000, 36 months,1,debt_consolidation,6,Low,1,Good Loan,0,11.71,B,2,14.19,13448.19,12000,0,396.92,409000001656,16-Mar-18,BBPS DT 16032018,"64,069.00",,780254.76,Rozhkova,581,Germany,107137.30,1,1,1
1658,2011,5,RENT,1,Low,1,20000, 60 months,2,debt_consolidation,6,High,2,Good Loan,0,14.27,C,3,10.08,23254.4,19999.99,0,468.17,409000001657,16-Mar-18,FDRL/INTERNAL FUND TRANSFE,,200000.00,980254.76,Bradley,704,Germany,145071.33,1,1,1
1659,2011,10,RENT,1,Low,1,16800, 36 months,1,debt_consolidation,6,Low,1,Good Loan,0,12.42,B,2,15.75,19951.6212,16800,0,561.38,409000001658,16-Mar-18,FDRL/INTERNAL FUND TRANSFE,,300000.00,1280254.76,Obialo,748,France,85495.24,1,1,1
1660,2011,10,MORTGAGE,3,Medium,2,30000, 60 months,2,credit_card,1,High,2,Good Loan,0,18.64,E,5,12.69,41851.24211,30000,0,772.29,409000001659,17-Mar-18,BBPS DT 17032018,"121,924.84",,1158329.92,Hudson,680,Spain,101139.30,1,1,1
1661,2011,0.5,RENT,1,Low,1,9000, 36 months,1,debt_consolidation,6,Low,1,Good Loan,0,10.65,B,2,9.65,10551.49535,9000,0,293.16,409000001660,19-Mar-18,BBPS DT 19032018,"43,998.98",,1114330.94,Veltri,655,France,10511.13,1,1,1
1662,2011,2,MORTGAGE,3,Low,1,5200, 36 months,1,credit_card,1,Low,1,Good Loan,0,9.91,B,2,22.67,5782.94,5200,0,167.57,409000001661,20-Mar-18,BBPS DT 20032018,"226,245.30",,888085.64,Mazzanti,690,Germany,137916.49,1,1,1
1663,2011,0.5,MORTGAGE,3,Low,1,6000, 36 months,1,debt_consolidation,6,High,2,Good Loan,0,16.77,D,4,6.83,7207.78,6000,0,213.24,409000001662,20-Mar-18,FDRL/INTERNAL FUND TRANSFE,,200000.00,1088085.64,Thorpe,695,Germany,193383.13,1,1,1
1664,2011,0.5,RENT,1,Low,1,15600, 36 months,1,credit_card,1,Low,1,Good Loan,0,12.69,B,2,11.42,17853.42,15600,0,523.3,409000001663,21-Mar-18,BBPS DT 21032018,"174,291.75",,913793.89,Golibe,700,Germany,189826.96,1,1,1
1665,2011,6,RENT,1,Low,1,18000, 60 months,2,debt_consolidation,6,High,2,Good Loan,0,13.49,C,3,17.77,21707.07,18000,0,414.09,409000001664,21-Mar-18,BBPS  DT 12022018,"50,650.62",,863143.27,Udinesi,773,France,144113.42,1,1,1
1666,2011,5,RENT,1,Low,1,11325, 36 months,1,debt_consolidation,6,Low,1,Good Loan,0,9.91,B,2,16.8,13134.88254,11325,0,364.95,409000001665,21-Mar-18,REV BBPS  DT 12022018,,171840.28,1034983.55,Stewart,749,France,143538.51,1,1,1
1667,2011,2,RENT,1,Low,1,14000, 36 months,1,debt_consolidation,6,High,2,Good Loan,0,14.65,C,3,22.89,17381.8672,14000,0,482.92,409000001666,22-Mar-18,BBPS DT 22032018,"99,571.00",,935412.55,Curtis,611,France,77677.14,1,1,1
1668,2011,1,MORTGAGE,3,Low,1,13975, 36 months,1,credit_card,1,Low,1,Good Loan,0,8.9,A,1,17.06,14814.99,13975,0,443.76,409000001667,23-Mar-18,BBPS DT 23032018,"68,100.91",,867311.64,Hayden,606,Spain,183717.94,1,1,1
1669,2011,9,RENT,1,Low,1,24000, 36 months,1,debt_consolidation,6,Low,1,Good Loan,0,7.9,A,1,10.92,26624.67,24000,0,750.97,409000001668,23-Mar-18,FDRL/INTERNAL FUND TRANSFE,,200000.00,1067311.64,H?,554,France,92180.62,1,1,1
1670,2011,4,MORTGAGE,3,Low,1,7000, 36 months,1,debt_consolidation,6,Low,1,Good Loan,0,7.9,A,1,15.38,7862.930529,7000,0,219.04,409000001669,26-Mar-18,BBPS DT 26032018,"138,542.03",,928769.61,Campbell,567,France,28690.90,1,1,1
1671,2011,7,MORTGAGE,3,Low,1,6000, 36 months,1,other,4,Low,1,Good Loan,0,12.42,B,2,18.84,7214.01911,6000,0,200.5,409000001670,27-Mar-18,BBPS DT 27032018,"117,114.79",,811654.82,Green,559,Spain,85891.02,1,1,1
1672,2011,6,OWN,2,Low,1,14000, 36 months,1,debt_consolidation,6,Low,1,Good Loan,0,12.42,B,2,13.82,16627.8117,14000,0,467.82,409000001671,27-Mar-18,FDRL/INTERNAL FUND TRANSFE,,200000.00,1011654.82,P'eng,594,Germany,42050.24,1,1,1
1673,2011,8,MORTGAGE,3,Medium,2,13800, 60 months,2,small_business,3,Low,1,Good Loan,0,11.71,B,2,4.44,17641.10185,13800,0,304.96,409000001672,28-Mar-18,BBPS DT 28032018,"168,011.64",,843643.18,Cremonesi,513,France,110142.34,1,1,1
1674,2011,10,RENT,1,Low,1,16000, 60 months,2,debt_consolidation,6,High,2,Good Loan,0,17.27,D,4,10.91,19575.91,11946.33,0,399.97,409000001673,29-Mar-18,BBPS DT 29032018,"117,919.02",,725724.16,Liang,652,Germany,179269.79,1,1,1
1675,2011,6,MORTGAGE,3,Low,1,24000, 60 months,2,debt_consolidation,6,High,2,Bad Loan,1,14.65,C,3,17.15,14869.6,6855.54,2406.82,566.56,409000001674,29-Mar-18,FDRL/INTERNAL FUND TRANSFE,,300000.00,1025724.16,Gough,680,Germany,90558.24,1,1,1
1676,2011,4,MORTGAGE,3,Low,1,18000, 60 months,2,major_purchase,8,Low,1,Good Loan,0,11.71,B,2,2.1,22009.20324,18000,0,397.77,409000001675,29-Mar-18,FDRL/INTERNAL FUND TRANSFE,,200000.00,1225724.16,Bates,784,Spain,162022.47,1,1,1
1677,2011,8,MORTGAGE,3,High,3,35000, 60 months,2,small_business,3,High,2,Good Loan,0,19.42,E,5,11.41,36681.77,35000,0,916.03,409000001676,31-Mar-18,FDRL/INTERNAL FUND TRANSFE,,200000.00,1425724.16,Padovesi,812,Spain,66926.83,1,1,1
1678,2011,0.5,RENT,1,Low,1,12000, 60 months,2,debt_consolidation,6,High,2,Good Loan,0,13.49,C,3,10.61,13506.66,9146.87,0,276.06,409000001677,31-Mar-18,BBPS DT 31032018,"213,036.21",,1212687.95,Yin,784,Spain,108891.30,1,1,1
1679,2011,5,RENT,1,Low,1,8000, 36 months,1,debt_consolidation,6,Low,1,Bad Loan,1,12.69,B,2,11.13,3291.71,2069.5,340.15,268.36,409000001678,3-Apr-18,BBPS DT 03042018,"62,142.89",,1150545.06,Kharlamov,570,France,71811.90,1,1,1
1680,2011,6.05,MORTGAGE,3,Medium,2,25000, 60 months,2,debt_consolidation,6,High,2,Good Loan,0,14.27,C,3,12.71,34313.02119,25000,0,585.22,409000001679,3-Apr-18,BBPS DT 02042018,"54,010.29",,1096534.77,Nicholls,712,France,92223.59,1,1,1
1681,2011,0.5,RENT,1,Low,1,1000, 36 months,1,moving,10,Low,1,Good Loan,0,10.65,B,2,4,1186.962767,1000,0,32.58,409000001680,4-Apr-18,BBPS DT 04042018,"40,282.34",,1056252.43,Burns,705,Spain,78065.90,1,1,1
1682,2011,1,OWN,2,Low,1,5000, 36 months,1,wedding,5,Low,1,Good Loan,0,6.62,A,1,13.76,5522.217864,5000,0,153.52,409000001681,5-Apr-18,BBPS DT 05042018,"118,388.47",,937863.96,Fleming,681,Spain,59679.90,1,1,1
1683,2011,0.5,RENT,1,Low,1,8500, 60 months,2,debt_consolidation,6,High,2,Good Loan,0,17.58,D,4,8.4,10453.25,6327.31,0,213.91,409000001682,5-Apr-18,FDRL/INTERNAL FUND TRANSFE,,200000.00,1137863.96,Watson,620,France,85000.32,1,1,1
1684,2011,6,MORTGAGE,3,Low,1,22000, 60 months,2,credit_card,1,Low,1,Good Loan,0,12.69,B,2,11.98,24330.63,16847.82,0,497.09,409000001683,6-Apr-18,BBPS DT 06042018,"123,743.72",,1014120.24,Obiajulu,711,France,159808.95,1,1,1
1685,2011,6,OWN,2,Low,1,10000, 36 months,1,credit_card,1,High,2,Good Loan,0,16.77,D,4,8.43,12781.86064,10000,0,355.39,409000001684,7-Apr-18,BBPS DT 07042018,"197,932.71",,816187.53,Han,613,France,129001.30,1,1,1
1686,2011,5,MORTGAGE,3,Medium,2,6000, 36 months,1,car,2,Low,1,Good Loan,0,7.9,A,1,20.09,6394.75,6000,0,187.75,409000001685,9-Apr-18,BBPS DT 09042018,"235,573.75",,580613.78,Ferguson,613,Germany,113557.70,1,1,1
1687,2011,6,MORTGAGE,3,Low,1,30000, 36 months,1,debt_consolidation,6,High,2,Good Loan,0,19.42,E,5,7.95,37600.03,30000,0,1106.07,409000001686,9-Apr-18,FDRL/INTERNAL FUND TRANSFE,,300000.00,880613.78,Tao,682,Spain,147758.51,1,1,1
1688,2011,10,MORTGAGE,3,Low,1,16000, 36 months,1,debt_consolidation,6,Low,1,Good Loan,0,6.62,A,1,9.77,17538.07,16000,0,491.26,409000001687,9-Apr-18,FDRL/INTERNAL FUND TRANSFE,,300000.00,1180613.78,Le Grand,850,Spain,28865.59,1,1,1
1689,2011,2,MORTGAGE,3,Medium,2,3000, 60 months,2,car,2,Low,1,Good Loan,0,12.42,B,2,6.6,3297.72,2301.06,0,67.38,409000001688,10-Apr-18,BBPS DT 10042018,"247,145.70",,933468.08,Valdez,601,France,160607.06,1,1,1
1690,2011,10,MORTGAGE,3,Low,1,16000, 60 months,2,credit_card,1,High,2,Good Loan,0,13.49,C,3,17.13,18015.38,12199.67,0,368.08,409000001689,11-Apr-18,BBPS DT 11042018,"161,435.30",,772032.78,Cunningham,595,Spain,100015.79,1,1,1
1691,2011,5,RENT,1,Medium,2,12000, 36 months,1,credit_card,1,High,2,Bad Loan,1,16.29,D,4,6.1,7600.58,4943.82,404.82,423.61,409000001690,11-Apr-18,FDRL/INTERNAL FUND TRANSFE,,300000.00,1072032.78,Godfrey,675,Spain,54478.52,1,1,1
1692,2011,10,MORTGAGE,3,Low,1,35000, 60 months,2,debt_consolidation,6,High,2,Good Loan,0,20.89,F,6,9.31,52402.3002,35000,0,944.71,409000001691,12-Apr-18,BBPS DT 12042018,"199,217.29",,872815.49,Mai,591,Spain,141677.33,1,1,1
1693,2011,1,RENT,1,Low,1,5000, 36 months,1,moving,10,Low,1,Good Loan,0,9.91,B,2,19.01,5799.192857,5000,0,161.13,409000001692,12-Apr-18,FDRL/INTERNAL FUND TRANSFE,,300000.00,1172815.49,Walker,602,France,84077.60,1,1,1
1694,2011,6,RENT,1,Medium,2,13000, 36 months,1,credit_card,1,Low,1,Bad Loan,1,12.69,B,2,6.33,8309.55,5931.99,426.76,436.09,409000001693,13-Apr-18,BBPS DT 13042018,"191,239.47",,981576.02,Pirozzi,554,Spain,106981.03,1,1,1
1695,2011,10,RENT,1,Low,1,11200, 36 months,1,credit_card,1,Low,1,Good Loan,0,10.65,B,2,10.15,13130.41827,11200,0,364.83,409000001694,13-Apr-18,FDRL/INTERNAL FUND TRANSFE,,200000.00,1181576.02,Feng,541,France,73551.44,1,1,1
1696,2011,2,RENT,1,Low,1,12000, 60 months,2,debt_consolidation,6,High,2,Good Loan,0,17.27,D,4,20.51,15062.52,12000,0,299.98,409000001695,13-Apr-18,FDRL/INTERNAL FUND TRANSFE,,200000.00,1381576.02,Akabueze,506,France,115842.10,1,1,1
1697,2011,10,MORTGAGE,3,Low,1,15000, 60 months,2,debt_consolidation,6,High,2,Bad Loan,1,18.25,D,4,21.41,10689.68,4432.24,1523.84,382.95,409000001696,16-Apr-18,BBPS DT 16042018,"76,266.87",,1305309.15,Robson,814,Germany,107013.59,1,1,1
1698,2011,3,MORTGAGE,3,High,3,35000, 60 months,2,home_improvement,7,High,2,Bad Loan,1,23.13,G,7,18.36,11699.83,3431.53,1814.33,989.29,409000001697,16-Apr-18,BBPS DT 15042018,"133,355.43",,1171953.72,Yevdokimova,683,France,24938.84,1,1,1
1699,2011,5,RENT,1,Low,1,3200, 36 months,1,debt_consolidation,6,Low,1,Good Loan,0,12.69,B,2,4.71,3641.26,3200,0,107.35,409000001698,16-Apr-18,BBPS DT 14042018,"100,657.31",,1071296.41,Ijendu,485,Germany,51113.14,1,1,1
1700,2011,0.5,RENT,1,Low,1,6000, 36 months,1,debt_consolidation,6,Low,1,Bad Loan,1,12.42,B,2,8.92,1303.62,704.71,303.62,200.5,409000001699,17-Apr-18,BBPS SETTELET DTD 17.04.2,"237,804.30",,833492.11,Colombo,696,Germany,33828.64,1,1,1
1701,2011,0.5,RENT,1,Low,1,3100, 36 months,1,credit_card,1,Low,1,Good Loan,0,11.71,B,2,21.78,3511.8,3100,0,102.54,409000001700,17-Apr-18,FDRL/INTERNAL FUND TRANSFE,,200000.00,1033492.11,Akubundu,608,France,128875.86,1,1,1
1702,2011,2,OWN,2,Low,1,5000, 36 months,1,medical,9,Low,1,Good Loan,0,9.91,B,2,23.18,5646.14,5000,0,161.13,409000001701,18-Apr-18,BBPS DT 18042018,"307,704.52",,725787.59,Francis,792,France,194700.81,1,1,1
1703,2011,2,RENT,1,Low,1,25000, 36 months,1,debt_consolidation,6,Low,1,Good Loan,0,12.69,B,2,9.33,30094.37099,25000,0,838.63,409000001702,18-Apr-18,FDRL/INTERNAL FUND TRANSFE,,200000.00,925787.59,Marshall,686,Spain,158974.45,1,1,1
1704,2011,10,MORTGAGE,3,Low,1,5000, 36 months,1,home_improvement,7,High,2,Bad Loan,1,16.77,D,4,24.54,4804,2460.66,1261,177.7,409000001703,18-Apr-18,FDRL/INTERNAL FUND TRANSFE,,300000.00,1225787.59,Rhodes,790,Germany,198182.73,1,1,1
1705,2011,5,MORTGAGE,3,Medium,2,8800, 36 months,1,home_improvement,7,Low,1,Good Loan,0,6.03,A,1,8.85,9641.52122,8800,0,267.84,409000001704,19-Apr-18,BBPS DT 19042018,"242,028.32",,983759.27,Y?,654,France,141404.07,1,1,1
1706,2011,9,RENT,1,Low,1,6000, 36 months,1,debt_consolidation,6,High,2,Good Loan,0,14.27,C,3,24.55,7406.495822,6000,0,205.86,409000001705,20-Apr-18,BBPS DT 20042018,"240,151.47",,743607.80,Bell,452,France,4175.68,1,1,1
1707,2011,5,RENT,1,Low,1,12000, 36 months,1,small_business,3,High,2,Good Loan,0,14.65,C,3,15.45,14260.65,11999.99,0,413.94,409000001706,21-Apr-18,BBPS DT 21042018,"153,156.83",,590450.97,Kerr,719,Spain,126876.47,1,1,1
1708,2011,5,RENT,1,Low,1,8000, 36 months,1,debt_consolidation,6,High,2,Good Loan,0,15.96,C,3,23.51,9035.57,8000,0,281.1,409000001707,21-Apr-18,FDRL/INTERNAL FUND TRANSFE,,300000.00,890450.97,Jideofor,707,France,41052.82,1,1,1
1709,2011,10,MORTGAGE,3,Low,1,10000, 36 months,1,debt_consolidation,6,Low,1,Good Loan,0,11.71,B,2,17.63,11901.78215,10000,0,330.76,409000001708,21-Apr-18,FDRL/INTERNAL FUND TRANSFE,,300000.00,1190450.97,Robertson,699,France,105760.01,1,1,1
1710,2011,7,MORTGAGE,3,Low,1,21000, 60 months,2,home_improvement,7,High,2,Good Loan,0,15.27,C,3,13.23,24550.67,15831.49,0,502.57,409000001709,23-Apr-18,BBPS DT 22042018,"142,263.54",,1048187.43,Kao,850,Spain,27937.12,1,1,1
1711,2011,6,MORTGAGE,3,Low,1,3975, 60 months,2,debt_consolidation,6,High,2,Good Loan,0,17.58,D,4,10.29,4881.16,2955.54,0,100.04,409000001710,23-Apr-18,BBPS DT 23042018,"106,937.58",,941249.85,Palmer,828,Spain,79355.87,1,1,1
1712,2011,8,RENT,1,Low,1,19075, 60 months,2,debt_consolidation,6,High,2,Bad Loan,1,17.58,D,4,23.91,4381.47,1485.09,1010.47,480.04,409000001711,24-Apr-18,BBPS DT 24042018,"212,480.40",,728769.45,Mackay,850,Germany,102180.27,1,1,1
1713,2011,0.5,RENT,1,Low,1,3000, 36 months,1,moving,10,Low,1,Bad Loan,1,8.9,A,1,8.24,1519.2,1231.42,0,95.26,409000001712,24-Apr-18,FDRL/INTERNAL FUND TRANSFE,,300000.00,1028769.45,Burgmann,712,Spain,95719.73,1,1,1
1714,2011,1,OWN,2,Low,1,5000, 36 months,1,debt_consolidation,6,High,2,Good Loan,0,14.27,C,3,17,6171.882612,5000,0,171.55,409000001713,24-Apr-18,FDRL/INTERNAL FUND TRANSFE,,200000.00,1228769.45,Davis,634,France,57121.51,1,1,1
1715,2011,10,RENT,1,Medium,2,35000, 60 months,2,debt_consolidation,6,Low,1,Good Loan,0,12.69,B,2,16.58,38721.32,26811.4,0,790.82,409000001714,24-Apr-18,FDRL/INTERNAL FUND TRANSFE,,200000.00,1428769.45,Milano,730,Germany,162478.11,1,1,1
1716,2011,2,RENT,1,Low,1,10625, 36 months,1,credit_card,1,Low,1,Good Loan,0,12.42,B,2,23.36,11246.16,10625,0,355.04,409000001715,25-Apr-18,BBPS DT 25042018,"188,141.79",,1240627.66,Dellucci,685,Germany,194808.51,1,1,1
1717,2011,8,RENT,1,Low,1,12000, 36 months,1,debt_consolidation,6,Low,1,Good Loan,0,11.71,B,2,18.31,14281.39356,12000,0,396.92,409000001716,26-Apr-18,BBPS DT 26042018,"123,185.81",,1117441.85,Coles,809,Spain,124045.65,1,1,1
1718,2011,0.5,RENT,1,Low,1,9750, 36 months,1,debt_consolidation,6,High,2,Good Loan,0,16.77,D,4,12.74,11995.09,9750.01,0,346.5,409000001717,27-Apr-18,BBPS DT 27042018,"164,119.79",,953322.06,Gray,707,Spain,17987.40,1,1,1
1719,2011,4,RENT,1,Low,1,12000, 36 months,1,other,4,High,2,Good Loan,0,17.27,D,4,18.77,15453.77238,12000,0,429.45,409000001718,27-Apr-18,FDRL/INTERNAL FUND TRANSFE,,300000.00,1253322.06,Macvitie,648,Spain,133653.38,1,1,1
1720,2011,7,RENT,1,Medium,2,21600, 36 months,1,debt_consolidation,6,High,2,Good Loan,0,19.03,E,5,9.71,28509.00237,21600,0,792.1,409000001719,27-Apr-18,FDRL/INTERNAL FUND TRANSFE,,300000.00,1553322.06,Townsend,760,Spain,25101.17,1,1,1
1721,2011,0.5,MORTGAGE,3,Low,1,6000, 36 months,1,home_improvement,7,Low,1,Good Loan,0,8.9,A,1,8.91,6857.538962,6000,0,190.52,409000001720,27-Apr-18,Indiaforensic BBPS GURANATEE FEE,"500,000.00",,1053322.06,Pope,805,Germany,33330.89,1,1,1
1722,2011,5,MORTGAGE,3,Low,1,25450, 60 months,2,major_purchase,8,High,2,Good Loan,0,21.28,F,6,20.9,26349.27,25450,0,692.53,409000001721,30-Apr-18,BBPS DT 28042018,"160,888.20",,892433.86,Jensen,585,France,2401.26,1,1,1
1723,2011,6,RENT,1,Low,1,3575, 36 months,1,debt_consolidation,6,Low,1,Good Loan,0,7.51,A,1,14.59,3788.8,3575,0,111.23,409000001722,30-Apr-18,BBPS DT 29042018,"157,810.46",,734623.40,Thomson,595,Spain,178361.04,1,1,1
1724,2011,10,RENT,1,Low,1,12000, 36 months,1,credit_card,1,Low,1,Good Loan,0,12.42,B,2,14.18,14432.08451,12000,0,400.99,409000001723,30-Apr-18,BBPS DT 30042018,"57,084.32",,677539.08,Chiazagomekpele,630,France,162697.93,1,1,1
1725,2011,10,RENT,1,Low,1,3000, 36 months,1,credit_card,1,Low,1,Good Loan,0,11.71,B,2,10.68,3324.21,3000,0,99.23,409000001724,30-Apr-18,FDRL/INTERNAL FUND TRANSFE,,200000.00,877539.08,Ozuluonye,627,Germany,80607.33,1,1,1
1726,2011,2,RENT,1,Low,1,7000, 36 months,1,other,4,Low,1,Bad Loan,1,8.9,A,1,6.13,5872.44,4653.05,324.44,222.28,409000001725,1-May-18,BBPS DT 01052018,"154,816.50",,722722.58,Wright,631,Germany,23146.62,1,1,1
1727,2011,10,MORTGAGE,3,Low,1,21000, 36 months,1,home_improvement,7,Low,1,Good Loan,0,11.71,B,2,3,25001.25424,21000,0,694.6,409000001726,1-May-18,FDRL/INTERNAL FUND TRANSFE,,200000.00,922722.58,Lung,776,Germany,89893.60,1,1,1
1728,2011,7,RENT,1,Medium,2,25000, 60 months,2,small_business,3,High,2,Bad Loan,1,22.06,F,6,7.04,10228.09,3367.5,1243.4,691.33,409000001727,1-May-18,FDRL/INTERNAL FUND TRANSFE,,200000.00,1122722.58,Lombardo,676,Spain,3173.31,1,1,1
1729,2011,10,MORTGAGE,3,Low,1,12000, 60 months,2,debt_consolidation,6,High,2,Bad Loan,1,14.27,C,3,9.35,4214.09,2439.93,557.77,280.91,409000001728,2-May-18,BBPS DT 02052018,"183,929.92",,938792.66,Leonard,758,Spain,123218.81,1,1,1
1730,2011,6,MORTGAGE,3,Low,1,25000, 60 months,2,debt_consolidation,6,High,2,Good Loan,0,18.25,D,4,18.84,29285.69,25000,0,638.25,409000001729,3-May-18,BBPS DT 03052018,"187,650.10",,751142.56,Johnston,637,France,74588.41,1,1,1
1731,2011,8,MORTGAGE,3,Low,1,6075, 36 months,1,debt_consolidation,6,Low,1,Good Loan,0,6.03,A,1,10.17,6646.926703,6075,0,184.9,409000001730,3-May-18,FDRL/INTERNAL FUND TRANSFE,,300000.00,1051142.56,P'eng,850,France,31288.77,1,1,1
1732,2011,10,RENT,1,Low,1,5000, 36 months,1,other,4,Low,1,Good Loan,0,11.71,B,2,13.48,5950.733572,5000,0,165.38,409000001731,4-May-18,BBPS DT 04052018,"139,069.50",,912073.06,Amechi,601,Spain,58561.31,1,1,1
1733,2011,10,RENT,1,Low,1,10400, 36 months,1,debt_consolidation,6,High,2,Bad Loan,1,15.27,C,3,19.58,9771.3,7313.37,0,361.9,409000001732,4-May-18,FDRL/INTERNAL FUND TRANSFE,,200000.00,1112073.06,Fang,735,France,148804.36,1,1,1
1734,2011,4,OWN,2,Low,1,8000, 36 months,1,debt_consolidation,6,High,2,Good Loan,0,15.96,C,3,12.34,9918.366348,8000,0,281.1,409000001733,4-May-18,FDRL/INTERNAL FUND TRANSFE,,300000.00,1412073.06,Docherty,614,Germany,51117.06,1,1,1
1735,2011,1,RENT,1,Low,1,11000, 36 months,1,credit_card,1,Low,1,Good Loan,0,12.42,B,2,18.17,12558.38,11000,0,367.57,409000001734,5-May-18,BBPS DT 05052018,"107,985.24",,1304087.82,Horton,672,Germany,164537.17,1,1,1
1736,2011,10,RENT,1,Low,1,33600, 60 months,2,debt_consolidation,6,High,2,Good Loan,0,14.27,C,3,20.57,38527.75,25528.37,0,786.53,409000001735,7-May-18,BBPS DT 06052018,"190,194.70",,1113893.12,Vincent,642,France,61977.82,1,1,1
1737,2011,3,RENT,1,Low,1,12000, 36 months,1,credit_card,1,High,2,Good Loan,0,14.27,C,3,24.56,13783.67,12000,0,411.71,409000001736,7-May-18,BBPS DT 07052018,"68,538.04",,1045355.08,Onio,633,Germany,193362.99,1,1,1
1738,2011,10,MORTGAGE,3,Low,1,12000, 36 months,1,debt_consolidation,6,Low,1,Good Loan,0,6.62,A,1,12.09,13261.07167,12000,0,368.45,409000001737,8-May-18,BBPS DT 08052018,"242,380.79",,802974.29,Schiavone,769,Spain,47722.79,1,1,1
1739,2011,10,MORTGAGE,3,Low,1,11100, 60 months,2,debt_consolidation,6,High,2,Good Loan,0,15.96,C,3,24.12,14747.10253,11100,0,269.7,409000001738,8-May-18,FDRL/INTERNAL FUND TRANSFE,,300000.00,1102974.29,Chandler,796,Spain,18510.41,1,1,1
1740,2011,2,RENT,1,Low,1,20000, 36 months,1,debt_consolidation,6,High,2,Good Loan,0,18.64,E,5,12.28,26267.68789,20000,0,729.49,409000001739,9-May-18,BBPS DT 09052018,"129,549.64",,973424.65,Fiorentino,715,France,65057.71,1,1,1
1741,2011,4,RENT,1,Low,1,3000, 36 months,1,debt_consolidation,6,Low,1,Bad Loan,1,10.65,B,2,8.58,2635.84,2156.21,0,97.72,409000001740,9-May-18,FDRL/INTERNAL FUND TRANSFE,,300000.00,1273424.65,Butusov,695,France,46374.64,1,1,1
1742,2011,6,RENT,1,Low,1,15075, 36 months,1,debt_consolidation,6,High,2,Bad Loan,1,15.27,C,3,20.5,14333.42,10146.62,694.34,524.58,409000001741,10-May-18,BBPS DT 10052018,"82,525.95",,1190898.70,Wang,747,France,42039.67,1,1,1
1743,2011,6,RENT,1,Low,1,15000, 36 months,1,credit_card,1,High,2,Good Loan,0,17.27,D,4,5.84,19320.20242,15000,0,536.81,409000001742,11-May-18,BBPS DT 11052018,"77,162.26",,1113736.44,Alexeieva,584,Germany,138192.98,1,1,1
1744,2011,3,MORTGAGE,3,Low,1,24000, 36 months,1,credit_card,1,High,2,Good Loan,0,17.58,D,4,14.33,30695.83083,24000,0,862.61,409000001743,14-May-18,FDRL/INTERNAL FUND TRANSFE,,300000.00,1413736.44,Vinogradova,476,France,22735.45,1,1,1
1745,2011,10,RENT,1,Low,1,8500, 36 months,1,debt_consolidation,6,Low,1,Good Loan,0,10.65,B,2,16.32,9963.881151,8500,0,276.88,409000001744,14-May-18,BBPS DT 12052018,"11,483.23",,1402253.21,Hughes,850,France,186910.74,1,1,1
1746,2011,2,MORTGAGE,3,Medium,2,28000, 60 months,2,debt_consolidation,6,High,2,Bad Loan,1,18.64,E,5,10.18,25106.38,11384.31,2376.13,720.81,409000001745,14-May-18,BBPS DT 13052018,,22479.51,1424732.72,Ts'ao,529,France,75285.47,1,1,1
1747,2011,6,RENT,1,Low,1,23000, 60 months,2,debt_consolidation,6,High,2,Good Loan,0,18.64,E,5,21.17,31409.28948,23000,0,592.09,409000001746,14-May-18,BBPS DT 14052018,,109368.29,1534101.01,Bage,584,Spain,130260.11,1,1,1
1748,2011,6,MORTGAGE,3,Low,1,5500, 36 months,1,debt_consolidation,6,Low,1,Good Loan,0,9.91,B,2,8.75,6283.23,5500,0,177.24,409000001747,15-May-18,BBPS DT 15052018,"141,740.47",,1392360.54,Yudina,586,Germany,15034.93,1,1,1
1749,2011,10,RENT,1,Low,1,15000, 36 months,1,debt_consolidation,6,High,2,Bad Loan,1,22.35,F,6,17.57,15214.98,9299.72,825.77,575.58,409000001748,16-May-18,BBPS DT 16052018,"7,367.22",,1384993.32,Naquin,674,Germany,175709.40,1,1,1
1750,2011,3,MORTGAGE,3,Medium,2,5000, 36 months,1,debt_consolidation,6,Low,1,Bad Loan,1,12.69,B,2,13.28,5025.25,3858.78,180.84,167.73,409000001749,17-May-18,BBPS DT 17052018,,13011.68,1398005.00,Endrizzi,552,France,101069.71,1,1,1
1751,2011,0.5,RENT,1,Low,1,8875, 36 months,1,wedding,5,High,2,Good Loan,0,14.65,C,3,21.16,9998.44,8875,0,306.14,409000001750,19-May-18,BBPS DT 19052018,,20256.89,1418261.89,Tang,601,Germany,153012.13,1,1,1
1752,2011,0.5,RENT,1,Low,1,8000, 36 months,1,moving,10,Low,1,Bad Loan,1,9.91,B,2,3.88,7495.28,5998.88,293,257.8,409000001751,19-May-18,BBPS DT 18052018,"39,858.43",,1378403.46,Schroeder,541,France,86173.92,1,1,1
1753,2011,10,RENT,1,Low,1,4500, 36 months,1,debt_consolidation,6,High,2,Bad Loan,1,14.27,C,3,18.92,4211.99,3045.41,205.17,154.4,409000001752,21-May-18,BBPS DT 20052018,,17961.93,1396365.39,Swearingen,744,Germany,197548.63,1,1,1
1754,2011,10,MORTGAGE,3,Medium,2,35000, 60 months,2,other,4,High,2,Good Loan,0,13.49,C,3,7.72,35782.71,35000,0,805.17,409000001753,21-May-18,BBPS DT 21052018,,41666.35,1438031.74,McGregor,595,Spain,37042.80,1,1,1
1755,2011,5,OWN,2,Low,1,10000, 36 months,1,credit_card,1,High,2,Good Loan,0,13.49,C,3,10.32,12209.10033,10000,0,339.31,409000001754,22-May-18,BBPS DT 22052018,"90,671.52",,1347360.22,Onyeorulu,724,Germany,121085.72,1,1,1
1756,2011,10,MORTGAGE,3,Low,1,18650, 36 months,1,credit_card,1,Low,1,Good Loan,0,7.9,A,1,21.62,21007.21353,18650,0,583.57,409000001755,23-May-18,BBPS DT 23052018,"153,131.62",,1194228.60,Clarke,533,Spain,194113.99,1,1,1
1757,2011,5,RENT,1,Low,1,16000, 60 months,2,debt_consolidation,6,High,2,Good Loan,0,15.27,C,3,7.76,18717.04,12068.91,0,382.92,409000001756,24-May-18,BBPS DT 25052018,"84,937.59",,1109291.01,Smith,618,France,101273.23,1,1,1
1758,2011,5,RENT,1,Medium,2,23700, 60 months,2,credit_card,1,High,2,Good Loan,0,17.58,D,4,13.17,33449.39357,23700,0,596.43,409000001757,25-May-18,BBPS DT 25052018,"127,374.04",,981916.97,Kozlova,523,Germany,118711.75,1,1,1
1759,2011,0.5,RENT,1,Low,1,6400, 36 months,1,major_purchase,8,Low,1,Good Loan,0,7.51,A,1,9.58,7166.272547,6400,0,199.11,409000001758,28-May-18,BBPS DT 26052018,"131,055.59",,850861.38,Nekrasov,642,Germany,582.53,1,1,1
1760,2011,2,RENT,1,Low,1,7000, 60 months,2,other,4,High,2,Good Loan,0,18.64,E,5,8.8,7389.85,7000,0,180.21,409000001759,28-May-18,BBPS DT 27052018,"51,500.80",,799360.58,Olague,584,France,192381.21,1,1,1
1761,2011,0.5,RENT,1,Low,1,3500, 36 months,1,debt_consolidation,6,High,2,Good Loan,0,14.27,C,3,20.19,4320.044523,3500,0,120.09,409000001760,28-May-18,BBPS DT 28052018,,53022.28,852382.86,Holt,521,France,136507.69,1,1,1
1762,2011,0.5,MORTGAGE,3,Low,1,10200, 36 months,1,other,4,Low,1,Good Loan,0,7.9,A,1,16.98,11457.67856,10200,0,319.17,409000001761,28-May-18,FDRL/INTERNAL FUND TRANSFE,,300000.00,1152382.86,Olsen,662,France,138871.12,1,1,1
1763,2011,5,RENT,1,Low,1,12000, 36 months,1,wedding,5,Low,1,Bad Loan,1,12.42,B,2,19.09,1700.92,1347.85,0,400.99,409000001762,29-May-18,BBPS DT 26052018,"142,369.35",,1010013.51,Mazzi,758,France,60728.89,1,1,1
1764,2011,2,RENT,1,Low,1,9000, 36 months,1,debt_consolidation,6,Low,1,Bad Loan,1,11.71,B,2,6.38,9433.46,7533.45,231.33,297.69,409000001763,30-May-18,BBPS DT 30052018,"110,513.70",,899499.81,Niu,717,France,189175.71,1,1,1
1765,2011,10,RENT,1,Low,1,4000, 36 months,1,debt_consolidation,6,Low,1,Good Loan,0,12.69,B,2,17.11,4601.11,4000,0,134.18,409000001764,30-May-18,FDRL/INTERNAL FUND TRANSFE,,300000.00,1199499.81,Graham,611,France,102547.56,1,1,1
1766,2011,4,MORTGAGE,3,Low,1,35000, 60 months,2,debt_consolidation,6,High,2,Bad Loan,1,21.28,F,6,16.56,32466.07,3594.41,22943.37,952.39,409000001765,31-May-18,BBPS DT 31052018,"115,854.87",,1083644.94,Millar,766,Germany,36706.56,1,1,1
1767,2011,2,MORTGAGE,3,Medium,2,20000, 60 months,2,credit_card,1,High,2,Good Loan,0,17.58,D,4,11.05,24263.25,20000,0,503.32,409000001766,1-Jun-18,BBPS DT 01062018,"34,285.36",,1049359.58,Bell,636,France,44756.25,1,1,1
1768,2011,3,MORTGAGE,3,Low,1,5000, 36 months,1,other,4,Low,1,Good Loan,0,9.91,B,2,6.98,5798.06078,5000,0,161.13,409000001767,2-Jun-18,BBPS DT 02062018,"65,093.04",,984266.54,Kelly,814,France,132870.15,1,1,1
1769,2011,10,RENT,1,Low,1,20000, 60 months,2,debt_consolidation,6,High,2,Bad Loan,1,13.49,C,3,23.31,13356.12,6736.63,1872.87,460.1,409000001768,4-Jun-18,BBPS DT 03062018,"38,019.06",,946247.48,T'an,760,Spain,16287.38,1,1,1
1770,2011,10,MORTGAGE,3,Low,1,7200, 36 months,1,other,4,Low,1,Good Loan,0,6.62,A,1,11.46,7352.82,7200,0,221.07,409000001769,4-Jun-18,BBPS DT 04062018,,14181.98,960429.46,Davila,607,Germany,121945.42,1,1,1
1771,2011,4,RENT,1,Low,1,5500, 36 months,1,other,4,Low,1,Good Loan,0,7.51,A,1,5.56,5538.32,5500,0,171.11,409000001770,5-Jun-18,BBPS DT 05062018,"78,982.56",,881446.90,Willis,725,Spain,131173.90,1,1,1
1772,2011,0.5,RENT,1,Low,1,3000, 36 months,1,major_purchase,8,Low,1,Good Loan,0,10.65,B,2,17.96,3345.95,3000,0,97.72,409000001771,6-Jun-18,BBPS DT 06062018,"64,415.11",,817031.79,Dumetochukwu,600,France,88669.89,1,1,1
1773,2011,10,RENT,1,Medium,2,20000, 60 months,2,debt_consolidation,6,High,2,Good Loan,0,15.27,C,3,18.63,23369.12,15066.11,0,478.64,409000001772,7-Jun-18,BBPS DT 07062018,"97,510.32",,719521.47,Giles,656,Germany,160835.30,1,1,1
1774,2011,9,RENT,1,Low,1,9000, 36 months,1,credit_card,1,High,2,Good Loan,0,16.77,D,4,16.74,11506.89964,9000,0,319.85,409000001773,8-Jun-18,BBPS DT 08062018,"25,366.64",,694154.83,O'Meara,640,Spain,24761.36,1,1,1
1775,2011,3,RENT,1,Low,1,9000, 36 months,1,debt_consolidation,6,Low,1,Good Loan,0,8.9,A,1,3.3,9257.86,9000,0,285.78,409000001774,11-Jun-18,FDRL/INTERNAL FUND TRANSFE,,300000.00,994154.83,Yao,439,France,138526.96,1,1,1
1776,2011,10,RENT,1,Low,1,6000, 36 months,1,debt_consolidation,6,Low,1,Good Loan,0,7.9,A,1,5.54,6723.887909,6000,0,187.75,409000001775,11-Jun-18,FDRL/INTERNAL FUND TRANSFE,,300000.00,1294154.83,Wallace,549,France,157442.75,1,1,1
1777,2011,9,MORTGAGE,3,Low,1,4000, 36 months,1,home_improvement,7,Low,1,Good Loan,0,6.62,A,1,10.48,4022.34,4000,0,122.82,409000001776,11-Jun-18,BBPS DT 09062018,"27,920.62",,1266234.21,T'ien,622,France,105295.77,1,1,1
1778,2011,10,MORTGAGE,3,Low,1,28200, 60 months,2,home_improvement,7,High,2,Good Loan,0,19.03,E,5,22.88,35833.45,20848.22,0,731.99,409000001777,11-Jun-18,BBPS DT 10062018,"8,112.82",,1258121.39,Ndubueze,715,France,97782.92,1,1,1
1779,2011,4,RENT,1,Low,1,21200, 60 months,2,debt_consolidation,6,High,2,Good Loan,0,18.25,D,4,23.25,30855.03719,21199.99,0,541.23,409000001778,11-Jun-18,BBPS DT 11062018,,82132.09,1340253.48,Chukwuraenye,657,France,68255.88,1,1,1
1780,2011,5,RENT,1,Medium,2,25000, 36 months,1,debt_consolidation,6,High,2,Good Loan,0,15.27,C,3,15.5,31120.26355,25000,0,869.95,409000001779,12-Jun-18,BBPS DT 12062018,"29,859.18",,1310394.30,K'ung,703,France,108790.95,1,1,1
1781,2011,7,RENT,1,Low,1,12000, 36 months,1,debt_consolidation,6,Low,1,Good Loan,0,11.71,B,2,4.67,14152.6919,12000,0,396.92,409000001780,13-Jun-18,BBPS DT 13062018,"16,905.35",,1293488.95,Stevenson,802,France,143706.18,1,1,1
1782,2011,6,MORTGAGE,3,Low,1,15000, 60 months,2,other,4,High,2,Good Loan,0,20.3,E,5,15.15,19543.51,10993.56,0,399.92,409000001781,14-Jun-18,BBPS DT 14062018,"39,815.49",,1253673.46,Marshall,793,Spain,148993.47,1,1,1
1783,2011,0.5,MORTGAGE,3,Low,1,17000, 36 months,1,home_improvement,7,Low,1,Good Loan,0,12.42,B,2,10.06,18956.75,17000,0,568.06,409000001782,15-Jun-18,BBPS DT 15062018,"30,196.44",,1223477.02,Hayward,554,France,95277.15,1,1,1
1784,2011,10,RENT,1,Low,1,20000, 36 months,1,other,4,Low,1,Good Loan,0,7.51,A,1,10.54,21616.32,20000,0,622.22,409000001783,18-Jun-18,BBPS DT 16062018,"12,958.25",,1210518.77,Tipton,533,Spain,152956.33,1,1,1
1785,2011,6.05,RENT,1,Low,1,5000, 60 months,2,credit_card,1,High,2,Bad Loan,1,16.77,D,4,7.39,614.6,274.86,0,123.65,409000001784,18-Jun-18,BBPS DT 17062018,,43963.21,1254481.98,Gibson,658,France,94925.62,1,1,1
1786,2011,6,RENT,1,Low,1,7700, 36 months,1,credit_card,1,Low,1,Good Loan,0,8.9,A,1,18.3,8800.303431,7700,0,244.5,409000001785,18-Jun-18,BBPS DT 18062018,,53656.53,1308138.51,Fraser,713,Germany,87308.18,1,1,1
1787,2011,4,RENT,1,Low,1,14000, 60 months,2,debt_consolidation,6,High,2,Good Loan,0,17.58,D,4,11.65,14998.24,14000,0,352.32,409000001786,19-Jun-18,BBPS DT 19062018,"180,907.04",,1127231.47,Fang,711,Spain,83978.86,1,1,1
1788,2011,0.5,RENT,1,Low,1,10000, 36 months,1,debt_consolidation,6,Low,1,Good Loan,0,12.42,B,2,8.55,11746.99695,10000,0,334.16,409000001787,20-Jun-18,BBPS DT 20062018,"146,123.98",,981107.49,Dubinina,669,France,37543.93,1,1,1
1789,2011,4,RENT,1,Low,1,6475, 36 months,1,debt_consolidation,6,Low,1,Good Loan,0,9.91,B,2,22.51,7492.767331,6475,0,208.66,409000001788,21-Jun-18,BBPS DT 21062018,"71,360.10",,909747.39,Morey,439,France,104889.30,1,1,1
1790,2011,10,RENT,1,Low,1,12000, 60 months,2,debt_consolidation,6,High,2,Bad Loan,1,19.91,E,5,14.38,11482.8,5130.25,1007,317.33,409000001789,22-Jun-18,BBPS DT 22062018,"34,623.77",,875123.62,Todd,763,Spain,149705.25,1,1,1
1791,2011,10,MORTGAGE,3,Low,1,12600, 60 months,2,debt_consolidation,6,High,2,Good Loan,0,19.03,E,5,12.67,15963.54,9292.47,0,327.06,409000001790,22-Jun-18,FDRL/INTERNAL FUND TRANSFE,,200000.00,1075123.62,Forbes,697,Germany,16445.79,1,1,1
1792,2011,9,MORTGAGE,3,Low,1,15600, 36 months,1,debt_consolidation,6,Low,1,Good Loan,0,6.03,A,1,18.49,16352.07,15600,0,474.8,409000001791,25-Jun-18,BBPS DT 23062018,"24,246.10",,1050877.52,De Salis,702,Spain,54689.16,1,1,1
1793,2011,3,RENT,1,Medium,2,25000, 36 months,1,debt_consolidation,6,High,2,Good Loan,0,15.96,C,3,8.21,31607.41415,25000.01,0,878.44,409000001792,25-Jun-18,BBPS DT 24062018,"26,719.16",,1024158.36,Barry,686,Spain,194913.86,1,1,1
1794,2011,10,MORTGAGE,3,Medium,2,14400, 36 months,1,credit_card,1,High,2,Good Loan,0,14.27,C,3,7.7,17657.74498,14400,0,494.05,409000001793,25-Jun-18,BBPS DT 25062018,,55573.29,1079731.65,Afamefuna,629,Spain,146371.72,1,1,1
1795,2011,2,MORTGAGE,3,High,3,25000, 36 months,1,car,2,Low,1,Good Loan,0,6.62,A,1,4.65,26420.12,25000,0,767.6,409000001794,26-Jun-18,BBPS DT 26062018,"48,110.56",,1031621.09,Ibbott,823,France,156603.70,1,1,1
1796,2011,10,MORTGAGE,3,Low,1,25000, 60 months,2,debt_consolidation,6,High,2,Good Loan,0,18.25,D,4,9.91,31246.95,18567.18,0,638.25,409000001795,27-Jun-18,BBPS DT 27062018,"63,907.21",,967713.88,Marshall,683,Germany,182566.76,1,1,1
1797,2011,9,RENT,1,Low,1,18000, 36 months,1,debt_consolidation,6,Low,1,Good Loan,0,7.9,A,1,23.13,20274.95379,18000,0,563.23,409000001796,28-Jun-18,BBPS DT 28062018,"23,085.44",,944628.44,Law,555,France,60194.05,1,1,1
1798,2011,6.05,MORTGAGE,3,Low,1,12000, 36 months,1,debt_consolidation,6,Low,1,Good Loan,0,6.62,A,1,12.53,13260.4136,12000,0,368.45,409000001797,28-Jun-18,FDRL/INTERNAL FUND TRANSFE,,200000.00,1144628.44,Pinto,647,Germany,36579.53,1,1,1
1799,2011,10,MORTGAGE,3,Low,1,4000, 36 months,1,debt_consolidation,6,Low,1,Good Loan,0,6.03,A,1,9.01,4378.65249,4000,0,121.75,409000001798,29-Jun-18,BBPS DT 29062018,"3,341.29",,1141287.15,Chinedum,714,France,5862.53,1,1,1
1800,2011,2,MORTGAGE,3,Low,1,30000, 60 months,2,debt_consolidation,6,High,2,Good Loan,0,18.64,E,5,15.58,42918.22939,30000,0,772.29,409000001799,30-Jun-18,BBPS DT 30062018,"12,252.00",,1129035.15,McKay,850,Spain,143030.09,1,1,1
1801,2011,6,MORTGAGE,3,Low,1,27700, 60 months,2,small_business,3,High,2,Good Loan,0,20.3,E,5,0.32,36158.36,20331.25,0,738.52,409000001800,2-Jul-18,BBPS DT 01072018,"22,571.88",,1106463.27,Otutodilinna,713,France,62700.08,1,1,1
1802,2011,10,RENT,1,Low,1,12000, 36 months,1,debt_consolidation,6,Low,1,Good Loan,0,7.51,A,1,11.91,13166.9,12000,0,373.33,409000001801,2-Jul-18,BBPS DT 02072018,,55900.40,1162363.67,She,452,France,99017.34,1,1,1
1803,2011,2,MORTGAGE,3,Low,1,10000, 36 months,1,medical,9,Low,1,Good Loan,0,7.51,A,1,13.08,10208.12,10000,0,311.11,409000001802,3-Jul-18,BBPS DT 03072018,,44892.38,1207256.05,Pai,683,Spain,187987.01,1,1,1
1804,2011,1,MORTGAGE,3,Medium,2,16000, 60 months,2,other,4,High,2,Bad Loan,1,22.35,F,6,21.16,10324.26,3313.54,1875.53,445.1,409000001803,4-Jul-18,BBPS DT 04072018,"6,904.87",,1200351.18,Kruglov,577,France,123454.62,1,1,1
1805,2011,2,MORTGAGE,3,Low,1,5000, 36 months,1,home_improvement,7,High,2,Good Loan,0,15.96,C,3,18.53,6322.075618,5000,0,175.69,409000001804,5-Jul-18,BBPS DT 05072018,,17198.35,1217549.53,Chin,552,France,10921.50,1,1,1
1806,2011,4,MORTGAGE,3,Medium,2,25000, 60 months,2,credit_card,1,High,2,Good Loan,0,24.11,G,7,8.3,31596.94,25000,0,720.8,409000001805,6-Jul-18,BBPS DT 06072018,"29,872.95",,1187676.58,King,769,Germany,53817.23,1,1,1
1807,2011,3,OWN,2,Low,1,8000, 36 months,1,credit_card,1,Low,1,Good Loan,0,8.9,A,1,14.75,9142.683196,8000,0,254.03,409000001806,7-Jul-18,BBPS DT 07072018,,12990.47,1200667.05,Hansen,691,France,81617.40,1,1,1
1808,2011,3,MORTGAGE,3,Low,1,17375, 36 months,1,home_improvement,7,High,2,Good Loan,0,14.27,C,3,19.15,21448.44032,17375,0,596.12,409000001807,9-Jul-18,BBPS DT 09072018,,67657.57,1268324.62,Ting,818,France,192298.84,1,1,1
1809,2011,3,RENT,1,Low,1,2500, 36 months,1,moving,10,Low,1,Good Loan,0,10.65,B,2,20.08,2996.48021,2500,0,81.44,409000001808,9-Jul-18,BBPS DT 08072018,"29,077.09",,1239247.53,Stone,739,France,143882.25,1,1,1
1810,2011,4,RENT,1,Low,1,15800, 60 months,2,debt_consolidation,6,High,2,Good Loan,0,18.25,D,4,13.1,19708.63,11715.16,0,403.37,409000001809,10-Jul-18,BBPS DT 10072018,"90,684.03",,1148563.50,McLean,639,France,53130.41,1,1,1
1811,2011,10,MORTGAGE,3,Low,1,6000, 36 months,1,debt_consolidation,6,Low,1,Good Loan,0,6.03,A,1,12.15,6285.4,6000,0,182.62,409000001810,11-Jul-18,BBPS DT 11072018,"66,435.79",,1082127.71,Zikoranachidimma,651,France,190454.04,1,1,1
1812,2011,7,MORTGAGE,3,High,3,35000, 36 months,1,house,12,Low,1,Good Loan,0,10.65,B,2,18.14,41037.5748,35000,0,1140.07,409000001811,12-Jul-18,BBPS DT 12072018,"121,795.12",,960332.59,Fu,779,France,111906.00,1,1,1
1813,2011,1,RENT,1,Low,1,15000, 36 months,1,debt_consolidation,6,High,2,Good Loan,0,16.77,D,4,16.45,19183.39395,15000,0,533.08,409000001812,13-Jul-18,BBPS DT 13072018,"41,636.56",,918696.03,Trevisano,850,Germany,113177.95,1,1,1
1814,2011,9,MORTGAGE,3,Low,1,18500, 36 months,1,debt_consolidation,6,Low,1,Good Loan,0,12.42,B,2,11.29,21857.61118,18500,0,618.19,409000001813,13-Jul-18,FDRL/INTERNAL FUND TRANSFE,,300000.00,1218696.03,Fallaci,829,France,30529.88,1,1,1
1815,2011,1,MORTGAGE,3,High,3,35000, 60 months,2,house,12,High,2,Good Loan,0,14.27,C,3,4.34,42852.57908,35000,0,819.3,409000001814,16-Jul-18,BBPS DT 14072018,"53,279.64",,1165416.39,Wiley,579,Germany,18800.13,1,1,1
1816,2011,0.5,MORTGAGE,3,Low,1,6000, 36 months,1,debt_consolidation,6,Low,1,Good Loan,0,10.65,B,2,8.1,6145.93,6000,0,195.44,409000001815,16-Jul-18,BBPS DT 15072018,,3521.67,1168938.06,Chiagoziem,510,France,46127.70,1,1,1
1817,2011,6,MORTGAGE,3,Low,1,15000, 36 months,1,debt_consolidation,6,Low,1,Good Loan,0,10.65,B,2,13.14,17589.48945,15000,0,488.6,409000001816,16-Jul-18,BBPS DT 16072018,,100682.10,1269620.16,Murray,531,France,75585.48,1,1,1
1818,2011,10,MORTGAGE,3,Medium,2,4800, 36 months,1,car,2,Low,1,Good Loan,0,12.42,B,2,9.64,5772.450725,4800,0,160.4,409000001817,17-Jul-18,BBPS DT 17072018,"100,369.80",,1169250.36,Chuang,628,Germany,63085.94,1,1,1
1819,2011,6,MORTGAGE,3,Low,1,18000, 60 months,2,debt_consolidation,6,High,2,Good Loan,0,19.42,E,5,13.07,23057.64,13275.4,0,471.1,409000001818,18-Jul-18,BBPS DT 18072018,"76,026.55",,1093223.81,Huang,633,Spain,74415.20,1,1,1
1820,2011,4,MORTGAGE,3,Low,1,20000, 36 months,1,home_improvement,7,Low,1,Good Loan,0,12.42,B,2,8.41,22950.36,19999.99,0,668.31,409000001819,19-Jul-18,BBPS DT 19072018,"30,494.01",,1062729.80,Chukwukere,714,Spain,139889.15,1,1,1
1821,2011,2,OWN,2,Low,1,29000, 60 months,2,debt_consolidation,6,Low,1,Good Loan,0,12.69,B,2,12.88,31620.34,29000.01,0,655.25,409000001820,20-Jul-18,BBPS DT 20072018,"90,799.39",,971930.41,Hsia,604,Spain,7267.25,1,1,1
1822,2011,6,RENT,1,Low,1,14125, 60 months,2,debt_consolidation,6,High,2,Good Loan,0,15.27,C,3,23.54,15168.95,14125,0,338.04,409000001821,21-Jul-18,BBPS DT 21072018,,21731.12,993661.53,Lee,630,Spain,186826.22,1,1,1
1823,2011,6,OWN,2,Low,1,17625, 60 months,2,debt_consolidation,6,High,2,Bad Loan,1,20.3,E,5,19.17,937.4,345.52,0,469.91,409000001822,23-Jul-18,BBPS DT 22072018,,33830.77,1027492.30,Theus,850,Spain,162149.07,1,1,1
1824,2011,2,RENT,1,Low,1,5000, 36 months,1,moving,10,Low,1,Good Loan,0,12.69,B,2,14.8,6034.083777,5000,0,167.73,409000001823,23-Jul-18,BBPS DT 23072018,,3260.67,1030752.97,Jennings,788,Germany,180150.49,1,1,1
1825,2011,8,RENT,1,Low,1,10000, 36 months,1,credit_card,1,Low,1,Good Loan,0,6.62,A,1,8.29,10844.15,10000,0,307.04,409000001824,23-Jul-18,BBPS DT 23072018,,49973.88,1080726.85,Parker,798,France,83478.12,1,1,1
1826,2011,10,MORTGAGE,3,Medium,2,10000, 36 months,1,small_business,3,Low,1,Good Loan,0,6.03,A,1,4.85,10956.34506,10000,0,304.36,409000001825,24-Jul-18,BBPS DT 24072018,,17711.45,1098438.30,Tan,770,Germany,26163.74,1,1,1
1827,2011,7,RENT,1,Low,1,13200, 60 months,2,credit_card,1,High,2,Good Loan,0,14.27,C,3,12.61,15107.29,10013.81,0,309,409000001826,25-Jul-18,BBPS DT 25072018,"97,234.02",,1001204.28,Barry,569,Germany,44381.06,1,1,1
1828,2011,0.5,MORTGAGE,3,Low,1,2400, 36 months,1,debt_consolidation,6,Low,1,Good Loan,0,11.71,B,2,1.6,2855.611293,2400,0,79.39,409000001827,26-Jul-18,BBPS DT 26072018,"22,302.35",,978901.93,Tuan,425,Spain,136365.00,1,1,1
1829,2011,6,MORTGAGE,3,Low,1,4000, 36 months,1,debt_consolidation,6,Low,1,Good Loan,0,7.9,A,1,9.75,4384.18,4000,0,125.17,409000001828,27-Jul-18,BBPS DT 27072018,,10227.38,989129.31,Patterson,547,Spain,99294.22,1,1,1
1830,2011,1,MORTGAGE,3,Low,1,12000, 36 months,1,debt_consolidation,6,Low,1,Good Loan,0,6.03,A,1,6.17,13147.47714,12000,0,365.23,409000001829,30-Jul-18,BBPS DT 28072018,,33190.68,1022319.99,Ofodile,725,Germany,173464.43,1,1,1
1831,2011,3,MORTGAGE,3,Low,1,24000, 60 months,2,credit_card,1,Low,1,Bad Loan,1,12.69,B,2,25.54,16810.68,10495.5,29.9,542.28,409000001830,30-Jul-18,BBPS DT 29072018,"4,625.14",,1017694.85,Chandler,506,France,127543.81,1,1,1
1832,2011,7,MORTGAGE,3,Low,1,4000, 60 months,2,debt_consolidation,6,High,2,Good Loan,0,19.03,E,5,7.2,5445.559176,4000,0,103.83,409000001831,30-Jul-18,BBPS DT 30072018,,71337.37,1089032.22,Nash,632,France,52526.65,1,1,1
1833,2011,6.05,MORTGAGE,3,Low,1,3200, 36 months,1,debt_consolidation,6,Low,1,Bad Loan,1,7.9,A,1,27.15,528.65,78.88,428.75,100.13,409000001832,31-Jul-18,BBPS DT 31072018,"29,089.53",,1059942.69,Atkinson,620,France,32589.45,1,1,1
1834,2011,6.05,RENT,1,Low,1,14000, 36 months,1,debt_consolidation,6,Low,1,Good Loan,0,11.71,B,2,14.94,16666.2024,14000,0,463.07,409000001833,1-Aug-18,BBPS DT 01082018,"30,347.75",,1029594.94,Brenan,663,Germany,47161.25,1,1,1
1835,2011,6,MORTGAGE,3,Low,1,10000, 36 months,1,debt_consolidation,6,High,2,Bad Loan,1,16.29,D,4,14.01,3291.06,1821.19,469.7,353.01,409000001834,2-Aug-18,BBPS DT 02082018,,20224.88,1049819.82,Obidimkpa,700,Spain,45424.13,1,1,1
1836,2011,3,RENT,1,Low,1,15000, 36 months,1,credit_card,1,Low,1,Good Loan,0,10.65,B,2,21.58,17572.27803,15000,0,488.6,409000001835,3-Aug-18,BBPS DT 03082018,"4,795.33",,1045024.49,Terry,696,Germany,8018.49,1,1,1
1837,2011,10,RENT,1,Low,1,10000, 36 months,1,other,4,Low,1,Good Loan,0,12.69,B,2,17.51,12070.94552,10000,0,335.45,409000001836,4-Aug-18,BBPS DT 04082018,"14,728.37",,1030296.12,Spring,767,Spain,195668.00,1,1,1
1838,2011,2,RENT,1,Low,1,1000, 36 months,1,debt_consolidation,6,High,2,Bad Loan,1,19.03,E,5,15.54,618,372.99,35.6,36.68,409000001837,6-Aug-18,BBPS DT 05082018,,62024.88,1092321.00,Mahmood,561,France,133167.11,1,1,1
1839,2011,3,MORTGAGE,3,Low,1,10075, 36 months,1,debt_consolidation,6,High,2,Good Loan,0,16.29,D,4,16.46,11510.27,10075,0,355.66,409000001838,6-Aug-18,BBPS DT 06082018,,66966.06,1159287.06,Campbell,350,Germany,123602.11,1,1,1
1840,2011,10,RENT,1,Low,1,19400, 60 months,2,small_business,3,High,2,Bad Loan,1,20.3,E,5,4.69,14420.39,5526.85,2008.24,517.23,409000001839,7-Aug-18,BBPS DT 07082018,"35,934.87",,1123352.19,Bellucci,706,France,186238.85,1,1,1
1841,2011,0.5,RENT,1,Low,1,22400, 36 months,1,debt_consolidation,6,Low,1,Good Loan,0,12.69,B,2,14.19,26355.29,22400,0,751.41,409000001840,8-Aug-18,BBPS DT 08082018,"10,667.64",,1112684.55,Amaechi,464,Spain,158668.87,1,1,1
1842,2011,4,RENT,1,Low,1,20000, 36 months,1,debt_consolidation,6,High,2,Good Loan,0,13.49,C,3,17.16,24396.02707,20000,0,678.61,409000001841,9-Aug-18,BBPS DT 09082018,,5322.89,1118007.44,Foxall,501,France,9249.36,1,1,1
1843,2011,3,MORTGAGE,3,High,3,35000, 60 months,2,debt_consolidation,6,High,2,Good Loan,0,17.27,D,4,5.65,48602.96599,35000,0,874.93,409000001842,10-Aug-18,BBPS DT 10082018,,10564.32,1128571.76,Bentley,745,Spain,116581.10,1,1,1
1844,2011,6,MORTGAGE,3,Low,1,25000, 60 months,2,credit_card,1,High,2,Good Loan,0,17.58,D,4,12.96,34484.34499,25000,0,629.14,409000001843,13-Aug-18,BBPS DT 11082018,,53362.07,1181933.83,Baird,587,France,44688.08,1,1,1
1845,2011,7,MORTGAGE,3,Medium,2,27000, 60 months,2,credit_card,1,Low,1,Good Loan,0,12.42,B,2,12.84,29699.97,20719.82,0,606.35,409000001844,13-Aug-18,BBPS DT 12082018,,151788.62,1333722.45,Howard,667,France,148608.39,1,1,1
1846,2011,4,RENT,1,Medium,2,35000, 60 months,2,debt_consolidation,6,High,2,Good Loan,0,22.74,G,7,16.94,37616.47,35000,0,981.45,409000001845,13-Aug-18,BBPS DT 13082018,,7164.58,1340887.03,Henry,737,France,188670.90,1,1,1
1847,2011,8,OWN,2,Low,1,15000, 36 months,1,other,4,Low,1,Good Loan,0,6.62,A,1,1.16,16158.8,15000,0,460.56,409000001846,14-Aug-18,BBPS DT 14082018,,6597.22,1347484.25,Sopuluchukwu,485,Spain,107067.37,1,1,1
1848,2011,4,MORTGAGE,3,Low,1,30000, 60 months,2,house,12,High,2,Good Loan,0,13.49,C,3,22.85,30338.69,30000,0,690.15,409000001847,16-Aug-18,BBPS DT 15082018,,30456.56,1377940.81,Rocher,590,Spain,61759.33,1,1,1
1849,2011,4,RENT,1,Low,1,22000, 60 months,2,debt_consolidation,6,High,2,Bad Loan,1,20.89,F,6,6.27,4280.04,1319.14,723.12,593.82,409000001848,16-Aug-18,BBPS DT 16082018,,156813.87,1534754.68,White,518,Germany,192776.64,1,1,1
1850,2011,2,MORTGAGE,3,Medium,2,21000, 60 months,2,debt_consolidation,6,High,2,Good Loan,0,16.77,D,4,13.69,30143.12448,21000,0,519.32,409000001849,17-Aug-18,BBPS DT 17082018,,94982.32,1629737.00,Komar,581,Spain,46735.19,1,1,1
1851,2011,10,RENT,1,Low,1,22500, 60 months,2,debt_consolidation,6,High,2,Good Loan,0,14.27,C,3,20.56,27607.2,22500,0,526.7,409000001850,18-Aug-18,BBPS DT 18082018,,77676.77,1707413.77,Russo,785,Germany,169117.74,1,1,1
1852,2011,10,MORTGAGE,3,Low,1,5000, 36 months,1,major_purchase,8,Low,1,Good Loan,0,7.51,A,1,12.37,5597.984331,5000,0,155.56,409000001851,20-Aug-18,BBPS DT 19082018,,54826.71,1762240.48,Loewenthal,799,France,89081.41,1,1,1
1853,2011,9,RENT,1,Low,1,9600, 36 months,1,small_business,3,Low,1,Good Loan,0,7.9,A,1,6.8,10812.60492,9600,0,300.39,409000001852,20-Aug-18,BBPS DT 20082018,,176705.41,1938945.89,Aliyeva,698,Spain,105227.86,1,1,1
1854,2011,7,RENT,1,Low,1,12000, 60 months,2,debt_consolidation,6,High,2,Good Loan,0,14.27,C,3,13.09,13740.25,9104.41,0,280.91,409000001853,21-Aug-18,BBPS DT 21082018,,39601.83,1978547.72,Montes,730,France,128246.81,1,1,1
1855,2011,10,RENT,1,Low,1,4500, 36 months,1,debt_consolidation,6,Low,1,Good Loan,0,6.03,A,1,10.99,4816.74,4500,0,136.96,409000001854,23-Aug-18,BBPS DT 22082018,,137436.94,2115984.66,Kuo,740,Germany,94554.74,1,1,1
1856,2011,0.5,MORTGAGE,3,Low,1,3000, 36 months,1,debt_consolidation,6,High,2,Good Loan,0,14.65,C,3,5.19,3723.649008,3000,0,103.49,409000001855,23-Aug-18,BBPS DT 23082018,,114273.52,2230258.18,Cheng,785,France,33823.50,1,1,1
1857,2011,6,MORTGAGE,3,Low,1,16100, 60 months,2,debt_consolidation,6,High,2,Good Loan,0,20.89,F,6,22.32,24098.89311,16100,0,434.57,409000001856,23-Aug-18,TRF TO  Indiaforensic SERVICES I,"1,000,000.00",,1230258.18,McIntosh,527,Spain,97468.44,1,1,1
1858,2011,10,MORTGAGE,3,Low,1,18200, 36 months,1,credit_card,1,High,2,Good Loan,0,18.25,D,4,10.07,23760.33477,18200,0,660.26,409000001857,24-Aug-18,BBPS DT 24082018,,65456.40,1295714.58,T'ao,544,France,164137.36,1,1,1
1859,2011,0.5,MORTGAGE,3,Low,1,35000, 60 months,2,debt_consolidation,6,High,2,Bad Loan,1,22.35,F,6,15.84,23897.68,3498.01,14170.08,973.64,409000001858,27-Aug-18,BBPS DT 25082018,,89601.49,1385316.07,Tyndall,705,France,191313.70,1,1,1
1860,2011,10,MORTGAGE,3,Low,1,15000, 36 months,1,debt_consolidation,6,Low,1,Good Loan,0,9.91,B,2,16.73,17359.32524,15000,0,483.38,409000001859,27-Aug-18,BBPS DT 26082018,,113986.27,1499302.34,Bailey,684,France,65257.57,1,1,1
1861,2011,2,MORTGAGE,3,Low,1,10000, 36 months,1,credit_card,1,Low,1,Good Loan,0,6.62,A,1,6.04,10648,10000,0,307.04,409000001860,27-Aug-18,BBPS DT 27082018,,137139.75,1636442.09,Onyekaozulu,639,Spain,178222.77,1,1,1
1862,2011,1,RENT,1,Low,1,8500, 36 months,1,debt_consolidation,6,Low,1,Good Loan,0,8.9,A,1,18.28,9607.211393,8500,0,269.91,409000001861,28-Aug-18,BBPS DT 28082018,,58964.84,1695406.93,Nwachukwu,565,Germany,179445.28,1,1,1
1863,2011,10,RENT,1,Low,1,1800, 36 months,1,medical,9,Low,1,Good Loan,0,11.71,B,2,15.33,2142.093054,1800,0,59.54,409000001862,29-Aug-18,BBPS DT 29082018,,71493.16,1766900.09,Romani,481,France,65500.53,1,1,1
1864,2011,9,RENT,1,Low,1,14000, 36 months,1,credit_card,1,Low,1,Good Loan,0,12.69,B,2,15.89,16765.91147,14000,0,469.63,409000001863,30-Aug-18,BBPS DT 30082018,"64,428.81",,1702471.28,Chin,731,Spain,97877.92,1,1,1
1865,2011,4,RENT,1,Low,1,3000, 36 months,1,car,2,High,2,Bad Loan,1,16.77,D,4,12.87,2772.12,2001.66,13.75,106.62,409000001864,31-Aug-18,BBPS DT 31082018,,8238.05,1710709.33,Bellucci,607,France,113051.57,1,1,1
1866,2011,10,RENT,1,Low,1,17200, 36 months,1,debt_consolidation,6,High,2,Good Loan,0,17.58,D,4,8.98,22243.74939,17200,0,618.21,409000001865,1-Sep-18,BBPS DT 01092018,,93996.73,1804706.06,Christmas,760,France,105969.05,1,1,1
1867,2011,1,RENT,1,Low,1,6000, 36 months,1,debt_consolidation,6,Low,1,Good Loan,0,9.91,B,2,11.57,6613.39,6000,0,193.35,409000001866,3-Sep-18,BBPS DT 02092018,,159127.05,1963833.11,Moore,559,France,122996.76,1,1,1
1868,2011,7,MORTGAGE,3,Low,1,16675, 60 months,2,car,2,Low,1,Good Loan,0,11.71,B,2,8.68,17467.85,16675,0,368.49,409000001867,3-Sep-18,BBPS DT 03092018,,233904.54,2197737.65,Genovesi,715,France,68087.15,1,1,1
1869,2011,10,RENT,1,Low,1,4000, 36 months,1,debt_consolidation,6,High,2,Good Loan,0,16.29,D,4,20.91,5042.825634,4000,0,141.21,409000001868,3-Sep-18,TRF TO  Indiaforensic SERVICES I,"1,000,000.00",,1197737.65,Cartwright,656,France,21478.36,1,1,1
1870,2011,10,MORTGAGE,3,Low,1,5250, 60 months,2,credit_card,1,High,2,Good Loan,0,17.58,D,4,23.45,6451,3905.27,0,132.12,409000001869,4-Sep-18,BBPS DT 04092018,,148802.00,1346539.65,Johnstone,652,Germany,158437.73,1,1,1
1871,2011,1,OWN,2,Low,1,2500, 60 months,2,car,2,Low,1,Good Loan,0,12.69,B,2,14.82,2761.51,1912.58,0,56.49,409000001870,5-Sep-18,BBPS DT 05092018,,79407.40,1425947.05,Warner,624,Spain,76551.70,1,1,1
1872,2011,1,RENT,1,Low,1,12875, 60 months,2,debt_consolidation,6,Low,1,Good Loan,0,11.71,B,2,13.69,14136.94,12875,0,284.52,409000001871,6-Sep-18,BBPS DT 06092018,,102541.01,1528488.06,Stephenson,634,Spain,15887.68,1,1,1
1873,2011,10,RENT,1,Low,1,7000, 36 months,1,debt_consolidation,6,Low,1,Good Loan,0,12.69,B,2,21.95,8450.547809,7000,0,234.82,409000001872,7-Sep-18,BBPS DT 07092018,,121975.46,1650463.52,Ellis,850,Spain,33741.84,1,1,1
1874,2011,5,MORTGAGE,3,Low,1,1500, 36 months,1,debt_consolidation,6,High,2,Good Loan,0,14.65,C,3,2.64,1861.351882,1500,0,51.75,409000001873,7-Sep-18,TRF TO  Indiaforensic SERVICES I,"1,000,000.00",,650463.52,Nebechi,659,Germany,20652.69,1,1,1
1875,2011,4,RENT,1,Low,1,5300, 36 months,1,debt_consolidation,6,Low,1,Good Loan,0,8.9,A,1,15.2,6057.238995,5300,0,168.3,409000001874,10-Sep-18,BBPS DT 08092018,,68254.49,718718.01,Chu,529,Spain,112781.50,1,1,1
1876,2011,10,MORTGAGE,3,Low,1,12250, 60 months,2,debt_consolidation,6,Low,1,Good Loan,0,11.71,B,2,23.76,13240.35,9424.49,0,270.71,409000001875,10-Sep-18,BBPS DT 09092018,,179898.57,898616.58,Onuchukwu,572,Spain,119996.95,1,1,1
1877,2011,7,MORTGAGE,3,Low,1,4200, 60 months,2,debt_consolidation,6,High,2,Good Loan,0,16.77,D,4,10.65,5708.680056,4200,0,103.87,409000001876,10-Sep-18,BBPS DT 10092018,,102201.02,1000817.60,Steele,640,Germany,6981.43,1,1,1
1878,2011,0.5,MORTGAGE,3,Low,1,2400, 36 months,1,other,4,Low,1,Good Loan,0,12.69,B,2,17.01,2858.677569,2400,0,80.51,409000001877,11-Sep-18,BBPS DT 11092018,"62,249.74",,938567.86,Quaife,770,Spain,185211.28,1,1,1
1879,2011,10,RENT,1,Low,1,24250, 60 months,2,debt_consolidation,6,High,2,Good Loan,0,19.03,E,5,24,30807.4,17924.76,0,629.46,409000001878,12-Sep-18,BBPS DT 12092018,,80279.07,1018846.93,Scott,648,Spain,78436.36,1,1,1
1880,2011,2,RENT,1,Low,1,12000, 36 months,1,credit_card,1,Low,1,Good Loan,0,7.9,A,1,17.06,13516.17836,12000,0,375.49,409000001879,13-Sep-18,BBPS DT 13092018,,60012.23,1078859.16,Yeh,579,France,139048.00,1,1,1
1881,2011,2,MORTGAGE,3,Low,1,10000, 36 months,1,debt_consolidation,6,Low,1,Good Loan,0,11.71,B,2,5.98,11837.09275,10000,0,330.76,409000001880,14-Sep-18,BBPS DT 14092018,,125122.85,1203982.01,Y?,589,Germany,136329.96,1,1,1
1882,2011,5,MORTGAGE,3,Low,1,22000, 60 months,2,other,4,High,2,Good Loan,0,18.25,D,4,19.64,27498.72,16339.81,0,561.66,409000001881,15-Sep-18,BBPS DT 15092018,,120905.14,1324887.15,Conti,530,Spain,14721.80,1,1,1
1883,2011,6,MORTGAGE,3,Low,1,20000, 60 months,2,debt_consolidation,6,High,2,Good Loan,0,16.77,D,4,17.56,23139.57,20000,0,494.59,409000001882,17-Sep-18,BBPS DT 17092018,938.84,,1323948.31,Holder,831,France,3430.38,1,1,1
1884,2011,3,RENT,1,Low,1,7800, 36 months,1,major_purchase,8,High,2,Good Loan,0,14.27,C,3,1.9,9629.204576,7800,0,267.61,409000001883,17-Sep-18,BBPS DT 16092018,,113977.87,1437926.18,Burgess,790,Germany,160450.21,1,1,1
1885,2011,10,OWN,2,Low,1,32000, 60 months,2,car,2,High,2,Good Loan,0,20.89,F,6,18.84,42298.59,23410.2,0,863.73,409000001884,17-Sep-18,TRF TO  Indiaforensic SERVICES I,"900,000.00",,537926.18,Ozuluonye,656,France,1485.27,1,1,1
1886,2011,0.5,RENT,1,Low,1,22950, 36 months,1,credit_card,1,High,2,Good Loan,0,13.49,C,3,21.83,28017.21455,22950,0,778.71,409000001885,18-Sep-18,BBPS DT 18092018,"6,542.73",,531383.45,De Luca,563,Spain,19720.08,1,1,1
1887,2011,1,RENT,1,Low,1,1000, 36 months,1,debt_consolidation,6,High,2,Bad Loan,1,16.29,D,4,15,665.81,438.44,32.21,35.31,409000001886,19-Sep-18,BBPS DT 19092018,,156502.39,687885.84,Li Fonti,667,Spain,41183.02,1,1,1
1888,2011,4,RENT,1,Low,1,1950, 36 months,1,debt_consolidation,6,High,2,Good Loan,0,14.27,C,3,16.93,2405.617584,1950,0,66.91,409000001887,20-Sep-18,BBPS DT 20092018,,161689.32,849575.16,Freeman,613,Spain,139410.08,1,1,1
1889,2011,1,OWN,2,Low,1,4650, 36 months,1,credit_card,1,Low,1,Good Loan,0,6.62,A,1,9.54,5138.666646,4650,0,142.78,409000001888,21-Sep-18,BBPS DT 21092018,,192331.28,1041906.44,Pisani,429,France,163691.48,1,1,1
1890,2011,6,RENT,1,Medium,2,20000, 60 months,2,home_improvement,7,High,2,Good Loan,0,19.91,E,5,24.23,25908.36,14719.3,0,528.88,409000001889,24-Sep-18,BBPS DT 23092018,"100,527.62",,941378.82,Ignatieff,665,France,115147.33,1,1,1
1891,2011,10,MORTGAGE,3,Medium,2,12000, 36 months,1,debt_consolidation,6,High,2,Good Loan,0,13.49,C,3,4.04,14452.39535,12000,0,407.17,409000001890,24-Sep-18,BBPS DT 22092018,,13361.85,954740.67,Lahti,731,France,74945.11,1,1,1
1892,2011,1,RENT,1,Low,1,9450, 36 months,1,debt_consolidation,6,High,2,Good Loan,0,16.77,D,4,14.08,11194.05,9450,0,335.84,409000001891,24-Sep-18,BBPS DT 24092018,"63,048.84",,891691.83,Perkins,584,France,180363.56,1,1,1
1893,2011,5,RENT,1,Low,1,16000, 36 months,1,other,4,Low,1,Good Loan,0,7.9,A,1,17.88,18011.73824,16000,0,500.65,409000001892,25-Sep-18,BBPS DT 25092018,"202,530.64",,689161.19,Conway,634,Germany,196021.73,1,1,1
1894,2011,8,RENT,1,Low,1,16000, 36 months,1,debt_consolidation,6,Low,1,Good Loan,0,8.9,A,1,8.93,18285.69527,16000,0,508.06,409000001893,26-Sep-18,BBPS DT 26092018,,49876.46,739037.65,Hayes,488,France,125979.36,1,1,1
1895,2011,3,RENT,1,Low,1,4800, 36 months,1,car,2,Low,1,Good Loan,0,10.65,B,2,3.38,5588.315034,4800,0,156.36,409000001894,27-Sep-18,BBPS DT 27092018,,67155.84,806193.49,Rizzo,535,Spain,111421.77,1,1,1
1896,2011,10,OWN,2,Low,1,5000, 36 months,1,vacation,11,Low,1,Good Loan,0,10.65,B,2,10.79,5753.23,5000,0,162.87,409000001895,28-Sep-18,BBPS  DT 28092018,,277871.07,1084064.56,Krylov,776,France,115818.51,1,1,1
1897,2011,1,RENT,1,Low,1,7100, 36 months,1,credit_card,1,Low,1,Good Loan,0,7.9,A,1,18.91,7903.54,7100,0,222.17,409000001896,28-Sep-18,TRF TO  Indiaforensic SERVICES I,"500,000.00",,584064.56,Li Fonti,850,Spain,179360.76,1,1,1
1898,2011,2,RENT,1,Low,1,6000, 36 months,1,credit_card,1,High,2,Good Loan,0,13.49,C,3,15.84,7324.612885,6000,0,203.59,409000001897,29-Sep-18,FDRL/INTERNAL FUND TRANSFE,,100000.00,684064.56,Talbot,673,Spain,82351.06,1,1,1
1899,2011,3,RENT,1,Low,1,9000, 36 months,1,debt_consolidation,6,High,2,Good Loan,0,16.29,D,4,13.97,11286.42526,9000,0,317.71,409000001898,29-Sep-18,BBPS  DT 29092018,"127,682.12",,556382.44,Matthias,850,Germany,192744.23,1,1,1
1900,2011,4,RENT,1,Low,1,5000, 36 months,1,debt_consolidation,6,Low,1,Good Loan,0,12.42,B,2,18.54,6001.873615,5000,0,167.08,409000001899,1-Oct-18,BBPS  DT 30092018,,244133.61,800516.05,Boyle,627,Spain,113408.47,1,1,1
1901,2011,10,RENT,1,Low,1,10000, 36 months,1,other,4,High,2,Good Loan,0,13.49,C,3,21.38,12106.11506,10000,0,339.31,409000001900,1-Oct-18,BBPS  DT 01102018,,254293.54,1054809.59,Ch'eng,570,France,124641.42,1,1,1
1902,2011,1,MORTGAGE,3,Low,1,25000, 60 months,2,small_business,3,High,2,Good Loan,0,17.58,D,4,9.91,30780.28,18627.26,0,629.14,409000001901,3-Oct-18,BBPS DT 02102018,,202370.40,1257179.99,Mason,796,Spain,54871.02,1,1,1
1903,2011,4,MORTGAGE,3,Low,1,15000, 60 months,2,debt_consolidation,6,High,2,Bad Loan,1,14.27,C,3,8.88,9545.19,4531.19,1483.23,351.13,409000001902,3-Oct-18,BBPS DT 03102018,,314101.50,1571281.49,Bruno,773,Spain,98820.09,1,1,1
1904,2011,6,MORTGAGE,3,Low,1,15000, 36 months,1,debt_consolidation,6,High,2,Good Loan,0,15.27,C,3,22.69,18484.94578,15000,0,521.97,409000001903,4-Oct-18,BBPS DT 04102018,,233096.74,1804378.23,Smeaton,752,Spain,45570.84,1,1,1
1905,2011,10,RENT,1,Low,1,8400, 36 months,1,debt_consolidation,6,High,2,Good Loan,0,18.64,E,5,18.47,10682.86,8400,0,306.39,409000001904,4-Oct-18,TRF TO  Indiaforensic SERVICES I,"1,000,000.00",,804378.23,Miller,625,Spain,182336.45,1,1,1
1906,2011,10,MORTGAGE,3,Medium,2,25000, 60 months,2,debt_consolidation,6,High,2,Good Loan,0,15.27,C,3,9.88,29271.72,18870.09,0,598.3,409000001905,5-Oct-18,BBPS DT 05102018,,250778.13,1055156.36,Gotch,535,Germany,118825.56,1,1,1
1907,2011,2,RENT,1,Low,1,6000, 36 months,1,moving,10,High,2,Good Loan,0,15.27,C,3,16.34,6954.62,6000,0,208.79,409000001906,5-Oct-18,TRF TO  Indiaforensic SERVICES I,"400,000.00",,655156.36,Fu,786,France,103372.79,1,1,1
1908,2011,4,MORTGAGE,3,Low,1,6000, 36 months,1,credit_card,1,Low,1,Good Loan,0,6.62,A,1,20.51,6611.610222,6000,0,184.23,409000001907,6-Oct-18,BBPS DT 06102018,,235850.74,891007.10,O'Toole,620,France,43486.73,1,1,1
1909,2011,6.05,MORTGAGE,3,Low,1,2500, 36 months,1,debt_consolidation,6,High,2,Good Loan,0,14.65,C,3,18.14,2888.13,2500,0,86.24,409000001908,8-Oct-18,BBPS DT 07102018,,276293.62,1167300.72,Ledford,605,Spain,40062.99,1,1,1
1910,2011,7,MORTGAGE,3,Low,1,12000, 36 months,1,renewable_energy,13,Low,1,Good Loan,0,6.62,A,1,10.56,13256.55655,12000,0,368.45,409000001909,8-Oct-18,BBPS DT 08102018,,358259.54,1525560.26,Iadanza,670,Spain,46175.70,1,1,1
1911,2011,0.5,RENT,1,Low,1,1500, 36 months,1,other,4,Low,1,Good Loan,0,12.42,B,2,22.19,1682.85,1500,0,50.13,409000001910,9-Oct-18,BBPS DT 09102018,,130070.96,1655631.22,Alaniz,617,Spain,120830.73,1,1,1
1912,2011,0.5,RENT,1,Low,1,8000, 36 months,1,car,2,Low,1,Bad Loan,1,10.65,B,2,1.88,4450.56,3228.91,273.38,260.59,409000001911,9-Oct-18,TRF TO  Indiaforensic SERVICES I,"800,000.00",,855631.22,Saunders,595,France,5967.09,1,1,1
1913,2011,2,MORTGAGE,3,Medium,2,24000, 60 months,2,debt_consolidation,6,Low,1,Good Loan,0,12.69,B,2,6.77,26523.1,18367.63,0,542.28,409000001912,10-Oct-18,BBPS DT 10102018,,200021.22,1055652.44,Lin,687,Germany,122134.56,1,1,1
1914,2011,9,RENT,1,Medium,2,7200, 36 months,1,credit_card,1,Low,1,Good Loan,0,11.71,B,2,9.47,7771.33,7200,0,238.15,409000001913,11-Oct-18,BBPS DT 11102018,,242343.57,1297996.01,Pinto,757,Germany,62972.13,1,1,1
1915,2011,4,MORTGAGE,3,Low,1,4400, 36 months,1,debt_consolidation,6,Low,1,Good Loan,0,7.9,A,1,1.09,4955.256845,4400,0,137.68,409000001914,11-Oct-18,TRF TO  Indiaforensic SERVICES I,"600,000.00",,697996.01,Streeter,746,Spain,174815.54,1,1,1
1916,2011,10,MORTGAGE,3,Medium,2,23000, 36 months,1,debt_consolidation,6,Low,1,Good Loan,0,6.62,A,1,3.77,25419.87501,23000,0,706.19,409000001915,12-Oct-18,BBPS DT 12102018,,263821.96,961817.97,Shaw,503,Spain,192841.13,1,1,1
1917,2011,10,MORTGAGE,3,Low,1,2000, 36 months,1,home_improvement,7,High,2,Good Loan,0,13.49,C,3,24.38,2440.54493,2000,0,67.87,409000001916,15-Oct-18,BBPS DT 13102018,,324167.89,1285985.86,Chen,543,Germany,33310.72,1,1,1
1918,2011,1,RENT,1,Low,1,12000, 36 months,1,credit_card,1,Low,1,Good Loan,0,12.69,B,2,8.31,14485.60765,12000,0,402.54,409000001917,15-Oct-18,BBPS DT 14102018,,303093.88,1589079.74,Barclay,428,Germany,72876.43,1,1,1
1919,2011,7,RENT,1,Low,1,17000, 60 months,2,debt_consolidation,6,High,2,Bad Loan,1,19.03,E,5,17.27,19771.8,11110.03,0,441.28,409000001918,15-Oct-18,BBPS DT 15102018,,322041.12,1911120.86,Kodilinyechukwu,768,France,50911.41,1,1,1
1920,2011,1,MORTGAGE,3,Low,1,3000, 36 months,1,car,2,Low,1,Good Loan,0,6.62,A,1,16.32,3314.926914,3000,0,92.12,409000001919,15-Oct-18,TRF TO  Indiaforensic SERVICES I,"1,000,000.00",,911120.86,Otitodilichukwu,618,France,142400.27,1,1,1
1921,2011,2,MORTGAGE,3,Medium,2,15000, 36 months,1,home_improvement,7,Low,1,Good Loan,0,6.03,A,1,6.23,16434.30214,15000,0,456.54,409000001920,16-Oct-18,BBPS DT 16102018,,151770.46,1062891.32,McKenzie,591,France,48778.46,1,1,1
1922,2011,10,MORTGAGE,3,Low,1,28625, 60 months,2,debt_consolidation,6,High,2,Bad Loan,1,22.35,F,6,24.6,32202.35,13832.29,2753.03,796.3,409000001921,17-Oct-18,BBPS DT 17102018,,267790.01,1330681.33,Woods,658,France,156361.58,1,1,1
1923,2011,8,RENT,1,Low,1,14000, 60 months,2,debt_consolidation,6,High,2,Bad Loan,1,17.27,D,4,17.97,15362.46,9011.91,0,349.98,409000001922,17-Oct-18,TRF TO  Indiaforensic SERVICES I,"500,000.00",,830681.33,Hsing,625,France,133807.77,1,1,1
1924,2011,4,MORTGAGE,3,Low,1,10200, 36 months,1,debt_consolidation,6,Low,1,Good Loan,0,12.42,B,2,17.86,11373.72,10200,0,340.84,409000001923,18-Oct-18,BBPS DT 18102018,,253166.77,1083848.10,Wheare,717,France,179128.69,1,1,1
1925,2011,9,MORTGAGE,3,Low,1,24000, 36 months,1,credit_card,1,Low,1,Good Loan,0,11.71,B,2,13.23,27328.12,24000,0,793.83,409000001924,18-Oct-18,TRF TO  Indiaforensic SERVICES I,"400,000.00",,683848.10,Yobachi,667,France,91810.71,1,1,1
1926,2011,5,MORTGAGE,3,Low,1,10250, 36 months,1,credit_card,1,High,2,Good Loan,0,14.65,C,3,19.63,12725.82585,10250,0,353.57,409000001925,19-Oct-18,BBPS DT 19102018,,336915.95,1020764.05,Fang,804,France,173195.33,1,1,1
1927,2011,3,RENT,1,Low,1,6100, 60 months,2,debt_consolidation,6,High,2,Good Loan,0,13.49,C,3,27.94,8320.460006,6100,0,140.33,409000001926,20-Oct-18,BBPS DT 20102018,,349274.16,1370038.21,Pearson,693,France,182270.88,1,1,1
1928,2011,2,RENT,1,Low,1,5800, 60 months,2,house,12,High,2,Bad Loan,1,17.58,D,4,1,1754.43,647.17,305.03,145.96,409000001927,22-Oct-18,BBPS DT 21102018,,307784.50,1677822.71,Brown,729,Germany,177130.33,1,1,1
1929,2011,2,RENT,1,Medium,2,24000, 36 months,1,debt_consolidation,6,Low,1,Good Loan,0,9.91,B,2,5.81,27837.09605,24000,0,773.4,409000001928,22-Oct-18,BBPS DT 22102018,,416939.17,2094761.88,L?,484,Germany,49954.79,1,1,1
1930,2011,1,MORTGAGE,3,Low,1,6000, 36 months,1,debt_consolidation,6,High,2,Good Loan,0,14.27,C,3,14.13,7097.94,6000,0,205.86,409000001929,22-Oct-18,TRF TO  Indiaforensic SERVICES I,"1,300,000.00",,794761.88,Padovesi,632,Spain,141896.74,1,1,1
1931,2011,0.5,OWN,2,Low,1,1000, 36 months,1,debt_consolidation,6,High,2,Bad Loan,1,16.29,D,4,22.08,1058.26,749.03,37.13,35.31,409000001930,23-Oct-18,BBPS DT 23102018,,267929.89,1062691.77,Soto,536,Germany,120661.71,1,1,1
1932,2011,3,RENT,1,Low,1,11000, 36 months,1,debt_consolidation,6,Low,1,Good Loan,0,9.91,B,2,13.4,11875.43,11000,0,354.48,409000001931,24-Oct-18,BBPS DT 24102018,,76371.19,1139062.96,Greco,573,France,149814.68,1,1,1
1933,2011,5,RENT,1,Low,1,9000, 36 months,1,other,4,High,2,Good Loan,0,16.77,D,4,14.63,11253.28115,9000,0,319.85,409000001932,25-Oct-18,BBPS DT 25102018,,295669.35,1434732.31,Giordano,655,Spain,41782.70,1,1,1
1934,2011,2,OWN,2,Low,1,3000, 36 months,1,other,4,Low,1,Good Loan,0,12.69,B,2,22.5,3620.643483,3000,0,100.64,409000001933,25-Oct-18,TRF TO  Indiaforensic SERVICES I,"600,000.00",,834732.31,Bogle,666,Germany,46172.47,1,1,1
1935,2011,4,RENT,1,Low,1,2000, 36 months,1,debt_consolidation,6,Low,1,Good Loan,0,10.65,B,2,6.67,2343.752933,2000,0,65.15,409000001934,26-Oct-18,BBPS DT 26102018,,126310.53,961042.84,Grimmett,726,Germany,2704.09,1,1,1
1936,2011,6,RENT,1,Low,1,12500, 60 months,2,debt_consolidation,6,High,2,Bad Loan,1,16.77,D,4,19.95,3399.78,1579.1,15.41,309.12,409000001935,29-Oct-18,BBPS DT 27102018,,198833.67,1159876.51,Ayers,523,France,6726.53,1,1,1
1937,2011,4,MORTGAGE,3,Low,1,13000, 36 months,1,debt_consolidation,6,Low,1,Good Loan,0,10.65,B,2,12.98,14698.27,13000,0,423.46,409000001936,29-Oct-18,BBPS DT 28102018,,282479.10,1442355.61,Miller,728,Germany,170764.08,1,1,1
1938,2011,6,MORTGAGE,3,Low,1,21000, 36 months,1,debt_consolidation,6,High,2,Good Loan,0,14.65,C,3,18.24,25377.79,21000,0,724.38,409000001937,29-Oct-18,BBPS DT 29102018,,330885.85,1773241.46,Webb,701,France,45742.42,1,1,1
1939,2011,5,MORTGAGE,3,Low,1,15000, 60 months,2,debt_consolidation,6,Low,1,Good Loan,0,12.69,B,2,12.5,18326.1,15000,0,338.93,409000001938,29-Oct-18,TRF TO  Indiaforensic SERVICES I,"1,000,000.00",,773241.46,Lombardi,518,France,162304.59,1,1,1
1940,2011,4,RENT,1,Medium,2,15000, 36 months,1,debt_consolidation,6,High,2,Good Loan,0,16.77,D,4,12.97,19179.96975,15000,0,533.08,409000001939,30-Oct-18,BBPS DT 30102018,,15113.17,788354.63,Wei,739,France,80883.82,1,1,1
1941,2011,2,RENT,1,Low,1,5000, 36 months,1,vacation,11,Low,1,Good Loan,0,7.9,A,1,18.37,5497.44,5000,0,156.46,409000001940,31-Oct-18,BBPS DT 31102018,,57953.44,846308.07,Ross,531,Germany,118508.09,1,1,1
1942,2011,5,RENT,1,Low,1,10000, 36 months,1,other,4,Low,1,Good Loan,0,7.51,A,1,10.11,11190.32468,10000,0,311.11,409000001941,1-Nov-18,BBPS DT 01112018,,290256.64,1136564.71,Jideofor,452,Spain,69697.74,1,1,1
1943,2011,0.5,OWN,2,Medium,2,30000, 36 months,1,debt_consolidation,6,High,2,Good Loan,0,16.77,D,4,13.73,31667.87,30000,0,1066.16,409000001942,2-Nov-18,BBPS DT 02112018,,355637.06,1492201.77,King,684,France,183575.01,1,1,1
1944,2011,7,MORTGAGE,3,Low,1,12000, 36 months,1,wedding,5,High,2,Good Loan,0,14.65,C,3,16.43,12285.76,12000,0,413.94,409000001943,3-Nov-18,BBPS DT 03112018,,282568.29,1774770.06,Nwokeocha,728,Germany,161203.60,1,1,1
1945,2011,9,RENT,1,Low,1,7200, 36 months,1,debt_consolidation,6,Low,1,Good Loan,0,8.9,A,1,22.26,8080.83,7200,0,228.63,409000001944,5-Nov-18,BBPS DT 04112018,,354950.17,2129720.23,Humphries,783,Spain,143752.77,1,1,1
1946,2011,10,MORTGAGE,3,Low,1,20000, 60 months,2,debt_consolidation,6,High,2,Bad Loan,1,20.89,F,6,16.23,2156,785.72,0,539.84,409000001945,5-Nov-18,BBPS DT 05112018,,545436.19,2675156.42,Olisaemeka,734,France,121894.31,1,1,1
1947,2011,9,MORTGAGE,3,Low,1,5500, 36 months,1,car,2,Low,1,Good Loan,0,6.03,A,1,10.85,6025.875356,5500,0,167.4,409000001946,6-Nov-18,BBPS DT 06112018,,182964.60,2858121.02,Yobanna,648,Germany,147055.87,1,1,1
1948,2011,10,RENT,1,Low,1,17625, 36 months,1,credit_card,1,Low,1,Good Loan,0,12.69,B,2,18.73,21281.40711,17625,0,591.23,409000001947,6-Nov-18,TRF TO  Indiaforensic SERVICES I,"2,000,000.00",,858121.02,Ch'iu,688,France,172033.57,1,1,1
1949,2011,2,RENT,1,Low,1,25000, 60 months,2,debt_consolidation,6,High,2,Bad Loan,1,19.91,E,5,12.08,27950.06,13343.22,2144.25,661.1,409000001948,7-Nov-18,BBPS DT 07112018,,471757.52,1329878.54,Fleming,680,Spain,143774.06,1,1,1
1950,2011,6,MORTGAGE,3,Low,1,29100, 60 months,2,debt_consolidation,6,Low,1,Good Loan,0,10.65,B,2,14,30675.58,22498.21,0,627.64,409000001949,8-Nov-18,BBPS DT 08112018,,375507.73,1705386.27,Trevisan,516,France,139366.58,1,1,1
1951,2011,1,RENT,1,Low,1,8325, 36 months,1,debt_consolidation,6,Low,1,Good Loan,0,6.62,A,1,19.89,9124.47,8325,0,255.61,409000001950,9-Nov-18,BBPS DT 09112018,,506473.63,2211859.90,Aleksandrova,680,France,81776.84,1,1,1
1952,2011,6,RENT,1,Low,1,7000, 36 months,1,other,4,High,2,Bad Loan,1,14.27,C,3,24.58,8405.94,6742.15,16.49,240.17,409000001951,12-Nov-18,BBPS DT 10112018,,352561.10,2564421.00,Onwuamaeze,604,France,190998.96,1,1,1
1953,2011,6,RENT,1,Low,1,10500, 36 months,1,debt_consolidation,6,High,2,Good Loan,0,14.27,C,3,9.06,12484.39,10500,0,360.25,409000001952,12-Nov-18,BBPS DT 11112018,,290327.23,2854748.23,Knox,624,Germany,4470.52,1,1,1
1954,2011,7,MORTGAGE,3,Low,1,17000, 60 months,2,credit_card,1,High,2,Bad Loan,1,18.64,E,5,13.17,8221.6,3338.99,800.42,437.63,409000001953,12-Nov-18,BBPS DT 12112018,,419224.80,3273973.03,Chia,623,France,135851.30,1,1,1
1955,2011,5,RENT,1,Low,1,5000, 36 months,1,credit_card,1,Low,1,Good Loan,0,12.42,B,2,3.99,5643.85,5000,0,167.08,409000001954,12-Nov-18,TRF TO  Indiaforensic SERVICES I,"2,500,000.00",,773973.03,Townsend,624,Spain,172372.63,1,1,1
1956,2011,10,MORTGAGE,3,Medium,2,25000, 36 months,1,moving,10,Low,1,Good Loan,0,7.51,A,1,0.82,27996.44943,25000,0,777.78,409000001955,13-Nov-18,BBPS DT 13112008,,163109.39,937082.42,Dike,565,Germany,135875.51,1,1,1
1957,2011,7,RENT,1,Low,1,18000, 60 months,2,debt_consolidation,6,High,2,Good Loan,0,18.64,E,5,11.76,23613.06,18000,0,463.38,409000001956,14-Nov-18,BBPS DT 14112008,,370836.70,1307919.12,Moyes,565,France,128124.70,1,1,1
1958,2011,4,RENT,1,Low,1,2000, 36 months,1,other,4,High,2,Good Loan,0,13.49,C,3,1.95,2124.94,2000,0,67.87,409000001957,14-Nov-18,TRF TO  Indiaforensic SERVICES I,"500,000.00",,807919.12,Beavers,710,France,167023.95,1,1,1
1959,2011,10,MORTGAGE,3,Low,1,2500, 36 months,1,debt_consolidation,6,High,2,Good Loan,0,15.96,C,3,20.61,3160.509812,2500,0,87.85,409000001958,15-Nov-18,BBPS DT 15112008,,375417.76,1183336.88,Tretiakova,645,France,149807.01,1,1,1
1960,2011,8,OWN,2,Low,1,10000, 36 months,1,debt_consolidation,6,Low,1,Good Loan,0,10.65,B,2,10.15,11597.32449,10000,0,325.74,409000001959,15-Nov-18,TRF TO  Indiaforensic SERVICES I,"500,000.00",,683336.88,Fuller,707,France,54290.62,1,1,1
1961,2011,5,OWN,2,Low,1,15600, 60 months,2,debt_consolidation,6,High,2,Bad Loan,1,19.42,E,5,22.78,16411.59,8656.94,40.84,408.29,409000001960,16-Nov-18,BBPS DT 16112008,,379555.15,1062892.03,Dellucci,655,Spain,86013.96,1,1,1
1962,2011,6,MORTGAGE,3,Low,1,6000, 36 months,1,moving,10,Low,1,Good Loan,0,7.9,A,1,8.03,6757.771779,6000,0,187.75,409000001961,16-Nov-18,TRF TO  Indiaforensic SERVICES I,"500,000.00",,562892.03,Ritchie,705,Spain,79886.06,1,1,1
1963,2011,5,OWN,2,Low,1,4500, 36 months,1,car,2,Low,1,Good Loan,0,11.71,B,2,7.11,5354.838907,4500,0,148.85,409000001962,17-Nov-18,BBPS DT 17112008,,322009.05,884901.08,Aikenhead,358,Spain,141959.11,1,1,1
1964,2011,6,RENT,1,Low,1,21600, 36 months,1,debt_consolidation,6,High,2,Bad Loan,1,18.64,E,5,17.67,17337.36,10505.96,1593.36,787.85,409000001963,19-Nov-18,BBPS DT 18112018,,500434.76,1385335.84,Douglas,578,Germany,66680.77,1,1,1
1965,2011,0.5,RENT,1,Low,1,5500, 36 months,1,credit_card,1,Low,1,Good Loan,0,11.71,B,2,11.56,6545.929718,5500,0,181.92,409000001964,19-Nov-18,BBPS DT 19112018,,481280.06,1866615.90,Kung,800,France,98640.15,1,1,1
1966,2011,10,RENT,1,Low,1,4850, 36 months,1,credit_card,1,High,2,Good Loan,0,14.27,C,3,18.63,5990.061201,4850,0,166.4,409000001965,20-Nov-18,BBPS DT 20112008,,436410.64,2303026.54,MacDonald,612,France,142797.50,1,1,1
1967,2011,5,OWN,2,Low,1,10000, 36 months,1,debt_consolidation,6,Low,1,Bad Loan,1,7.51,A,1,17.07,4721.7,3616.59,375.68,311.11,409000001966,20-Nov-18,TRF TO  Indiaforensic SERVICES I,"1,700,000.00",,603026.54,Okwudilichukwu,681,Germany,163581.67,1,1,1
1968,2011,8,RENT,1,Low,1,15000, 60 months,2,debt_consolidation,6,High,2,Bad Loan,1,15.27,C,3,18.98,14669.5,8927.2,0,358.98,409000001967,21-Nov-18,BBPS DT 21112008,,295177.19,898203.73,Ni,559,Spain,163221.22,1,1,1
1969,2011,10,RENT,1,Low,1,7000, 36 months,1,debt_consolidation,6,Low,1,Good Loan,0,6.62,A,1,26.32,7735.429815,7000,0,214.93,409000001968,22-Nov-18,BBPS DT 22112008,,426704.94,1324908.67,Simmons,488,Spain,12440.44,1,1,1
1970,2011,6,RENT,1,Low,1,25000, 36 months,1,debt_consolidation,6,Low,1,Good Loan,0,6.62,A,1,5.04,27564.16072,25000,0,767.6,409000001969,22-Nov-18,TRF TO  Indiaforensic SERVICES I,"600,000.00",,724908.67,H?,717,France,145551.60,1,1,1
1971,2011,6.05,RENT,1,Low,1,10000, 36 months,1,debt_consolidation,6,Low,1,Good Loan,0,11.71,B,2,26.13,11899.84584,10000,0,330.76,409000001970,23-Nov-18,BBPS DT 23112008,,423446.49,1148355.16,Hancock,666,France,50908.48,1,1,1
1972,2011,9,RENT,1,Medium,2,25000, 36 months,1,credit_card,1,High,2,Good Loan,0,13.49,C,3,8.85,29452.53,24999.99,0,848.27,409000001971,26-Nov-18,BBPS DT 24112018,,398309.17,1546664.33,Cran,582,Spain,30149.21,1,1,1
1973,2011,8,RENT,1,Low,1,9425, 36 months,1,credit_card,1,High,2,Good Loan,0,13.49,C,3,15.71,11509.23319,9425,0,319.8,409000001972,26-Nov-18,BBPS DT 25112018,,313533.71,1860198.04,McKay,733,Spain,57769.20,1,1,1
1974,2011,0.5,RENT,1,Low,1,5500, 36 months,1,debt_consolidation,6,Low,1,Good Loan,0,12.69,B,2,21.24,6618.921871,5500,0,184.5,409000001973,26-Nov-18,BBPS DT 26112018,,463841.24,2324039.28,P'an,693,France,156381.47,1,1,1
1975,2011,2,RENT,1,Low,1,6400, 36 months,1,debt_consolidation,6,High,2,Bad Loan,1,17.27,D,4,6.93,5649.84,3692.08,396.18,229.04,409000001974,26-Nov-18,TRF TO  Indiaforensic SERVICES I,"1,700,000.00",,624039.28,Parkhill,694,France,178123.86,1,1,1
1976,2011,5,RENT,1,Low,1,13500, 60 months,2,debt_consolidation,6,High,2,Good Loan,0,19.03,E,5,12.11,19059.5395,13500,0,350.43,409000001975,27-Nov-18,BBPS DT 27112008,,288502.17,912541.45,Golubova,622,France,51112.80,1,1,1
1977,2011,3,RENT,1,Low,1,10000, 36 months,1,major_purchase,8,Low,1,Good Loan,0,6.62,A,1,4.96,11050.41871,10000,0,307.04,409000001976,28-Nov-18,BBPS DT 28112008,,260361.75,1172903.20,Nwankwo,598,Spain,173783.38,1,1,1
1978,2011,10,MORTGAGE,3,Low,1,30000, 60 months,2,home_improvement,7,High,2,Good Loan,0,15.96,C,3,16.64,30400.31,30000,0,728.91,409000001977,29-Nov-18,BBPS DT 29112008,,426237.52,1599140.72,Johnson,717,Spain,174770.14,1,1,1
1979,2011,10,MORTGAGE,3,Low,1,18000, 36 months,1,credit_card,1,Low,1,Bad Loan,1,7.9,A,1,15,9080.39,6979.13,641.84,563.23,409000001978,29-Nov-18,TRF TO  Indiaforensic SERVICES I,"1,000,000.00",,599140.72,Mao,494,Germany,172063.09,1,1,1
1980,2011,6,MORTGAGE,3,Low,1,8575, 36 months,1,debt_consolidation,6,Low,1,Good Loan,0,10.65,B,2,18.82,10052.61988,8575,0,279.32,409000001979,30-Nov-18,BBPS DT 30112008,,335997.77,935138.49,Echezonachukwu,644,France,155294.17,1,1,1
1981,2011,6,RENT,1,Low,1,18000, 36 months,1,debt_consolidation,6,High,2,Good Loan,0,14.65,C,3,19.63,21602.59,18000,0,620.9,409000001980,1-Dec-18,BBPS DT 01122008,,268923.12,1204061.61,McElyea,554,France,40320.30,1,1,1
1982,2011,3,RENT,1,Low,1,18000, 60 months,2,other,4,High,2,Good Loan,0,19.42,E,5,3.27,20510.29,18000,0,471.1,409000001981,3-Dec-18,BBPS DT 02122008,,271416.97,1475478.58,Rosas,476,Spain,134260.34,1,1,1
1983,2011,10,MORTGAGE,3,Low,1,25000, 60 months,2,debt_consolidation,6,High,2,Bad Loan,1,16.77,D,4,20.79,18451.01,8336.14,2377.03,618.23,409000001982,3-Dec-18,BBPS DT 03122008,,291149.66,1766628.24,Phillips,667,France,147090.90,1,1,1
1984,2011,10,RENT,1,Low,1,15000, 60 months,2,credit_card,1,High,2,Good Loan,0,15.96,C,3,23.75,17828.38,11277.69,0,364.46,409000001983,3-Dec-18,TRF TO  Indiaforensic SERVICES I,"1,200,000.00",,566628.24,Palerma,748,Spain,132368.47,1,1,0
1985,2011,7,RENT,1,Low,1,3000, 36 months,1,other,4,Low,1,Good Loan,0,12.42,B,2,6.4,3606.773077,3000,0,100.25,409000001984,4-Dec-18,BBPS DT 04122008,,360370.52,926998.76,Morris,531,Spain,164741.50,1,1,0
1986,2011,10,MORTGAGE,3,Medium,2,30000, 60 months,2,debt_consolidation,6,High,2,Good Loan,0,13.49,C,3,7.48,33477.44,30000,0,690.15,409000001985,5-Dec-18,BBPS DT 05122008,,315346.66,1242345.42,Pavlova,719,Spain,63051.32,1,1,0
1987,2011,9,RENT,1,Low,1,3600, 36 months,1,vacation,11,High,2,Good Loan,0,15.27,C,3,11.83,3937.86,3600,0,125.28,409000001986,5-Dec-18,FDRL/INTERNAL FUND TRANSFE,,200000.00,1442345.42,Lu,845,Germany,199761.29,1,1,0
1988,2011,8,MORTGAGE,3,Low,1,9600, 60 months,2,home_improvement,7,Low,1,Good Loan,0,12.69,B,2,8.84,11794.89,9600,0,216.91,409000001987,5-Dec-18,FDRL/INTERNAL FUND TRANSFE,,300000.00,1742345.42,Yamamoto,738,France,55725.04,1,1,0
1989,2011,10,RENT,1,Low,1,4500, 36 months,1,credit_card,1,Low,1,Good Loan,0,12.42,B,2,24.1,5410.555478,4500,0,150.37,409000001988,5-Dec-18,TRF TO  Indiaforensic SERVICES I,"500,000.00",,1242345.42,Angelo,563,Spain,163145.50,1,1,0
1990,2011,10,MORTGAGE,3,Medium,2,5000, 36 months,1,vacation,11,Low,1,Good Loan,0,10.65,B,2,7.6,5674.97,5000,0,162.87,409000001989,6-Dec-18,BBPS DT 06122008,,403296.60,1645642.02,Zaitsev,695,Spain,57992.49,1,1,0
1991,2011,10,MORTGAGE,3,Low,1,35000, 36 months,1,home_improvement,7,Low,1,Good Loan,0,7.9,A,1,12.76,37669.61,35000,0,1095.16,409000001990,7-Dec-18,BBPS DT 06122008,,615753.17,2261395.19,Cawker,841,Spain,193093.77,1,1,0
1992,2011,10,RENT,1,Low,1,19500, 60 months,2,home_improvement,7,Low,1,Good Loan,0,12.42,B,2,12.7,22885.95,19500,0,437.92,409000001991,7-Dec-18,TRF TO  Indiaforensic SERVICES I,"1,500,000.00",,761395.19,Froggatt,626,Germany,57531.14,1,1,0
1993,2011,3,MORTGAGE,3,Low,1,4200, 36 months,1,other,4,Low,1,Good Loan,0,8.9,A,1,4.54,4725.43,4200,0,133.37,409000001992,10-Dec-18,BBPS DT 08122018,,515462.82,1276858.01,Gorbunov,613,France,77242.19,1,1,0
1994,2011,6.05,MORTGAGE,3,Low,1,10000, 36 months,1,major_purchase,8,Low,1,Good Loan,0,9.91,B,2,23.81,11597.76355,10000,0,322.25,409000001993,10-Dec-18,BBPS DT 09122018,,193681.75,1470539.76,Tai,824,Germany,153046.16,1,1,0
1995,2011,8,RENT,1,Low,1,5250, 36 months,1,debt_consolidation,6,High,2,Good Loan,0,15.27,C,3,24.77,6452.97,5250,0,182.69,409000001994,10-Dec-18,BBPS DT 10122018,,439890.04,1910429.80,Rowe,705,France,63405.20,1,1,0
1996,2011,6.05,RENT,1,Low,1,3000, 36 months,1,major_purchase,8,Low,1,Good Loan,0,10.65,B,2,13.39,3478.281765,3000,0,97.72,409000001995,10-Dec-18,TRF TO  Indiaforensic SERVICES I,"1,200,000.00",,710429.80,Mikkelsen,584,France,106564.88,1,1,0
1997,2011,10,MORTGAGE,3,Low,1,11000, 36 months,1,credit_card,1,Low,1,Good Loan,0,9.91,B,2,20.16,12678.13954,11000,0,354.48,409000001996,11-Dec-18,BBPS DT 11122008,,245690.74,956120.54,Kovalyov,534,France,42763.12,1,1,0
1998,2011,7,MORTGAGE,3,Medium,2,24000, 60 months,2,other,4,Low,1,Good Loan,0,10.65,B,2,4.13,29550.10267,24000,0,517.64,409000001997,12-Dec-18,BBPS DT 12122018,,361675.89,1317796.43,Mbanefo,672,France,168753.34,1,1,0
1999,2011,1,RENT,1,Low,1,2000, 36 months,1,other,4,High,2,Bad Loan,1,16.29,D,4,15.61,1550.6,988.17,142.4,70.61,409000001998,13-Dec-18,BBPS DT 13122008,,126219.22,1444015.65,Ts'ai,603,France,19483.35,1,1,0
2000,2011,3,MORTGAGE,3,Medium,2,35000, 36 months,1,debt_consolidation,6,Low,1,Good Loan,0,10.65,B,2,14.35,40826.75684,35000,0,1140.07,409000001999,13-Dec-18,TRF TO  Indiaforensic SERVICES I,"800,000.00",,644015.65,Enderby,633,Germany,158646.46,1,1,0
2001,2011,5,RENT,1,Low,1,12700, 36 months,1,debt_consolidation,6,Low,1,Bad Loan,1,11.71,B,2,6.04,12182.03,9850.54,0,420.07,409000002000,14-Dec-18,BBPS DT 14122018,,467994.77,1112010.42,Lombardi,842,France,83172.19,1,1,0
2002,2011,10,RENT,1,Low,1,20000, 36 months,1,debt_consolidation,6,High,2,Good Loan,0,15.27,C,3,17.68,23924.11,20000,0,695.96,409000002001,15-Dec-18,BBPS DT 15122018,,474113.93,1586124.35,Hamilton,661,France,76889.79,1,1,0
2003,2011,6,RENT,1,Low,1,7000, 36 months,1,home_improvement,7,High,2,Good Loan,0,13.49,C,3,16.83,8538.318336,7000,0,237.52,409000002002,17-Dec-18,BBPS DT 17122018,,518230.79,2104355.14,Hsia,601,France,51554.58,1,1,0
2004,2011,5,RENT,1,Low,1,12000, 60 months,2,wedding,5,Low,1,Good Loan,0,12.42,B,2,3.76,13190.97,9203.3,0,269.49,409000002003,17-Dec-18,BBPS DT 16122018,,512680.61,2617035.75,Mao,632,France,105570.39,1,1,0
2005,2011,10,RENT,1,Low,1,5000, 36 months,1,credit_card,1,High,2,Good Loan,0,13.49,C,3,17.4,6105.40034,5000,0,169.66,409000002004,17-Dec-18,TRF TO  Indiaforensic SERVICES I,"2,000,000.00",,617035.75,Ugochukwu,684,Germany,79495.01,1,1,0
2006,2011,3,RENT,1,Low,1,6600, 60 months,2,debt_consolidation,6,High,2,Bad Loan,1,19.42,E,5,15.87,4507.67,1735.34,706.63,172.74,409000002005,18-Dec-18,BBPS DT 18122018,,148602.58,765638.33,West,785,Germany,52583.79,1,1,0
2007,2011,10,MORTGAGE,3,Medium,2,18000, 60 months,2,home_improvement,7,High,2,Good Loan,0,19.42,E,5,10.31,23071.16,13281.75,0,471.1,409000002006,19-Dec-18,BBPS DT 19122018,,193871.01,959509.34,Hughes,687,France,26848.25,1,1,0
2008,2011,7,MORTGAGE,3,Low,1,25475, 36 months,1,credit_card,1,High,2,Good Loan,0,16.29,D,4,16.84,30536.3,25475,0,899.28,409000002007,20-Dec-18,BBPS DT 20122018,"2,547.60",,956961.74,Chukwuemeka,705,Germany,10072.55,1,1,0
2009,2011,2,OWN,2,Low,1,22250, 60 months,2,credit_card,1,High,2,Bad Loan,1,21.28,F,6,21.9,24411.44,13679.08,1264.67,605.45,409000002008,20-Dec-18,BBPS DT 20122018,,183822.29,1140784.03,Lira,639,France,187296.78,1,1,0
2010,2011,4,MORTGAGE,3,Low,1,11000, 36 months,1,debt_consolidation,6,Low,1,Good Loan,0,8.9,A,1,13.57,11978.56,11000,0,349.29,409000002009,20-Dec-18,TRF TO  Indiaforensic SERVICES I,"500,000.00",,640784.03,Li,729,Germany,104016.61,1,1,0
2011,2011,4,RENT,1,Low,1,8000, 36 months,1,other,4,Low,1,Good Loan,0,10.65,B,2,17.33,9378.694719,8000,0,260.59,409000002010,21-Dec-18,BBPS DT 21122018,,86250.63,727034.66,Castiglione,556,Spain,151310.16,1,1,0
2012,2011,5,MORTGAGE,3,Low,1,6000, 36 months,1,debt_consolidation,6,Low,1,Good Loan,0,7.9,A,1,22.71,6691.8,6000,0,187.75,409000002011,24-Dec-18,BBPS DT 23122018,"182,440.81",,544593.85,Paterson,570,France,62810.91,1,1,0
2013,2011,10,RENT,1,Low,1,10000, 36 months,1,credit_card,1,Low,1,Good Loan,0,11.71,B,2,7.11,11903.88222,10000,0,330.76,409000002012,24-Dec-18,BBPS DT 22122018,"3,261.88",,541331.97,Blair,841,France,60830.38,1,1,0
2014,2011,4,OWN,2,Medium,2,24000, 60 months,2,debt_consolidation,6,High,2,Bad Loan,1,18.64,E,5,22.49,9082.63,2911.41,1741.33,617.83,409000002013,24-Dec-18,FDRL/INTERNAL FUND TRANSFE,,100000.00,641331.97,Dellucci,705,Germany,116672.02,1,1,0
2015,2011,10,MORTGAGE,3,Low,1,23000, 60 months,2,debt_consolidation,6,Low,1,Good Loan,0,12.69,B,2,29.83,24939.22,17155.53,0,519.68,409000002014,24-Dec-18,BBPS DT24122018  IMPS GL,"99,820.78",,541511.19,Udinesi,553,France,77304.49,1,1,0
2016,2011,5,RENT,1,Low,1,12000, 36 months,1,debt_consolidation,6,High,2,Good Loan,0,16.77,D,4,17.61,15285.96461,12000,0,426.47,409000002015,26-Dec-18,FDRL/INTERNAL FUND TRANSFE,,300000.00,841511.19,Yuan,779,Germany,52894.01,1,1,0
2017,2011,10,MORTGAGE,3,Low,1,18000, 60 months,2,debt_consolidation,6,High,2,Good Loan,0,18.25,D,4,19.68,26450.4835,18000,0,459.54,409000002016,26-Dec-18,FDRL/INTERNAL FUND TRANSFE,,300000.00,1141511.19,Yuryeva,696,France,116471.43,1,1,0
2018,2011,7,RENT,1,Low,1,20000, 60 months,2,credit_card,1,High,2,Good Loan,0,17.58,D,4,17.15,25430.55,20000,0,503.32,409000002017,26-Dec-18,BBPS DT 26122018,"214,821.75",,926689.44,Wilson,728,Spain,4539.38,1,1,0
2019,2011,8,RENT,1,Low,1,14850, 36 months,1,debt_consolidation,6,Low,1,Good Loan,0,8.9,A,1,21.9,16973.14599,14850,0,471.54,409000002018,26-Dec-18,BBPS DT 25122018,"242,437.03",,684252.41,Dean,691,Germany,142367.72,1,1,0
2020,2011,10,MORTGAGE,3,Low,1,15000, 60 months,2,debt_consolidation,6,High,2,Bad Loan,1,18.25,D,4,10.45,11053.79,4642.44,1481.45,382.95,409000002019,27-Dec-18,FDRL/INTERNAL FUND TRANSFE,,100000.00,784252.41,Ross,706,France,110520.48,1,1,0
2021,2011,10,MORTGAGE,3,Low,1,12650, 36 months,1,debt_consolidation,6,Low,1,Good Loan,0,8.9,A,1,11.9,14451.10194,12650,0,401.68,409000002020,27-Dec-18,BBPS DT 27122018,"209,147.76",,575104.65,Kent,627,Germany,188258.49,1,1,0
2022,2011,5,RENT,1,Low,1,17500, 36 months,1,credit_card,1,High,2,Good Loan,0,13.49,C,3,10.97,21368.52801,17500,0,593.79,409000002021,28-Dec-18,FDRL/INTERNAL FUND TRANSFE,,200000.00,775104.65,Vasiliev,716,Germany,197322.13,1,1,0
2023,2011,10,RENT,1,Low,1,21000, 60 months,2,debt_consolidation,6,High,2,Good Loan,0,16.77,D,4,14.72,25383.5,15706.73,0,519.32,409000002022,28-Dec-18,BBPS DT 28122018,"200,080.84",,575023.81,Golibe,501,Germany,80241.14,1,1,0
2024,2011,6,MORTGAGE,3,Medium,2,15000, 60 months,2,debt_consolidation,6,High,2,Good Loan,0,15.96,C,3,23.7,21096.39248,15000,0,364.46,409000002023,28-Dec-18,FDRL/INTERNAL FUND TRANSFE,,300000.00,875023.81,Chukwukere,601,France,172814.99,1,1,0
2025,2011,10,RENT,1,Low,1,15000, 60 months,2,credit_card,1,High,2,Good Loan,0,17.27,D,4,16.13,18342.55,11195.01,0,374.97,409000002024,29-Dec-18,BBPS DT 29122018,"146,825.27",,728198.54,Fedorova,545,Spain,38410.74,1,1,0
2026,2011,10,MORTGAGE,3,Low,1,9500, 36 months,1,debt_consolidation,6,Low,1,Good Loan,0,6.03,A,1,7.78,10408.36933,9500,0,289.14,409000002025,31-Dec-18,FDRL/INTERNAL FUND TRANSFE,,100000.00,828198.54,Chien,634,France,17622.82,1,1,0
2027,2011,7,RENT,1,Low,1,13000, 60 months,2,credit_card,1,High,2,Good Loan,0,17.27,D,4,15.31,14435.46,13000.01,0,324.98,409000002026,31-Dec-18,BBPS DT 30122018,"117,494.93",,710703.61,Rossi,451,Spain,48021.71,1,1,0
2028,2011,10,RENT,1,Low,1,12000, 60 months,2,debt_consolidation,6,High,2,Bad Loan,1,14.27,C,3,13.75,2800.7,1454.09,0,280.91,409000002027,31-Dec-18,BBPS DT 31122018,"50,376.69",,660326.92,Samson,655,France,88958.49,1,1,0
2029,2011,5,RENT,1,Low,1,8000, 36 months,1,debt_consolidation,6,Low,1,Good Loan,0,7.9,A,1,15.21,9010.451026,8000,0,250.33,409000002028,31-Dec-18,FDRL/INTERNAL FUND TRANSFE,,200000.00,860326.92,Fenton,458,France,116343.09,1,1,0
2030,2011,3,RENT,1,Low,1,6400, 60 months,2,other,4,High,2,Good Loan,0,19.42,E,5,6.06,8187.71,4715.57,0,167.51,409000002029,1-Jan-19,BBPS DT 01012019,"160,965.27",,699361.65,Mackey,520,France,166102.61,1,1,0
2031,2011,8,RENT,1,Low,1,10000, 36 months,1,credit_card,1,Low,1,Good Loan,0,8.9,A,1,7.24,11428.40297,10000,0,317.54,409000002030,2-Jan-19,BBPS DT 02012019,"38,298.74",,661062.91,Payton,624,Spain,104353.26,1,1,0
2032,2011,6,RENT,1,Low,1,12000, 36 months,1,debt_consolidation,6,High,2,Good Loan,0,14.27,C,3,9.25,13783.77,12000,0,411.71,409000002031,3-Jan-19,FDRL/INTERNAL FUND TRANSFE,,100000.00,761062.91,Cowger,765,France,115429.32,1,1,0
2033,2011,0.5,RENT,1,Low,1,4125, 36 months,1,credit_card,1,Low,1,Good Loan,0,11.71,B,2,22.99,4922.920799,4125,0,136.44,409000002032,3-Jan-19,BBPS DT 03012019,"94,509.56",,666553.35,Banks,667,Germany,178106.34,1,1,0
2034,2011,2,RENT,1,Low,1,7000, 36 months,1,debt_consolidation,6,Low,1,Good Loan,0,6,B,2,18.83,8094.194981,7000,0,217.88,409000002033,4-Jan-19,FDRL/INTERNAL FUND TRANSFE,,100000.00,766553.35,Pugliesi,665,Spain,132152.32,1,1,0
2035,2011,0.5,OWN,2,Low,1,6000, 36 months,1,small_business,3,Low,1,Good Loan,0,8.9,A,1,13.82,6171.85,6000,0,190.52,409000002034,4-Jan-19,FDRL/INTERNAL FUND TRANSFE,,200000.00,966553.35,Fantin,709,Germany,21521.38,1,1,0
2036,2011,10,RENT,1,Low,1,14300, 60 months,2,credit_card,1,Low,1,Good Loan,0,11.71,B,2,26.96,15462.91,11005.89,0,316.01,409000002035,4-Jan-19,BBPS DT 04012019,"124,836.90",,841716.45,Bentley,583,France,27431.62,1,1,0
2037,2011,0.5,MORTGAGE,3,Medium,2,33000, 36 months,1,debt_consolidation,6,High,2,Bad Loan,1,18.64,E,5,7.11,36040.93,25066.43,1146.75,1203.66,409000002036,5-Jan-19,BBPS DT 05012019,"82,438.52",,759277.93,Freeman,782,Spain,42143.61,1,1,0
2038,2011,10,RENT,1,Low,1,17625, 60 months,2,credit_card,1,High,2,Good Loan,0,17.58,D,4,27.27,21686.81,13125.99,0,443.55,409000002037,7-Jan-19,BBPS DT 06012019,"146,158.69",,613119.24,Wong,668,Spain,106457.11,1,1,0
2039,2011,5,MORTGAGE,3,Low,1,6000, 36 months,1,other,4,Low,1,Good Loan,0,6.03,A,1,11.39,6405.63,6000.01,0,182.62,409000002038,7-Jan-19,BBPS DT 07012019,"90,624.51",,522494.73,Onwuamaeze,621,France,133831.37,1,1,0
2040,2011,10,MORTGAGE,3,Low,1,10000, 36 months,1,debt_consolidation,6,High,2,Bad Loan,1,16.77,D,4,9.57,9083.1,6084.55,573.9,355.39,409000002039,7-Jan-19,FDRL/INTERNAL FUND TRANSFE,,100000.00,622494.73,Shen,579,Germany,164083.72,1,1,0
2041,2011,0.5,RENT,1,Low,1,1500, 36 months,1,moving,10,Low,1,Good Loan,0,12.42,B,2,13.39,1545.59,1500,0,50.13,409000002040,8-Jan-19,FDRL/INTERNAL FUND TRANSFE,,200000.00,822494.73,Huang,547,France,159207.34,1,1,0
2042,2011,5,RENT,1,Low,1,13200, 36 months,1,debt_consolidation,6,Low,1,Good Loan,0,11.71,B,2,20.99,15713.87162,13200,0,436.61,409000002041,8-Jan-19,BBPS DT 08012019,"200,263.25",,622231.48,Yeh,840,France,84487.62,1,1,0
2043,2011,7,MORTGAGE,3,Low,1,25000, 60 months,2,credit_card,1,High,2,Good Loan,0,19.03,E,5,22.08,25397.32,25000,0,648.93,409000002042,9-Jan-19,BBPS DT 09012019,"155,967.41",,466264.07,Shih,667,Germany,3674.71,1,1,0
2044,2011,1,OWN,2,Low,1,6000, 36 months,1,credit_card,1,Low,1,Good Loan,0,8.9,A,1,1.05,6088.15,6000,0,190.52,409000002043,9-Jan-19,FDRL/INTERNAL FUND TRANSFE,,200000.00,666264.07,Henderson,723,France,12092.03,1,1,0
2045,2011,2,MORTGAGE,3,Low,1,5150, 36 months,1,debt_consolidation,6,Low,1,Good Loan,0,6.62,A,1,23.38,5660.104801,5150,0,158.13,409000002044,10-Jan-19,BBPS DT 10012019,"130,922.36",,535341.71,Fang,487,France,77475.73,1,1,0
2046,2011,2,RENT,1,Low,1,5000, 36 months,1,debt_consolidation,6,Low,1,Good Loan,0,11.71,B,2,11.42,5950.99608,5000,0,165.38,409000002045,10-Jan-19,FDRL/INTERNAL FUND TRANSFE,,100000.00,635341.71,Dellucci,668,France,41291.73,1,1,0
2047,2011,10,RENT,1,Low,1,21625, 60 months,2,debt_consolidation,6,Low,1,Good Loan,0,12.69,B,2,29.09,28749.6538,21625,0,488.62,409000002046,10-Jan-19,FDRL/INTERNAL FUND TRANSFE,,100000.00,735341.71,Chou,520,Germany,343.38,1,1,0
2048,2011,4,RENT,1,Low,1,18000, 36 months,1,debt_consolidation,6,Low,1,Bad Loan,1,7.9,A,1,15.07,8004.08,6010.44,688.2,563.23,409000002047,11-Jan-19,BBPS DT 05012019,"125,569.82",,609771.89,Conti,549,France,47432.43,1,1,0
2049,2011,5,MORTGAGE,3,Low,1,5000, 60 months,2,other,4,Low,1,Good Loan,0,11.71,B,2,7.81,5405.14,3847.5,0,110.5,409000002048,14-Jan-19,FDRL/INTERNAL FUND TRANSFE,,200000.00,809771.89,Roberts,567,France,127827.18,1,1,0
2050,2011,7,MORTGAGE,3,Low,1,3000, 36 months,1,home_improvement,7,Low,1,Good Loan,0,11.71,B,2,22.51,3260.12,3000,0,99.23,409000002049,14-Jan-19,BBPS DT 12012019,"86,420.15",,723351.74,Lo Duca,720,France,35633.15,1,1,0
2051,2011,10,RENT,1,Low,1,7500, 36 months,1,major_purchase,8,High,2,Good Loan,0,17.58,D,4,20.88,9230.922359,7500,0,269.57,409000002050,14-Jan-19,BBPS DT 13012019,"89,563.51",,633788.23,Glover,492,France,182865.09,1,1,0
2052,2011,0.5,OWN,2,Low,1,5000, 36 months,1,debt_consolidation,6,High,2,Good Loan,0,14.65,C,3,13.06,5736.34,5000,0,172.48,409000002051,14-Jan-19,BBPS DT 14012019,"78,829.57",,554958.66,Johnstone,712,France,169386.81,1,1,0
2053,2011,5,RENT,1,Low,1,15000, 60 months,2,debt_consolidation,6,Low,1,Bad Loan,1,12.69,B,2,4.68,2366.28,1299.47,0,338.93,409000002052,14-Jan-19,FDRL/INTERNAL FUND TRANSFE,,200000.00,754958.66,Ashton,689,Germany,149073.88,1,1,0
2054,2011,2,RENT,1,Low,1,12000, 36 months,1,credit_card,1,Low,1,Good Loan,0,10.65,B,2,19.43,13673.81,12000,0,390.88,409000002053,15-Jan-19,BBPS DT 15012019,"216,993.16",,537965.50,Melton,850,France,184107.26,1,1,0
2055,2011,2,MORTGAGE,3,Low,1,14000, 36 months,1,debt_consolidation,6,Low,1,Good Loan,0,8.9,A,1,13.83,15572.45,14000,0,444.55,409000002054,15-Jan-19,FDRL/INTERNAL FUND TRANSFE,,300000.00,837965.50,Marshall,747,France,22750.17,1,1,0
2056,2011,3,MORTGAGE,3,Low,1,10200, 36 months,1,debt_consolidation,6,Low,1,Good Loan,0,6.62,A,1,17.03,11256.61034,10200,0,313.18,409000002055,16-Jan-19,BBPS DT 16012019,"191,929.33",,646036.17,Kenenna,469,Germany,11950.29,1,1,0
2057,2011,1,MORTGAGE,3,Low,1,14000, 60 months,2,debt_consolidation,6,Low,1,Good Loan,0,8.9,A,1,11.45,14172.47,10924.81,0,289.94,409000002056,17-Jan-19,BBPS DT 17012019,"126,215.90",,519820.27,Zakharov,539,Spain,152880.07,1,1,0
2058,2011,1,OWN,2,Low,1,15000, 36 months,1,debt_consolidation,6,High,2,Good Loan,0,18.64,E,5,11.25,18721.7,15000,0,547.12,409000002057,17-Jan-19,FDRL/INTERNAL FUND TRANSFE,,300000.00,819820.27,Chukwualuka,743,France,175252.78,1,1,0
2059,2011,3,RENT,1,Low,1,2700, 36 months,1,credit_card,1,High,2,Good Loan,0,14.27,C,3,24.6,3332.097062,2700,0,92.64,409000002058,18-Jan-19,BBPS DT 18012019,"130,791.71",,689028.56,Chu,707,France,174303.29,1,1,0
2060,2011,0.5,RENT,1,Low,1,16000, 60 months,2,credit_card,1,High,2,Good Loan,0,18.64,E,5,19.03,23900.40459,16000,0,411.89,409000002059,19-Jan-19,BBPS DT 19012019,"192,484.66",,496543.90,Capon,581,Spain,80701.72,1,1,0
2061,2011,3,MORTGAGE,3,Low,1,18000, 36 months,1,debt_consolidation,6,High,2,Good Loan,0,17.58,D,4,17.67,20770.02,18000,0,646.96,409000002060,19-Jan-19,FDRL/INTERNAL FUND TRANSFE,,300000.00,796543.90,Cattaneo,737,Spain,198516.20,1,1,0
2062,2011,10,RENT,1,Low,1,12000, 60 months,2,credit_card,1,Low,1,Good Loan,0,12.42,B,2,6.69,13189.93,9202.66,0,269.49,409000002061,21-Jan-19,BBPS DT 20012019,"102,723.80",,693820.10,Patrick,445,Germany,175756.36,1,1,0
2063,2011,9,RENT,1,Low,1,7500, 36 months,1,debt_consolidation,6,Low,1,Bad Loan,1,12.69,B,2,15.21,5767.89,4013.53,502.56,251.59,409000002062,21-Jan-19,BBPS DT 21012019,"89,496.01",,604324.09,Taylor,703,Germany,82824.08,1,1,0
2064,2011,10,MORTGAGE,3,Low,1,1800, 36 months,1,debt_consolidation,6,Low,1,Good Loan,0,7.51,A,1,28.31,1979.99,1800,0,56,409000002063,22-Jan-19,FDRL/INTERNAL FUND TRANSFE,,300000.00,904324.09,Stephenson,588,Germany,179866.01,1,1,0
2065,2011,10,RENT,1,Medium,2,12000, 36 months,1,major_purchase,8,Low,1,Good Loan,0,11.71,B,2,3.44,14283.93171,12000,0,396.92,409000002064,22-Jan-19,BBPS DT 22012019,"264,718.05",,639606.04,Yeh,765,France,159899.97,1,1,0
2066,2011,10,RENT,1,Medium,2,8000, 60 months,2,other,4,High,2,Bad Loan,1,19.03,E,5,17.3,2504.8,776.19,414.04,207.66,409000002065,22-Jan-19,FDRL/INTERNAL FUND TRANSFE,,300000.00,939606.04,DeRose,626,France,138504.28,1,1,0
2067,2011,6,RENT,1,Low,1,6250, 36 months,1,debt_consolidation,6,Low,1,Good Loan,0,7.9,A,1,21.77,6962.870302,6250,0,195.57,409000002066,23-Jan-19,BBPS DT 23012019,"203,288.12",,736317.92,Vavilov,545,Germany,127394.67,1,1,0
2068,2011,6,RENT,1,Medium,2,11000, 36 months,1,car,2,High,2,Good Loan,0,13.49,C,3,6.83,13178.15145,11000,0,373.24,409000002067,23-Jan-19,FDRL/INTERNAL FUND TRANSFE,,200000.00,936317.92,Browne,744,France,58961.49,1,1,0
2069,2011,8,RENT,1,Low,1,20000, 36 months,1,debt_consolidation,6,Low,1,Good Loan,0,12.69,B,2,11.18,24138.10716,20000,0,670.9,409000002068,24-Jan-19,BBPS DT 24012019,"210,283.26",,726034.66,Collingridge de Tourcey,658,Spain,103644.98,1,1,0
2070,2011,1,RENT,1,Low,1,20000, 60 months,2,debt_consolidation,6,High,2,Bad Loan,1,19.91,E,5,15.35,14234.29,5461.61,2074.88,528.88,409000002069,24-Jan-19,FDRL/INTERNAL FUND TRANSFE,,200000.00,926034.66,Rowe,629,Germany,119647.70,1,1,0
2071,2011,1,OWN,2,Low,1,3775, 36 months,1,debt_consolidation,6,High,2,Good Loan,0,15.27,C,3,21.42,4696.327795,3775,0,131.37,409000002070,25-Jan-19,BBPS DT 25012019,"160,068.63",,765966.03,Jibunoh,719,France,28465.86,1,1,0
2072,2011,10,MORTGAGE,3,Medium,2,6000, 36 months,1,debt_consolidation,6,Low,1,Good Loan,0,6.03,A,1,1.32,6573.563822,6000,0,182.62,409000002071,28-Jan-19,BBPS DT 26012019,"184,208.33",,581757.70,Korovin,686,Spain,152979.14,1,1,0
2073,2011,8,MORTGAGE,3,Low,1,15000, 36 months,1,debt_consolidation,6,High,2,Good Loan,0,13.49,C,3,7.83,16102.39,15000,0,508.96,409000002072,28-Jan-19,BBPS DT 27012019,"70,743.08",,511014.62,Hammonds,743,France,190911.02,1,1,0
2074,2011,5,MORTGAGE,3,Low,1,16750, 60 months,2,debt_consolidation,6,Low,1,Good Loan,0,12.42,B,2,23.83,18419.1,12849.95,0,376.16,409000002073,28-Jan-19,BBPS DT 28012019,"40,666.41",,470348.21,Ward,626,Spain,95794.98,1,1,0
2075,2011,10,MORTGAGE,3,Low,1,7750, 36 months,1,debt_consolidation,6,Low,1,Good Loan,0,7.51,A,1,8.69,8315.01,7750,0,241.11,409000002074,28-Jan-19,FDRL/INTERNAL FUND TRANSFE,,200000.00,670348.21,Olisanugo,661,Germany,189742.78,1,1,0
2076,2011,4,RENT,1,Low,1,7000, 36 months,1,credit_card,1,High,2,Good Loan,0,14.27,C,3,10.91,7656.02,7000,0,240.17,409000002075,29-Jan-19,FDRL/INTERNAL FUND TRANSFE,,200000.00,870348.21,Gallop,710,Germany,188574.08,1,1,0
2077,2011,10,MORTGAGE,3,Low,1,9800, 36 months,1,home_improvement,7,Low,1,Good Loan,0,12.69,B,2,10.79,11776.68728,9800,0,328.74,409000002076,29-Jan-19,BBPS DT 29012019,"356,676.85",,513671.36,Gartrell,654,France,183872.88,1,1,0
2078,2011,5,MORTGAGE,3,Low,1,25000, 36 months,1,home_improvement,7,Low,1,Good Loan,0,7.9,A,1,2.44,28159.40494,25000,0,782.26,409000002077,29-Jan-19,FDRL/INTERNAL FUND TRANSFE,,200000.00,713671.36,K'ung,569,Spain,196555.32,1,1,0
2079,2011,6,RENT,1,Low,1,4000, 36 months,1,credit_card,1,Low,1,Bad Loan,1,11.71,B,2,12.37,3266.75,2376.27,243.86,132.31,409000002078,30-Jan-19,BBPS DT 30012019,"241,598.45",,472072.91,Oluchi,640,France,112503.24,1,1,0
2080,2011,9,MORTGAGE,3,Low,1,13200, 60 months,2,credit_card,1,High,2,Good Loan,0,17.58,D,4,15.33,16232.5,9825.95,0,332.19,409000002079,30-Jan-19,FDRL/INTERNAL FUND TRANSFE,,200000.00,672072.91,Jamieson,562,France,46864.00,1,1,0
2081,2011,9,RENT,1,Low,1,12000, 36 months,1,debt_consolidation,6,Low,1,Good Loan,0,6.03,A,1,18.89,13029.9,12000,0,365.23,409000002080,31-Jan-19,FDRL/INTERNAL FUND TRANSFE,,100000.00,772072.91,Barlow,721,France,65864.40,1,1,0
2082,2011,10,RENT,1,Low,1,21575, 60 months,2,debt_consolidation,6,High,2,Good Loan,0,23.91,G,7,18.5,26069.54,21575,0,619.55,409000002081,31-Jan-19,BBPS DT 31012019,"207,386.49",,564686.42,White,456,Germany,125167.92,1,1,0
2083,2011,0.5,RENT,1,Low,1,3300, 36 months,1,moving,10,High,2,Good Loan,0,14.65,C,3,11.6,4011.398126,3300,0,113.84,409000002082,31-Jan-19,FDRL/INTERNAL FUND TRANSFE,,200000.00,764686.42,Stewart,811,Spain,177519.39,1,1,0
2084,2011,5,RENT,1,Medium,2,5400, 36 months,1,debt_consolidation,6,High,2,Good Loan,0,15.27,C,3,13.17,6760.559123,5400,0,187.91,409000002083,1-Feb-19,BBPS DT 01022019,"194,258.69",,570427.73,Buccho,534,France,169653.32,1,1,0
2085,2011,5,RENT,1,Low,1,12000, 36 months,1,debt_consolidation,6,Low,1,Good Loan,0,12.42,B,2,16.8,14346.24746,12000,0,400.99,409000002084,1-Feb-19,FDRL/INTERNAL FUND TRANSFE,,200000.00,770427.73,Benson,423,France,118372.55,1,1,0
2086,2011,8,MORTGAGE,3,Low,1,16000, 60 months,2,debt_consolidation,6,High,2,Good Loan,0,15.27,C,3,19.67,20580.67004,16000,0,382.92,409000002085,2-Feb-19,BBPS DT 02022019,"99,147.70",,671280.03,Thompson,594,Germany,16481.12,1,1,0
2087,2011,5,RENT,1,Low,1,16250, 36 months,1,credit_card,1,Low,1,Bad Loan,1,12.42,B,2,15.94,6129.7,3921.24,708.5,543,409000002086,4-Feb-19,BBPS DT 03022019,"96,122.11",,575157.92,Todd,725,Spain,138525.19,1,1,0
2088,2011,3,MORTGAGE,3,Low,1,12000, 36 months,1,credit_card,1,High,2,Good Loan,0,15.27,C,3,11.8,13811.28,12000,0,417.58,409000002087,4-Feb-19,BBPS DT 04022019,"32,352.14",,542805.78,Burgin,716,France,14608.00,1,1,0
2089,2011,3,RENT,1,Low,1,6000, 36 months,1,debt_consolidation,6,Low,1,Good Loan,0,8.9,A,1,24.23,6856.963423,6000,0,190.52,409000002088,5-Feb-19,FDRL/INTERNAL FUND TRANSFE,,100000.00,642805.78,Nnaife,595,Germany,81548.38,1,1,0
2090,2011,0.5,RENT,1,Low,1,10000, 36 months,1,debt_consolidation,6,Low,1,Good Loan,0,7.51,A,1,2.54,11189.15923,10000,0,311.11,409000002089,5-Feb-19,FDRL/INTERNAL FUND TRANSFE,,200000.00,842805.78,Okwudiliolisa,679,France,69608.48,1,1,0
2091,2011,2,RENT,1,Low,1,20000, 60 months,2,small_business,3,Low,1,Good Loan,0,12.69,B,2,5.23,26577.85764,20000,0,451.9,409000002090,5-Feb-19,BBPS DT 05022019,"181,443.09",,661362.69,Johnson,667,Spain,68873.80,1,1,0
2092,2011,2,RENT,1,Low,1,12000, 36 months,1,credit_card,1,Low,1,Good Loan,0,12.69,B,2,12.48,13807.88,12000,0,402.54,409000002091,5-Feb-19,FDRL/INTERNAL FUND TRANSFE,,200000.00,861362.69,Parkes,661,France,81102.81,1,1,0
2093,2011,2,RENT,1,Low,1,13200, 36 months,1,debt_consolidation,6,Low,1,Good Loan,0,12.42,B,2,12.54,15847.42527,13200,0,441.09,409000002092,6-Feb-19,BBPS DT 06022019,"216,238.51",,645124.18,Lo,655,Spain,81054.00,1,1,0
2094,2011,7,RENT,1,Low,1,11625, 60 months,2,debt_consolidation,6,High,2,Good Loan,0,19.03,E,5,23.44,16931.80787,11625,0,301.76,409000002093,6-Feb-19,FDRL/INTERNAL FUND TRANSFE,,300000.00,945124.18,Martin,555,France,74149.77,1,1,0
2095,2011,4,MORTGAGE,3,Low,1,15000, 36 months,1,debt_consolidation,6,High,2,Good Loan,0,13.49,C,3,20.41,16374.86,15000,0,508.96,409000002094,7-Feb-19,BBPS DT 07022019,"171,418.15",,773706.03,Kapustina,531,Spain,99503.19,1,1,0
2096,2011,2,MORTGAGE,3,Low,1,18000, 36 months,1,debt_consolidation,6,High,2,Good Loan,0,13.49,C,3,16.72,21107.76,18000,0,610.75,409000002095,8-Feb-19,BBPS DT 08022019,"149,942.60",,623763.43,Page,611,Germany,10109.47,1,1,0
2097,2011,0.5,RENT,1,Low,1,8300, 36 months,1,debt_consolidation,6,Low,1,Bad Loan,1,8.9,A,1,3.8,5145.92,4076.93,251.25,263.56,409000002096,8-Feb-19,FDRL/INTERNAL FUND TRANSFE,,300000.00,923763.43,Amaechi,600,France,58855.85,1,1,0
2098,2011,6.05,RENT,1,Low,1,7000, 36 months,1,other,4,Low,1,Bad Loan,1,9.91,B,2,12.22,7604.58,6325.49,171.36,225.58,409000002097,11-Feb-19,BBPS DT 09022019,"110,277.09",,813486.34,Munro,531,Spain,84402.46,1,1,0
2099,2011,4,RENT,1,Low,1,7000, 36 months,1,debt_consolidation,6,High,2,Good Loan,0,15.27,C,3,9.77,8170.46,7000,0,243.59,409000002098,11-Feb-19,BBPS DT 10022019,"80,808.84",,732677.50,Panicucci,601,France,49713.87,1,1,0
2100,2011,7,MORTGAGE,3,Medium,2,35000, 60 months,2,home_improvement,7,High,2,Bad Loan,1,19.91,E,5,11.2,16760.35,5816.81,1677.93,925.54,409000002099,11-Feb-19,BBPS DT 11022019,"33,114.80",,699562.70,Greathouse,548,France,133537.53,1,1,0
2101,2011,7,RENT,1,Low,1,18000, 60 months,2,debt_consolidation,6,High,2,Bad Loan,1,17.27,D,4,19.83,8472.77,3638.7,841.98,449.97,409000002100,12-Feb-19,BBPS DT 12022019,"116,967.69",,582595.01,Ts'ui,759,France,124615.59,1,1,0
2102,2011,5,OWN,2,Low,1,10800, 36 months,1,major_purchase,8,Low,1,Good Loan,0,6.03,A,1,1.63,10959.15,10800,0,328.71,409000002101,12-Feb-19,FDRL/INTERNAL FUND TRANSFE,,100000.00,682595.01,Napolitani,678,Spain,98090.69,1,1,0
2103,2011,0.5,RENT,1,Low,1,20000, 36 months,1,debt_consolidation,6,Low,1,Good Loan,0,9.91,B,2,9.39,22590.07,20000,0,644.5,409000002102,13-Feb-19,BBPS DT 13022019,"90,749.23",,591845.78,Beers,755,Germany,42607.69,1,1,0
2104,2011,2,RENT,1,Low,1,10000, 36 months,1,major_purchase,8,Low,1,Good Loan,0,12.42,B,2,13.33,12025.79449,10000,0,334.16,409000002103,13-Feb-19,FDRL/INTERNAL FUND TRANSFE,,100000.00,691845.78,Tretyakova,594,France,192434.11,1,1,0
2105,2011,10,RENT,1,Low,1,18000, 36 months,1,credit_card,1,High,2,Good Loan,0,15.27,C,3,20.19,21758.3,18000,0,626.36,409000002104,14-Feb-19,BBPS DT 14022019,"96,638.52",,595207.26,Lin,768,France,60686.40,1,1,0
2106,2011,10,MORTGAGE,3,Low,1,10000, 60 months,2,car,2,High,2,Good Loan,0,13.49,C,3,13.32,11627.11,10000,0,230.05,409000002105,14-Feb-19,FDRL/INTERNAL FUND TRANSFE,,100000.00,695207.26,Costa,492,France,49463.44,1,1,0
2107,2011,6,RENT,1,Low,1,7200, 36 months,1,credit_card,1,Low,1,Good Loan,0,12.42,B,2,11.07,8658.030945,7200,0,240.59,409000002106,15-Feb-19,BBPS DT 15022019,"132,416.61",,562790.65,Ibezimako,637,Germany,81431.99,1,1,0
2108,2011,5,OWN,2,Low,1,5000, 36 months,1,home_improvement,7,Low,1,Good Loan,0,7.9,A,1,6.44,5296.31,5000,0,156.46,409000002107,15-Feb-19,FDRL/INTERNAL FUND TRANSFE,,100000.00,662790.65,Marcelo,646,Spain,22909.56,1,1,0
2109,2011,3,RENT,1,Low,1,25000, 60 months,2,debt_consolidation,6,High,2,Bad Loan,1,17.58,D,4,5.68,25825.97,14617.01,0,629.14,409000002108,16-Feb-19,BBPS DT 16022019,"199,604.27",,463186.38,Hay,593,Germany,65532.17,1,1,0
2110,2011,10,MORTGAGE,3,Low,1,8375, 36 months,1,medical,9,Low,1,Good Loan,0,7.51,A,1,21.14,9138.98,8375,0,260.56,409000002109,16-Feb-19,FDRL/INTERNAL FUND TRANSFE,,100000.00,563186.38,Moore,596,Spain,141053.85,1,1,0
2111,2011,5,MORTGAGE,3,Low,1,30000, 60 months,2,debt_consolidation,6,High,2,Bad Loan,1,20.89,F,6,24.14,7279.83,2772.17,0,809.75,409000002110,18-Feb-19,FDRL/INTERNAL FUND TRANSFE,,300000.00,863186.38,Lumholtz,722,Germany,3472.63,1,1,0
2112,2011,10,RENT,1,Low,1,19075, 60 months,2,debt_consolidation,6,High,2,Good Loan,0,20.89,F,6,17.38,29214.2,18472.09,0,514.87,409000002111,18-Feb-19,BBPS DT 17022019,"109,270.49",,753915.89,Simpson,642,France,102083.78,1,1,0
2113,2011,9,RENT,1,Low,1,1200, 36 months,1,other,4,Low,1,Good Loan,0,12.42,B,2,18.95,1442.64291,1200,0,40.1,409000002112,18-Feb-19,BBPS DT 18022019,"57,932.84",,695983.05,Hill,472,Spain,1801.77,1,1,0
2114,2011,10,MORTGAGE,3,Low,1,15000, 60 months,2,debt_consolidation,6,High,2,Good Loan,0,17.27,D,4,20.82,21350.02762,15000,0,374.97,409000002113,19-Feb-19,BBPS DT 19022019,"181,484.83",,514498.22,Mouzon,738,Germany,85185.44,1,1,0
2115,2011,5,RENT,1,Low,1,3000, 36 months,1,debt_consolidation,6,Low,1,Good Loan,0,12.42,B,2,16.2,3551.677332,3000,0,100.25,409000002114,20-Feb-19,FDRL/INTERNAL FUND TRANSFE,,100000.00,614498.22,Wu,732,Spain,119882.70,1,1,0
2116,2011,10,RENT,1,Low,1,35000, 60 months,2,debt_consolidation,6,High,2,Bad Loan,1,18.64,E,5,20.66,12612.45,5535.28,10.63,901.01,409000002115,20-Feb-19,FDRL/INTERNAL FUND TRANSFE,,100000.00,714498.22,Pirozzi,404,Germany,83715.66,1,1,0
2117,2011,10,MORTGAGE,3,Low,1,8000, 36 months,1,home_improvement,7,Low,1,Good Loan,0,7.9,A,1,4.54,8976.306507,8000,0,250.33,409000002116,20-Feb-19,BBPS DT 20022019,"145,202.42",,569295.80,Ibeabuchi,701,France,23425.78,1,1,0
2118,2011,4,MORTGAGE,3,Medium,2,16000, 36 months,1,home_improvement,7,Low,1,Good Loan,0,7.9,A,1,9.09,18020.79919,16000,0,500.65,409000002117,20-Feb-19,FDRL/INTERNAL FUND TRANSFE,,100000.00,669295.80,Garnsey,683,France,77326.78,1,1,0
2119,2011,8,RENT,1,Low,1,10000, 36 months,1,home_improvement,7,Low,1,Good Loan,0,10.65,B,2,19.74,10500.4,10000,0,325.74,409000002118,21-Feb-19,BBPS DT 21022019,"165,058.25",,504237.55,Synnot,460,France,156150.08,1,1,0
2120,2011,4,RENT,1,Low,1,27050, 36 months,1,small_business,3,High,2,Good Loan,0,13.49,C,3,21.34,33098.86412,27050,0,917.82,409000002119,21-Feb-19,FDRL/INTERNAL FUND TRANSFE,,300000.00,804237.55,Wildman,690,France,108577.97,1,1,0
2121,2011,0.5,RENT,1,Low,1,8000, 36 months,1,debt_consolidation,6,High,2,Good Loan,0,18.25,D,4,6,10398.4268,8000,0,290.23,409000002120,22-Feb-19,BBPS DT 22022019,"61,442.29",,742795.26,Anenechukwu,618,Germany,133573.29,1,1,0
2122,2011,3,RENT,1,Low,1,7500, 36 months,1,wedding,5,High,2,Good Loan,0,16.29,D,4,13.05,9476.224665,7500,0,264.76,409000002121,25-Feb-19,FDRL/INTERNAL FUND TRANSFE,,100000.00,842795.26,Tai,671,France,102057.86,1,1,0
2123,2011,5,MORTGAGE,3,Medium,2,12000, 36 months,1,debt_consolidation,6,High,2,Good Loan,0,16.29,D,4,11.7,15274.33161,12000,0,423.61,409000002122,25-Feb-19,BBPS DT 23022019,"85,626.32",,757168.94,Plant,765,Spain,47247.56,1,1,0
2124,2011,0.5,RENT,1,Low,1,8500, 36 months,1,home_improvement,7,Low,1,Good Loan,0,8.9,A,1,19.56,9714.182665,8500,0,269.91,409000002123,25-Feb-19,BBPS DT 24022019,"78,877.02",,678291.92,Azubuike,651,Germany,114566.47,1,1,0
2125,2011,10,MORTGAGE,3,Low,1,12000, 60 months,2,debt_consolidation,6,High,2,Bad Loan,1,15.27,C,3,12.47,2078.48,686.54,649.28,287.19,409000002124,25-Feb-19,BBPS DT 25022019,"19,145.05",,659146.87,Galkin,704,France,184464.70,1,1,0
2126,2011,2,RENT,1,Low,1,10000, 36 months,1,credit_card,1,Low,1,Good Loan,0,11.71,B,2,12.16,11903.77721,10000,0,330.76,409000002125,25-Feb-19,FDRL/INTERNAL FUND TRANSFE,,100000.00,759146.87,Johnston,544,France,151401.33,1,1,0
2127,2011,4,OWN,2,Low,1,15000, 60 months,2,debt_consolidation,6,High,2,Good Loan,0,18.25,D,4,17.17,18958.11,15000,0,382.95,409000002126,26-Feb-19,BBPS DT 26022019,"80,664.07",,678482.80,Babbage,790,France,70607.10,1,1,0
2128,2011,6,RENT,1,Low,1,15000, 36 months,1,debt_consolidation,6,High,2,Good Loan,0,14.27,C,3,17.46,15353,15000,0,514.64,409000002127,26-Feb-19,BBPS TDS @2% OCT 18 VIJAY,2.7,,678480.10,Walker,710,Germany,147074.67,1,1,0
2129,2011,9,MORTGAGE,3,Low,1,10000, 36 months,1,debt_consolidation,6,High,2,Good Loan,0,16.77,D,4,11.13,11029.46,10000,0,355.39,409000002128,27-Feb-19,BBPS DT 27022019,"135,504.16",,542975.94,Rice,743,France,105780.18,1,1,0
2130,2011,10,MORTGAGE,3,Medium,2,35000, 60 months,2,home_improvement,7,High,2,Good Loan,0,19.03,E,5,24.74,50110.74058,35000,0,908.5,409000002129,27-Feb-19,FDRL/INTERNAL FUND TRANSFE,,200000.00,742975.94,Norton,702,France,109496.45,1,1,0
2131,2011,4,MORTGAGE,3,Low,1,12000, 36 months,1,debt_consolidation,6,Low,1,Good Loan,0,9.91,B,2,3.38,13455.32,12000,0,386.7,409000002130,28-Feb-19,BBPS DT 28022019,"92,031.56",,650944.38,Bogolyubov,704,France,137739.45,1,1,0
2132,2011,10,MORTGAGE,3,Low,1,35000, 60 months,2,debt_consolidation,6,High,2,Good Loan,0,19.42,E,5,20.89,44846.22,25819.29,0,916.03,409000002131,1-Mar-19,BBPS DT 01032019,"118,475.77",,532468.61,Gibbons,614,France,105140.92,1,1,0
2133,2011,7,RENT,1,Low,1,6800, 36 months,1,credit_card,1,High,2,Good Loan,0,20.3,E,5,24.21,9044.819543,6800,0,253.76,409000002132,2-Mar-19,FDRL/INTERNAL FUND TRANSFE,,300000.00,832468.61,Chia,609,Spain,113276.46,1,1,0
2134,2011,0.5,RENT,1,Medium,2,30000, 36 months,1,debt_consolidation,6,High,2,Good Loan,0,17.27,D,4,11.78,38643.18228,30000,0,1073.62,409000002133,2-Mar-19,BBPS DT 02032019,"16,440.61",,816028.00,Smith,688,France,172531.23,1,1,0
2135,2011,0.5,RENT,1,Low,1,12000, 36 months,1,debt_consolidation,6,Low,1,Good Loan,0,7.51,A,1,18.79,13361.80447,12000,0,373.33,409000002134,4-Mar-19,BBPS DT 03032019,"59,110.48",,756917.52,Hunter,713,France,64375.40,1,1,0
2136,2011,9,MORTGAGE,3,Low,1,18725, 60 months,2,debt_consolidation,6,High,2,Bad Loan,1,17.27,D,4,23.35,21616.54,12842.94,0,468.09,409000002135,4-Mar-19,BBPS DT 04032019,"3,002.37",,753915.15,Ekechukwu,736,Germany,28434.44,1,1,0
2137,2011,0.5,RENT,1,Low,1,13000, 60 months,2,debt_consolidation,6,High,2,Good Loan,0,15.27,C,3,13.5,17040.94806,13000,0,311.12,409000002136,5-Mar-19,BBPS DT 05032019,"10,331.83",,743583.32,Bellucci,727,France,46941.41,1,1,0
2138,2011,10,MORTGAGE,3,Medium,2,18000, 36 months,1,debt_consolidation,6,Low,1,Good Loan,0,12.42,B,2,14.24,20756.56,18000,0,601.48,409000002137,23-Feb-16,NEFT/SBIN316054519453/Mr,,21000.00,764583.32,Ford,850,France,29333.01,1,1,0
2139,2011,5,RENT,1,Low,1,12000, 36 months,1,credit_card,1,Low,1,Good Loan,0,12.42,B,2,16.85,13108.2,12000.01,0,400.99,409000002138,23-Feb-16,NEFT/SBIN316054795331/Mr,,1000.00,765583.32,Scott,718,Spain,193724.51,1,1,0
2140,2011,5,MORTGAGE,3,Low,1,16500, 60 months,2,small_business,3,Low,1,Bad Loan,1,11.71,B,2,3.13,16018.06,11106.97,0,364.62,409000002139,29-Feb-16,NEFT/SD1279001248/DHARAMB,,21000.00,786583.32,Gregson,643,France,34967.75,1,1,0
2141,2011,4,RENT,1,Low,1,8000, 60 months,2,other,4,High,2,Good Loan,0,21.67,F,6,6.69,10729.62,5818.57,0,219.46,409000002140,2-Mar-16,NEFT/SBIN116062424445/DEE,,21000.00,807583.32,Moore,653,France,55663.85,1,1,0
2142,2011,10,OWN,2,Medium,2,35000, 60 months,2,credit_card,1,High,2,Good Loan,0,19.42,E,5,18.11,44861.03,25825.95,0,916.03,409000002141,30-Mar-16,NEFT/MAHBH16090571628/M/s,,20000.00,827583.32,Wallace,674,France,55753.12,1,1,0
2143,2011,2,MORTGAGE,3,Low,1,18000, 36 months,1,home_improvement,7,Low,1,Good Loan,0,11.71,B,2,7.45,21430.00883,18000,0,595.37,409000002142,6-Apr-16,NEFT/SD1290309312/VIDYART,,1000.00,828583.32,Cook,690,France,176962.31,1,1,0
2144,2011,10,MORTGAGE,3,Low,1,20000, 36 months,1,credit_card,1,Low,1,Good Loan,0,12.69,B,2,17.56,24140.03792,20000,0,670.9,409000002143,7-Apr-16,NEFT/BARBH16098696964/MOT,,1000.00,829583.32,Speth,819,France,181507.44,1,1,0
2145,2011,10,MORTGAGE,3,High,3,12000, 36 months,1,debt_consolidation,6,Low,1,Good Loan,0,7.51,A,1,10.01,12876.55,12000,0,373.33,409000002144,8-Apr-16,NEFT/SAA33261155/SANJEET,,1000.00,830583.32,Boag,634,Spain,61995.57,1,1,0
2146,2011,8,MORTGAGE,3,Low,1,12000, 36 months,1,debt_consolidation,6,Low,1,Good Loan,0,7.51,A,1,15.41,12625.86,12000,0,373.33,409000002145,13-Apr-16,NEFT/BKIDN16104834588/KAV,,21000.00,851583.32,Grave,633,Spain,98349.13,1,1,0
2147,2011,10,RENT,1,Low,1,1000, 36 months,1,other,4,Low,1,Good Loan,0,9.91,B,2,10.33,1085.42,1000,0,32.23,409000002146,16-Apr-16,NEFT/CBINH16107289293/M S,,1000.00,852583.32,Streeten,850,France,59748.19,1,1,0
2148,2011,5,RENT,1,Low,1,20000, 36 months,1,debt_consolidation,6,Low,1,Good Loan,0,12.69,B,2,6.38,24141.01404,20000,0,670.9,409000002147,20-Apr-16,NEFT/BKIDN16111600591/KRI,,1000.00,853583.32,Fox,665,France,159840.51,1,1,0
2149,2011,4,RENT,1,Low,1,24000, 36 months,1,debt_consolidation,6,High,2,Good Loan,0,16.29,D,4,6.7,29511.51,24000,0,847.21,409000002148,21-Apr-16,NEFT/STBP916112924171/UNI,,1000.00,854583.32,Artemyeva,630,Spain,6656.64,1,1,0
2150,2011,10,MORTGAGE,3,Low,1,15000, 60 months,2,debt_consolidation,6,High,2,Good Loan,0,13.49,C,3,21.6,16738.33,15000,0,345.08,409000002149,25-Apr-16,NEFT/SD1293975857/JAI RAM,,1000.00,855583.32,Giordano,836,Spain,37141.62,1,1,0
2151,2011,8,RENT,1,Low,1,12000, 36 months,1,debt_consolidation,6,Low,1,Good Loan,0,11.71,B,2,16.8,14284.56171,12000,0,396.92,409000002150,25-Apr-16,NEFT/SBIN116116210635/PAD,,21000.00,876583.32,Perkins,668,France,37094.75,1,1,0
2152,2011,6,MORTGAGE,3,Low,1,17000, 36 months,1,debt_consolidation,6,Low,1,Good Loan,0,12.42,B,2,13.94,20242.32096,17000,0,568.06,409000002151,5-May-16,NEFT/BKIDN16126554823/NAS,,21000.00,897583.32,Walton,753,France,159475.08,1,1,0
2153,2011,6,MORTGAGE,3,Low,1,12000, 36 months,1,debt_consolidation,6,Low,1,Good Loan,0,12.42,B,2,9.69,14432.19504,12000,0,400.99,409000002152,6-May-16,NEFT/SBIN216127966232/RAV,,20994.28,918577.60,Hay,745,France,51548.14,1,1,0
2154,2011,10,RENT,1,Medium,2,20000, 60 months,2,debt_consolidation,6,High,2,Good Loan,0,21.28,F,6,4.96,30928.37799,20000,0,544.23,409000002153,11-May-16,NEFT/CBINH16132151302/Mr.,,1000.00,919577.60,Gardner,693,France,58719.63,1,1,0
2155,2011,1,RENT,1,Medium,2,24000, 36 months,1,credit_card,1,Low,1,Good Loan,0,12.69,B,2,23.13,28977.46599,24000,0,805.08,409000002154,12-May-16,NEFT/IBKL160512086896/SUN,,21000.00,940577.60,Milne,606,Germany,7861.68,1,1,0
2156,2011,9,MORTGAGE,3,Low,1,7500, 36 months,1,credit_card,1,Low,1,Good Loan,0,6.62,A,1,16.77,8252.546008,7500,0,230.28,409000002155,12-May-16,NEFT/SBIN716133295639/PRA,,1000.00,941577.60,She,660,France,19199.61,1,1,0
2157,2011,5,RENT,1,Low,1,20000, 60 months,2,debt_consolidation,6,High,2,Good Loan,0,14.65,C,3,12.65,27704.37026,20000,0,472.14,409000002156,13-May-16,NEFT/SBIN816134053552/KAS,,1000.00,942577.60,Hu,608,France,178504.29,1,1,0
2158,2011,6,MORTGAGE,3,Medium,2,7000, 60 months,2,major_purchase,8,High,2,Good Loan,0,15.96,C,3,11.26,8307.66,5256.29,0,170.08,409000002157,13-May-16,NEFT/SBIN816134469009/Mr,,21000.00,963577.60,Uwakwe,744,France,189016.14,1,1,0
2159,2011,2,RENT,1,Low,1,12800, 60 months,2,debt_consolidation,6,High,2,Good Loan,0,17.58,D,4,19.05,15216.26,12799.99,0,322.12,409000002158,16-May-16,6.14E+11,,5000.00,968577.60,Bird,731,France,156048.64,1,1,0
2160,2011,10,MORTGAGE,3,Low,1,3000, 36 months,1,major_purchase,8,Low,1,Good Loan,0,6.03,A,1,11.93,3282.198864,3000,0,91.31,409000002159,16-May-16,6.14E+11,,5000.00,973577.60,Anderson,683,France,52876.41,1,1,0
2161,2011,3,RENT,1,Low,1,10000, 36 months,1,debt_consolidation,6,Low,1,Good Loan,0,12.42,B,2,19.86,12026.07083,10000,0,334.16,409000002160,16-May-16,6.14E+11,,5000.00,978577.60,Bellew,727,France,19653.08,1,1,0
2162,2011,4,MORTGAGE,3,Low,1,8400, 60 months,2,debt_consolidation,6,Low,1,Good Loan,0,8.9,A,1,7.44,8492.03,6546.41,0,173.97,409000002161,16-May-16,6.14E+11,,5000.00,983577.60,Cocci,561,Germany,139451.98,1,1,0
2163,2011,4,OWN,2,Low,1,15000, 36 months,1,credit_card,1,Low,1,Good Loan,0,6.03,A,1,10.81,16434.44577,15000,0,456.54,409000002162,16-May-16,NEFT/SFB52108866/SUMAN EN,,21000.00,1004577.60,Krichauff,700,France,128136.29,1,1,0
2164,2011,5,MORTGAGE,3,Low,1,30000, 60 months,2,credit_card,1,High,2,Good Loan,0,22.06,F,6,14.7,42011.09,30000,0,829.6,409000002163,17-May-16,6.14E+11,,1000.00,1005577.60,Cameron,605,France,45206.57,1,1,0
2165,2011,10,MORTGAGE,3,Medium,2,12000, 36 months,1,major_purchase,8,Low,1,Good Loan,0,7.51,A,1,6.3,13403.1456,12000,0,373.33,409000002164,17-May-16,NEFT/CBINH16138124492/Mr.,,20000.00,1025577.60,Becker,767,Spain,190146.83,1,1,0
2166,2011,4,MORTGAGE,3,Low,1,11125, 36 months,1,debt_consolidation,6,High,2,Good Loan,0,13.49,C,3,15.63,13583.6539,11125,0,377.48,409000002165,19-May-16,NEFT/CBINH16140123873/Mr.,,20000.00,1045577.60,Ainsworth,511,France,158313.87,1,1,0
2167,2011,4,MORTGAGE,3,Low,1,20000, 60 months,2,house,12,High,2,Good Loan,0,14.27,C,3,0.6,22325.39,20000,0,468.17,409000002166,20-May-16,NEFT/BKIDN16141481959/KRI,,20000.00,1065577.60,Biryukov,667,France,96670.20,1,1,0
2168,2011,2,RENT,1,Low,1,3525, 36 months,1,debt_consolidation,6,Low,1,Good Loan,0,6.62,A,1,12.92,3892.259,3525,0,108.24,409000002167,27-May-16,NEFT/SBIN616148454741/ARJ,,20000.00,1085577.60,Redding,787,France,62163.53,1,1,0
2169,2011,2,RENT,1,Low,1,3000, 36 months,1,moving,10,Low,1,Good Loan,0,7.51,A,1,14.89,3230.83,3000,0,93.34,409000002168,31-May-16,NEFT/CBINH16152A05238/MAN,,21000.00,1106577.60,Wood,705,Germany,88428.41,1,1,0
2170,2011,10,OWN,2,Medium,2,19800, 60 months,2,home_improvement,7,High,2,Good Loan,0,21.67,F,6,1.61,26587.31,14413.78,0,543.15,409000002169,7-Jun-16,NEFT/SBIN616159262965/dee,,1000.00,1107577.60,Scott,773,Germany,35908.46,1,1,0
2171,2011,10,RENT,1,Low,1,10000, 36 months,1,credit_card,1,Low,1,Good Loan,0,10.65,B,2,24.15,11723.79957,10000,0,325.74,409000002170,8-Jun-16,NEFT/SBIN616160853986/MOH,,1000.00,1108577.60,Gould,554,France,168780.04,1,1,0
2172,2011,4,MORTGAGE,3,Medium,2,5000, 36 months,1,other,4,Low,1,Good Loan,0,9.91,B,2,10.7,5816.099852,5000,0,161.13,409000002171,8-Jun-16,NEFT/SBIN616160853413/ABB,,1000.00,1109577.60,Hao,526,Germany,191263.76,1,1,0
2173,2011,10,RENT,1,Medium,2,3000, 36 months,1,debt_consolidation,6,Low,1,Good Loan,0,12.69,B,2,13.84,3092.87,3000,0,100.64,409000002172,9-Jun-16,NEFT/BKIDN16161554131/DEE,,21000.00,1130577.60,Power,661,Germany,83052.03,1,1,0
2174,2011,6,MORTGAGE,3,Low,1,11200, 36 months,1,debt_consolidation,6,High,2,Good Loan,0,14.27,C,3,13.51,11952.7,11200,0,384.26,409000002173,10-Jun-16,NEFT/SBIN916162127714/Mr,,1000.00,1131577.60,White,698,France,125962.02,1,1,0
2175,2011,1,RENT,1,Low,1,4800, 36 months,1,debt_consolidation,6,Low,1,Good Loan,0,7.9,A,1,14.44,5353.53,4800,0,150.2,409000002174,16-Jun-16,NEFT/SD1308679702/MANOJ K,,12000.00,1143577.60,Thorpe,646,France,164696.27,1,1,0
2176,2011,6,RENT,1,Low,1,6000, 36 months,1,debt_consolidation,6,Low,1,Good Loan,0,12.42,B,2,24.99,6601.67,6000,0,200.5,409000002175,16-Jun-16,NEFT/SBIN316168317601/RAK,,12000.00,1155577.60,Tuan,757,Germany,187011.96,1,1,0
2177,2011,10,RENT,1,Low,1,3500, 36 months,1,debt_consolidation,6,Low,1,Good Loan,0,9.91,B,2,20.71,4058.699787,3500,0,112.79,409000002176,16-Jun-16,NEFT/SBIN316168348715/MUK,,12000.00,1167577.60,Inman,699,Spain,55324.49,1,1,0
2178,2011,7,OWN,2,Low,1,13350, 60 months,2,debt_consolidation,6,High,2,Good Loan,0,17.27,D,4,20.53,19029.03387,13350,0,333.73,409000002177,16-Jun-16,NEFT/SBIN316168320808/MUK,,12000.00,1179577.60,Hanson,667,France,34335.55,1,1,0
2179,2011,10,RENT,1,Low,1,15000, 36 months,1,other,4,Low,1,Good Loan,0,11.71,B,2,9.73,17600.97,15000,0,496.14,409000002178,17-Jun-16,NEFT/SBIN316169520860/A D,,12000.00,1191577.60,MacDonald,774,Spain,17004.14,1,1,0
2180,2011,7,RENT,1,Low,1,20000, 60 months,2,debt_consolidation,6,Low,1,Good Loan,0,12.69,B,2,15.48,22095.06,15304.19,0,451.9,409000002179,18-Jun-16,NEFT/FDRL439156264/ACHARIY,,21000.00,1212577.60,Parkes,745,Spain,116331.42,1,1,0
2181,2011,8,OWN,2,Low,1,25000, 36 months,1,other,4,Low,1,Good Loan,0,7.9,A,1,19.07,28160.21639,25000,0,782.26,409000002180,22-Jun-16,NEFT/SAA34915621/SHIV SHA,,12000.00,1224577.60,Stanley,649,France,22974.01,1,1,0
2182,2011,6,RENT,1,Low,1,5600, 36 months,1,debt_consolidation,6,Low,1,Good Loan,0,6.03,A,1,16.29,6035.9,5600,0,170.44,409000002181,24-Jun-16,NEFT/SBIN616176940371/Mr,,1000.00,1225577.60,Fischer,634,Germany,49725.16,1,1,0
2183,2011,10,RENT,1,Low,1,25000, 60 months,2,debt_consolidation,6,High,2,Good Loan,0,17.27,D,4,21.07,30595.25,18670.03,0,624.95,409000002182,27-Jun-16,NEFT/CBINH16179A02820/CHA,,12000.00,1237577.60,Chinweuba,665,Spain,87412.74,1,1,0
2184,2011,6,MORTGAGE,3,Low,1,16000, 36 months,1,debt_consolidation,6,High,2,Good Loan,0,13.49,C,3,20.09,19564.12411,16000,0,542.89,409000002183,27-Jun-16,NEFT/SBIN716179727588/Mr,,1000.00,1238577.60,Henning,713,France,26136.89,1,1,0
2185,2011,9,MORTGAGE,3,Low,1,24000, 36 months,1,other,4,Low,1,Good Loan,0,7.51,A,1,11.81,25938.1676,24000,0,746.66,409000002184,28-Jun-16,NEFT/SBIN816180176925/DEE,,20000.00,1258577.60,Ogochukwu,652,France,126554.96,1,1,0
2186,2011,10,MORTGAGE,3,Low,1,14000, 60 months,2,credit_card,1,High,2,Good Loan,0,13.49,C,3,24.73,15755.95,10670.28,0,322.07,409000002185,29-Jun-16,NEFT/SBIN816181708340/GOB,,2000.00,1260577.60,Narelle,739,Spain,193321.30,1,1,0
2187,2011,5,RENT,1,Low,1,2400, 36 months,1,debt_consolidation,6,High,2,Good Loan,0,17.27,D,4,8.76,3089.672749,2400,0,85.89,409000002186,29-Jun-16,NEFT/SBIN816181725132/NAZ,,20000.00,1280577.60,Bergman,556,Germany,90928.02,1,1,0
2188,2011,0.5,RENT,1,Low,1,11500, 36 months,1,debt_consolidation,6,Low,1,Good Loan,0,7.51,A,1,9.12,12690.23845,11500,0,357.78,409000002187,29-Jun-16,NEFT/SBIN816181727342/ABB,,20000.00,1300577.60,Sagese,699,Spain,76510.46,1,1,0
2189,2011,5,RENT,1,Low,1,2100, 36 months,1,major_purchase,8,High,2,Good Loan,0,14.65,C,3,7.66,2608.104226,2100,0,72.44,409000002188,29-Jun-16,6.18E+11,,2000.00,1302577.60,Anenechi,708,Spain,120115.50,1,1,0
2190,2011,6.05,MORTGAGE,3,Low,1,6000, 36 months,1,small_business,3,Low,1,Good Loan,0,7.9,A,1,24.13,6757.956186,6000,0,187.75,409000002189,30-Jun-16,6.18E+11,,2000.00,1304577.60,Palerma,480,France,197984.58,1,1,0
2191,2011,5,OWN,2,Low,1,14000, 60 months,2,debt_consolidation,6,High,2,Good Loan,0,13.49,C,3,23.87,16761.36,11913.69,0,322.07,409000002190,30-Jun-16,NEFT/SAA205140562/RAJNISH,,1000.00,1305577.60,Okwudilichukwu,700,Germany,142977.05,1,1,0
2192,2011,4,RENT,1,Low,1,12800, 60 months,2,debt_consolidation,6,High,2,Good Loan,0,13.49,C,3,16.59,15308.75,10730.39,0,294.47,409000002191,30-Jun-16,NEFT/SBIN916182568748/JAW,,20000.00,1325577.60,Harrison,525,Spain,82522.61,1,1,0
2193,2011,2,RENT,1,Low,1,8000, 36 months,1,debt_consolidation,6,Low,1,Bad Loan,1,7.51,A,1,7.71,6374.09,5184.38,405.41,248.89,409000002192,1-Jul-16,6.18E+11,,1000.00,1326577.60,Jamieson,845,France,150664.97,1,1,0
2194,2011,7,RENT,1,Low,1,12400, 60 months,2,other,4,High,2,Good Loan,0,21.28,F,6,15.77,16187.11,12400,0,337.42,409000002193,1-Jul-16,6.18E+11,,2000.00,1328577.60,Goodman,613,France,114153.44,1,1,0
2195,2011,7,OWN,2,Low,1,15000, 36 months,1,debt_consolidation,6,High,2,Good Loan,0,17.58,D,4,4.38,19125.97613,15000,0,539.14,409000002194,1-Jul-16,6.18E+11,,2000.00,1330577.60,Ko,850,France,171706.66,1,1,0
2196,2011,4,RENT,1,Low,1,7200, 36 months,1,credit_card,1,Low,1,Good Loan,0,8.9,A,1,10.62,8228.673455,7200,0,228.63,409000002195,3-Jul-16,6.19E+11,,2000.00,1332577.60,Norman,798,Spain,119071.56,1,1,0
2197,2011,0.5,RENT,1,Low,1,8000, 36 months,1,major_purchase,8,Low,1,Good Loan,0,7.9,A,1,9.32,8341.22,8000,0,250.33,409000002196,4-Jul-16,NEFT/SAA205977061/PRAVEEN,,1000.00,1333577.60,Ugochukwutubelum,773,Germany,143007.49,1,1,0
2198,2011,6,MORTGAGE,3,Low,1,10000, 36 months,1,wedding,5,Low,1,Good Loan,0,9.91,B,2,22.88,11544.39988,10000,0,322.25,409000002197,4-Jul-16,NEFT/SBIN516186067895/Mrs,,21000.00,1354577.60,Uvarova,614,Spain,31302.35,1,1,0
2199,2011,10,MORTGAGE,3,Low,1,21200, 36 months,1,small_business,3,Low,1,Bad Loan,1,12.42,B,2,21.18,12096.57,8451.46,732.27,708.41,409000002198,5-Jul-16,NEFT/SBIN616187051242/MO,,21000.00,1375577.60,Chia,473,Spain,71139.80,1,1,0
2200,2011,10,MORTGAGE,3,Low,1,9300, 60 months,2,other,4,High,2,Good Loan,0,14.27,C,3,3.62,10536.02,9300,0,217.7,409000002199,6-Jul-16,6.19E+11,,5000.00,1380577.60,Piazza,762,France,54122.89,1,1,0
2201,2011,4,RENT,1,Low,1,21500, 60 months,2,debt_consolidation,6,High,2,Good Loan,0,19.03,E,5,18.28,26785.09,15422.96,0,558.08,409000002200,11-Jul-16,NEFT/SBIN816193916982/Mr,,1000.00,1381577.60,Power,701,France,120031.29,1,1,0
2202,2011,8,RENT,1,Low,1,15000, 60 months,2,credit_card,1,High,2,Good Loan,0,14.65,C,3,17.21,19130.38855,15000,0,354.1,409000002201,11-Jul-16,6.19E+11,,2000.00,1383577.60,P'eng,600,France,104076.51,1,1,0
2203,2011,4,RENT,1,Low,1,30000, 60 months,2,debt_consolidation,6,High,2,Good Loan,0,20.89,F,6,16.91,30522.93,30000,0,809.75,409000002202,12-Jul-16,NEFT/SBIN116194122076/Mr,,21000.00,1404577.60,Johnson,850,Spain,175853.64,1,1,0
2204,2011,0.5,RENT,1,Low,1,19125, 60 months,2,debt_consolidation,6,High,2,Good Loan,0,15.27,C,3,23.18,23237.68,19125,0,457.7,409000002203,12-Jul-16,6.19E+11,,2000.00,1406577.60,Walker,613,Spain,175795.87,1,1,0
2205,2011,1,MORTGAGE,3,Low,1,17000, 36 months,1,debt_consolidation,6,High,2,Good Loan,0,14.65,C,3,20.9,20912.98224,17000,0,586.41,409000002204,14-Jul-16,NEFT/SBIN216196807820/M S,,1000.00,1407577.60,Innes,509,France,15360.91,1,1,0
2206,2011,1,RENT,1,Low,1,20000, 60 months,2,debt_consolidation,6,Low,1,Good Loan,0,12.42,B,2,15.48,22030.49,20000,0,449.15,409000002205,15-Jul-16,NEFT/SBIN316197386153/PRA,,21000.00,1428577.60,Francis,509,Spain,168460.12,1,1,0
2207,2011,0.5,RENT,1,Low,1,5000, 36 months,1,moving,10,Low,1,Good Loan,0,7.51,A,1,3.7,5602.623049,5000,0,155.56,409000002206,15-Jul-16,NEFT/IBKL160715032313/MD,,2000.00,1430577.60,Chidozie,609,France,181177.90,1,1,0
2208,2011,3,OWN,2,Low,1,5000, 36 months,1,debt_consolidation,6,High,2,Good Loan,0,14.27,C,3,7.95,6176.880421,5000,0,171.55,409000002207,15-Jul-16,NEFT/SBIN316197729327/RAJ,,21000.00,1451577.60,Mackenzie,456,France,58363.94,1,1,0
2209,2011,4,RENT,1,Low,1,3800, 36 months,1,credit_card,1,High,2,Good Loan,0,18.25,D,4,19.11,4961.476833,3800,0,137.86,409000002208,15-Jul-16,NEFT/SBIN316197771024/SUM,,12000.00,1463577.60,Craigie,728,France,20276.87,1,1,0
2210,2011,10,RENT,1,Low,1,5000, 36 months,1,debt_consolidation,6,Low,1,Bad Loan,1,6.62,A,1,10.84,919.38,764.67,0,153.52,409000002209,17-Jul-16,6.20E+11,,1000.00,1464577.60,Manfrin,663,Spain,91514.62,1,1,0
2211,2011,10,MORTGAGE,3,Low,1,29000, 60 months,2,debt_consolidation,6,High,2,Good Loan,0,17.58,D,4,8.88,30368.58,29000,0,729.8,409000002210,18-Jul-16,6.20E+11,,1000.00,1465577.60,Onyekachi,673,Germany,76703.10,1,1,0
2212,2011,0.5,MORTGAGE,3,Low,1,14000, 60 months,2,car,2,High,2,Good Loan,0,17.58,D,4,10.01,17227.74,10428.13,0,352.32,409000002211,18-Jul-16,NEFT/SBIN416200847549/KUL,,21000.00,1486577.60,Pethard,717,France,110887.14,1,1,0
2213,2011,10,MORTGAGE,3,Low,1,12000, 36 months,1,credit_card,1,Low,1,Good Loan,0,10.65,B,2,17.47,13028.33,12000,0,390.88,409000002212,19-Jul-16,6.20E+11,,1000.00,1487577.60,Nwabugwu,741,Germany,109843.16,1,1,0
2214,2011,10,RENT,1,Low,1,23000, 36 months,1,debt_consolidation,6,High,2,Good Loan,0,13.49,C,3,22.63,28082.23786,23000,0,780.41,409000002213,19-Jul-16,NEFT/VCGBH16201473150/SUR,,21000.00,1508577.60,DeRose,498,Germany,12577.21,1,1,0
2215,2011,10,RENT,1,Low,1,14000, 36 months,1,debt_consolidation,6,Low,1,Good Loan,0,12.69,B,2,14.73,16108.41,14000,0,469.63,409000002214,19-Jul-16,NEFT/SBIN516201186588/M S,,20000.00,1528577.60,Ch'eng,850,France,179365.10,1,1,0
2216,2011,9,RENT,1,Low,1,5000, 36 months,1,debt_consolidation,6,Low,1,Good Loan,0,11.71,B,2,13.48,5951.99361,5000,0,165.38,409000002215,19-Jul-16,NEFT/SBIN516201283749/Mr,,12000.00,1540577.60,Padovesi,493,France,65816.53,1,1,0
2217,2011,2,MORTGAGE,3,Low,1,2500, 36 months,1,credit_card,1,High,2,Good Loan,0,13.49,C,3,23.67,2988.711768,2500,0,84.83,409000002216,19-Jul-16,NEFT/CBINH16201130367/Mr.,,12000.00,1552577.60,Obielumani,686,France,124170.90,1,1,0
2218,2011,3,RENT,1,Low,1,12000, 36 months,1,debt_consolidation,6,Low,1,Good Loan,0,11.71,B,2,21.42,14285.61171,12000,0,396.92,409000002217,20-Jul-16,6.20E+11,,1.00,1552578.60,Stephens,666,Spain,175015.12,1,1,0
2219,2011,6.05,MORTGAGE,3,Low,1,5000, 36 months,1,vacation,11,Low,1,Good Loan,0,6.03,A,1,7.76,5025.39,5000,0,152.18,409000002218,20-Jul-16,6.20E+11,,5000.00,1557578.60,Emery,733,Spain,115441.66,1,1,0
2220,2011,9,MORTGAGE,3,Low,1,19800, 60 months,2,major_purchase,8,Low,1,Good Loan,0,11.71,B,2,3.65,21129.3,19800,0,437.55,409000002219,20-Jul-16,6.20E+11,,5000.00,1562578.60,Dufresne,631,Germany,128247.03,1,1,0
2221,2011,10,MORTGAGE,3,Low,1,22000, 60 months,2,debt_consolidation,6,High,2,Good Loan,0,18.25,D,4,18.9,33083.57992,22000,0,561.66,409000002220,20-Jul-16,6.20E+11,,5000.00,1567578.60,Lee,714,Germany,141914.94,1,1,0
2222,2011,2,RENT,1,Low,1,15000, 36 months,1,debt_consolidation,6,High,2,Good Loan,0,13.49,C,3,16.4,17103.3,15000,0,508.96,409000002221,21-Jul-16,6.20E+11,,5000.00,1572578.60,Hsing,767,Germany,115566.57,1,1,0
2223,2011,0.5,MORTGAGE,3,Medium,2,7200, 36 months,1,debt_consolidation,6,High,2,Bad Loan,1,13.49,C,3,12.12,5618.9,4249.97,14.03,244.3,409000002222,21-Jul-16,6.20E+11,,1000.00,1573578.60,Longo,711,Germany,175423.69,1,1,0
2224,2011,2,MORTGAGE,3,Low,1,10000, 36 months,1,debt_consolidation,6,High,2,Good Loan,0,16.77,D,4,4.24,12773.7053,10000,0,355.39,409000002223,21-Jul-16,NEFT/N203160171249493/UJA,,12000.00,1585578.60,Vial,722,France,133447.49,1,1,0
2225,2011,10,RENT,1,Medium,2,8000, 36 months,1,debt_consolidation,6,High,2,Good Loan,0,16.29,D,4,3.84,10164.62704,8000,0,282.41,409000002224,21-Jul-16,6.20E+11,,5000.00,1590578.60,Chukwudi,631,Spain,114474.98,1,1,0
2226,2011,0.5,RENT,1,Low,1,4800, 36 months,1,credit_card,1,Low,1,Good Loan,0,8.9,A,1,18.29,5425.65,4800,0,152.42,409000002225,21-Jul-16,NEFT/CBINH16203A02342/PRA,,1000.00,1591578.60,Grant,701,Germany,52044.66,1,1,0
2227,2011,7,RENT,1,Low,1,5000, 36 months,1,debt_consolidation,6,Low,1,Good Loan,0,6.62,A,1,19.08,5359.6,5000,0,153.52,409000002226,21-Jul-16,6.20E+11,,2000.00,1593578.60,Ma,790,Spain,180290.68,1,1,0
2228,2011,2,RENT,1,Low,1,10000, 36 months,1,debt_consolidation,6,Low,1,Good Loan,0,12.69,B,2,7.04,12071.05815,10000,0,335.45,409000002227,22-Jul-16,NEFT/BKIDN16203950524/YUG,,20000.00,1613578.60,Sun,633,Spain,132034.13,1,1,0
2229,2011,4,RENT,1,Low,1,15000, 36 months,1,wedding,5,High,2,Good Loan,0,13.49,C,3,18.18,18312.81847,15000,0,508.96,409000002228,22-Jul-16,NEFT/SBIN616204824059/Mr,,20000.00,1633578.60,Moss,644,France,20968.88,1,1,0
2230,2011,0.5,RENT,1,Low,1,25000, 60 months,2,debt_consolidation,6,Low,1,Good Loan,0,11.71,B,2,6.76,25721.95,25000,0,552.46,409000002229,22-Jul-16,NEFT/CBINH16204A05024/SUN,,12000.00,1645578.60,Booth,757,Spain,158735.10,1,1,0
2231,2011,6,MORTGAGE,3,Low,1,25000, 60 months,2,debt_consolidation,6,Low,1,Good Loan,0,10.65,B,2,7.88,27452.89,25000,0,539.21,409000002230,22-Jul-16,6.20E+11,,1000.00,1646578.60,Ross,696,France,196134.44,1,1,0
2232,2011,10,MORTGAGE,3,Low,1,31000, 60 months,2,debt_consolidation,6,Low,1,Good Loan,0,12.42,B,2,18.31,33402.6,23173.45,0,696.18,409000002231,23-Jul-16,6.21E+11,,1000.00,1647578.60,Ndukaku,746,France,22374.97,1,1,0
2233,2011,8,MORTGAGE,3,Low,1,12000, 36 months,1,credit_card,1,Low,1,Good Loan,0,10.65,B,2,15.56,14067.95227,12000,0,390.88,409000002232,25-Jul-16,NEFT/SBIN716207496423/Mr,,10000.00,1657578.60,Pruneda,649,Spain,161668.15,1,1,0
2234,2011,6,RENT,1,Low,1,10000, 36 months,1,credit_card,1,High,2,Good Loan,0,15.96,C,3,10.25,12242.45924,10000,0,351.38,409000002233,25-Jul-16,6.21E+11,,4500.00,1662078.60,Neumann,565,Spain,67339.34,1,1,0
2235,2011,3,RENT,1,Low,1,20000, 36 months,1,debt_consolidation,6,Low,1,Good Loan,0,12.42,B,2,19.09,22833.07,20000,0,668.31,409000002234,25-Jul-16,NEFT/SBIN716207563847/Mr,,10000.00,1672078.60,Calabrese,720,France,56229.72,1,1,0
2236,2011,6,RENT,1,Low,1,20000, 36 months,1,debt_consolidation,6,High,2,Good Loan,0,14.27,C,3,9.79,24691.51582,20000,0,686.18,409000002235,25-Jul-16,6.21E+11,,1000.00,1673078.60,Yobachukwu,648,Spain,140991.23,1,1,0
2237,2011,2,RENT,1,Low,1,21000, 60 months,2,debt_consolidation,6,High,2,Bad Loan,1,20.89,F,6,6.52,8407.58,2903.76,1049.06,566.83,409000002236,25-Jul-16,6.21E+11,,1000.00,1674078.60,Tung,632,Germany,177644.52,1,1,0
2238,2011,6.05,OWN,2,Low,1,8000, 36 months,1,debt_consolidation,6,Low,1,Good Loan,0,6.03,A,1,0.57,8584.26,8000,0,243.49,409000002237,25-Jul-16,NEFT/SBIN716207739939/GOB,,6500.00,1680578.60,Marchesi,622,France,142342.55,1,1,0
2239,2011,10,MORTGAGE,3,Low,1,15500, 36 months,1,credit_card,1,High,2,Good Loan,0,14.65,C,3,17.56,16700.33,15500,0,534.66,409000002238,25-Jul-16,6.21E+11,,1000.00,1681578.60,Hess,835,France,154559.28,1,1,0
2240,2011,5,RENT,1,Low,1,5575, 36 months,1,debt_consolidation,6,Low,1,Good Loan,0,6.62,A,1,21.17,6154.855687,5575,0,171.18,409000002239,25-Jul-16,6.21E+11,,5000.00,1686578.60,Pickering,493,France,176570.28,1,1,0
2241,2011,0.5,RENT,1,Low,1,30000, 60 months,2,debt_consolidation,6,Low,1,Good Loan,0,12.42,B,2,25.27,37132.93272,30000,0,673.72,409000002240,25-Jul-16,6.21E+11,,5000.00,1691578.60,Mazzi,785,Germany,191961.83,1,1,0
2242,2011,6,MORTGAGE,3,Low,1,10000, 36 months,1,debt_consolidation,6,High,2,Bad Loan,1,14.27,C,3,23.1,1370.2,911.38,0,343.09,409000002241,26-Jul-16,NEFT/SAA209471183/PRAVEEN,,11000.00,1702578.60,Madukaego,681,Germany,9452.88,1,1,0
2243,2011,7,RENT,1,Low,1,20000, 60 months,2,debt_consolidation,6,High,2,Good Loan,0,14.65,C,3,23.94,27778.57709,20000,0,472.14,409000002242,26-Jul-16,6.21E+11,,1000.00,1703578.60,Trentino,621,Germany,165257.31,1,1,0
2244,2011,1,RENT,1,Low,1,10000, 36 months,1,debt_consolidation,6,Low,1,Good Loan,0,12.42,B,2,23.71,11635.7,10000,0,334.16,409000002243,26-Jul-16,NEFT/SAA209481181/RAJNISH,,11000.00,1714578.60,Paterson,756,Spain,169763.89,1,1,0
2245,2011,2,RENT,1,Low,1,12000, 60 months,2,debt_consolidation,6,Low,1,Good Loan,0,12.69,B,2,24.57,15685.58144,12000,0,271.14,409000002244,28-Jul-16,TRF TO  Indiaforensic SERVICES I,"1,100,000.00",,614578.60,Marchesi,515,France,160663.11,1,1,0
2246,2011,5,RENT,1,Low,1,1450, 36 months,1,debt_consolidation,6,High,2,Good Loan,0,14.27,C,3,6.95,1789.412526,1450,0,49.75,409000002245,28-Jul-16,NEFT/SBIN916210629562/MD,,21000.00,635578.60,Anayolisa,625,France,192072.10,1,1,0
2247,2011,2,MORTGAGE,3,Low,1,30000, 60 months,2,debt_consolidation,6,High,2,Good Loan,0,21.28,F,6,11.44,36820.14,30000,0,816.34,409000002246,29-Jul-16,6.21E+11,,1000.00,636578.60,Poole,717,Spain,93275.61,1,1,0
2248,2011,1,RENT,1,Low,1,12900, 60 months,2,debt_consolidation,6,High,2,Good Loan,0,18.25,D,4,21.79,16115.57,9572.79,0,329.34,409000002247,29-Jul-16,NEFT/SBIN916211962920/GOU,,5000.00,641578.60,Zhou,595,Germany,112269.67,1,1,0
2249,2011,10,MORTGAGE,3,Low,1,24000, 60 months,2,small_business,3,Low,1,Good Loan,0,11.71,B,2,16,29583.63632,24000,0,530.36,409000002248,30-Jul-16,6.21E+11,,1000.00,642578.60,Bates,539,Spain,2186.83,1,1,0
2250,2011,1,MORTGAGE,3,Low,1,2000, 36 months,1,debt_consolidation,6,High,2,Good Loan,0,14.27,C,3,6.74,2468.105267,2000,0,68.62,409000002249,30-Jul-16,NEFT/SBIN116212431058/GOU,,5000.00,647578.60,Olejuru,762,France,43075.70,1,1,0
2251,2011,10,RENT,1,Low,1,22000, 60 months,2,debt_consolidation,6,High,2,Good Loan,0,17.27,D,4,13.8,26898.51,16418.74,0,549.96,409000002250,30-Jul-16,6.21E+11,,1000.00,648578.60,Bustard,706,Spain,12368.11,1,1,0
2252,2011,9,MORTGAGE,3,Low,1,7000, 36 months,1,small_business,3,Low,1,Good Loan,0,8.9,A,1,4.1,7995.357377,7000,0,222.28,409000002251,30-Jul-16,NEFT/IBKL160730922905/MD,,10000.00,658578.60,Wade,677,Spain,42410.21,1,1,0
2253,2011,10,RENT,1,Low,1,10000, 36 months,1,debt_consolidation,6,Low,1,Good Loan,0,11.71,B,2,8.27,10703.66,10000,0,330.76,409000002252,30-Jul-16,6.21E+11,,1000.00,659578.60,Tan,733,Germany,190430.81,1,1,0
2254,2011,10,MORTGAGE,3,Low,1,25000, 60 months,2,house,12,Low,1,Good Loan,0,11.71,B,2,13.38,27086.69,19252.59,0,552.46,409000002253,1-Aug-16,6.21E+11,,10000.00,669578.60,Ngozichukwuka,684,Spain,138394.37,1,1,0
2255,2011,5,RENT,1,Low,1,7750, 36 months,1,debt_consolidation,6,High,2,Bad Loan,1,14.27,C,3,17.34,2484.52,1446.22,361.64,265.9,409000002254,2-Aug-16,NEFT/BARBH16215547124/MAN,,1000.00,670578.60,Calabrese,679,France,172501.38,1,1,0
2256,2011,9,MORTGAGE,3,Low,1,20000, 60 months,2,debt_consolidation,6,High,2,Good Loan,0,15.27,C,3,12.33,28158.7,20000,0,478.64,409000002255,3-Aug-16,6.22E+11,,1000.00,671578.60,Lane,478,Spain,197916.43,1,1,0
2257,2011,2,MORTGAGE,3,Medium,2,29100, 60 months,2,major_purchase,8,High,2,Good Loan,0,18.64,E,5,18.12,31740.07,29100,0,749.12,409000002256,3-Aug-16,6.22E+11,,1000.00,672578.60,Forbes,696,France,7035.36,1,1,0
2258,2011,2,RENT,1,Low,1,12000, 36 months,1,credit_card,1,Low,1,Good Loan,0,8.9,A,1,24.44,13564.19563,12000,0,381.04,409000002257,3-Aug-16,NEFT/BKIDN16216653709/AMR,,1000.00,673578.60,Davy,686,Spain,159676.55,1,1,0
2259,2011,2,RENT,1,Medium,2,10150, 36 months,1,credit_card,1,Low,1,Good Loan,0,7.51,A,1,8.35,11364.52311,10150,0,315.78,409000002258,3-Aug-16,6.22E+11,,1000.00,674578.60,Ma,466,France,80603.99,1,1,0
2260,2011,8,RENT,1,Low,1,3800, 36 months,1,debt_consolidation,6,High,2,Good Loan,0,13.49,C,3,6.23,4638.920419,3800,0,128.94,409000002259,3-Aug-16,6.22E+11,,1000.00,675578.60,Barrera,686,France,187599.80,1,1,0
2261,2011,10,MORTGAGE,3,Low,1,10000, 36 months,1,major_purchase,8,Low,1,Good Loan,0,6.03,A,1,19.4,10956.31633,10000,0,304.36,409000002260,3-Aug-16,NEFT/SBIN516216068416/KUN,,12000.00,687578.60,Alexander,576,France,94450.97,1,1,0
2262,2011,0.5,RENT,1,Low,1,7000, 36 months,1,debt_consolidation,6,Low,1,Good Loan,0,11.71,B,2,4.88,8189.72,7000,0,231.54,409000002261,3-Aug-16,6.22E+11,,1000.00,688578.60,Ngozichukwuka,763,Germany,143981.27,1,1,0
2263,2011,6.05,MORTGAGE,3,Low,1,15000, 36 months,1,small_business,3,Low,1,Good Loan,0,6.03,A,1,0.75,16287.38,15000,0,456.54,409000002262,3-Aug-16,6.22E+11,,1000.00,689578.60,Murray,572,France,26450.57,1,1,0
2264,2011,7,RENT,1,Medium,2,10000, 36 months,1,car,2,High,2,Good Loan,0,13.49,C,3,16.91,12199.84994,10000,0,339.31,409000002263,3-Aug-16,6.22E+11,,1000.00,690578.60,Hall,757,France,164482.92,1,1,0
2265,2011,2,RENT,1,Low,1,22000, 60 months,2,debt_consolidation,6,Low,1,Good Loan,0,11.71,B,2,17.21,26295.06,19492.95,0,486.16,409000002264,3-Aug-16,6.22E+11,,1000.00,691578.60,Padovesi,582,France,84012.81,1,1,0
2266,2011,4,RENT,1,Low,1,18825, 60 months,2,debt_consolidation,6,High,2,Bad Loan,1,22.06,F,6,22.42,16889.86,6376.72,1793.33,520.57,409000002265,3-Aug-16,6.22E+11,,1000.00,692578.60,Lysaght,623,France,101192.08,1,1,0
2267,2011,2,RENT,1,Low,1,10000, 36 months,1,debt_consolidation,6,Low,1,Bad Loan,1,7.51,A,1,19.56,7777.75,6672.99,16.75,311.11,409000002266,3-Aug-16,6.22E+11,,1000.00,693578.60,Kelechi,617,Germany,175324.74,1,1,0
2268,2011,1,RENT,1,Low,1,20000, 60 months,2,debt_consolidation,6,High,2,Good Loan,0,17.27,D,4,8.7,23233.8,20000,0,499.96,409000002267,4-Aug-16,6.22E+11,,1000.00,694578.60,Nebechi,425,France,197226.32,1,1,0
2269,2011,7,RENT,1,Low,1,8000, 36 months,1,debt_consolidation,6,High,2,Good Loan,0,14.65,C,3,3.94,9931.971753,8000,0,275.96,409000002268,4-Aug-16,NEFT/BKIDN16217771228/GAY,,11000.00,705578.60,Hanson,659,France,99504.03,1,1,0
2270,2011,10,RENT,1,Low,1,12000, 36 months,1,debt_consolidation,6,Low,1,Good Loan,0,12.42,B,2,13.57,14287.38991,12000,0,400.99,409000002269,5-Aug-16,NEFT/PUNBH16218531092/ASH,,1000.00,706578.60,Kao,605,France,83700.66,1,1,0
2271,2011,0.5,RENT,1,Low,1,20450, 60 months,2,debt_consolidation,6,High,2,Bad Loan,1,18.64,E,5,23.14,8359.47,3228.86,999.74,526.45,409000002270,5-Aug-16,6.22E+11,,1000.00,707578.60,Tu,538,France,28226.15,1,1,0
2272,2011,3,MORTGAGE,3,Low,1,12000, 36 months,1,credit_card,1,High,2,Bad Loan,1,14.27,C,3,19.77,2031.94,963.05,385.5,411.71,409000002271,6-Aug-16,6.22E+11,,1000.00,708578.60,Palerma,665,Germany,35321.65,1,1,0
2273,2011,6.05,MORTGAGE,3,Low,1,7000, 60 months,2,debt_consolidation,6,Low,1,Good Loan,0,12.42,B,2,19.79,7694.19,5368.51,0,157.21,409000002272,6-Aug-16,6.22E+11,,1000.00,709578.60,Fallaci,491,Germany,41229.73,1,1,0
2274,2011,4,MORTGAGE,3,Medium,2,24000, 60 months,2,debt_consolidation,6,Low,1,Good Loan,0,12.69,B,2,5.2,26511.76,18361.84,0,542.28,409000002273,8-Aug-16,NEFT/CBINH16221A01703/PRA,,11000.00,720578.60,Shen,726,Spain,78970.58,1,1,0
2275,2011,3,RENT,1,Medium,2,24000, 60 months,2,debt_consolidation,6,High,2,Good Loan,0,17.58,D,4,5.14,29527.63,17873.47,0,603.98,409000002274,8-Aug-16,NEFT/SBIN916221237880/Mr,,11000.00,731578.60,Ts'ui,580,France,107890.69,1,1,0
2276,2011,2,RENT,1,Low,1,7000, 36 months,1,debt_consolidation,6,Low,1,Bad Loan,1,10.65,B,2,21.06,1097.26,495.88,227.3,228.02,409000002275,10-Aug-16,NEFT/BKIDN16223186111/RAK,,11000.00,742578.60,Chikezie,550,France,191870.28,1,1,0
2277,2011,10,MORTGAGE,3,Low,1,17500, 36 months,1,credit_card,1,Low,1,Good Loan,0,10.65,B,2,18.93,20249.93,17500,0,570.04,409000002276,10-Aug-16,NEFT/CBINH16223132289/Mr.,,1000.00,743578.60,He,542,France,7905.06,1,1,0
2278,2011,10,OWN,2,Low,1,6400, 36 months,1,credit_card,1,Low,1,Good Loan,0,7.51,A,1,24.33,7166.237336,6400,0,199.11,409000002277,10-Aug-16,6.22E+11,,1000.00,744578.60,Dreyer,732,France,65731.53,1,1,0
2279,2011,0.5,RENT,1,Low,1,15000, 60 months,2,debt_consolidation,6,High,2,Good Loan,0,17.27,D,4,22.16,18340.18,11180.9,0,374.97,409000002278,10-Aug-16,6.22E+11,,5000.00,749578.60,Short,473,France,145698.73,1,1,0
2280,2011,3,RENT,1,Low,1,13000, 36 months,1,debt_consolidation,6,Low,1,Good Loan,0,7.9,A,1,10.87,14642.51798,13000,0,406.78,409000002279,10-Aug-16,6.22E+11,,5000.00,754578.60,Hunt,745,Spain,50046.25,1,1,0
2281,2011,9,MORTGAGE,3,Low,1,18000, 60 months,2,debt_consolidation,6,High,2,Good Loan,0,15.96,C,3,13.89,21387.83,13531.85,0,437.35,409000002280,10-Aug-16,6.22E+11,,2000.00,756578.60,Ricci,732,France,60830.24,1,1,0
2282,2011,2,RENT,1,Low,1,8000, 36 months,1,small_business,3,Low,1,Good Loan,0,6.62,A,1,11.8,8640.88,8000,0,245.63,409000002281,11-Aug-16,6.22E+11,,1000.00,757578.60,Teng,848,Germany,158853.98,1,1,0
2283,2011,9,MORTGAGE,3,Low,1,7800, 36 months,1,debt_consolidation,6,Low,1,Good Loan,0,10.65,B,2,7.15,7937.01,7800,0,254.08,409000002282,11-Aug-16,NEFT/SBIN316224151904/RAM,,1000.00,758578.60,Ijendu,572,France,111243.09,1,1,0
2284,2011,5,RENT,1,Low,1,15000, 36 months,1,debt_consolidation,6,High,2,Good Loan,0,14.27,C,3,22.03,18355.00567,15000,0,514.64,409000002283,12-Aug-16,6.23E+11,,1000.00,759578.60,Kibby,702,France,171014.69,1,1,0
2285,2011,10,OWN,2,Low,1,23600, 60 months,2,debt_consolidation,6,High,2,Good Loan,0,18.64,E,5,24.36,29754.38,17493.55,0,607.54,409000002284,12-Aug-16,NEFT/P16081210064975/ANIL,,1000.00,760578.60,Obiuto,664,Germany,170835.32,1,1,0
2286,2011,4,RENT,1,Low,1,15000, 36 months,1,debt_consolidation,6,Low,1,Good Loan,0,12.42,B,2,15.74,17691.10787,15000,0,501.23,409000002285,12-Aug-16,6.23E+11,,1000.00,761578.60,Ramos,630,Germany,47775.34,1,1,0
2287,2011,10,RENT,1,Low,1,24000, 60 months,2,wedding,5,High,2,Bad Loan,1,18.25,D,4,18.35,9735.17,3819.41,1157.55,612.72,409000002286,12-Aug-16,6.23E+11,,1000.00,762578.60,Calabrese,618,Germany,139297.71,1,1,0
2288,2011,10,RENT,1,Low,1,23500, 60 months,2,debt_consolidation,6,Low,1,Good Loan,0,12.69,B,2,16.05,31377.93002,23500,0,530.98,409000002287,12-Aug-16,6.23E+11,,1000.00,763578.60,Vasin,556,France,195167.38,1,1,0
2289,2011,4,MORTGAGE,3,Low,1,35000, 60 months,2,debt_consolidation,6,High,2,Good Loan,0,21.67,F,6,19.9,44331.83,35000,0,960.11,409000002288,12-Aug-16,6.23E+11,,1000.00,764578.60,Munro,619,France,160948.87,1,1,0
2290,2011,4,RENT,1,Low,1,2100, 36 months,1,other,4,High,2,Good Loan,0,17.27,D,4,6.49,2704.787211,2100,0,75.16,409000002289,12-Aug-16,6.23E+11,,1000.00,765578.60,Keeley,644,France,44965.54,1,1,0
2291,2011,10,RENT,1,Low,1,16600, 60 months,2,debt_consolidation,6,High,2,Good Loan,0,15.96,C,3,13.17,20507.03,16600,0,403.33,409000002290,12-Aug-16,6.23E+11,,1000.00,766578.60,Archer,658,Spain,52137.73,1,1,0
2292,2011,3,RENT,1,Medium,2,18000, 60 months,2,debt_consolidation,6,High,2,Good Loan,0,15.96,C,3,14.64,20052.63,18000,0,437.35,409000002291,13-Aug-16,6.23E+11,,1000.00,767578.60,Murray,598,Spain,109296.18,1,1,0
2293,2011,5,OWN,2,Low,1,16000, 36 months,1,credit_card,1,High,2,Good Loan,0,14.27,C,3,18.62,18928.97,16000,0,548.95,409000002292,13-Aug-16,6.23E+11,,1000.00,768578.60,Chidiegwu,677,France,20092.89,1,1,0
2294,2011,10,MORTGAGE,3,Low,1,12000, 36 months,1,credit_card,1,Low,1,Good Loan,0,12.42,B,2,13.25,13963.11,12000,0,400.99,409000002293,13-Aug-16,6.23E+11,,1000.00,769578.60,Tang,689,Spain,197804.00,1,1,0
2295,2011,10,MORTGAGE,3,Low,1,18000, 60 months,2,debt_consolidation,6,High,2,Bad Loan,1,19.03,E,5,17.57,8209.47,3569.63,0,467.23,409000002294,17-Aug-16,6.23E+11,,5000.00,774578.60,Farrar,591,France,118782.06,1,1,0
2296,2011,0.5,RENT,1,Low,1,10800, 36 months,1,credit_card,1,High,2,Good Loan,0,13.49,C,3,23.71,13187.34159,10800,0,366.45,409000002295,17-Aug-16,6.23E+11,,5000.00,779578.60,Shaw,699,France,152876.13,1,1,0
2297,2011,10,RENT,1,Low,1,15000, 36 months,1,debt_consolidation,6,Low,1,Good Loan,0,12.42,B,2,17.21,17816.23391,15000,0,501.23,409000002296,18-Aug-16,NEFT/CBINH16231A00772/SON,,1000.00,780578.60,Napolitani,749,Germany,135655.29,1,1,0
2298,2011,10,MORTGAGE,3,Low,1,7100, 36 months,1,home_improvement,7,High,2,Good Loan,0,15.27,C,3,16.08,8620.8,7100,0,247.07,409000002297,18-Aug-16,6.23E+11,,1000.00,781578.60,Greenhalgh,709,France,103970.58,1,1,0
2299,2011,6,RENT,1,Low,1,10000, 36 months,1,debt_consolidation,6,Low,1,Good Loan,0,9.91,B,2,20.05,11559.28166,10000,0,322.25,409000002298,19-Aug-16,6.23E+11,,1000.00,782578.60,Martin,607,Germany,35786.76,1,1,0
2300,2011,5,RENT,1,Low,1,6000, 36 months,1,debt_consolidation,6,Low,1,Good Loan,0,12.69,B,2,19.91,7243.085388,6000,0,201.27,409000002299,19-Aug-16,6.23E+11,,1000.00,783578.60,Hu,650,Germany,25325.07,1,1,0
2301,2011,10,RENT,1,Low,1,10400, 36 months,1,debt_consolidation,6,High,2,Good Loan,0,16.29,D,4,24.57,13228.08931,10400,0,367.13,409000002300,20-Aug-16,6.23E+11,,1000.00,784578.60,Y?an,651,Spain,18732.84,1,1,0
2302,2011,3,MORTGAGE,3,Low,1,2000, 36 months,1,other,4,Low,1,Good Loan,0,12.42,B,2,20.79,2345.925484,2000,0,66.84,409000002301,20-Aug-16,6.23E+11,,1000.00,785578.60,Odili,676,France,118522.73,1,1,0
2303,2011,4,MORTGAGE,3,Low,1,8000, 36 months,1,debt_consolidation,6,High,2,Good Loan,0,16.29,D,4,17.52,10108.98518,8000,0,282.41,409000002302,20-Aug-16,NEFT/CBINH16233A06107/SON,,10000.00,795578.60,H?,723,France,89972.25,1,1,0
2304,2011,10,RENT,1,Low,1,10000, 36 months,1,debt_consolidation,6,High,2,Good Loan,0,14.27,C,3,11.67,11675.48,10000,0,343.09,409000002303,20-Aug-16,6.23E+11,,1000.00,796578.60,Chiemela,714,Spain,187194.15,1,1,0
2305,2011,10,RENT,1,Low,1,12000, 36 months,1,credit_card,1,Low,1,Good Loan,0,11.71,B,2,17.99,14284.08921,12000,0,396.92,409000002304,20-Aug-16,6.23E+11,,1000.00,797578.60,Yuan,759,Spain,106785.70,1,1,0
2306,2011,7,MORTGAGE,3,Low,1,16000, 60 months,2,debt_consolidation,6,High,2,Good Loan,0,15.96,C,3,20.52,18998.14,12019.39,0,388.75,409000002305,21-Aug-16,6.23E+11,,1000.00,798578.60,Clements,582,France,142516.35,1,1,0
2307,2011,6,RENT,1,Medium,2,35000, 36 months,1,debt_consolidation,6,High,2,Good Loan,0,19.03,E,5,4.18,46192.24011,35000,0,1283.5,409000002306,22-Aug-16,6.24E+11,,1000.00,799578.60,Kolesnikov,697,France,73334.43,1,1,0
2308,2011,2,RENT,1,Low,1,4500, 36 months,1,wedding,5,Low,1,Good Loan,0,6.62,A,1,25.17,4803.71,4500,0,138.17,409000002307,23-Aug-16,NEFT/SBIN816236506566/SUD,,1000.00,800578.60,Rutherford,610,Germany,186612.47,1,1,0
2309,2011,5,RENT,1,Low,1,12000, 60 months,2,credit_card,1,High,2,Good Loan,0,19.03,E,5,17.16,16816.14552,12000,0,311.49,409000002308,24-Aug-16,NEFT/SBIN816237956149/ANK,,7000.00,807578.60,Hsiung,488,Germany,123613.81,1,1,0
2310,2011,10,MORTGAGE,3,Medium,2,20000, 36 months,1,medical,9,Low,1,Good Loan,0,7.9,A,1,5.22,22526.52653,20000,0,625.81,409000002309,24-Aug-16,NEFT/CBINH16237A06113/DHA,,12000.00,819578.60,Angelo,599,Germany,31368.08,1,1,0
2311,2011,4,RENT,1,Low,1,10000, 36 months,1,debt_consolidation,6,Low,1,Good Loan,0,10.65,B,2,19.28,11571.15,10000,0,325.74,409000002310,24-Aug-16,6.24E+11,,1000.00,820578.60,Mendes,781,France,40066.95,1,1,0
2312,2011,10,MORTGAGE,3,Low,1,20000, 60 months,2,debt_consolidation,6,High,2,Good Loan,0,19.42,E,5,16.2,29175.12313,20000,0,523.45,409000002311,24-Aug-16,NEFT/CBINH16237A06186/SON,,1000.00,821578.60,McGregor,645,France,175969.19,1,1,0
2313,2011,2,RENT,1,Low,1,28000, 60 months,2,debt_consolidation,6,High,2,Good Loan,0,20.89,F,6,18.77,37004.13,20481.1,0,755.77,409000002312,25-Aug-16,6.24E+11,,1000.00,822578.60,Bronner,545,France,10034.77,1,1,0
2314,2011,10,MORTGAGE,3,Low,1,4000, 36 months,1,debt_consolidation,6,Low,1,Good Loan,0,10.65,B,2,9.57,4503.06,4000,0,130.3,409000002313,25-Aug-16,NEFT/SBIN916238278625/FIR,,10000.00,832578.60,Mironova,597,Germany,151167.94,1,1,0
2315,2011,4,RENT,1,Low,1,12000, 36 months,1,debt_consolidation,6,Low,1,Good Loan,0,6.03,A,1,11.68,13147.47714,12000,0,365.23,409000002314,25-Aug-16,NEFT/SBIN916238291478/Mr,,21000.00,853578.60,Ku,561,Spain,191387.76,1,1,0
2316,2011,4,RENT,1,Low,1,12000, 36 months,1,debt_consolidation,6,High,2,Good Loan,0,16.77,D,4,6.22,14216.56,12000,0,426.47,409000002315,28-Aug-16,6.24E+11,,1000.00,854578.60,Evans,662,France,51229.17,1,1,0
2317,2011,1,MORTGAGE,3,Medium,2,20000, 36 months,1,credit_card,1,High,2,Good Loan,0,13.49,C,3,10.54,24212.09531,20000,0,678.61,409000002316,29-Aug-16,NEFT/BKIDN16242200003/PRA,,12000.00,866578.60,Henderson,649,Germany,87351.42,1,1,0
2318,2011,2,RENT,1,Low,1,8000, 36 months,1,debt_consolidation,6,Low,1,Good Loan,0,7.9,A,1,6.4,8965.336134,8000,0,250.33,409000002317,30-Aug-16,NEFT/SBIN216243251832/DHA,,20000.00,886578.60,Smith,630,France,48984.95,1,1,0
2319,2011,3,RENT,1,Medium,2,35000, 60 months,2,credit_card,1,High,2,Good Loan,0,18.64,E,5,12,43223.26,25193.37,0,901.01,409000002318,30-Aug-16,NEFT/SBIN216243317496/ASH,,20000.00,906578.60,Russell,672,Spain,182738.00,1,1,0
2320,2011,3,MORTGAGE,3,Medium,2,20000, 36 months,1,debt_consolidation,6,Low,1,Good Loan,0,11.71,B,2,17.33,23793.40491,20000,0,661.52,409000002319,31-Aug-16,NEFT/N244160182458867/SMA,,12000.00,918578.60,Sun,636,Germany,153535.27,1,1,0
2321,2011,7,RENT,1,Low,1,20000, 36 months,1,debt_consolidation,6,Low,1,Good Loan,0,12.42,B,2,20.06,24053.54154,20000,0,668.31,409000002320,1-Sep-16,NEFT/CBINH16245A00904/HAR,,1000.00,919578.60,McDonald,593,Germany,125079.65,1,1,0
2322,2011,3,MORTGAGE,3,Low,1,3500, 36 months,1,home_improvement,7,Low,1,Good Loan,0,7.9,A,1,8.1,3721.3,3500,0,109.52,409000002321,1-Sep-16,NEFT/CBINH16245A00945/RAJ,,1000.00,920578.60,Wong,545,Germany,162321.26,1,1,0
2323,2011,4,OWN,2,Low,1,5000, 36 months,1,wedding,5,High,2,Bad Loan,1,13.49,C,3,14.33,1429.8,763.95,243.21,169.66,409000002322,1-Sep-16,NEFT/SBIN516245435372/ROH,,20000.00,940578.60,Niu,567,Spain,3414.72,1,1,0
2324,2011,4,RENT,1,Low,1,1300, 36 months,1,moving,10,High,2,Bad Loan,1,14.27,C,3,7.8,796.46,541.96,43.19,44.61,409000002323,2-Sep-16,6.25E+11,,5000.00,945578.60,Fanucci,583,France,165082.25,1,1,0
2325,2011,4,RENT,1,Low,1,7500, 36 months,1,credit_card,1,High,2,Good Loan,0,15.27,C,3,6.51,9391.220184,7500,0,260.99,409000002324,2-Sep-16,6.25E+11,,5000.00,950578.60,Zetticci,681,France,52021.39,1,1,0
2326,2011,10,MORTGAGE,3,Medium,2,7800, 36 months,1,medical,9,Low,1,Good Loan,0,8.9,A,1,17.39,8313.14,7800,0,247.68,409000002325,2-Sep-16,6.25E+11,,2000.00,952578.60,Hsia,762,Spain,148256.43,1,1,0
2327,2011,6,RENT,1,Low,1,6925, 36 months,1,debt_consolidation,6,Low,1,Good Loan,0,11.71,B,2,21.74,8243.730679,6925,0,229.06,409000002326,3-Sep-16,NEFT/CBINH16247A05058/SEE,,1000.00,953578.60,McIntosh,648,Spain,122899.01,1,1,0
2328,2011,10,OWN,2,Low,1,12800, 36 months,1,credit_card,1,High,2,Good Loan,0,13.49,C,3,18.43,15324.33,12800,0,434.31,409000002327,5-Sep-16,NEFT/UTBIN16249526895/MUN,,1000.00,954578.60,Kozlova,644,France,10771.46,1,1,0
2329,2011,10,RENT,1,Low,1,15000, 36 months,1,debt_consolidation,6,High,2,Bad Loan,1,15.27,C,3,18.63,4371.72,2404.31,723.6,521.97,409000002328,5-Sep-16,NEFT/SBIN816249307265/NAR,,12000.00,966578.60,Meany,706,Spain,18255.51,1,1,0
2330,2011,6,MORTGAGE,3,Low,1,8000, 36 months,1,debt_consolidation,6,Low,1,Good Loan,0,12.69,B,2,7.44,9657.240704,8000,0,268.36,409000002329,7-Sep-16,NEFT/SBIN916251519257/SHU,,21000.00,987578.60,Thompson,850,France,183566.78,1,1,0
2331,2011,5,RENT,1,Low,1,5375, 36 months,1,credit_card,1,Low,1,Good Loan,0,12.69,B,2,17,6488.960959,5375,0,180.31,409000002330,8-Sep-16,NEFT/CBINH16252A09706/ANI,,1000.00,988578.60,Le Gallienne,484,Spain,175224.12,1,1,0
2332,2011,0.5,RENT,1,Low,1,2500, 36 months,1,credit_card,1,Low,1,Good Loan,0,12.69,B,2,13.5,3016.666582,2500,0,83.87,409000002331,8-Sep-16,NEFT/BKIDN16252820852/SAN,,12000.00,1000578.60,Cheng,508,Germany,147913.56,1,1,0
2333,2011,1,RENT,1,Low,1,17625, 36 months,1,debt_consolidation,6,Low,1,Good Loan,0,8.9,A,1,24.67,19922.81,17625,0,559.66,409000002332,8-Sep-16,NEFT/CBINH16252A09655/MAN,,1000.00,1001578.60,P'eng,439,France,180598.66,1,1,0
2334,2011,10,MORTGAGE,3,Low,1,6000, 36 months,1,other,4,High,2,Bad Loan,1,15.27,C,3,23.38,2914.94,2010.01,0,208.79,409000002333,8-Sep-16,NEFT/N252160186060982/PAR,,12000.00,1013578.60,Lloyd,484,Spain,186136.48,1,1,0
2335,2011,0.5,OWN,2,Low,1,7100, 36 months,1,debt_consolidation,6,Low,1,Good Loan,0,12.42,B,2,17.65,8472.658253,7100,0,237.25,409000002334,9-Sep-16,NEFT/SBIN216253660797/RAN,,12000.00,1025578.60,Wheeler,803,Spain,7455.20,1,1,0
2336,2011,10,RENT,1,Medium,2,20000, 60 months,2,debt_consolidation,6,High,2,Good Loan,0,16.77,D,4,5.5,24170.74,14951.75,0,494.59,409000002335,9-Sep-16,6.25E+11,,20000.00,1045578.60,Christie,724,Germany,80552.11,1,1,0
2337,2011,2,MORTGAGE,3,Low,1,2800, 36 months,1,medical,9,Low,1,Good Loan,0,10.65,B,2,18.83,3282.239063,2800,0,91.21,409000002336,9-Sep-16,NEFT/VIJBH16253024948/ANI,,1000.00,1046578.60,He,640,France,25722.28,1,1,0
2338,2011,3,MORTGAGE,3,Medium,2,14000, 60 months,2,credit_card,1,High,2,Good Loan,0,20.89,F,6,20.04,17789.03,14000,0,377.89,409000002337,9-Sep-16,NEFT/BKIDN16253896956/OM,,21000.00,1067578.60,King,701,Spain,170996.86,1,1,0
2339,2011,4,RENT,1,Low,1,12000, 36 months,1,credit_card,1,Low,1,Good Loan,0,7.51,A,1,19.05,13438.03829,12000,0,373.33,409000002338,9-Sep-16,NEFT/SBIN316253200646/ARB,,12000.00,1079578.60,Favors,537,France,20603.32,1,1,0
2340,2011,3,RENT,1,Low,1,6625, 36 months,1,credit_card,1,Low,1,Bad Loan,1,12.69,B,2,21.55,2439.91,1761.95,0,222.24,409000002339,10-Sep-16,6.25E+11,,1000.00,1080578.60,Vida,651,Germany,141763.26,1,1,0
2341,2011,7,MORTGAGE,3,Low,1,14675, 36 months,1,debt_consolidation,6,Low,1,Good Loan,0,12.69,B,2,16.95,15812.67,14675,0,492.28,409000002340,10-Sep-16,6.25E+11,,1000.00,1081578.60,Thomas,523,Germany,122284.38,1,1,0
2342,2011,7,RENT,1,Low,1,15000, 36 months,1,debt_consolidation,6,Low,1,Good Loan,0,11.71,B,2,15.97,17856.08583,15000,0,496.14,409000002341,10-Sep-16,6.25E+11,,1000.00,1082578.60,Wayn,717,France,190011.85,1,1,0
2343,2011,3,RENT,1,Low,1,12000, 36 months,1,debt_consolidation,6,Low,1,Good Loan,0,7.9,A,1,11.09,13515.84641,12000,0,375.49,409000002342,12-Sep-16,NEFT/CBINH16256A05985/VIK,,1000.00,1083578.60,Tan,593,Spain,128046.98,1,1,0
2344,2011,8,RENT,1,Low,1,13000, 36 months,1,credit_card,1,Low,1,Good Loan,0,8.9,A,1,25.12,14859.02234,13000,0,412.8,409000002343,12-Sep-16,NEFT/SAA77688970/AGRADUT,,12000.00,1095578.60,Gibson,706,Germany,135662.17,1,1,0
2345,2011,10,RENT,1,Low,1,12000, 36 months,1,credit_card,1,Low,1,Good Loan,0,10.65,B,2,16.87,13973.68998,12000,0,390.88,409000002344,13-Sep-16,6.26E+11,,1000.00,1096578.60,Y?,714,Germany,7571.51,1,1,0
2346,2011,10,RENT,1,Low,1,10000, 36 months,1,credit_card,1,High,2,Good Loan,0,16.29,D,4,5.76,12705.91637,10000,0,353.01,409000002345,14-Sep-16,6.26E+11,,1000.00,1097578.60,Calabresi,794,Spain,23596.24,1,1,0
2347,2011,10,RENT,1,Low,1,11550, 36 months,1,credit_card,1,High,2,Good Loan,0,16.77,D,4,10.65,12958.61,11550,0,410.47,409000002346,14-Sep-16,6.26E+11,,1000.00,1098578.60,Enyinnaya,518,Germany,92727.42,1,1,0
2348,2011,4,OWN,2,Low,1,6000, 36 months,1,home_improvement,7,Low,1,Good Loan,0,8.9,A,1,8.32,6857.415633,6000,0,190.52,409000002347,14-Sep-16,NEFT/SBIN516258102528/Mr,,1000.00,1099578.60,Ritchie,589,Germany,65156.83,1,1,0
2349,2011,6,MORTGAGE,3,High,3,35000, 60 months,2,debt_consolidation,6,High,2,Good Loan,0,18.64,E,5,6.17,44120.63,25940.48,0,901.01,409000002348,14-Sep-16,6.26E+11,,1000.00,1100578.60,Chia,824,France,60151.77,1,1,0
2350,2011,10,RENT,1,Medium,2,9000, 36 months,1,debt_consolidation,6,High,2,Good Loan,0,16.77,D,4,9.94,11496.37242,9000,0,319.85,409000002349,15-Sep-16,6.26E+11,,1000.00,1101578.60,Wang,719,Germany,149097.38,1,1,0
2351,2011,1,RENT,1,Low,1,12000, 60 months,2,debt_consolidation,6,High,2,Good Loan,0,14.65,C,3,22.18,15748.24629,12000,0,283.28,409000002350,15-Sep-16,NEFT/SBIN616259043936/Mr,,12000.00,1113578.60,Lorenzo,617,Germany,35199.24,1,1,0
2352,2011,8,MORTGAGE,3,Low,1,28000, 36 months,1,debt_consolidation,6,Low,1,Good Loan,0,7.9,A,1,4.77,31538.82955,28000,0,876.13,409000002351,16-Sep-16,6.26E+11,,1000.00,1114578.60,Pai,651,France,129451.29,1,1,0
2353,2011,4,MORTGAGE,3,Low,1,17400, 60 months,2,debt_consolidation,6,High,2,Bad Loan,1,14.65,C,3,11.25,14785.02,8898.28,0,410.76,409000002352,16-Sep-16,6.26E+11,,1000.00,1115578.60,Nuttall,637,Spain,145134.49,1,1,0
2354,2011,10,MORTGAGE,3,Low,1,13000, 36 months,1,credit_card,1,Low,1,Good Loan,0,6.03,A,1,5.34,14188.33906,13000,0,395.67,409000002353,17-Sep-16,6.26E+11,,1000.00,1116578.60,Osborne,554,France,192709.69,1,1,0
2355,2011,5,OWN,2,Low,1,14000, 60 months,2,debt_consolidation,6,High,2,Good Loan,0,13.49,C,3,19.44,15766.61,10676.57,0,322.07,409000002354,18-Sep-16,6.26E+11,,1000.00,1117578.60,Ferri,731,Germany,139083.70,1,1,0
2356,2011,5,RENT,1,Low,1,17000, 36 months,1,debt_consolidation,6,High,2,Good Loan,0,13.49,C,3,15.73,18221.11,17000,0,576.82,409000002355,18-Sep-16,6.26E+11,,1000.00,1118578.60,Hamilton,569,Spain,83629.60,1,1,0
2357,2011,4,RENT,1,Low,1,6000, 36 months,1,debt_consolidation,6,High,2,Good Loan,0,14.65,C,3,15.68,7466.99954,6000,0,206.97,409000002356,18-Sep-16,6.26E+11,,1000.00,1119578.60,McEwan,625,Germany,35625.41,1,1,0
2358,2011,0.5,RENT,1,Low,1,20000, 36 months,1,credit_card,1,Low,1,Good Loan,0,10.65,B,2,6.72,23449.986,20000,0,651.47,409000002357,18-Sep-16,6.26E+11,,1000.00,1120578.60,Lai,592,France,35338.96,1,1,0
2359,2011,5,MORTGAGE,3,Low,1,1100, 36 months,1,vacation,11,High,2,Bad Loan,1,14.65,C,3,12.2,151.48,99.68,0,37.95,409000002358,19-Sep-16,NEFT/BKIDN16263432048/CHA,,1000.00,1121578.60,Hs?,669,France,15602.80,1,1,0
2360,2011,4,RENT,1,Low,1,10000, 36 months,1,wedding,5,Low,1,Good Loan,0,7.9,A,1,7.5,10480.29,10000,0,312.91,409000002359,19-Sep-16,NEFT/CBINH16263A03570/ARU,,1000.00,1122578.60,Thompson,663,Germany,182355.21,1,1,0
2361,2011,5,RENT,1,Low,1,7000, 36 months,1,debt_consolidation,6,Low,1,Good Loan,0,9.91,B,2,8.64,8118.709345,7000,0,225.58,409000002360,19-Sep-16,6.26E+11,,1000.00,1123578.60,Boyd,518,Germany,89327.67,1,1,0
2362,2011,2,MORTGAGE,3,Low,1,14000, 36 months,1,debt_consolidation,6,Low,1,Good Loan,0,10.65,B,2,17.39,16201.53,14000,0,456.03,409000002361,19-Sep-16,NEFT/SBIN716263669458/PRA,,11000.00,1134578.60,Trevisani,686,Germany,151903.60,1,1,0
2363,2011,10,MORTGAGE,3,Low,1,5000, 36 months,1,debt_consolidation,6,Low,1,Good Loan,0,6.62,A,1,13.91,5525.397377,5000,0,153.52,409000002362,20-Sep-16,NEFT/SBIN716264903035/S K,,1000.00,1135578.60,Lucciano,709,Germany,11.58,1,1,0
2364,2011,4,MORTGAGE,3,Low,1,8500, 36 months,1,credit_card,1,Low,1,Good Loan,0,6.62,A,1,17.21,9393.059394,8500,0,260.99,409000002363,20-Sep-16,6.26E+11,,1000.00,1136578.60,Holman,571,France,77519.62,1,1,0
2365,2011,5,MORTGAGE,3,Low,1,19750, 60 months,2,debt_consolidation,6,High,2,Good Loan,0,16.77,D,4,14.29,23705.71,19750,0,488.4,409000002364,21-Sep-16,NEFT/SBIN816265561545/NIT,,21000.00,1157578.60,Bazhenov,707,France,91423.69,1,1,0
2366,2011,6,MORTGAGE,3,Low,1,21000, 36 months,1,other,4,Low,1,Good Loan,0,10.65,B,2,2.06,24015.1,21000,0,684.04,409000002365,21-Sep-16,6.27E+11,,1000.00,1158578.60,Douglas,701,Germany,106287.77,1,1,0
2367,2011,6,OWN,2,Low,1,15000, 60 months,2,credit_card,1,High,2,Bad Loan,1,18.64,E,5,13.34,6561.47,2943,20.55,386.15,409000002366,22-Sep-16,6.27E+11,,1000.00,1159578.60,Hill,672,France,161800.77,1,1,0
2368,2011,6,RENT,1,Low,1,12000, 36 months,1,credit_card,1,Low,1,Good Loan,0,6.62,A,1,18.57,13259.5216,12000,0,368.45,409000002367,22-Sep-16,6.27E+11,,1000.00,1160578.60,Lo,620,Germany,80582.34,1,1,0
2369,2011,7,MORTGAGE,3,Medium,2,9000, 36 months,1,debt_consolidation,6,Low,1,Good Loan,0,7.51,A,1,9.16,10077.53421,9000,0,280,409000002368,22-Sep-16,6.27E+11,,1000.00,1161578.60,Forbes,557,Spain,185094.48,1,1,0
2370,2011,10,RENT,1,Medium,2,18000, 36 months,1,debt_consolidation,6,High,2,Good Loan,0,18.64,E,5,11.95,23674.2604,18000,0,656.54,409000002369,22-Sep-16,NEFT/UTBIN16266467185/MUN,,11000.00,1172578.60,Lin,648,Spain,172586.89,1,1,0
2371,2011,6,MORTGAGE,3,High,3,10000, 36 months,1,debt_consolidation,6,High,2,Good Loan,0,14.27,C,3,5.65,12346.34252,10000,0,343.09,409000002370,23-Sep-16,6.27E+11,,1000.00,1173578.60,Sinclair,479,France,195649.79,1,1,0
2372,2011,10,MORTGAGE,3,Low,1,7000, 36 months,1,debt_consolidation,6,Low,1,Good Loan,0,8.9,A,1,12.45,8000.373441,7000,0,222.28,409000002371,23-Sep-16,6.27E+11,,1000.00,1174578.60,Kemp,730,France,145792.01,1,1,0
2373,2011,10,RENT,1,Low,1,8000, 36 months,1,credit_card,1,High,2,Good Loan,0,16.29,D,4,14.57,10164.90558,8000,0,282.41,409000002372,24-Sep-16,6.27E+11,,1000.00,1175578.60,Ebelegbulam,737,Germany,138510.01,1,1,0
2374,2011,10,RENT,1,Low,1,26000, 60 months,2,debt_consolidation,6,High,2,Bad Loan,1,19.03,E,5,22.22,27870.93,13061.84,2936.45,674.89,409000002373,24-Sep-16,6.27E+11,,1000.00,1176578.60,Woods,616,France,168895.06,1,1,0
2375,2011,5,RENT,1,Low,1,28000, 60 months,2,debt_consolidation,6,Low,1,Good Loan,0,10.65,B,2,8.91,33806.23056,28000,0,603.92,409000002374,24-Sep-16,6.27E+11,,1000.00,1177578.60,Genovese,639,Spain,97983.44,1,1,0
2376,2011,6,RENT,1,Low,1,35000, 60 months,2,debt_consolidation,6,High,2,Bad Loan,1,13.49,C,3,14.55,22643.25,11261.91,3333.57,805.17,409000002375,24-Sep-16,6.27E+11,,1000.00,1178578.60,Tseng,815,Spain,85167.88,1,1,0
2377,2011,8,RENT,1,Low,1,5500, 60 months,2,other,4,High,2,Bad Loan,1,19.42,E,5,10.56,4407.99,1834.07,538.24,143.95,409000002376,26-Sep-16,NEFT/SBIN116270149261/Mr,,1000.00,1179578.60,Chiang,786,Spain,18210.36,1,1,0
2378,2011,4,MORTGAGE,3,Medium,2,14400, 60 months,2,debt_consolidation,6,High,2,Good Loan,0,14.65,C,3,10.75,18133.48,14400,0,339.94,409000002377,26-Sep-16,NEFT/CBINH16270135641/Mr.,,11000.00,1190578.60,Williams,549,France,13608.18,1,1,0
2379,2011,10,RENT,1,Low,1,10000, 36 months,1,other,4,Low,1,Good Loan,0,10.65,B,2,18.22,11716.57347,10000,0,325.74,409000002378,26-Sep-16,6.27E+11,,1000.00,1191578.60,Wilson,622,France,110457.99,1,1,0
2380,2011,10,OWN,2,Low,1,28000, 36 months,1,credit_card,1,High,2,Bad Loan,1,16.77,D,4,13.78,32751.27,24401.87,574.17,995.08,409000002379,26-Sep-16,6.27E+11,,1000.00,1192578.60,Wang,624,France,31231.35,1,1,0
2381,2011,2,OWN,2,Low,1,5000, 36 months,1,major_purchase,8,High,2,Good Loan,0,16.29,D,4,4.65,6328.7999,5000,0,176.51,409000002380,27-Sep-16,NEFT/PUNBH16271276983/TAP,,11000.00,1203578.60,Moore,841,France,141582.66,1,1,0
2382,2011,10,RENT,1,Low,1,20000, 36 months,1,debt_consolidation,6,Low,1,Good Loan,0,11.71,B,2,22.74,23788.22916,20000,0,661.52,409000002381,27-Sep-16,NEFT/BKIDN16271887938/CHA,,11000.00,1214578.60,Iadanza,614,Spain,14666.35,1,1,0
2383,2011,1,RENT,1,Low,1,7000, 36 months,1,credit_card,1,High,2,Good Loan,0,16.77,D,4,22.21,8530.67,7000,0,248.77,409000002382,28-Sep-16,NEFT/MAHBH16272458415/Mr.,,1000.00,1215578.60,Wallace,676,France,55400.17,1,1,0
2384,2011,8,MORTGAGE,3,Low,1,10000, 36 months,1,debt_consolidation,6,High,2,Good Loan,0,13.49,C,3,8.68,11781.88,10000,0,339.31,409000002383,28-Sep-16,6.27E+11,,1000.00,1216578.60,Clark,697,France,174667.65,1,1,0
2385,2011,10,RENT,1,Low,1,10000, 36 months,1,credit_card,1,High,2,Good Loan,0,16.77,D,4,12.9,12788.68079,10000,0,355.39,409000002384,28-Sep-16,NEFT/CBINH16272A09224/MAN,,11000.00,1227578.60,Y?,732,France,154189.08,1,1,0
2386,2011,10,RENT,1,Low,1,10000, 36 months,1,credit_card,1,Low,1,Bad Loan,1,11.71,B,2,19.92,10915.08,9013.92,16.12,330.76,409000002385,28-Sep-16,NEFT/CBINH16272A09388/DHE,,1000.00,1228578.60,Yermakov,623,France,142170.44,1,1,0
2387,2011,9,RENT,1,Low,1,20000, 36 months,1,debt_consolidation,6,Low,1,Good Loan,0,10.65,B,2,14.36,23447.90242,20000,0,651.47,409000002386,28-Sep-16,NEFT/CBINH16272A09262/RAK,,1000.00,1229578.60,Wei,541,France,94499.06,1,1,0
2388,2011,1,RENT,1,Low,1,6000, 36 months,1,debt_consolidation,6,Low,1,Good Loan,0,12.69,B,2,5.41,7242.353324,6000,0,201.27,409000002387,28-Sep-16,NEFT/CBINH16272A09166/GUD,,12000.00,1241578.60,Chukwunonso,773,Spain,182081.45,1,1,0
2389,2011,10,RENT,1,Low,1,16000, 36 months,1,debt_consolidation,6,High,2,Good Loan,0,17.27,D,4,19.81,19189.51,16000,0,572.6,409000002388,28-Sep-16,NEFT/CBINH16272A09197/SAN,,12000.00,1253578.60,McIntyre,762,Germany,68562.26,1,1,0
2390,2011,6,MORTGAGE,3,Medium,2,3400, 36 months,1,debt_consolidation,6,Low,1,Good Loan,0,9.91,B,2,16.95,3942.900431,3400,0,109.57,409000002389,29-Sep-16,NEFT/SBIN216273932967/SAN,,20000.00,1273578.60,Ts'ai,655,Spain,88798.02,1,1,0
2391,2011,2,MORTGAGE,3,Low,1,6000, 36 months,1,debt_consolidation,6,High,2,Good Loan,0,13.49,C,3,8.32,7130.02,6000,0,203.59,409000002390,29-Sep-16,NEFT/SBIN316273038712/SAN,,11000.00,1284578.60,Chung,602,Germany,113781.99,1,1,0
2392,2011,10,MORTGAGE,3,Low,1,7000, 36 months,1,credit_card,1,Low,1,Bad Loan,1,7.9,A,1,14.37,2188.1,1779.84,0,219.04,409000002391,29-Sep-16,NEFT/UTBIN16273732103/M/S,,21000.00,1305578.60,Tsou,850,France,121866.87,1,1,0
2393,2011,3,OWN,2,Low,1,12000, 60 months,2,debt_consolidation,6,High,2,Good Loan,0,13.49,C,3,21.42,13509,9148.25,0,276.06,409000002392,29-Sep-16,NEFT/SBIN316273362578/Mr,,11000.00,1316578.60,Aitken,649,Spain,150390.57,1,1,0
2394,2011,6,RENT,1,Low,1,7875, 60 months,2,debt_consolidation,6,High,2,Good Loan,0,19.42,E,5,19.82,11961.63077,7875,0,206.11,409000002393,29-Sep-16,6.27E+11,,1000.00,1317578.60,Dawson,850,Germany,60708.72,1,1,0
2395,2011,10,MORTGAGE,3,Medium,2,21000, 60 months,2,other,4,High,2,Good Loan,0,21.28,F,6,10.89,27997.96,15334.06,0,571.44,409000002394,29-Sep-16,NEFT/SBIN316273440441/PRI,,10994.25,1328572.85,Ward,543,France,78858.07,1,1,0
2396,2011,6,MORTGAGE,3,Low,1,17000, 36 months,1,debt_consolidation,6,Low,1,Good Loan,0,6.62,A,1,13.85,18309.94,17000,0,521.97,409000002395,29-Sep-16,NEFT/CBINH16273133139/Mr.,,20000.00,1348572.85,Pai,672,France,56407.42,1,1,0
2397,2011,6.05,RENT,1,Low,1,6000, 36 months,1,car,2,Low,1,Good Loan,0,9.91,B,2,10.43,6959.183441,6000,0,193.35,409000002396,29-Sep-16,NEFT/SBIN316273522566/M S,,1000.00,1349572.85,Ifeanyichukwu,600,France,125698.97,1,1,0
2398,2011,10,MORTGAGE,3,Low,1,9500, 36 months,1,debt_consolidation,6,Low,1,Good Loan,0,6.62,A,1,19.28,9748.4,9500,0,291.69,409000002397,30-Sep-16,NEFT/CBINH16274A04738/MAH,,1000.00,1350572.85,Briggs,671,Spain,23235.38,1,1,0
2399,2011,10,MORTGAGE,3,Low,1,16000, 60 months,2,debt_consolidation,6,High,2,Good Loan,0,14.27,C,3,11.88,19354.7,16000,0,374.54,409000002398,30-Sep-16,6.27E+11,,1000.00,1351572.85,Morrison,706,Spain,75732.25,1,1,0
2400,2011,10,MORTGAGE,3,Low,1,35000, 60 months,2,debt_consolidation,6,High,2,Bad Loan,1,22.35,F,6,12.37,41927.68,18860.53,2995.86,973.64,409000002399,30-Sep-16,6.27E+11,,1000.00,1352572.85,Wall,541,Germany,179861.79,1,1,0
2401,2011,4,RENT,1,Low,1,1200, 36 months,1,other,4,High,2,Bad Loan,1,18.25,D,4,24.12,1380.67,990.34,33.53,43.54,409000002400,1-Oct-16,NEFT/UTBIN16275043249/IJA,,21000.00,1373572.85,Nebechukwu,711,Germany,42976.64,1,1,0
2402,2011,1,OWN,2,Low,1,20000, 60 months,2,debt_consolidation,6,High,2,Bad Loan,1,17.58,D,4,17.6,2183.74,638.95,676.84,503.32,409000002401,3-Oct-16,NEFT/CBINH16277A00957/SAN,,1000.00,1374572.85,Yao,630,Spain,10486.69,1,1,0
2403,2011,0.5,RENT,1,Low,1,5000, 36 months,1,other,4,High,2,Bad Loan,1,14.27,C,3,1.75,694.07,281.43,164.82,171.55,409000002402,3-Oct-16,NEFT/CBINH16277A09229/VIK,,11000.00,1385572.85,Liao,531,France,56794.73,1,1,0
2404,2011,1,RENT,1,Low,1,5400, 36 months,1,medical,9,High,2,Bad Loan,1,16.29,D,4,20.03,1142.7,727.59,0,190.63,409000002403,5-Oct-16,6.28E+11,,11000.00,1396572.85,Ch'ang,641,France,28157.34,1,1,0
2405,2011,6,RENT,1,Low,1,12000, 60 months,2,debt_consolidation,6,High,2,Bad Loan,1,19.91,E,5,22.22,8543.51,3273.36,1255.96,317.33,409000002404,6-Oct-16,6.28E+11,,5000.00,1401572.85,Burke,631,Germany,152422.91,1,1,0
2406,2011,10,MORTGAGE,3,Low,1,12775, 36 months,1,credit_card,1,Low,1,Good Loan,0,9.91,B,2,20.94,14817.13889,12775,0,411.68,409000002405,6-Oct-16,6.28E+11,,5000.00,1406572.85,Kay,685,France,167033.83,1,1,0
2407,2011,0.5,RENT,1,Low,1,5000, 36 months,1,other,4,High,2,Good Loan,0,17.58,D,4,5.33,6468.306309,5000,0,179.72,409000002406,6-Oct-16,6.28E+11,,2000.00,1408572.85,McIntyre,702,Spain,126082.18,1,1,0
2408,2011,2,RENT,1,Low,1,15000, 60 months,2,debt_consolidation,6,High,2,Good Loan,0,19.91,E,5,17.93,23143.90186,15000,0,396.66,409000002407,7-Oct-16,6.28E+11,,5000.00,1413572.85,Chidiegwu,708,Germany,181499.77,1,1,0
2409,2011,3,MORTGAGE,3,Low,1,15600, 36 months,1,credit_card,1,High,2,Good Loan,0,13.49,C,3,18.53,18989.67723,15600,0,529.32,409000002408,7-Oct-16,TRF TO  Indiaforensic SERVICES I,"850,000.00",,563572.85,Musgrove,653,Spain,41967.03,1,1,0
2410,2011,10,MORTGAGE,3,Low,1,5050, 60 months,2,other,4,High,2,Bad Loan,1,21.67,F,6,10.45,2483.82,992.43,0,138.53,409000002409,8-Oct-16,6.28E+11,,5000.00,568572.85,Boulger,654,Germany,186300.59,1,1,0
2411,2011,3,RENT,1,Low,1,12000, 60 months,2,debt_consolidation,6,High,2,Good Loan,0,18.25,D,4,22.61,12540.75,12000,0,306.36,409000002410,8-Oct-16,6.28E+11,,5000.00,573572.85,Gow,596,France,85412.54,1,1,0
2412,2011,5,MORTGAGE,3,Medium,2,24000, 60 months,2,home_improvement,7,High,2,Good Loan,0,18.64,E,5,15.33,28528.44,23999.99,0,617.83,409000002411,8-Oct-16,6.28E+11,,5000.00,578572.85,Amaechi,549,Germany,23343.18,1,1,0
2413,2011,4,MORTGAGE,3,Low,1,25000, 60 months,2,wedding,5,Low,1,Good Loan,0,12.42,B,2,12.09,31688.99697,25000,0,561.44,409000002412,8-Oct-16,6.28E+11,,1000.00,579572.85,Robe,754,France,180698.32,1,1,0
2414,2011,5,MORTGAGE,3,Low,1,12000, 36 months,1,debt_consolidation,6,High,2,Good Loan,0,16.29,D,4,16.33,15247.47908,12000,0,423.61,409000002413,9-Oct-16,6.28E+11,,1000.00,580572.85,Bibi,815,Germany,136071.05,1,1,0
2415,2011,4,RENT,1,Low,1,10000, 36 months,1,credit_card,1,Low,1,Good Loan,0,12.69,B,2,13.53,11916.81174,10000,0,335.45,409000002414,11-Oct-16,6.29E+11,,12000.00,592572.85,Niu,556,France,175149.20,1,1,0
2416,2011,0.5,RENT,1,Low,1,2400, 36 months,1,vacation,11,Low,1,Good Loan,0,9.91,B,2,18.78,2749.46,2400,0,77.34,409000002415,13-Oct-16,NEFT/CBINH16287A05619/SAN,,1000.00,593572.85,Palerma,706,France,146949.74,1,1,0
2417,2011,4,RENT,1,Low,1,5825, 36 months,1,credit_card,1,High,2,Good Loan,0,14.27,C,3,20.21,7191.957839,5825,0,199.85,409000002416,13-Oct-16,NEFT/SBIN416287847203/NAB,,21000.00,614572.85,Cocci,850,France,88920.68,1,1,0
2418,2011,10,RENT,1,Low,1,20000, 36 months,1,debt_consolidation,6,Low,1,Good Loan,0,11.71,B,2,21.05,23785.84767,20000,0,661.52,409000002417,13-Oct-16,NEFT/CBINH16287A07910/DHE,,11000.00,625572.85,Artemieva,732,Spain,45098.62,1,1,0
2419,2011,7,RENT,1,Low,1,16000, 36 months,1,credit_card,1,Low,1,Good Loan,0,11.71,B,2,19.43,19046.05807,16000,0,529.22,409000002418,14-Oct-16,NEFT/SBIN516288401682/Mr,,11000.00,636572.85,Arcuri,614,France,20339.79,1,1,0
2420,2011,4,MORTGAGE,3,Low,1,1500, 36 months,1,other,4,Low,1,Good Loan,0,9.91,B,2,2.72,1616.7,1500,0,48.34,409000002419,14-Oct-16,NEFT/SBIN516288474497/M H,,21000.00,657572.85,Owen,580,Spain,108528.74,1,1,0
2421,2011,8,MORTGAGE,3,Low,1,12500, 36 months,1,small_business,3,Low,1,Good Loan,0,10.65,B,2,12.12,14655.84267,12500,0,407.17,409000002420,15-Oct-16,NEFT/CBINH16289A04744/SAN,,11000.00,668572.85,Franklin,593,France,145560.38,1,1,0
2422,2011,10,MORTGAGE,3,Low,1,12000, 60 months,2,debt_consolidation,6,Low,1,Bad Loan,1,8.9,A,1,9.65,5218.7,3583.71,0,248.52,409000002421,15-Oct-16,NEFT/CBINH16289A08393/SAN,,1000.00,669572.85,Lorenzo,653,Germany,199357.24,1,1,0
2423,2011,6.05,MORTGAGE,3,Low,1,6000, 36 months,1,major_purchase,8,Low,1,Good Loan,0,6.03,A,1,5.6,6492.86,6000,0,182.62,409000002422,19-Oct-16,NEFT/N293160197868430/SAN,,1000.00,670572.85,Muriel,746,France,43106.17,1,1,0
2424,2011,10,MORTGAGE,3,Low,1,3500, 36 months,1,car,2,Low,1,Good Loan,0,8.9,A,1,19.76,3526.33,3500,0,111.14,409000002423,20-Oct-16,NEFT/BARBH16294527200/AKH,,12000.00,682572.85,MacDevitt,662,France,137508.31,1,1,0
2425,2011,6,MORTGAGE,3,Low,1,4000, 36 months,1,medical,9,High,2,Good Loan,0,16.77,D,4,7.12,4665.28,4000,0,142.16,409000002424,20-Oct-16,NEFT/CBINH16294A04839/RAJ,,11000.00,693572.85,Chijindum,573,France,91957.39,1,1,0
2426,2011,3,RENT,1,Low,1,12100, 60 months,2,house,12,High,2,Good Loan,0,17.27,D,4,11.5,12784.13,12100,0,302.48,409000002425,20-Oct-16,NEFT/CBINH16294A04692/HAR,,11000.00,704572.85,Gibson,684,Spain,120612.11,1,1,0
2427,2011,10,MORTGAGE,3,Low,1,20000, 60 months,2,debt_consolidation,6,High,2,Bad Loan,1,14.27,C,3,7.42,15917.78,9567.12,26.52,468.17,409000002426,24-Oct-16,NEFT/SBIN116298681910/GAN,,12000.00,716572.85,Whitehead,793,France,102921.17,1,1,0
2428,2011,6.05,MORTGAGE,3,Low,1,8500, 36 months,1,debt_consolidation,6,Low,1,Good Loan,0,7.9,A,1,11.62,9371.57,8500,0,265.97,409000002427,24-Oct-16,NEFT/MAHBH16298499334/Mr.,,12000.00,728572.85,Johnstone,798,Germany,31686.33,1,1,0
2429,2011,2,MORTGAGE,3,Low,1,15000, 36 months,1,debt_consolidation,6,Low,1,Good Loan,0,12.42,B,2,9.69,17212.09,15000,0,501.23,409000002428,25-Oct-16,NEFT/CBINH16299A08915/MAH,,11000.00,739572.85,Endrizzi,524,France,180002.42,1,1,0
2430,2011,10,MORTGAGE,3,Low,1,15600, 36 months,1,debt_consolidation,6,Low,1,Good Loan,0,7.9,A,1,20.01,17570.82709,15600,0,488.13,409000002429,25-Oct-16,NEFT/N299160199285360/RAK,,11000.00,750572.85,Burke,816,France,28407.40,1,1,0
2431,2011,5,MORTGAGE,3,Low,1,10000, 36 months,1,debt_consolidation,6,Low,1,Good Loan,0,12.42,B,2,15.07,10493.15,10000,0,334.16,409000002430,26-Oct-16,6.30E+11,,12000.00,762572.85,Johnson,742,Germany,73743.95,1,1,0
2432,2011,10,MORTGAGE,3,Low,1,2400, 36 months,1,debt_consolidation,6,Low,1,Good Loan,0,12.42,B,2,9.82,2739.73,2400,0,80.2,409000002431,26-Oct-16,6.30E+11,,12000.00,774572.85,Yeh,540,France,186233.26,1,1,0
2433,2011,6,MORTGAGE,3,Medium,2,12000, 60 months,2,car,2,Low,1,Good Loan,0,7.9,A,1,8.09,13350.71116,12000,0,242.75,409000002432,27-Oct-16,6.30E+11,,5000.00,779572.85,Marshall,537,Germany,31728.86,1,1,0
2434,2011,10,MORTGAGE,3,Low,1,19000, 60 months,2,debt_consolidation,6,High,2,Bad Loan,1,20.3,E,5,17.24,2662.12,758.66,638.4,506.57,409000002433,27-Oct-16,6.30E+11,,5000.00,784572.85,Kao,759,Spain,48244.64,1,1,0
2435,2011,4,RENT,1,Low,1,8000, 60 months,2,wedding,5,High,2,Good Loan,0,14.27,C,3,11.85,10474.44542,8000,0,187.27,409000002434,27-Oct-16,6.30E+11,,2000.00,786572.85,Browne,774,France,113266.28,1,1,0
2436,2011,9,RENT,1,Low,1,10000, 36 months,1,credit_card,1,High,2,Bad Loan,1,15.96,C,3,9.39,7026.97,4957.89,10.97,351.38,409000002435,27-Oct-16,6.30E+11,,5000.00,791572.85,Taylor,608,Germany,71178.09,1,1,0
2437,2011,4,MORTGAGE,3,Medium,2,9000, 36 months,1,home_improvement,7,Low,1,Good Loan,0,6.62,A,1,7.26,9505.71,9000,0,276.34,409000002436,27-Oct-16,6.30E+11,,5000.00,796572.85,Gibbons,704,Spain,25684.93,1,1,0
2438,2011,10,MORTGAGE,3,Medium,2,26375, 60 months,2,debt_consolidation,6,High,2,Good Loan,0,17.58,D,4,22.66,32488.78,19660.45,0,663.75,409000002437,27-Oct-16,6.30E+11,,2000.00,798572.85,Nott,581,France,29737.14,1,1,0
2439,2011,1,OWN,2,Low,1,10000, 36 months,1,credit_card,1,High,2,Good Loan,0,13.49,C,3,20.18,11668.68,10000,0,339.31,409000002438,27-Oct-16,NEFT/SBIN416301935538/MOH,,1000.00,799572.85,Lei,628,Germany,149922.38,1,1,0
2440,2011,2,RENT,1,Low,1,10000, 36 months,1,debt_consolidation,6,Low,1,Good Loan,0,11.71,B,2,12.23,11903.61971,10000,0,330.76,409000002439,28-Oct-16,6.30E+11,,1000.00,800572.85,Alexeeva,566,France,180702.12,1,1,0
2441,2011,6,MORTGAGE,3,Low,1,12600, 60 months,2,credit_card,1,High,2,Bad Loan,1,20.3,E,5,20.05,2009.82,766.35,0,335.93,409000002440,29-Oct-16,NEFT/SBIN816303366296/SAN,,1000.00,801572.85,Sheets,701,Spain,27597.59,1,1,0
2442,2011,0.5,MORTGAGE,3,Medium,2,6000, 36 months,1,home_improvement,7,Low,1,Good Loan,0,10.65,B,2,15.82,7033.976137,6000,0,195.44,409000002441,31-Oct-16,NEFT/SBIN116305096270/IRF,,12000.00,813572.85,Tokaryev,735,Spain,95025.27,1,1,0
2443,2011,0.5,RENT,1,Low,1,12800, 36 months,1,debt_consolidation,6,Low,1,Good Loan,0,12.42,B,2,24.66,15305.15261,12800,0,427.72,409000002442,31-Oct-16,6.31E+11,,1000.00,814572.85,Ts'ui,680,France,167035.07,1,1,0
2444,2011,10,MORTGAGE,3,Medium,2,13000, 60 months,2,credit_card,1,High,2,Good Loan,0,15.96,C,3,11.99,17143.11957,13000,0,315.86,409000002443,2-Nov-16,NEFT/SBIN216307265211/ROH,,1000.00,815572.85,Johnston,560,France,116781.71,1,1,0
2445,2011,2,RENT,1,Low,1,8000, 36 months,1,other,4,Low,1,Good Loan,0,7.9,A,1,11.52,9010.487908,8000,0,250.33,409000002444,3-Nov-16,6.31E+11,,5000.00,820572.85,Kung,663,Germany,21170.81,1,1,0
2446,2011,5,MORTGAGE,3,Medium,2,6975, 36 months,1,credit_card,1,Low,1,Good Loan,0,9.91,B,2,20.79,8025.342911,6975,0,224.77,409000002445,3-Nov-16,6.31E+11,,5000.00,825572.85,Unwin,665,France,29641.58,1,1,0
2447,2011,10,OWN,2,Low,1,13000, 36 months,1,debt_consolidation,6,Low,1,Good Loan,0,7.9,A,1,16.41,13330.19,13000,0,406.78,409000002446,3-Nov-16,6.31E+11,,2000.00,827572.85,Hsueh,758,France,116520.07,1,1,0
2448,2011,2,MORTGAGE,3,Low,1,12000, 60 months,2,debt_consolidation,6,High,2,Good Loan,0,16.77,D,4,18.2,16971.58834,12000,0,296.75,409000002447,4-Nov-16,6.31E+11,,21000.00,848572.85,Hao,621,France,44220.40,1,1,0
2449,2011,4,RENT,1,Low,1,5000, 36 months,1,wedding,5,Low,1,Good Loan,0,6.62,A,1,0.81,5488.517761,5000,0,153.52,409000002448,4-Nov-16,NEFT/P16110447781189/UPEN,,12000.00,860572.85,L?,764,Germany,166188.28,1,1,0
2450,2011,10,MORTGAGE,3,Medium,2,17000, 36 months,1,debt_consolidation,6,Low,1,Good Loan,0,11.71,B,2,14.66,19887.17618,17000,0,562.3,409000002449,5-Nov-16,6.31E+11,,1000.00,861572.85,Frater,537,Germany,140857.76,1,1,0
2451,2011,4,RENT,1,Low,1,12800, 36 months,1,credit_card,1,Low,1,Bad Loan,1,12.42,B,2,22.58,11334.69,8357.55,637.16,427.72,409000002450,7-Nov-16,6.31E+11,,1000.00,862572.85,Brennan,589,France,37024.28,1,1,0
2452,2011,10,RENT,1,Low,1,1600, 36 months,1,other,4,Low,1,Good Loan,0,8.9,A,1,17.67,1828.343698,1600,0,50.81,409000002451,7-Nov-16,NEFT/SAA37986382/JITENDRA,,1000.00,863572.85,Pisani,555,France,27513.47,1,1,0
2453,2011,6.05,MORTGAGE,3,Low,1,1200, 36 months,1,other,4,Low,1,Good Loan,0,10.65,B,2,7.56,1406.666987,1200,0,39.09,409000002452,7-Nov-16,6.31E+11,,1000.00,864572.85,Golubev,734,France,17744.72,1,1,0
2454,2011,0.5,MORTGAGE,3,Low,1,26300, 60 months,2,credit_card,1,High,2,Bad Loan,1,23.13,G,7,15.06,16354.36,6396.84,16.28,743.38,409000002453,8-Nov-16,NEFT/CBINH16313A08810/JIT,,12000.00,876572.85,Vanmeter,783,Spain,4423.63,1,1,0
2455,2011,10,RENT,1,Low,1,18800, 60 months,2,debt_consolidation,6,High,2,Bad Loan,1,20.89,F,6,14.11,8625.48,3523.24,12.94,507.45,409000002454,10-Nov-16,6.32E+11,,1000.00,877572.85,Hs?,678,Germany,109718.44,1,1,0
2456,2011,4,MORTGAGE,3,Low,1,12000, 36 months,1,credit_card,1,Low,1,Good Loan,0,11.71,B,2,19.13,14284.19421,12000,0,396.92,409000002455,10-Nov-16,6.32E+11,,5000.00,882572.85,Scott,661,France,107243.31,1,1,0
2457,2011,10,RENT,1,Medium,2,28000, 36 months,1,debt_consolidation,6,Low,1,Good Loan,0,7.9,A,1,16.36,31522.37894,28000,0,876.13,409000002456,10-Nov-16,6.32E+11,,3000.00,885572.85,Crawford,607,Spain,115288.24,1,1,0
2458,2011,6.05,OWN,2,Low,1,3125, 60 months,2,other,4,High,2,Good Loan,0,21.67,F,6,13.01,4221.23,2271.36,0,85.73,409000002457,10-Nov-16,6.32E+11,,5000.00,890572.85,P'eng,537,Spain,41233.97,1,1,0
2459,2011,9,OWN,2,Medium,2,20000, 36 months,1,other,4,Low,1,Good Loan,0,12.69,B,2,11.14,24137.49132,20000,0,670.9,409000002458,10-Nov-16,6.32E+11,,3000.00,893572.85,Rearick,513,Spain,52952.24,1,1,0
2460,2011,5,MORTGAGE,3,Low,1,20000, 60 months,2,debt_consolidation,6,Low,1,Good Loan,0,12.69,B,2,29.73,25355.11702,20000,0,451.9,409000002459,10-Nov-16,6.32E+11,,1.00,893573.85,Genovesi,576,France,78955.80,1,1,0
2461,2011,10,RENT,1,Low,1,5000, 36 months,1,medical,9,Low,1,Good Loan,0,9.91,B,2,17.32,5791.639734,5000,0,161.13,409000002460,10-Nov-16,6.32E+11,,5000.00,898573.85,Glenny,660,Germany,26025.60,1,1,0
2462,2011,3,MORTGAGE,3,Medium,2,19000, 36 months,1,car,2,High,2,Good Loan,0,13.49,C,3,13.18,22054.49,19000,0,644.68,409000002461,10-Nov-16,6.32E+11,,2000.00,900573.85,Marks,637,France,174536.17,1,1,0
2463,2011,1,OWN,2,Low,1,35000, 36 months,1,debt_consolidation,6,Low,1,Good Loan,0,9.91,B,2,6.5,39787.41,35000,0,1127.88,409000002462,10-Nov-16,6.32E+11,,5000.00,905573.85,Fleming,672,France,147311.47,1,1,0
2464,2011,4,RENT,1,Low,1,8000, 36 months,1,debt_consolidation,6,Low,1,Bad Loan,1,9.91,B,2,22.24,1031.64,579.04,259.47,257.8,409000002463,10-Nov-16,6.32E+11,,3000.00,908573.85,Davison,629,France,77965.44,1,1,0
2465,2011,10,RENT,1,Low,1,7200, 36 months,1,debt_consolidation,6,High,2,Good Loan,0,17.58,D,4,21.54,9311.428345,7200,0,258.79,409000002464,11-Nov-16,6.32E+11,,5000.00,913573.85,Chibuzo,583,Germany,5635.63,1,1,0
2466,2011,2,RENT,1,Low,1,2400, 36 months,1,debt_consolidation,6,Low,1,Good Loan,0,9.91,B,2,18.69,2668.97,2400,0,77.34,409000002465,11-Nov-16,6.32E+11,,2000.00,915573.85,Wilson,763,Spain,81310.10,1,1,0
2467,2011,2,MORTGAGE,3,Low,1,25000, 60 months,2,debt_consolidation,6,High,2,Bad Loan,1,19.03,E,5,22.25,24639.38,11673.94,1966.09,648.93,409000002466,11-Nov-16,6.32E+11,,5000.00,920573.85,Endrizzi,516,Germany,111421.45,1,1,0
2468,2011,5,OWN,2,Low,1,24250, 36 months,1,debt_consolidation,6,High,2,Good Loan,0,19.03,E,5,15.21,32043.91609,24250,0,889.28,409000002467,11-Nov-16,6.32E+11,,3000.00,923573.85,Yuryeva,617,France,190269.21,1,1,0
2469,2011,2,RENT,1,Low,1,12000, 36 months,1,debt_consolidation,6,Low,1,Good Loan,0,10.65,B,2,26.64,14068.33856,12000,0,390.88,409000002468,11-Nov-16,6.32E+11,,1000.00,924573.85,Ugochukwu,700,France,100950.48,1,1,0
2470,2011,8,MORTGAGE,3,Low,1,15000, 60 months,2,debt_consolidation,6,High,2,Good Loan,0,15.96,C,3,14.35,17826.82,11276.85,0,364.46,409000002469,11-Nov-16,6.32E+11,,1000.00,925573.85,Lo Duca,727,Germany,113033.73,1,1,0
2471,2011,4,RENT,1,Low,1,19200, 60 months,2,debt_consolidation,6,High,2,Bad Loan,1,18.25,D,4,15.2,23495.81,13844.94,0,490.17,409000002470,12-Nov-16,6.32E+11,,5000.00,930573.85,Gallo,689,Spain,120663.57,1,1,0
2472,2011,5,MORTGAGE,3,Low,1,9500, 36 months,1,credit_card,1,Low,1,Good Loan,0,11.71,B,2,13.99,11308.7749,9500,0,314.23,409000002471,12-Nov-16,6.32E+11,,3000.00,933573.85,Trout,626,Germany,187192.23,1,1,0
2473,2011,10,RENT,1,Low,1,20000, 60 months,2,debt_consolidation,6,High,2,Good Loan,0,15.96,C,3,18.88,26834.07102,20000,0,485.94,409000002472,13-Nov-16,NEFT/CBINH16318A06030/MUN,,8000.00,941573.85,Morley,686,France,97825.23,1,1,0
2474,2011,0.5,RENT,1,Low,1,9000, 36 months,1,debt_consolidation,6,Low,1,Good Loan,0,12.69,B,2,18.35,10753.04982,9000,0,301.91,409000002473,13-Nov-16,NEFT/AXISF16318000234/SUM,,8000.00,949573.85,Chou,351,Germany,169621.69,1,1,0
2475,2011,6,MORTGAGE,3,Low,1,16000, 36 months,1,debt_consolidation,6,Low,1,Good Loan,0,7.9,A,1,20.84,17998.29677,16000,0,500.65,409000002474,14-Nov-16,6.32E+11,,5000.00,954573.85,Shao,739,France,191557.10,1,1,0
2476,2011,3,MORTGAGE,3,Low,1,19600, 36 months,1,wedding,5,Low,1,Good Loan,0,9.91,B,2,16.2,22658.12845,19600,0,631.61,409000002475,14-Nov-16,6.32E+11,,3000.00,957573.85,Trentino,627,France,103287.62,1,1,0
2477,2011,10,MORTGAGE,3,Low,1,18800, 60 months,2,debt_consolidation,6,High,2,Good Loan,0,13.49,C,3,23.63,21169.91,14335.55,0,432.49,409000002476,14-Nov-16,6.32E+11,,5000.00,962573.85,Mazzanti,451,Germany,167538.66,1,1,0
2478,2011,7,MORTGAGE,3,Low,1,10000, 36 months,1,major_purchase,8,High,2,Good Loan,0,14.27,C,3,6.94,12324.33432,10000,0,343.09,409000002477,14-Nov-16,6.32E+11,,3000.00,965573.85,Endrizzi,512,France,64869.32,1,1,0
2479,2011,10,MORTGAGE,3,Low,1,20000, 60 months,2,debt_consolidation,6,High,2,Bad Loan,1,18.25,D,4,11.49,13804.57,5611.13,2062.96,510.6,409000002478,14-Nov-16,6.32E+11,,5000.00,970573.85,Monaldo,774,France,102426.06,1,1,0
2480,2011,4,RENT,1,Low,1,9750, 36 months,1,debt_consolidation,6,High,2,Bad Loan,1,17.27,D,4,8.56,1705.09,851.7,310.89,348.93,409000002479,14-Nov-16,6.32E+11,,3000.00,973573.85,Otutodilinna,652,France,107876.20,1,1,0
2481,2011,10,RENT,1,Low,1,35000, 60 months,2,debt_consolidation,6,High,2,Good Loan,0,22.06,F,6,16.36,47414.22,25435.69,0,967.86,409000002480,14-Nov-16,6.32E+11,,5000.00,978573.85,Allen,638,Germany,37294.88,1,1,0
2482,2011,10,MORTGAGE,3,Low,1,20000, 36 months,1,debt_consolidation,6,Low,1,Good Loan,0,7.9,A,1,18.32,22216.43,20000,0,625.81,409000002481,14-Nov-16,6.32E+11,,3000.00,981573.85,Milne,475,France,89248.99,1,1,0
2483,2011,3,RENT,1,Low,1,12000, 36 months,1,credit_card,1,High,2,Good Loan,0,14.27,C,3,16.4,12551.08,12000,0,411.71,409000002482,14-Nov-16,6.32E+11,,5000.00,986573.85,Somadina,567,Spain,91973.63,1,1,0
2484,2011,3,RENT,1,Low,1,8000, 36 months,1,debt_consolidation,6,Low,1,Good Loan,0,12.42,B,2,13.32,8996.96,8000,0,267.33,409000002483,14-Nov-16,6.32E+11,,3000.00,989573.85,Chieloka,750,France,16870.20,1,1,0
2485,2011,3,MORTGAGE,3,Low,1,28000, 60 months,2,debt_consolidation,6,Low,1,Good Loan,0,12.69,B,2,17.64,36400.92161,28000,0,632.66,409000002484,14-Nov-16,6.32E+11,,8000.00,997573.85,Chukwuebuka,850,France,121681.19,1,1,0
2486,2011,4,RENT,1,Low,1,6000, 36 months,1,credit_card,1,High,2,Good Loan,0,14.27,C,3,7.64,6209.15,6000,0,205.86,409000002485,15-Nov-16,6.32E+11,,5000.00,1002573.85,Chioke,753,France,33730.43,1,1,0
2487,2011,6,MORTGAGE,3,Medium,2,16000, 36 months,1,major_purchase,8,Low,1,Good Loan,0,6.03,A,1,12.45,17125.97,16000,0,486.97,409000002486,15-Nov-16,6.32E+11,,3000.00,1005573.85,Kovalev,683,Spain,104786.59,1,1,0
2488,2011,8,RENT,1,Low,1,19600, 36 months,1,credit_card,1,Low,1,Good Loan,0,9.91,B,2,22.53,22735.11078,19600,0,631.61,409000002487,15-Nov-16,6.32E+11,,5000.00,1010573.85,Doherty,710,France,94790.34,1,1,0
2489,2011,2,MORTGAGE,3,Low,1,11500, 36 months,1,credit_card,1,Low,1,Good Loan,0,7.9,A,1,4.45,12952.60673,11500,0,359.84,409000002488,15-Nov-16,6.32E+11,,3000.00,1013573.85,Baranov,645,Spain,28726.07,1,1,0
2490,2011,2,RENT,1,Low,1,3000, 36 months,1,debt_consolidation,6,Low,1,Good Loan,0,12.42,B,2,24.38,3504.61,3000,0,100.25,409000002489,15-Nov-16,6.32E+11,,5000.00,1018573.85,Rossi,714,France,67057.27,1,1,0
2491,2011,0.5,RENT,1,Low,1,5000, 36 months,1,car,2,Low,1,Good Loan,0,7.9,A,1,17.23,5185.28,5000,0,156.46,409000002490,15-Nov-16,6.32E+11,,3000.00,1021573.85,Robinson,696,Germany,69079.85,1,1,0
2492,2011,7,MORTGAGE,3,Low,1,7000, 36 months,1,credit_card,1,Low,1,Bad Loan,1,12.42,B,2,12.84,2418.12,1513.22,315.09,233.91,409000002491,15-Nov-16,6.32E+11,,5000.00,1026573.85,Bidencope,612,Spain,179780.74,1,1,0
2493,2011,6,MORTGAGE,3,Low,1,23325, 36 months,1,credit_card,1,High,2,Good Loan,0,15.27,C,3,14.99,29210.41959,23325,0,811.66,409000002492,15-Nov-16,6.32E+11,,3000.00,1029573.85,T'ien,520,Germany,183572.39,1,1,0
2494,2011,10,RENT,1,High,3,22200, 36 months,1,small_business,3,Low,1,Good Loan,0,12.69,B,2,5.14,24652.67,22200,0,744.7,409000002493,15-Nov-16,6.32E+11,,5000.00,1034573.85,De Bernales,782,Spain,142587.32,1,1,0
2495,2011,6,RENT,1,Low,1,14675, 60 months,2,debt_consolidation,6,High,2,Good Loan,0,17.27,D,4,24.52,17941.85,10950.55,0,366.85,409000002494,15-Nov-16,6.32E+11,,3000.00,1037573.85,Wade,666,France,177844.06,1,1,0
2496,2011,7,RENT,1,Low,1,14400, 60 months,2,debt_consolidation,6,Low,1,Bad Loan,1,12.69,B,2,16.06,13702.82,9010.05,1344.29,325.37,409000002495,15-Nov-16,6.32E+11,,5000.00,1042573.85,Chung,466,Germany,197634.11,1,1,0
2497,2011,10,MORTGAGE,3,Low,1,28000, 60 months,2,small_business,3,Low,1,Good Loan,0,11.71,B,2,6.16,30307.05,21568.64,0,618.75,409000002496,15-Nov-16,6.32E+11,,3000.00,1045573.85,Stevenson,567,France,121053.19,1,1,0
2498,2011,4,MORTGAGE,3,Low,1,12000, 60 months,2,credit_card,1,High,2,Good Loan,0,19.03,E,5,15.3,15234.15,8865.09,0,311.49,409000002497,15-Nov-16,6.32E+11,,5000.00,1050573.85,Chienezie,613,France,149613.77,1,1,0
2499,2011,9,MORTGAGE,3,Low,1,15000, 36 months,1,debt_consolidation,6,Low,1,Bad Loan,1,7.9,A,1,9.83,12203.36,10463.28,10.4,469.36,409000002498,15-Nov-16,6.32E+11,,3000.00,1053573.85,Cashin,718,France,142.81,1,1,0
2500,2011,2,OWN,2,Low,1,15000, 60 months,2,debt_consolidation,6,High,2,Bad Loan,1,21.67,F,6,14.36,4313.27,1184,0,411.48,409000002499,15-Nov-16,6.32E+11,,5000.00,1058573.85,Seppelt,614,France,131766.67,1,1,0
2501,2011,10,MORTGAGE,3,Low,1,15850, 60 months,2,debt_consolidation,6,High,2,Good Loan,0,13.49,C,3,27.6,18289.05,15850,0,364.63,409000002500,15-Nov-16,6.32E+11,,3000.00,1061573.85,Brownless,711,France,53311.78,1,1,0
2502,2011,1,MORTGAGE,3,Low,1,12000, 36 months,1,credit_card,1,High,2,Good Loan,0,13.49,C,3,16.28,13308.59,12000,0,407.17,409000002501,15-Nov-16,6.32E+11,,5000.00,1066573.85,McDonald,691,Germany,107665.02,1,1,0
2503,2011,2,RENT,1,Low,1,1800, 36 months,1,other,4,Low,1,Bad Loan,1,12.69,B,2,17.66,736.59,477.27,75.71,60.39,409000002502,15-Nov-16,6.32E+11,,3000.00,1069573.85,Mamelu,527,France,109523.88,1,1,0
2504,2011,6.05,MORTGAGE,3,Low,1,3200, 60 months,2,home_improvement,7,Low,1,Bad Loan,1,9.91,B,2,12.44,203.52,83.18,0,67.85,409000002503,15-Nov-16,6.32E+11,,5000.00,1074573.85,McGregor,476,France,112132.86,1,1,0
2505,2011,0.5,RENT,1,Low,1,17000, 36 months,1,credit_card,1,High,2,Good Loan,0,16.77,D,4,15.41,20138.79,17000,0,604.16,409000002504,15-Nov-16,6.32E+11,,3000.00,1077573.85,McDonald,619,Spain,113645.40,1,1,0
2506,2011,0.5,RENT,1,Low,1,5500, 36 months,1,debt_consolidation,6,High,2,Good Loan,0,15.96,C,3,21.49,6953.438236,5500,0,193.26,409000002505,15-Nov-16,6.32E+11,,5000.00,1082573.85,Crawford,607,Germany,180890.40,1,1,0
2507,2011,1,RENT,1,Low,1,10000, 36 months,1,debt_consolidation,6,High,2,Good Loan,0,13.49,C,3,8.06,11329.52,10000,0,339.31,409000002506,15-Nov-16,6.32E+11,,3000.00,1085573.85,Feng,695,Spain,70974.13,1,1,0
2508,2011,8,MORTGAGE,3,Low,1,11600, 60 months,2,debt_consolidation,6,High,2,Bad Loan,1,14.27,C,3,23.21,13011.19,8559.75,0,271.54,409000002507,15-Nov-16,6.32E+11,,5000.00,1090573.85,Genovese,653,France,53379.52,1,1,0
2509,2011,10,RENT,1,Low,1,16000, 60 months,2,debt_consolidation,6,High,2,Bad Loan,1,14.27,C,3,29.36,16837.92,10873.15,0,374.54,409000002508,15-Nov-16,6.32E+11,,3000.00,1093573.85,Pirozzi,677,France,158531.01,1,1,0
2510,2011,10,MORTGAGE,3,Low,1,35000, 60 months,2,credit_card,1,High,2,Good Loan,0,22.06,F,6,14.71,47414.74,25435.91,0,967.86,409000002509,15-Nov-16,6.32E+11,,5000.00,1098573.85,Gibbs,655,France,179267.94,1,1,0
2511,2011,6,OWN,2,Low,1,11100, 60 months,2,credit_card,1,High,2,Bad Loan,1,15.96,C,3,20.49,10557.8,5551.93,808.2,269.7,409000002510,15-Nov-16,6.32E+11,,3000.00,1101573.85,Milne,625,France,84606.03,1,1,0
2512,2011,5,RENT,1,Low,1,13000, 36 months,1,debt_consolidation,6,Low,1,Good Loan,0,11.71,B,2,16.78,15474.02512,13000,0,429.99,409000002511,15-Nov-16,6.32E+11,,5000.00,1106573.85,Dickson,679,Germany,56984.58,1,1,0
2513,2011,10,MORTGAGE,3,Low,1,12250, 36 months,1,credit_card,1,High,2,Good Loan,0,14.27,C,3,22.8,15126.81688,12250,0,420.29,409000002512,15-Nov-16,6.32E+11,,3000.00,1109573.85,O'Connor,734,France,116912.45,1,1,0
2514,2011,10,RENT,1,Low,1,29100, 60 months,2,debt_consolidation,6,High,2,Bad Loan,1,20.3,E,5,20.23,27930.24,13865.57,33.15,775.84,409000002513,16-Nov-16,6.32E+11,,5000.00,1114573.85,McGuirk,666,France,102999.33,1,1,0
2515,2011,10,MORTGAGE,3,Low,1,21600, 60 months,2,debt_consolidation,6,High,2,Bad Loan,1,17.58,D,4,9.75,18122.71,8599.57,1858.89,543.58,409000002514,16-Nov-16,6.32E+11,,3000.00,1117573.85,Toscani,592,Germany,132801.57,1,1,0
2516,2011,7,RENT,1,Low,1,10000, 36 months,1,credit_card,1,High,2,Good Loan,0,15.96,C,3,5.57,12643.80895,10000,0,351.38,409000002515,16-Nov-16,6.32E+11,,5000.00,1122573.85,Ruth,564,France,85455.62,1,1,0
2517,2011,5,RENT,1,Low,1,29100, 60 months,2,debt_consolidation,6,High,2,Good Loan,0,18.64,E,5,22.18,42618.71113,29100,0,749.12,409000002516,16-Nov-16,6.32E+11,,3000.00,1125573.85,Hughes,814,France,98657.01,1,1,0
2518,2011,3,RENT,1,Low,1,2000, 36 months,1,debt_consolidation,6,High,2,Good Loan,0,14.27,C,3,8.58,2050.86,2000,0,68.62,409000002517,16-Nov-16,6.32E+11,,5000.00,1130573.85,Onyekaozulu,592,Germany,107948.72,1,1,0
2519,2011,2,RENT,1,Low,1,9500, 36 months,1,debt_consolidation,6,Low,1,Good Loan,0,8.9,A,1,14.34,10857.3557,9500,0,301.66,409000002518,16-Nov-16,6.32E+11,,3000.00,1133573.85,Aksenov,758,France,67944.09,1,1,0
2520,2011,0.5,RENT,1,Low,1,21000, 36 months,1,credit_card,1,Low,1,Bad Loan,1,11.71,B,2,9.84,14585.91,11325.16,0,694.6,409000002519,16-Nov-16,6.32E+11,,5000.00,1138573.85,K'ung,612,Spain,192892.05,1,1,0
2521,2011,9,RENT,1,Low,1,11300, 36 months,1,credit_card,1,High,2,Good Loan,0,13.49,C,3,21.05,13799.71342,11300,0,383.42,409000002520,16-Nov-16,6.32E+11,,3000.00,1141573.85,Meng,498,Germany,187247.56,1,1,0
2522,2011,1,RENT,1,Low,1,12000, 36 months,1,debt_consolidation,6,Low,1,Good Loan,0,12.69,B,2,19.37,14318.68341,12000,0,402.54,409000002521,16-Nov-16,6.32E+11,,5000.00,1146573.85,Nwoye,638,Germany,114722.42,1,1,0
2523,2011,10,MORTGAGE,3,Low,1,15800, 60 months,2,debt_consolidation,6,High,2,Good Loan,0,19.03,E,5,20.1,16050.99,15800,0,410.13,409000002522,16-Nov-16,6.32E+11,,3000.00,1149573.85,Calabresi,558,France,111687.57,1,1,0
2524,2011,4,RENT,1,Low,1,18000, 36 months,1,credit_card,1,Low,1,Good Loan,0,10.65,B,2,10.66,21102.3147,18000,0,586.32,409000002523,16-Nov-16,6.32E+11,,5000.00,1154573.85,Milano,756,France,184182.25,1,1,0
2525,2011,4,RENT,1,Low,1,6400, 36 months,1,credit_card,1,Low,1,Good Loan,0,8.9,A,1,11.84,7283.720418,6400,0,203.23,409000002524,16-Nov-16,6.32E+11,,3000.00,1157573.85,Kirby,782,Spain,52759.82,1,1,0
2526,2011,8,RENT,1,Low,1,6000, 36 months,1,credit_card,1,Low,1,Good Loan,0,7.51,A,1,17.56,6718.821951,6000,0,186.67,409000002525,16-Nov-16,6.32E+11,,5000.00,1162573.85,Ho,505,France,126451.14,1,1,0
2527,2011,2,RENT,1,Low,1,6000, 36 months,1,debt_consolidation,6,Low,1,Good Loan,0,8.9,A,1,14.71,6857.497853,6000,0,190.52,409000002526,16-Nov-16,6.32E+11,,3000.00,1165573.85,Chukwuemeka,671,Spain,12048.67,1,1,0
2528,2011,4,RENT,1,Low,1,5000, 36 months,1,other,4,Low,1,Good Loan,0,11.71,B,2,9.56,5951.836105,5000,0,165.38,409000002527,16-Nov-16,6.32E+11,,1000.00,1166573.85,Hale,801,France,95804.33,1,1,0
2529,2011,6,MORTGAGE,3,Medium,2,26400, 60 months,2,debt_consolidation,6,High,2,Good Loan,0,19.91,E,5,13.41,34915.94,26399.99,0,698.12,409000002528,17-Nov-16,6.32E+11,,5000.00,1171573.85,K?,604,France,197911.52,1,1,0
2530,2011,1,MORTGAGE,3,Low,1,11300, 36 months,1,debt_consolidation,6,High,2,Good Loan,0,14.65,C,3,5.85,13199.65,11300,0,389.79,409000002529,17-Nov-16,6.32E+11,,3000.00,1174573.85,Rice,716,France,182531.74,1,1,0
2531,2011,5,MORTGAGE,3,Low,1,14000, 36 months,1,debt_consolidation,6,High,2,Good Loan,0,14.27,C,3,8.86,17090.31788,14000,0,480.33,409000002530,17-Nov-16,6.32E+11,,5000.00,1179573.85,Brown,624,France,168002.31,1,1,0
2532,2011,5,OWN,2,Low,1,15000, 36 months,1,credit_card,1,High,2,Good Loan,0,16.29,D,4,22.44,17559.71,15000,0,529.51,409000002531,17-Nov-16,6.32E+11,,11.00,1179584.85,Sagese,607,Germany,79450.61,1,1,0
2533,2011,10,RENT,1,Medium,2,23600, 36 months,1,credit_card,1,High,2,Good Loan,0,13.49,C,3,14.19,28571.82445,23600,0,800.76,409000002532,17-Nov-16,6.32E+11,,1989.00,1181573.85,Aksyonova,827,France,60615.83,1,1,0
2534,2011,1,MORTGAGE,3,Low,1,5100, 36 months,1,debt_consolidation,6,Low,1,Good Loan,0,8.9,A,1,21.57,5829.311425,5100,0,161.95,409000002533,17-Nov-16,6.32E+11,,5000.00,1186573.85,Findlay,606,France,8643.21,1,1,0
2535,2011,0.5,MORTGAGE,3,Low,1,7500, 36 months,1,wedding,5,Low,1,Good Loan,0,8.9,A,1,7.49,8571.882593,7500,0,238.15,409000002534,17-Nov-16,6.32E+11,,3000.00,1189573.85,Walker,717,Germany,172172.70,1,1,0
2536,2011,10,RENT,1,Low,1,10000, 36 months,1,credit_card,1,Low,1,Good Loan,0,10.65,B,2,9.72,11101.01,10000,0,325.74,409000002535,17-Nov-16,6.32E+11,,5000.00,1194573.85,Hao,651,Germany,174434.06,1,1,0
2537,2011,2,RENT,1,Low,1,6000, 36 months,1,debt_consolidation,6,High,2,Good Loan,0,19.42,E,5,15.57,7951.599429,6000,0,221.22,409000002536,17-Nov-16,6.32E+11,,3000.00,1197573.85,Hammer,691,France,194930.30,1,1,0
2538,2011,10,OWN,2,Low,1,2000, 36 months,1,other,4,High,2,Good Loan,0,14.27,C,3,14.92,2365.82,2000,0,68.62,409000002537,17-Nov-16,NEFT/CBINH16322A00296/ASH,,8000.00,1205573.85,Abbott,573,France,137476.71,1,1,0
2539,2011,10,MORTGAGE,3,Low,1,6000, 36 months,1,major_purchase,8,Low,1,Good Loan,0,7.51,A,1,27.73,6718.46986,6000,0,186.67,409000002538,17-Nov-16,NEFT/CBINH16322A00231/NIL,,8000.00,1213573.85,Lucas,723,Spain,94415.60,1,1,0
2540,2011,1,RENT,1,Low,1,18000, 60 months,2,debt_consolidation,6,High,2,Good Loan,0,20.3,E,5,12.87,23495.1,13210.88,0,479.9,409000002539,17-Nov-16,6.32E+11,,5000.00,1218573.85,Davydova,584,Germany,120376.87,1,1,0
2541,2011,3,RENT,1,Low,1,10000, 36 months,1,debt_consolidation,6,High,2,Good Loan,0,16.77,D,4,20.4,10912.62,10000,0,355.39,409000002540,17-Nov-16,6.32E+11,,1000.00,1219573.85,West,550,Germany,97623.42,1,1,0
2542,2011,7,RENT,1,Low,1,24000, 60 months,2,credit_card,1,High,2,Good Loan,0,21.67,F,6,19.93,35160.63307,24000,0,658.36,409000002541,17-Nov-16,6.32E+11,,5000.00,1224573.85,Smith,611,France,66238.23,1,1,0
2543,2011,2,RENT,1,Low,1,10000, 36 months,1,credit_card,1,Low,1,Good Loan,0,12.42,B,2,12.83,10842.74,10000,0,334.16,409000002542,17-Nov-16,6.32E+11,,5000.00,1229573.85,Mai,549,Germany,131710.59,1,1,0
2544,2011,3,RENT,1,Low,1,10000, 36 months,1,credit_card,1,High,2,Good Loan,0,16.77,D,4,21.63,12788.08037,10000,0,355.39,409000002543,18-Nov-16,6.32E+11,,8000.00,1237573.85,Fiorentino,850,Spain,69052.87,1,1,0
2545,2011,10,MORTGAGE,3,Low,1,10175, 36 months,1,credit_card,1,Low,1,Good Loan,0,12.69,B,2,10.79,10964.29,10175,0,341.32,409000002544,18-Nov-16,6.32E+11,,5000.00,1242573.85,Freeman,668,Germany,56780.97,1,1,0
2546,2011,3,RENT,1,Low,1,17000, 60 months,2,debt_consolidation,6,High,2,Bad Loan,1,19.03,E,5,16.84,13560.32,3535.87,5636.36,441.28,409000002545,18-Nov-16,6.32E+11,,3000.00,1245573.85,Nkemjika,686,France,170072.90,1,1,0
2547,2011,8,MORTGAGE,3,Low,1,5600, 36 months,1,debt_consolidation,6,Low,1,Good Loan,0,7.9,A,1,23.85,6307.467716,5600,0,175.23,409000002546,18-Nov-16,6.32E+11,,5000.00,1250573.85,Ramos,660,France,191849.15,1,1,0
2548,2011,0.5,RENT,1,Medium,2,20000, 60 months,2,debt_consolidation,6,High,2,Bad Loan,1,18.25,D,4,9.26,5011.74,1162.52,1082.34,510.6,409000002547,18-Nov-16,6.32E+11,,3000.00,1253573.85,Mario,682,Spain,84803.76,1,1,0
2549,2011,4,RENT,1,Low,1,10000, 36 months,1,credit_card,1,Low,1,Good Loan,0,11.71,B,2,10.99,11903.72471,10000,0,330.76,409000002548,18-Nov-16,6.32E+11,,1.00,1253574.85,Chien,524,France,31840.59,1,1,0
2550,2011,10,RENT,1,Low,1,5600, 36 months,1,debt_consolidation,6,High,2,Good Loan,0,15.27,C,3,4.8,7025.629464,5600,0,194.87,409000002549,18-Nov-16,6.32E+11,,5000.00,1258574.85,Dubinina,645,France,12096.61,1,1,0
2551,2011,10,MORTGAGE,3,Medium,2,2800, 36 months,1,credit_card,1,Low,1,Good Loan,0,10.65,B,2,10.83,3282.190908,2800,0,91.21,409000002550,18-Nov-16,6.32E+11,,3000.00,1261574.85,Wang,850,France,44165.84,1,1,0
2552,2011,2,MORTGAGE,3,Low,1,9600, 36 months,1,small_business,3,Low,1,Good Loan,0,11.71,B,2,11,11364.3317,9600,0,317.53,409000002551,18-Nov-16,6.32E+11,,5000.00,1266574.85,Hsieh,537,France,91406.62,1,1,0
2553,2011,10,MORTGAGE,3,Low,1,24000, 36 months,1,debt_consolidation,6,Low,1,Good Loan,0,6.62,A,1,4.06,25068.93,24000,0,736.89,409000002552,18-Nov-16,6.32E+11,,3000.00,1269574.85,Moran,599,Spain,83282.21,1,1,0
2554,2011,3,MORTGAGE,3,Low,1,18400, 60 months,2,debt_consolidation,6,High,2,Bad Loan,1,14.27,C,3,9.01,8306.54,4865.98,16.34,430.72,409000002553,18-Nov-16,NEFT/PUNBH16323383189/RAJ,,8000.00,1277574.85,Hung,727,Spain,198446.91,1,1,0
2555,2011,10,MORTGAGE,3,Low,1,9000, 36 months,1,debt_consolidation,6,Low,1,Good Loan,0,6.62,A,1,12.93,9946.107889,9000,0,276.34,409000002554,18-Nov-16,6.32E+11,,1.00,1277575.85,Moss,756,Spain,7554.68,1,1,0
2556,2011,10,RENT,1,Low,1,30750, 60 months,2,debt_consolidation,6,High,2,Good Loan,0,19.91,E,5,19.42,41957.28855,30750,0,813.15,409000002555,18-Nov-16,NEFT/PUGBH16323282208/Mr,,8000.00,1285575.85,Fedorova,755,France,80416.16,1,1,0
2557,2011,0.5,RENT,1,Low,1,6000, 36 months,1,debt_consolidation,6,Low,1,Good Loan,0,12.42,B,2,21.64,6918.39,6000,0,200.5,409000002556,18-Nov-16,6.32E+11,,8000.00,1293575.85,Li,634,Spain,164549.74,1,1,0
2558,2011,4,RENT,1,Low,1,5000, 36 months,1,credit_card,1,High,2,Bad Loan,1,15.96,C,3,23.47,1131.44,559.39,254.99,175.69,409000002557,18-Nov-16,6.32E+11,,5000.00,1298575.85,Nebechi,837,France,175477.03,1,1,0
2559,2011,2,MORTGAGE,3,High,3,33600, 60 months,2,debt_consolidation,6,High,2,Good Loan,0,20.3,E,5,13.56,43879.84,24670.65,0,895.82,409000002558,18-Nov-16,6.32E+11,,3000.00,1301575.85,Obialo,727,Germany,137903.54,1,1,0
2560,2011,10,MORTGAGE,3,Low,1,10000, 36 months,1,debt_consolidation,6,Low,1,Good Loan,0,10.65,B,2,9.47,11352.06,10000,0,325.74,409000002559,19-Nov-16,6.32E+11,,5000.00,1306575.85,Bateson,567,Germany,93795.86,1,1,0
2561,2011,8,MORTGAGE,3,Low,1,16800, 60 months,2,debt_consolidation,6,High,2,Bad Loan,1,16.77,D,4,20.57,7427.22,3206.65,796.02,415.45,409000002560,19-Nov-16,6.32E+11,,3000.00,1309575.85,Long,650,Spain,67997.13,1,1,0
2562,2011,7,MORTGAGE,3,Low,1,16550, 60 months,2,other,4,High,2,Good Loan,0,14.65,C,3,9.88,19142.25,12550.41,0,390.69,409000002561,19-Nov-16,6.32E+11,,1.00,1309576.85,Nelson,655,Spain,49492.15,1,1,0
2563,2011,10,MORTGAGE,3,Low,1,12000, 60 months,2,debt_consolidation,6,Low,1,Good Loan,0,11.71,B,2,23.3,12968.6,9231.02,0,265.18,409000002562,19-Nov-16,6.32E+11,,5000.00,1314576.85,Bell,763,France,35825.18,1,1,0
2564,2011,10,MORTGAGE,3,Low,1,22000, 60 months,2,credit_card,1,High,2,Bad Loan,1,14.65,C,3,27.9,22539.65,12430.09,2286.56,519.35,409000002563,19-Nov-16,6.32E+11,,3000.00,1317576.85,Udinese,843,France,67494.23,1,1,0
2565,2011,10,RENT,1,Low,1,10800, 36 months,1,debt_consolidation,6,Low,1,Bad Loan,1,7.51,A,1,16.59,2858.04,1909.16,510.58,336,409000002564,19-Nov-16,6.32E+11,,1.00,1317577.85,Mao,667,France,73963.17,1,1,0
2566,2011,10,RENT,1,Low,1,7200, 36 months,1,credit_card,1,Low,1,Good Loan,0,10.65,B,2,24.55,8441.174256,7200,0,234.53,409000002565,19-Nov-16,6.32E+11,,5000.00,1322577.85,Fanucci,705,France,145159.26,1,1,0
2567,2011,10,MORTGAGE,3,Low,1,10625, 36 months,1,debt_consolidation,6,High,2,Good Loan,0,14.27,C,3,14.74,13119.47931,10625,0,364.54,409000002566,19-Nov-16,6.32E+11,,3000.00,1325577.85,Yeh,660,Germany,123850.58,1,1,0
2568,2011,1,RENT,1,Low,1,5000, 36 months,1,moving,10,High,2,Bad Loan,1,15.96,C,3,2.43,1804.31,1033.87,227.33,175.69,409000002567,19-Nov-16,6.32E+11,,5000.00,1330577.85,Onuoha,553,France,23822.04,1,1,0
2569,2011,8,RENT,1,Low,1,10000, 36 months,1,debt_consolidation,6,High,2,Good Loan,0,15.27,C,3,21.39,10127.51,10000,0,347.98,409000002568,19-Nov-16,6.32E+11,,3000.00,1333577.85,Moore,612,Germany,45750.21,1,1,0
2570,2011,6,RENT,1,Low,1,5000, 36 months,1,other,4,High,2,Good Loan,0,13.49,C,3,23.5,6104.806738,5000,0,169.66,409000002569,19-Nov-16,6.32E+11,,5000.00,1338577.85,Thornton,641,Germany,159773.14,1,1,0
2571,2011,1,MORTGAGE,3,Low,1,8400, 36 months,1,debt_consolidation,6,Low,1,Good Loan,0,6.62,A,1,1.84,9282.618909,8400,0,257.92,409000002570,19-Nov-16,6.32E+11,,3000.00,1341577.85,Warlow-Davies,513,Spain,84238.63,1,1,0
2572,2011,10,RENT,1,Low,1,25000, 60 months,2,small_business,3,High,2,Bad Loan,1,18.64,E,5,5.81,6453.66,2154.63,1309.5,643.58,409000002571,19-Nov-16,6.32E+11,,5000.00,1346577.85,Champion,680,France,72330.46,1,1,0
2573,2011,0.5,RENT,1,Low,1,24000, 60 months,2,major_purchase,8,High,2,Good Loan,0,17.58,D,4,20.48,35499.26002,24000,0,603.98,409000002572,19-Nov-16,6.32E+11,,3000.00,1349577.85,Mazzanti,711,France,26767.85,1,1,0
2574,2011,4,RENT,1,Low,1,4800, 36 months,1,debt_consolidation,6,Low,1,Good Loan,0,7.9,A,1,10.74,4950.02,4800,0,150.2,409000002573,19-Nov-16,NEFT/AXSK163240006111/MAH,,8000.00,1357577.85,Macleod,689,Spain,164768.82,1,1,0
2575,2011,10,MORTGAGE,3,Low,1,14000, 36 months,1,debt_consolidation,6,High,2,Bad Loan,1,14.65,C,3,25.97,3860.27,2599.22,0,482.92,409000002574,19-Nov-16,6.32E+11,,5000.00,1362577.85,Lei,665,Germany,1112.76,1,1,0
2576,2011,10,MORTGAGE,3,Medium,2,7000, 36 months,1,debt_consolidation,6,High,2,Good Loan,0,13.49,C,3,23.6,8546.915969,7000,0,237.52,409000002575,19-Nov-16,6.32E+11,,6.00,1362583.85,Lucchese,551,Germany,176680.16,1,1,0
2577,2011,3,RENT,1,Low,1,15000, 36 months,1,debt_consolidation,6,High,2,Good Loan,0,16.77,D,4,16.13,19183.26089,15000,0,533.08,409000002576,19-Nov-16,6.32E+11,,2994.00,1365577.85,Lombardo,645,Spain,43999.64,1,1,0
2578,2011,7,RENT,1,Low,1,13000, 36 months,1,credit_card,1,Low,1,Good Loan,0,12.42,B,2,7.77,15634.40954,13000,0,434.4,409000002577,19-Nov-16,6.32E+11,,5000.00,1370577.85,William,616,Germany,140746.13,1,1,0
2579,2011,1,MORTGAGE,3,Medium,2,30000, 36 months,1,credit_card,1,High,2,Good Loan,0,14.27,C,3,13.93,31045.7,30000,0,1029.27,409000002578,19-Nov-16,6.32E+11,,3000.00,1373577.85,Wright,582,France,152790.92,1,1,0
2580,2011,4,RENT,1,Low,1,6400, 36 months,1,small_business,3,Low,1,Good Loan,0,8.9,A,1,9.26,7331.059034,6400,0,203.23,409000002579,20-Nov-16,6.33E+11,,5000.00,1378577.85,Ozoemena,365,Germany,81537.85,1,1,0
2581,2011,10,RENT,1,Low,1,5650, 36 months,1,debt_consolidation,6,Low,1,Good Loan,0,9.91,B,2,17.29,6553.05392,5650,0,182.08,409000002580,20-Nov-16,6.33E+11,,3000.00,1381577.85,Boyle,697,Germany,7387.80,1,1,0
2582,2011,7,RENT,1,Low,1,7000, 36 months,1,major_purchase,8,Low,1,Good Loan,0,7.51,A,1,25.56,7838.427268,7000,0,217.78,409000002581,20-Nov-16,6.33E+11,,1.00,1381578.85,Chinwendu,704,France,183038.33,1,1,0
2583,2011,3,RENT,1,Low,1,8500, 36 months,1,debt_consolidation,6,Low,1,Good Loan,0,11.71,B,2,18.43,10115.24738,8500,0,281.15,409000002582,20-Nov-16,6.33E+11,,5000.00,1386578.85,Uwaezuoke,656,France,138849.06,1,1,0
2584,2011,3,MORTGAGE,3,Low,1,28000, 60 months,2,debt_consolidation,6,High,2,Good Loan,0,15.96,C,3,8.32,34868.07,27999.99,0,680.32,409000002583,20-Nov-16,6.33E+11,,3000.00,1389578.85,Archambault,712,France,170333.38,1,1,0
2585,2011,6,RENT,1,Low,1,7000, 36 months,1,credit_card,1,Low,1,Good Loan,0,7.51,A,1,16.72,7838.110382,7000,0,217.78,409000002584,20-Nov-16,6.33E+11,,5000.00,1394578.85,Ko,748,France,60416.76,1,1,0
2586,2011,5,MORTGAGE,3,Low,1,30000, 60 months,2,credit_card,1,High,2,Good Loan,0,20.89,F,6,14.6,37695.74,30000,0,809.75,409000002585,20-Nov-16,6.33E+11,,3000.00,1397578.85,Udegbulam,724,France,100240.20,1,1,0
2587,2011,2,RENT,1,Low,1,20000, 36 months,1,debt_consolidation,6,Low,1,Good Loan,0,12.69,B,2,21.3,21007.07,20000,0,670.9,409000002586,20-Nov-16,6.33E+11,,5000.00,1402578.85,Greene,691,France,2704.98,1,1,0
2588,2011,10,RENT,1,Low,1,6000, 36 months,1,debt_consolidation,6,High,2,Good Loan,0,14.27,C,3,21.94,7407.928406,6000,0,205.86,409000002587,20-Nov-16,6.33E+11,,3000.00,1405578.85,Hunter,563,France,68815.05,1,1,0
2589,2011,9,MORTGAGE,3,Low,1,10000, 36 months,1,car,2,Low,1,Good Loan,0,7.9,A,1,15.12,11082.15,10000,0,312.91,409000002588,20-Nov-16,6.33E+11,,5000.00,1410578.85,Blinova,741,France,64839.23,1,1,0
2590,2011,5,RENT,1,Low,1,12000, 36 months,1,debt_consolidation,6,Low,1,Good Loan,0,7.9,A,1,18.2,13479.30114,12000,0,375.49,409000002589,20-Nov-16,6.33E+11,,3000.00,1413578.85,De Garis,778,France,144494.94,1,1,0
2591,2011,0.5,MORTGAGE,3,Low,1,12500, 60 months,2,home_improvement,7,High,2,Good Loan,0,21.28,F,6,5.48,18599.44168,12500,0,340.14,409000002590,21-Nov-16,6.33E+11,,5000.00,1418578.85,Okwudiliolisa,848,Spain,185510.34,1,1,0
2592,2011,10,MORTGAGE,3,Low,1,15000, 60 months,2,car,2,Low,1,Good Loan,0,10.65,B,2,26.61,15818.39,11601.24,0,323.53,409000002591,21-Nov-16,6.33E+11,,3000.00,1421578.85,Ts'ai,634,Germany,56055.72,1,1,0
2593,2011,6,RENT,1,Low,1,16450, 60 months,2,credit_card,1,High,2,Good Loan,0,17.27,D,4,24.85,20163.98,12358.93,0,411.22,409000002592,21-Nov-16,6.33E+11,,5000.00,1426578.85,Tuan,505,Germany,155061.97,1,1,0
2594,2011,0.5,RENT,1,Low,1,2500, 36 months,1,other,4,High,2,Good Loan,0,15.27,C,3,21.61,2809.91,2500,0,87,409000002593,21-Nov-16,6.33E+11,,3000.00,1429578.85,Tseng,692,Germany,119817.19,1,1,0
2595,2011,0.5,OWN,2,Low,1,6200, 36 months,1,major_purchase,8,Low,1,Good Loan,0,7.9,A,1,7.6,6983.097569,6200,0,194,409000002594,21-Nov-16,6.33E+11,,5000.00,1434578.85,Holmwood,537,Germany,16259.64,1,1,0
2596,2011,10,RENT,1,Low,1,12000, 36 months,1,credit_card,1,Low,1,Good Loan,0,12.69,B,2,22.66,14301.98735,12000,0,402.54,409000002595,21-Nov-16,6.33E+11,,3000.00,1437578.85,Thompson,633,France,184654.87,1,1,0
2597,2011,2,RENT,1,Low,1,10000, 36 months,1,credit_card,1,High,2,Good Loan,0,14.27,C,3,4.93,12346.40481,10000,0,343.09,409000002596,21-Nov-16,6.33E+11,,5000.00,1442578.85,Y?,833,France,5278.78,1,1,0
2598,2011,10,OWN,2,Low,1,4800, 36 months,1,debt_consolidation,6,High,2,Good Loan,0,16.29,D,4,16.72,5700.99,4800,0,169.45,409000002597,21-Nov-16,6.33E+11,,3000.00,1445578.85,Chidubem,592,Spain,113244.73,1,1,0
2599,2011,7,MORTGAGE,3,Low,1,17050, 36 months,1,debt_consolidation,6,Low,1,Good Loan,0,12.69,B,2,20.84,19175.71,17050,0,571.94,409000002598,21-Nov-16,6.33E+11,,5000.00,1450578.85,Trevisani,587,Spain,8908.00,1,1,0
2600,2011,10,MORTGAGE,3,Low,1,15000, 60 months,2,debt_consolidation,6,High,2,Good Loan,0,22.74,G,7,22.32,20601.8,10855.26,0,420.62,409000002599,21-Nov-16,6.33E+11,,3000.00,1453578.85,Hsiung,550,Spain,64490.67,1,1,0
2601,2011,3,RENT,1,Low,1,12700, 36 months,1,debt_consolidation,6,High,2,Good Loan,0,14.27,C,3,10.07,15502.51571,12700,0,435.73,409000002600,21-Nov-16,6.33E+11,,5000.00,1458578.85,Randall,680,France,154971.63,1,1,0
2602,2011,5,MORTGAGE,3,Medium,2,35000, 60 months,2,debt_consolidation,6,High,2,Good Loan,0,19.91,E,5,10.9,52570.9673,35000,0,925.54,409000002601,21-Nov-16,6.33E+11,,3000.00,1461578.85,Leach,622,Spain,155786.39,1,1,0
2603,2011,5,MORTGAGE,3,Low,1,12000, 60 months,2,home_improvement,7,High,2,Bad Loan,1,20.3,E,5,14.65,13486.9,5503.11,2330.6,319.94,409000002602,21-Nov-16,6.33E+11,,5000.00,1466578.85,Godfrey,594,Germany,129084.82,1,1,0
2604,2011,2,RENT,1,Low,1,15000, 60 months,2,debt_consolidation,6,High,2,Good Loan,0,19.91,E,5,20.82,21534.08279,15000,0,396.66,409000002603,21-Nov-16,6.33E+11,,3000.00,1469578.85,Wallace,643,Germany,188533.11,1,1,0
2605,2011,0.5,RENT,1,Low,1,24000, 60 months,2,credit_card,1,High,2,Good Loan,0,19.03,E,5,17.67,27277.6,24000,0,622.97,409000002604,21-Nov-16,6.33E+11,,5000.00,1474578.85,Wei,540,France,13411.67,1,1,0
2606,2011,10,MORTGAGE,3,Medium,2,35000, 60 months,2,credit_card,1,High,2,Good Loan,0,19.42,E,5,16.72,44858.17,25824.6,0,916.03,409000002605,21-Nov-16,6.33E+11,,3000.00,1477578.85,Mitchell,635,Spain,15733.19,1,1,0
2607,2011,2,RENT,1,Low,1,11200, 36 months,1,debt_consolidation,6,High,2,Good Loan,0,17.27,D,4,14.07,14425.29454,11200,0,400.82,409000002606,21-Nov-16,6.33E+11,,5000.00,1482578.85,Light,657,France,73127.61,1,1,0
2608,2011,10,RENT,1,Low,1,7000, 36 months,1,credit_card,1,Low,1,Good Loan,0,11.71,B,2,24.24,8332.988094,7000,0,231.54,409000002607,21-Nov-16,6.33E+11,,3000.00,1485578.85,Capon,814,France,101704.19,1,1,0
2609,2011,8,RENT,1,Low,1,6200, 60 months,2,credit_card,1,High,2,Good Loan,0,19.42,E,5,11.35,8814.416618,6200,0,162.27,409000002608,22-Nov-16,6.33E+11,,5000.00,1490578.85,Hou,600,France,101986.16,1,1,0
2610,2011,10,MORTGAGE,3,Low,1,20000, 60 months,2,credit_card,1,High,2,Good Loan,0,15.96,C,3,23.54,28535.32655,20000,0,485.94,409000002609,22-Nov-16,6.33E+11,,3000.00,1493578.85,Rowe,682,France,114442.66,1,1,0
2611,2011,10,RENT,1,Low,1,35000, 60 months,2,debt_consolidation,6,High,2,Bad Loan,1,23.91,G,7,21.92,26027.59,8325.13,3918.69,1005.06,409000002610,22-Nov-16,6.33E+11,,8000.00,1501578.85,Holloway,682,France,15669.17,1,1,0
2612,2011,10,RENT,1,Low,1,12000, 36 months,1,credit_card,1,High,2,Good Loan,0,16.77,D,4,11.78,14216.77,12000,0,426.47,409000002611,22-Nov-16,6.33E+11,,5000.00,1506578.85,O'Sullivan,566,France,157486.10,1,1,0
2613,2011,6,RENT,1,Low,1,8500, 60 months,2,debt_consolidation,6,High,2,Good Loan,0,20.3,E,5,10.6,13327.19002,8500,0,226.62,409000002612,22-Nov-16,6.33E+11,,3000.00,1509578.85,Udinesi,550,Spain,131281.28,1,1,0
2614,2011,8,RENT,1,Low,1,12000, 36 months,1,credit_card,1,Low,1,Good Loan,0,6.62,A,1,9.89,13231.22796,12000,0,368.45,409000002613,22-Nov-16,6.33E+11,,5000.00,1514578.85,Nwebube,630,France,197001.15,1,1,0
2615,2011,9,RENT,1,Low,1,12000, 60 months,2,debt_consolidation,6,High,2,Good Loan,0,13.49,C,3,24.82,16298.59997,12000,0,276.06,409000002614,22-Nov-16,6.33E+11,,3000.00,1517578.85,Chibueze,546,Germany,128881.87,1,1,0
2616,2011,10,RENT,1,Low,1,20000, 60 months,2,credit_card,1,High,2,Bad Loan,1,17.27,D,4,23.08,19014.33,9141.54,1515.49,499.96,409000002615,22-Nov-16,6.33E+11,,5000.00,1522578.85,Walker,486,France,85101.00,1,1,0
2617,2011,1,RENT,1,Low,1,10400, 36 months,1,debt_consolidation,6,High,2,Good Loan,0,13.49,C,3,22.62,12676.4357,10400,0,352.88,409000002616,22-Nov-16,6.33E+11,,3000.00,1525578.85,Gregory,762,Spain,149822.04,1,1,0
2618,2011,2,RENT,1,Low,1,5000, 36 months,1,wedding,5,Low,1,Good Loan,0,12.69,B,2,12.87,6037.853138,5000,0,167.73,409000002617,22-Nov-16,6.33E+11,,5000.00,1530578.85,Kuo,692,Germany,108040.86,1,1,0
2619,2011,8,RENT,1,Low,1,8400, 36 months,1,debt_consolidation,6,High,2,Good Loan,0,17.27,D,4,12.85,10818.18642,8400,0,300.62,409000002618,22-Nov-16,6.33E+11,,3000.00,1533578.85,Wilson,498,France,135795.53,1,1,0
2620,2011,10,MORTGAGE,3,Low,1,24000, 60 months,2,debt_consolidation,6,High,2,Good Loan,0,21.67,F,6,18.02,32132.06,24000,0,658.36,409000002619,22-Nov-16,6.33E+11,,5000.00,1538578.85,Lanford,850,Spain,25867.67,1,1,0
2621,2011,6,RENT,1,Low,1,20000, 36 months,1,debt_consolidation,6,Low,1,Good Loan,0,12.42,B,2,26.4,22707.93,19999.99,0,668.31,409000002620,22-Nov-16,6.33E+11,,5000.00,1543578.85,Meng,603,France,130483.56,1,1,0
2622,2011,6,MORTGAGE,3,Low,1,12300, 60 months,2,credit_card,1,High,2,Good Loan,0,19.91,E,5,24.91,15956.03,9051.07,0,325.26,409000002621,22-Nov-16,6.33E+11,,3000.00,1546578.85,Yeh,551,France,183479.12,1,1,0
2623,2011,10,RENT,1,Low,1,11000, 36 months,1,home_improvement,7,High,2,Good Loan,0,13.49,C,3,11.02,13431.43347,11000,0,373.24,409000002622,22-Nov-16,6.33E+11,,3000.00,1549578.85,Onwuatuegwu,627,Germany,77027.34,1,1,0
2624,2011,3,MORTGAGE,3,Low,1,18950, 60 months,2,credit_card,1,High,2,Good Loan,0,19.03,E,5,13.99,28083.63009,18950,0,491.89,409000002623,22-Nov-16,NEFT/SBIN216327754744/Mr,,8000.00,1557578.85,Goliwe,515,France,94141.75,1,1,0
2625,2011,10,RENT,1,Low,1,12000, 36 months,1,debt_consolidation,6,Low,1,Good Loan,0,11.71,B,2,13.37,13044.05,12000,0,396.92,409000002624,22-Nov-16,6.33E+11,,5000.00,1562578.85,Anthony,605,Spain,4092.75,1,1,0
2626,2011,2,OWN,2,Low,1,20000, 36 months,1,debt_consolidation,6,Low,1,Good Loan,0,11.71,B,2,15.98,23806.92441,20000,0,661.52,409000002625,22-Nov-16,6.33E+11,,3000.00,1565578.85,Scott,567,Germany,109257.59,1,1,0
2627,2011,4,RENT,1,Low,1,3650, 60 months,2,debt_consolidation,6,High,2,Good Loan,0,17.58,D,4,12.5,4485.73,2712.84,0,91.86,409000002626,22-Nov-16,6.33E+11,,5000.00,1570578.85,Genovese,568,Germany,104617.99,1,1,0
2628,2011,0.5,RENT,1,Medium,2,12000, 36 months,1,credit_card,1,High,2,Bad Loan,1,14.27,C,3,13.71,14285.06,11170.88,186.65,411.71,409000002627,22-Nov-16,6.33E+11,,3000.00,1573578.85,Onyeorulu,571,Germany,167705.07,1,1,0
2629,2011,10,RENT,1,Low,1,7200, 36 months,1,debt_consolidation,6,High,2,Good Loan,0,17.58,D,4,8.64,9181.088804,7200,0,258.79,409000002628,22-Nov-16,NEFT/MAHBH16327500557/SAI,,8000.00,1581578.85,Myers,634,Germany,103712.05,1,1,0
2630,2011,7,MORTGAGE,3,Low,1,33950, 36 months,1,debt_consolidation,6,Low,1,Good Loan,0,7.9,A,1,24.71,38240.96728,33950,0,1062.31,409000002629,22-Nov-16,6.33E+11,,5000.00,1586578.85,Davey,768,Spain,161242.99,1,1,0
2631,2011,4,MORTGAGE,3,Low,1,13000, 60 months,2,debt_consolidation,6,High,2,Good Loan,0,15.96,C,3,8.27,17047.74,11480.4,0,315.86,409000002630,22-Nov-16,6.33E+11,,3000.00,1589578.85,Parsons,554,Germany,6089.13,1,1,0
2632,2011,2,RENT,1,Low,1,12600, 60 months,2,debt_consolidation,6,High,2,Good Loan,0,16.77,D,4,20.22,15306.23,12600.01,0,311.59,409000002631,22-Nov-16,6.33E+11,,5000.00,1594578.85,Chikere,629,France,159777.37,1,1,0
2633,2011,0.5,RENT,1,Low,1,15000, 36 months,1,debt_consolidation,6,Low,1,Good Loan,0,11.71,B,2,15.56,17437.23,15000,0,496.14,409000002632,22-Nov-16,6.33E+11,,3000.00,1597578.85,Hs?eh,638,Spain,7919.08,1,1,0
2634,2011,7,RENT,1,Low,1,4250, 36 months,1,credit_card,1,Low,1,Good Loan,0,12.69,B,2,9.26,5076.207234,4250,0,142.57,409000002633,22-Nov-16,IB:  OFT TO XX5051 INTERN,,8000.00,1605578.85,Sal,576,France,188274.60,1,1,0
2635,2011,5,RENT,1,Low,1,7000, 36 months,1,credit_card,1,Low,1,Good Loan,0,9.91,B,2,5.01,7141.6,7000,0,225.58,409000002634,22-Nov-16,NEFT/BARBH16327549610/RAJ,,8000.00,1613578.85,Ts'ai,661,Spain,27608.12,1,1,0
2636,2011,10,MORTGAGE,3,Low,1,1500, 36 months,1,small_business,3,High,2,Good Loan,0,15.96,C,3,19.63,1629.76,1500,0,52.71,409000002635,23-Nov-16,6.33E+11,,1.00,1613579.85,Witt,592,France,183569.25,1,1,0
2637,2011,10,MORTGAGE,3,Medium,2,25000, 36 months,1,home_improvement,7,Low,1,Good Loan,0,7.9,A,1,0,25634.55,25000,0,782.26,409000002636,23-Nov-16,6.33E+11,,8000.00,1621579.85,Skelton,702,Spain,145537.32,1,1,0
2638,2011,5,RENT,1,Low,1,15600, 60 months,2,debt_consolidation,6,High,2,Good Loan,0,20.3,E,5,18.9,22015.3679,15600,0,415.92,409000002637,23-Nov-16,6.33E+11,,5000.00,1626579.85,Kazantseva,647,France,164717.95,1,1,0
2639,2011,10,RENT,1,Medium,2,21000, 60 months,2,debt_consolidation,6,High,2,Good Loan,0,18.64,E,5,13.57,31237.28891,21000,0,540.61,409000002638,23-Nov-16,6.33E+11,,3000.00,1629579.85,Bowhay,593,France,76357.43,1,1,0
2640,2011,7,RENT,1,Low,1,20000, 60 months,2,debt_consolidation,6,Low,1,Good Loan,0,12.69,B,2,15.53,25352.87783,20000,0,451.9,409000002639,23-Nov-16,6.33E+11,,5000.00,1634579.85,Beyer,712,Germany,120158.72,1,1,0
2641,2011,3,MORTGAGE,3,Low,1,20000, 60 months,2,credit_card,1,High,2,Bad Loan,1,13.49,C,3,20.62,5437.62,2212.41,1021.45,460.1,409000002640,23-Nov-16,6.33E+11,,3000.00,1637579.85,Fries,625,Spain,151843.54,1,1,0
2642,2011,5,RENT,1,Low,1,12000, 36 months,1,debt_consolidation,6,Low,1,Good Loan,0,8.9,A,1,16.03,13153.92,12000,0,381.04,409000002641,23-Nov-16,6.33E+11,,5000.00,1642579.85,Tao,538,Germany,5698.97,1,1,0
2643,2011,10,RENT,1,Low,1,10000, 36 months,1,credit_card,1,Low,1,Good Loan,0,12.69,B,2,10.16,11949.64687,10000,0,335.45,409000002642,23-Nov-16,6.33E+11,,3000.00,1645579.85,Kaodilinakachukwu,637,Spain,122865.55,1,1,0
2644,2011,10,MORTGAGE,3,Low,1,5800, 60 months,2,debt_consolidation,6,High,2,Good Loan,0,19.03,E,5,17.44,8222.82673,5800,0,150.56,409000002643,23-Nov-16,6.33E+11,,1.00,1645580.85,Ni,632,France,152665.85,1,1,0
2645,2011,3,RENT,1,Low,1,2400, 36 months,1,moving,10,Low,1,Good Loan,0,12.42,B,2,16.4,2866.251111,2400,0,80.2,409000002644,23-Nov-16,6.33E+11,,5000.00,1650580.85,Hsueh,736,France,192131.77,1,1,0
2646,2011,9,RENT,1,Low,1,28100, 60 months,2,debt_consolidation,6,High,2,Good Loan,0,14.65,C,3,24.16,30429.76,28100,0,663.35,409000002645,23-Nov-16,6.33E+11,,3000.00,1653580.85,Connely,755,France,62851.60,1,1,0
2647,2011,10,MORTGAGE,3,Low,1,4500, 36 months,1,credit_card,1,Low,1,Good Loan,0,6.62,A,1,15.77,4524.97,4500,0,138.17,409000002646,23-Nov-16,6.33E+11,,5000.00,1658580.85,Becker,425,Spain,140941.47,1,1,0
2648,2011,1,RENT,1,Low,1,4800, 36 months,1,credit_card,1,Low,1,Good Loan,0,10.65,B,2,11.82,5623.477264,4800,0,156.36,409000002647,23-Nov-16,6.33E+11,,3000.00,1661580.85,Clayton,461,France,56767.67,1,1,0
2649,2011,6.05,MORTGAGE,3,Low,1,5000, 36 months,1,debt_consolidation,6,Low,1,Good Loan,0,7.9,A,1,17.16,5631.690323,5000,0,156.46,409000002648,23-Nov-16,6.33E+11,,5000.00,1666580.85,Connolly,745,France,177235.23,1,1,0
2650,2011,9,RENT,1,Low,1,18000, 36 months,1,debt_consolidation,6,Low,1,Good Loan,0,10.65,B,2,10.64,21102.89414,18000,0,586.32,409000002649,23-Nov-16,6.33E+11,,3000.00,1669580.85,Graham,616,France,86242.18,1,1,0
2651,2011,10,MORTGAGE,3,Low,1,25000, 36 months,1,debt_consolidation,6,Low,1,Good Loan,0,7.51,A,1,15.48,27860.82645,25000,0,777.78,409000002650,23-Nov-16,6.33E+11,,8000.00,1677580.85,Ch'ien,587,France,34215.58,1,1,0
2652,2011,2,MORTGAGE,3,Medium,2,18000, 36 months,1,debt_consolidation,6,Low,1,Good Loan,0,7.9,A,1,2.69,20274.40053,18000,0,563.23,409000002651,23-Nov-16,6.33E+11,,5000.00,1682580.85,Manfrin,850,Germany,44406.17,1,1,0
2653,2011,4,RENT,1,Low,1,6000, 36 months,1,credit_card,1,High,2,Good Loan,0,15.96,C,3,4.15,7100.23,6000,0,210.83,409000002652,23-Nov-16,6.33E+11,,3000.00,1685580.85,Kuo,601,France,165196.65,1,1,0
2654,2011,10,RENT,1,Medium,2,35000, 60 months,2,credit_card,1,High,2,Bad Loan,1,22.35,F,6,12.95,46850.28,24581.94,0,973.64,409000002653,23-Nov-16,6.33E+11,,5000.00,1690580.85,Fomin,730,Spain,34542.41,1,1,0
2655,2011,5,RENT,1,Low,1,27000, 36 months,1,debt_consolidation,6,High,2,Good Loan,0,13.49,C,3,19.59,32971.7865,27000,0,916.13,409000002654,23-Nov-16,6.33E+11,,3000.00,1693580.85,Chamberlain,532,France,74838.64,1,1,0
2656,2011,10,RENT,1,Low,1,3000, 36 months,1,major_purchase,8,Low,1,Good Loan,0,9.91,B,2,8,3462.693814,3000,0,96.68,409000002655,23-Nov-16,6.33E+11,,5000.00,1698580.85,Barber,850,Germany,36980.54,1,1,0
2657,2011,1,RENT,1,Low,1,10000, 36 months,1,debt_consolidation,6,Low,1,Good Loan,0,10.65,B,2,24.19,11664.22727,10000,0,325.74,409000002656,23-Nov-16,6.33E+11,,3000.00,1701580.85,Zimmer,779,Spain,111676.63,1,1,0
2658,2011,4,RENT,1,Low,1,10125, 36 months,1,debt_consolidation,6,High,2,Good Loan,0,14.65,C,3,8.13,12571.54178,10125,0,349.26,409000002657,23-Nov-16,6.33E+11,,5000.00,1706580.85,Brazenor,562,France,25858.68,1,1,0
2659,2011,8,MORTGAGE,3,Low,1,8000, 36 months,1,debt_consolidation,6,Low,1,Good Loan,0,12.42,B,2,24.92,9621.881036,8000,0,267.33,409000002658,23-Nov-16,6.33E+11,,3000.00,1709580.85,Cocci,670,Germany,177028.00,1,1,0
2660,2011,6,RENT,1,Low,1,10000, 36 months,1,debt_consolidation,6,Low,1,Good Loan,0,9.91,B,2,7.63,11255.25,10000,0,322.25,409000002659,23-Nov-16,6.33E+11,,5000.00,1714580.85,Caldwell,729,France,30990.16,1,1,0
2661,2011,0.5,RENT,1,Medium,2,35000, 60 months,2,other,4,High,2,Good Loan,0,14.27,C,3,1.99,47749.74334,35000,0,819.3,409000002660,23-Nov-16,6.33E+11,,3000.00,1717580.85,Yirawala,767,France,136915.15,1,1,0
2662,2011,7,MORTGAGE,3,Low,1,21600, 60 months,2,home_improvement,7,High,2,Good Loan,0,21.67,F,6,12.49,23541.77,21600,0,592.53,409000002661,23-Nov-16,6.33E+11,,5000.00,1722580.85,Donaldson,742,France,108457.99,1,1,0
2663,2011,3,RENT,1,Medium,2,12000, 36 months,1,debt_consolidation,6,Low,1,Good Loan,0,10.65,B,2,11.88,14069.54572,12000,0,390.88,409000002662,23-Nov-16,6.33E+11,,3000.00,1725580.85,Ozerova,669,France,131609.48,1,1,0
2664,2011,10,RENT,1,Low,1,6000, 36 months,1,debt_consolidation,6,High,2,Good Loan,0,15.27,C,3,23.29,6076.55,6000,0,208.79,409000002663,23-Nov-16,6.33E+11,,5000.00,1730580.85,Bruce,542,Spain,159737.56,1,1,0
2665,2011,6,OWN,2,Low,1,14000, 36 months,1,credit_card,1,High,2,Good Loan,0,16.29,D,4,12.26,17788.6986,14000,0,494.21,409000002664,23-Nov-16,6.33E+11,,6.00,1730586.85,Kang,586,France,142238.54,1,1,0
2666,2011,0.5,RENT,1,Low,1,8000, 36 months,1,credit_card,1,High,2,Good Loan,0,14.27,C,3,19.34,9877.715403,8000,0,274.48,409000002665,23-Nov-16,6.33E+11,,2994.00,1733580.85,Rossi,612,Germany,105890.55,1,1,0
2667,2011,1,RENT,1,Low,1,14000, 60 months,2,debt_consolidation,6,High,2,Good Loan,0,13.49,C,3,19.77,15765.05,10675.65,0,322.07,409000002666,23-Nov-16,6.33E+11,,5000.00,1738580.85,Ts'ai,740,France,194270.91,1,1,0
2668,2011,5,MORTGAGE,3,Low,1,8000, 36 months,1,debt_consolidation,6,Low,1,Good Loan,0,12.69,B,2,10.55,9657.747517,8000,0,268.36,409000002667,23-Nov-16,6.33E+11,,3000.00,1741580.85,Moran,584,France,105443.47,1,1,0
2669,2011,5,RENT,1,Medium,2,21000, 36 months,1,small_business,3,Low,1,Good Loan,0,8.9,A,1,2.94,22824.54,21000,0,666.82,409000002668,23-Nov-16,NEFT/IBKL161123081134/SAC,,8000.00,1749580.85,Jennings,524,France,173899.42,1,1,0
2670,2011,10,MORTGAGE,3,Low,1,22000, 60 months,2,debt_consolidation,6,Low,1,Bad Loan,1,11.71,B,2,18.45,20596.97,12394.78,2158.39,486.16,409000002669,23-Nov-16,6.33E+11,,5000.00,1754580.85,Tokareva,614,France,122823.34,1,1,0
2671,2011,2,RENT,1,Low,1,6000, 36 months,1,house,12,High,2,Good Loan,0,15.96,C,3,18.25,7147.69,6000,0,210.83,409000002670,23-Nov-16,6.33E+11,,3000.00,1757580.85,Pagnotto,598,France,13181.37,1,1,0
2672,2011,1,RENT,1,Medium,2,15000, 36 months,1,debt_consolidation,6,High,2,Good Loan,0,17.58,D,4,6.91,19323.37474,15000,0,539.14,409000002671,23-Nov-16,NEFT/BKIDN16328518534/SHR,,8000.00,1765580.85,Castella,799,Spain,140780.80,1,1,0
2673,2011,4,RENT,1,Low,1,5200, 36 months,1,debt_consolidation,6,Low,1,Good Loan,0,11.71,B,2,5.58,6131.876659,5200,0,172,409000002672,24-Nov-16,6.33E+11,,5000.00,1770580.85,Du Cane,724,France,78560.64,1,1,0
2674,2011,10,MORTGAGE,3,Low,1,17500, 36 months,1,credit_card,1,Low,1,Good Loan,0,7.9,A,1,11.43,19710.8289,17500,0,547.58,409000002673,24-Nov-16,6.33E+11,,3000.00,1773580.85,Ferguson,601,France,185855.21,1,1,0
2675,2011,2,RENT,1,Low,1,6400, 36 months,1,debt_consolidation,6,Low,1,Good Loan,0,11.71,B,2,15.84,7385.13,6400,0,211.69,409000002674,24-Nov-16,6.33E+11,,5000.00,1778580.85,Odinakachukwu,804,France,128276.95,1,1,0
2676,2011,3,MORTGAGE,3,Low,1,3825, 36 months,1,debt_consolidation,6,Low,1,Good Loan,0,10.65,B,2,9.65,4286.47,3825,0,124.6,409000002675,24-Nov-16,6.33E+11,,3000.00,1781580.85,Woronoff,745,Germany,140197.42,1,1,0
2677,2011,3,OWN,2,Low,1,21000, 36 months,1,debt_consolidation,6,Low,1,Good Loan,0,7.9,A,1,13.6,23273.18,21000,0,657.1,409000002676,24-Nov-16,NEFT/SBIN316329772877/M S,,8000.00,1789580.85,Meng,667,Germany,32462.39,1,1,0
2678,2011,9,MORTGAGE,3,Low,1,14000, 36 months,1,credit_card,1,Low,1,Good Loan,0,12.42,B,2,19.8,16627.53535,14000,0,467.82,409000002677,24-Nov-16,NEFT/SBIN316329804113/Mr,,8000.00,1797580.85,Sinclair,518,France,162253.90,1,1,0
2679,2011,10,RENT,1,Low,1,18950, 36 months,1,other,4,Low,1,Good Loan,0,10.65,B,2,18.94,22218.36141,18950,0,617.27,409000002678,24-Nov-16,NEFT/SBIN316329788979/M S,,8000.00,1805580.85,Hsu,819,France,30498.70,1,1,0
2680,2011,6,OWN,2,Low,1,3000, 36 months,1,home_improvement,7,Low,1,Good Loan,0,9.91,B,2,8.19,3478.77073,3000,0,96.68,409000002679,24-Nov-16,6.33E+11,,5000.00,1810580.85,Panicucci,520,Spain,90280.70,1,1,0
2681,2011,5,OWN,2,Low,1,2400, 36 months,1,vacation,11,Low,1,Bad Loan,1,12.69,B,2,15.28,2817.85,2310.05,13.26,80.51,409000002680,24-Nov-16,6.33E+11,,3000.00,1813580.85,Burns,625,France,32615.21,1,1,0
2682,2011,5,OWN,2,Low,1,6000, 36 months,1,other,4,Low,1,Good Loan,0,12.69,B,2,18.06,6905.04,6000,0,201.27,409000002681,24-Nov-16,NEFT/000017885305/VINITA,,8000.00,1821580.85,Onodugoadiegbemma,673,Germany,196142.26,1,1,0
2683,2011,5,MORTGAGE,3,Medium,2,16000, 60 months,2,debt_consolidation,6,High,2,Good Loan,0,18.64,E,5,10.77,24033.26,16000,0,411.89,409000002682,24-Nov-16,NEFT/BKIDN16329563035/VIS,,8000.00,1829580.85,Darling,656,Germany,16998.72,1,1,0
2684,2011,10,RENT,1,Low,1,18000, 36 months,1,credit_card,1,Low,1,Good Loan,0,12.42,B,2,7.4,20437.53,18000,0,601.48,409000002683,24-Nov-16,NEFT/MAHBH16329549188/Mr.,,8000.00,1837580.85,Maggard,850,Spain,62980.96,1,1,0
2685,2011,5,RENT,1,Low,1,10000, 36 months,1,credit_card,1,High,2,Good Loan,0,16.29,D,4,14.11,12706.40383,10000,0,353.01,409000002684,24-Nov-16,6.33E+11,,5000.00,1842580.85,Thomas,574,Spain,185660.30,1,1,0
2686,2011,6,RENT,1,Low,1,2125, 36 months,1,debt_consolidation,6,High,2,Good Loan,0,15.27,C,3,14.95,2661.97,2124.99,0,73.95,409000002685,24-Nov-16,6.33E+11,,5000.00,1847580.85,Lettiere,679,France,77331.77,1,1,0
2687,2011,5,RENT,1,Low,1,7500, 36 months,1,debt_consolidation,6,Low,1,Bad Loan,1,7.9,A,1,29.29,3049.02,2504.96,0,234.68,409000002686,24-Nov-16,6.33E+11,,3000.00,1850580.85,Ponomaryov,530,Germany,97338.62,1,1,0
2688,2011,4,MORTGAGE,3,Low,1,10000, 36 months,1,small_business,3,Low,1,Good Loan,0,6.62,A,1,2.59,10677.42,10000,0,307.04,409000002687,24-Nov-16,NEFT/SBIN316329943138/MOH,,8000.00,1858580.85,Oliver,508,France,67234.33,1,1,0
2689,2011,10,MORTGAGE,3,Low,1,21000, 60 months,2,small_business,3,Low,1,Good Loan,0,12.42,B,2,7.35,23096.67,16113.53,0,471.61,409000002688,24-Nov-16,NEFT/SBIN316329943719/PAR,,8000.00,1866580.85,Chienezie,558,Germany,143783.28,1,1,0
2690,2011,2,RENT,1,High,3,25000, 36 months,1,credit_card,1,High,2,Good Loan,0,13.49,C,3,10.78,30527.36207,25000,0,848.27,409000002689,24-Nov-16,6.33E+11,,8000.00,1874580.85,Mao,414,France,77661.12,1,1,0
2691,2011,10,RENT,1,Low,1,16000, 36 months,1,credit_card,1,Low,1,Good Loan,0,9.91,B,2,14.46,18331.89,16000,0,515.6,409000002690,24-Nov-16,6.33E+11,,1.00,1874581.85,Ho,648,Spain,89123.99,1,1,0
2692,2011,7,MORTGAGE,3,Low,1,20000, 36 months,1,small_business,3,Low,1,Good Loan,0,7.9,A,1,21.42,22264.23,20000,0,625.81,409000002691,24-Nov-16,6.33E+11,,5000.00,1879581.85,Lucchese,721,France,70810.80,1,1,0
2693,2011,10,RENT,1,Medium,2,3600, 36 months,1,debt_consolidation,6,High,2,Good Loan,0,14.27,C,3,2.89,3914.2,3600,0,123.52,409000002692,24-Nov-16,6.33E+11,,3000.00,1882581.85,Prokhorova,751,France,17550.49,1,1,0
2694,2011,5,RENT,1,Low,1,20000, 60 months,2,debt_consolidation,6,High,2,Good Loan,0,18.25,D,4,0.07,24980.4,14845.31,0,510.6,409000002693,24-Nov-16,6.33E+11,,5000.00,1887581.85,Alekseyeva,662,France,21497.27,1,1,0
2695,2011,10,RENT,1,Low,1,24000, 60 months,2,credit_card,1,High,2,Good Loan,0,19.03,E,5,23.74,30483.93,17737.13,0,622.97,409000002694,24-Nov-16,6.33E+11,,3000.00,1890581.85,Blacklock,628,Germany,124749.08,1,1,0
2696,2011,2,RENT,1,Low,1,19075, 60 months,2,debt_consolidation,6,High,2,Good Loan,0,20.3,E,5,22.75,24944.44,14000.18,0,508.57,409000002695,25-Nov-16,6.33E+11,,3000.00,1893581.85,Sazonova,597,Germany,36051.46,1,1,0
2697,2011,4,RENT,1,Low,1,10000, 60 months,2,debt_consolidation,6,High,2,Good Loan,0,18.64,E,5,12.19,13332.05,10000,0,257.43,409000002696,25-Nov-16,6.33E+11,,5000.00,1898581.85,Henty,698,Spain,143681.83,1,1,0
2698,2011,1,RENT,1,Low,1,8000, 36 months,1,credit_card,1,Low,1,Good Loan,0,11.71,B,2,15.74,8460.69,8000,0,264.61,409000002697,25-Nov-16,6.33E+11,,3000.00,1901581.85,Li,723,France,150694.58,1,1,0
2699,2011,6.05,RENT,1,Low,1,1000, 36 months,1,debt_consolidation,6,High,2,Good Loan,0,14.65,C,3,17.16,1241.384368,1000,0,34.5,409000002698,25-Nov-16,TRF TO  Indiaforensic SERVICES I,"1,450,000.00",,451581.85,Azuka,586,France,170487.40,1,1,0
2700,2011,1,MORTGAGE,3,Low,1,4000, 36 months,1,credit_card,1,Low,1,Good Loan,0,8.9,A,1,19.18,4571.603962,4000,0,127.02,409000002699,25-Nov-16,6.33E+11,,5000.00,456581.85,Alexander,633,Germany,97684.46,1,1,0
2701,2011,1,RENT,1,Low,1,18800, 60 months,2,credit_card,1,High,2,Bad Loan,1,18.25,D,4,16.15,7160.19,2760.9,932.41,479.96,409000002700,25-Nov-16,6.33E+11,,3000.00,459581.85,Brock,564,France,53520.03,1,1,0
2702,2011,4,RENT,1,Low,1,14000, 36 months,1,credit_card,1,Low,1,Good Loan,0,12.42,B,2,14.57,16668.60647,14000,0,467.82,409000002701,25-Nov-16,6.33E+11,,1.00,459582.85,Shen,649,France,15200.61,1,1,0
2703,2011,10,RENT,1,Low,1,15000, 60 months,2,credit_card,1,High,2,Good Loan,0,15.27,C,3,11.88,17514.1,11295.1,0,358.98,409000002702,25-Nov-16,6.33E+11,,5000.00,464582.85,Padovesi,622,France,196894.62,1,1,0
2704,2011,4,MORTGAGE,3,Medium,2,16775, 36 months,1,credit_card,1,High,2,Good Loan,0,14.27,C,3,12.42,19052.68,16775,0,575.54,409000002703,25-Nov-16,6.33E+11,,3000.00,467582.85,Bulgakov,459,Germany,4969.13,1,1,0
2705,2011,3,RENT,1,Low,1,6325, 36 months,1,credit_card,1,Low,1,Good Loan,0,8.9,A,1,22.94,7176.398686,6325,0,200.84,409000002704,25-Nov-16,NEFT/SBIN416330350067/Mr,,8000.00,475582.85,Mazzanti,718,France,26229.24,1,1,0
2706,2011,6.05,RENT,1,Low,1,5700, 60 months,2,credit_card,1,High,2,Good Loan,0,18.64,E,5,7.46,8367.769588,5700,0,146.74,409000002705,25-Nov-16,6.33E+11,,5000.00,480582.85,Lord,655,Spain,134034.32,1,1,0
2707,2011,5,RENT,1,Low,1,13225, 36 months,1,debt_consolidation,6,High,2,Good Loan,0,13.49,C,3,22.53,16149.75637,13225,0,448.74,409000002706,25-Nov-16,6.33E+11,,3000.00,483582.85,Ramos,696,France,198032.93,1,1,0
2708,2011,2,RENT,1,Low,1,10000, 36 months,1,debt_consolidation,6,High,2,Good Loan,0,14.65,C,3,12.08,12354.72039,10000,0,344.95,409000002707,25-Nov-16,6.33E+11,,8000.00,491582.85,Pai,637,France,119882.86,1,1,0
2709,2011,5,RENT,1,Low,1,13500, 36 months,1,debt_consolidation,6,Low,1,Good Loan,0,8.9,A,1,3.16,14798.35,13500,0,428.67,409000002708,25-Nov-16,NEFT/SBIN416330433005/HEM,,8000.00,499582.85,Yuan,630,Spain,133102.30,1,1,0
2710,2011,3,OWN,2,Low,1,12000, 60 months,2,debt_consolidation,6,Low,1,Good Loan,0,12.69,B,2,17.62,12375.05,12000,0,271.14,409000002709,25-Nov-16,6.33E+11,,5000.00,504582.85,Mao,592,France,176395.02,1,1,0
2711,2011,10,MORTGAGE,3,Low,1,15000, 60 months,2,debt_consolidation,6,Low,1,Good Loan,0,7.9,A,1,7.39,15479.81,15000,0,303.43,409000002710,25-Nov-16,6.33E+11,,3000.00,507582.85,Uspenskaya,634,Germany,193179.88,1,1,0
2712,2011,10,RENT,1,Low,1,20200, 60 months,2,debt_consolidation,6,High,2,Bad Loan,1,21.28,F,6,16.87,13809.19,4571.71,2240.16,549.67,409000002711,25-Nov-16,NEFT/SBIN416330583714/Mr,,8000.00,515582.85,Powell,608,France,125062.02,1,1,0
2713,2011,10,RENT,1,Low,1,20000, 36 months,1,debt_consolidation,6,High,2,Bad Loan,1,14.27,C,3,14.69,12331.18,8382.17,679.72,686.18,409000002712,25-Nov-16,NEFT/MAHBH16330589081/Mr.,,8000.00,523582.85,Brown,565,Germany,143287.58,1,1,0
2714,2011,1,RENT,1,Medium,2,12000, 36 months,1,moving,10,High,2,Good Loan,0,13.49,C,3,20.56,14654.23711,12000,0,407.17,409000002713,25-Nov-16,NEFT/N330160210685878/RAJ,,8000.00,531582.85,Poole,763,Spain,87236.40,1,1,0
2715,2011,10,MORTGAGE,3,Low,1,25975, 60 months,2,credit_card,1,High,2,Good Loan,0,22.06,F,6,24.85,35182.43,18874.47,0,718.29,409000002714,25-Nov-16,6.33E+11,,5000.00,536582.85,McChesney,665,France,93769.89,1,1,0
2716,2011,10,MORTGAGE,3,Low,1,10600, 60 months,2,credit_card,1,High,2,Good Loan,0,14.27,C,3,28.78,12135.23,8042.45,0,248.13,409000002715,25-Nov-16,6.33E+11,,3000.00,539582.85,Lucchese,649,France,88965.46,1,1,0
2717,2011,6,RENT,1,Low,1,13475, 36 months,1,debt_consolidation,6,Low,1,Good Loan,0,10.65,B,2,22.83,15799.25234,13475,0,438.93,409000002716,25-Nov-16,6.33E+11,,5000.00,544582.85,Clements,695,France,30793.61,1,1,0
2718,2011,10,RENT,1,Low,1,4000, 36 months,1,credit_card,1,Low,1,Good Loan,0,9.91,B,2,21.02,4517.3,4000,0,128.9,409000002717,25-Nov-16,6.33E+11,,3000.00,547582.85,Yuriev,775,Germany,74532.02,1,1,0
2719,2011,5,MORTGAGE,3,Low,1,5000, 60 months,2,other,4,Low,1,Good Loan,0,9.91,B,2,15.41,5194.46,3889.63,0,106.02,409000002718,25-Nov-16,6.33E+11,,5000.00,552582.85,Endrizzi,788,France,113086.08,1,1,0
2720,2011,5,OWN,2,Low,1,7500, 36 months,1,home_improvement,7,High,2,Bad Loan,1,16.29,D,4,16.67,1296.37,664.4,238.57,264.76,409000002719,25-Nov-16,6.33E+11,,3000.00,555582.85,Pan,569,Germany,32574.01,0,1,0
2721,2011,1,MORTGAGE,3,Low,1,21000, 60 months,2,small_business,3,High,2,Bad Loan,1,19.42,E,5,11.26,8705.58,3263.12,1019.16,549.62,409000002720,26-Nov-16,6.33E+11,,5000.00,560582.85,Manfrin,726,Spain,130113.78,0,1,0
2722,2011,10,RENT,1,Low,1,9600, 60 months,2,credit_card,1,High,2,Good Loan,0,17.27,D,4,12.9,13161.08137,9600,0,239.99,409000002721,26-Nov-16,6.33E+11,,3000.00,563582.85,Kennedy,564,Germany,104722.47,0,1,0
2723,2011,10,RENT,1,Low,1,10000, 36 months,1,debt_consolidation,6,Low,1,Good Loan,0,7.51,A,1,26.34,11196.96152,10000,0,311.11,409000002722,26-Nov-16,6.33E+11,,4000.00,567582.85,Conway,544,France,14559.62,0,1,0
2724,2011,8,MORTGAGE,3,Low,1,3725, 36 months,1,debt_consolidation,6,Low,1,Good Loan,0,12.69,B,2,18.72,4075.76,3725,0,124.96,409000002723,26-Nov-16,6.33E+11,,4000.00,571582.85,Lablanc,614,France,598.80,0,1,0
2725,2011,10,MORTGAGE,3,Low,1,19425, 60 months,2,debt_consolidation,6,High,2,Bad Loan,1,20.89,F,6,21.19,19414.81,8519.21,1625.63,524.32,409000002724,26-Nov-16,6.33E+11,,5000.00,576582.85,Dodd,453,Germany,129697.99,0,1,0
2726,2011,10,RENT,1,Low,1,25900, 60 months,2,credit_card,1,High,2,Good Loan,0,16.77,D,4,22.94,37383.66232,25900,0,640.49,409000002725,26-Nov-16,6.33E+11,,3000.00,579582.85,Muir,471,France,36315.03,0,1,0
2727,2011,6,MORTGAGE,3,Low,1,30000, 60 months,2,debt_consolidation,6,High,2,Bad Loan,1,21.67,F,6,1.19,29013.36,12021.24,2632.2,822.95,409000002726,26-Nov-16,6.33E+11,,5000.00,584582.85,Milanesi,829,Germany,1114.12,0,1,0
2728,2011,0.5,RENT,1,Low,1,13000, 60 months,2,debt_consolidation,6,High,2,Good Loan,0,19.42,E,5,9.82,19074.74835,13000,0,340.24,409000002727,26-Nov-16,6.33E+11,,788.00,585370.85,Shen,754,Germany,70954.41,0,1,0
2729,2011,5,OWN,2,Low,1,15600, 60 months,2,debt_consolidation,6,High,2,Bad Loan,1,14.65,C,3,22.33,15096.99,9388.05,0,368.27,409000002728,26-Nov-16,6.33E+11,,2212.00,587582.85,Dillon,749,Germany,73470.98,0,1,0
2730,2011,7,MORTGAGE,3,Low,1,20000, 36 months,1,debt_consolidation,6,Low,1,Good Loan,0,12.69,B,2,19.3,24035.13446,20000,0,670.9,409000002729,26-Nov-16,6.33E+11,,5000.00,592582.85,Hoelscher,667,France,91573.19,0,1,0
2731,2011,10,RENT,1,Medium,2,10000, 36 months,1,debt_consolidation,6,Low,1,Good Loan,0,9.91,B,2,8.22,11572.40017,10000,0,322.25,409000002730,26-Nov-16,6.33E+11,,3000.00,595582.85,Bell,670,Spain,3154.95,0,1,0
2732,2011,10,RENT,1,Low,1,8000, 36 months,1,debt_consolidation,6,High,2,Bad Loan,1,14.65,C,3,22.28,0,0,0,275.96,409000002731,26-Nov-16,6.33E+11,,8000.00,603582.85,Liao,670,France,88187.81,0,1,0
2733,2011,5,RENT,1,Low,1,12000, 60 months,2,debt_consolidation,6,Low,1,Good Loan,0,11.71,B,2,13.49,15717.69998,12000,0,265.18,409000002732,26-Nov-16,6.33E+11,,8000.00,611582.85,Udokamma,623,Germany,118855.26,0,1,0
2734,2011,5,MORTGAGE,3,Low,1,12000, 36 months,1,debt_consolidation,6,Low,1,Good Loan,0,9.91,B,2,6.05,12290.47,12000,0,386.7,409000002733,26-Nov-16,6.33E+11,,5000.00,616582.85,Sinnett,571,France,125256.53,0,1,0
2735,2011,4,RENT,1,Low,1,4000, 36 months,1,credit_card,1,Low,1,Good Loan,0,12.42,B,2,11.37,4515.03,4000,0,133.67,409000002734,26-Nov-16,6.33E+11,,3000.00,619582.85,Palerma,641,Germany,39016.43,0,1,0
2736,2011,0.5,RENT,1,Low,1,9750, 60 months,2,debt_consolidation,6,High,2,Good Loan,0,20.3,E,5,15.94,13756.73209,9750,0,259.95,409000002735,27-Nov-16,6.33E+11,,5000.00,624582.85,Chimaijem,551,Germany,145796.49,0,1,0
2737,2011,4,MORTGAGE,3,Low,1,24000, 36 months,1,debt_consolidation,6,Low,1,Good Loan,0,7.51,A,1,3.46,24296.95,24000,0,746.66,409000002736,27-Nov-16,6.33E+11,,3000.00,627582.85,Porter,741,Germany,168816.22,0,1,0
2738,2011,0.5,MORTGAGE,3,Medium,2,35000, 60 months,2,debt_consolidation,6,High,2,Good Loan,0,19.91,E,5,16.07,49495.98715,35000,0,925.54,409000002737,27-Nov-16,6.33E+11,,8000.00,635582.85,Fan,472,France,73322.00,0,1,0
2739,2011,10,MORTGAGE,3,Medium,2,3125, 60 months,2,credit_card,1,High,2,Good Loan,0,16.77,D,4,9.56,4270.932054,3125,0,77.28,409000002738,27-Nov-16,6.33E+11,,5000.00,640582.85,Palmer,650,Spain,113677.53,0,1,0
2740,2011,10,MORTGAGE,3,Medium,2,12000, 36 months,1,wedding,5,Low,1,Good Loan,0,11.71,B,2,11.86,14180.38758,12000,0,396.92,409000002739,27-Nov-16,6.33E+11,,3000.00,643582.85,Younger,625,France,124607.70,0,1,0
2741,2011,9,OWN,2,Low,1,17500, 36 months,1,debt_consolidation,6,Low,1,Good Loan,0,8.9,A,1,7.01,20001.55993,17500,0,555.69,409000002740,27-Nov-16,6.33E+11,,5000.00,648582.85,Burke,650,Germany,11276.48,0,1,0
2742,2011,10,MORTGAGE,3,Low,1,6000, 36 months,1,debt_consolidation,6,Low,1,Good Loan,0,11.71,B,2,13.21,7089.721292,6000,0,198.46,409000002741,27-Nov-16,6.33E+11,,3500.00,652082.85,Nwagugheuzo,535,France,136620.64,0,1,0
2743,2011,3,MORTGAGE,3,Low,1,15000, 60 months,2,debt_consolidation,6,High,2,Good Loan,0,13.49,C,3,11.4,16874.34,11428.47,0,345.08,409000002742,27-Nov-16,6.33E+11,,8000.00,660082.85,Young,649,France,70523.92,0,1,0
2744,2011,6.05,RENT,1,Low,1,8000, 60 months,2,debt_consolidation,6,High,2,Bad Loan,1,17.58,D,4,21.2,4896.44,1708.33,870.17,201.33,409000002743,28-Nov-16,6.33E+11,,5000.00,665082.85,Watson,689,France,51980.25,0,1,0
2745,2011,0.5,RENT,1,Medium,2,28000, 60 months,2,credit_card,1,High,2,Good Loan,0,18.64,E,5,23.15,39576.73895,28000,0,720.81,409000002744,28-Nov-16,6.33E+11,,2000.00,667082.85,Tseng,694,Spain,113481.02,0,1,0
2746,2011,10,RENT,1,Medium,2,30000, 36 months,1,home_improvement,7,Low,1,Good Loan,0,7.9,A,1,0.34,31532.24,30000,0,938.71,409000002745,28-Nov-16,6.33E+11,,5000.00,672082.85,Drake,655,Germany,49025.79,0,1,0
2747,2011,1,MORTGAGE,3,Medium,2,28000, 60 months,2,debt_consolidation,6,High,2,Good Loan,0,18.25,D,4,10.84,35000.67,20796.77,0,714.83,409000002746,28-Nov-16,6.33E+11,,2000.00,674082.85,Hanna,620,France,145937.99,0,1,0
2748,2011,6.05,RENT,1,Low,1,1000, 36 months,1,vacation,11,High,2,Good Loan,0,15.96,C,3,8.9,1063.3,1000,0,35.14,409000002747,28-Nov-16,6.33E+11,,5000.00,679082.85,Padovesi,577,France,25161.61,0,1,0
2749,2011,6,MORTGAGE,3,Low,1,23800, 36 months,1,debt_consolidation,6,Low,1,Good Loan,0,12.42,B,2,13.54,27795.87,23800,0,795.29,409000002748,28-Nov-16,6.33E+11,,3000.00,682082.85,Loftus,401,Germany,175753.55,0,1,0
2750,2011,3,MORTGAGE,3,Low,1,17000, 36 months,1,debt_consolidation,6,Low,1,Good Loan,0,6.03,A,1,15.58,18625.92257,17000,0,517.41,409000002749,28-Nov-16,6.33E+11,,5000.00,687082.85,Buccho,599,France,24903.09,0,1,0
2751,2011,8,RENT,1,Low,1,18000, 60 months,2,credit_card,1,High,2,Bad Loan,1,15.27,C,3,22.08,11328.36,5040.96,1832.64,430.78,409000002750,28-Nov-16,6.33E+11,,3000.00,690082.85,Lorenzo,481,France,169719.35,0,1,0
2752,2011,0.5,MORTGAGE,3,Low,1,13500, 60 months,2,house,12,Low,1,Good Loan,0,12.42,B,2,9.05,16793.35057,13500,0,303.18,409000002751,28-Nov-16,6.33E+11,,5000.00,695082.85,Ibezimako,704,France,179565.57,0,1,0
2753,2011,4,MORTGAGE,3,Low,1,24000, 36 months,1,credit_card,1,Low,1,Good Loan,0,9.91,B,2,14.88,27837.50361,24000,0,773.4,409000002752,28-Nov-16,6.33E+11,,3000.00,698082.85,Wei,698,Spain,115337.74,0,1,0
2754,2011,1,RENT,1,Low,1,3600, 36 months,1,debt_consolidation,6,Low,1,Good Loan,0,7.51,A,1,9.54,4030.266449,3600,0,112,409000002753,28-Nov-16,NEFT/SDC49400210/GOVINDSI,,8000.00,706082.85,Ross,480,France,48131.92,0,1,0
2755,2011,10,MORTGAGE,3,Low,1,15000, 36 months,1,other,4,High,2,Good Loan,0,16.29,D,4,20.88,19060.06934,15000,0,529.51,409000002754,28-Nov-16,6.33E+11,,5000.00,711082.85,Oluchukwu,682,France,160828.98,0,1,0
2756,2011,7,MORTGAGE,3,Low,1,1000, 36 months,1,other,4,High,2,Good Loan,0,13.49,C,3,23.89,1124.7,1000,0,33.94,409000002755,28-Nov-16,6.33E+11,,3000.00,714082.85,Walker,700,Spain,145151.96,0,1,0
2757,2011,3,RENT,1,Medium,2,30000, 60 months,2,debt_consolidation,6,High,2,Bad Loan,1,23.52,G,7,8.54,7625.93,1635.98,1628.03,854.71,409000002756,29-Nov-16,6.33E+11,,5000.00,719082.85,Wu,492,France,196293.76,0,1,0
2758,2011,3,RENT,1,Low,1,3600, 36 months,1,credit_card,1,High,2,Good Loan,0,13.49,C,3,22.97,4393.643411,3600,0,122.15,409000002757,29-Nov-16,6.33E+11,,3000.00,722082.85,Chidalu,444,France,161653.50,0,1,0
2759,2011,9,MORTGAGE,3,Low,1,15500, 60 months,2,debt_consolidation,6,Low,1,Good Loan,0,10.65,B,2,8.92,16903.18,15500,0,334.31,409000002758,29-Nov-16,6.33E+11,,5000.00,727082.85,Ingram,624,France,84635.64,0,1,0
2760,2011,1,RENT,1,Low,1,14000, 36 months,1,credit_card,1,High,2,Good Loan,0,17.58,D,4,13.65,18107.1411,14000,0,503.19,409000002759,29-Nov-16,6.33E+11,,3000.00,730082.85,Ch'en,709,France,159486.76,0,1,0
2761,2011,0.5,RENT,1,Low,1,6400, 36 months,1,credit_card,1,High,2,Good Loan,0,13.49,C,3,8.48,7502.69,6400,0,217.16,409000002760,29-Nov-16,NEFT/BDBLH16334003065/NAN,,8000.00,738082.85,Iredale,557,Germany,38596.34,0,1,0
2762,2011,5,MORTGAGE,3,Low,1,3600, 36 months,1,debt_consolidation,6,Low,1,Good Loan,0,6.62,A,1,10.11,3760.17,3600,0,110.54,409000002761,29-Nov-16,6.33E+11,,5000.00,743082.85,Gallagher,646,Germany,27814.74,0,1,0
2763,2011,2,RENT,1,Medium,2,14000, 36 months,1,major_purchase,8,Low,1,Good Loan,0,6.62,A,1,1.19,14682.48,14000,0,429.86,409000002762,29-Nov-16,6.33E+11,,3000.00,746082.85,Padilla,719,Germany,183893.31,0,1,0
2764,2011,1,RENT,1,Low,1,4025, 36 months,1,small_business,3,Low,1,Good Loan,0,9.91,B,2,16.99,4652.209608,4025,0,129.71,409000002763,29-Nov-16,6.33E+11,,800.00,746882.85,Potter,706,Germany,140803.70,0,1,0
2765,2011,10,RENT,1,Low,1,15000, 60 months,2,debt_consolidation,6,High,2,Good Loan,0,20.89,F,6,11.33,19800.64,10961.97,0,404.88,409000002764,29-Nov-16,6.33E+11,,5000.00,751882.85,Mao,660,France,146585.53,0,1,0
2766,2011,1,RENT,1,Low,1,2600, 36 months,1,debt_consolidation,6,Low,1,Good Loan,0,12.69,B,2,1.25,2730.53,2600,0,87.22,409000002765,29-Nov-16,6.33E+11,,3000.00,754882.85,Schneider,667,France,40062.29,0,1,0
2767,2011,10,OWN,2,Low,1,16500, 36 months,1,debt_consolidation,6,Low,1,Good Loan,0,8.9,A,1,12.3,18473.48,16500,0,523.93,409000002766,29-Nov-16,6.33E+11,,5000.00,759882.85,Ibragimova,705,France,181300.32,0,1,0
2768,2011,4,MORTGAGE,3,Low,1,15000, 60 months,2,debt_consolidation,6,High,2,Good Loan,0,13.49,C,3,13.21,15498.93,15000,0,345.08,409000002767,29-Nov-16,6.33E+11,,3000.00,762882.85,Huang,598,Germany,84136.12,0,1,0
2769,2011,2,RENT,1,Low,1,8875, 36 months,1,debt_consolidation,6,Low,1,Bad Loan,1,8.9,A,1,18.16,1970.22,1544.05,0,281.81,409000002768,29-Nov-16,6.33E+11,,5000.00,767882.85,Anderson,669,France,197594.34,0,1,0
2770,2011,10,OWN,2,Low,1,30000, 60 months,2,debt_consolidation,6,High,2,Bad Loan,1,18.64,E,5,23,7751.7,2583.57,1583.38,772.29,409000002769,29-Nov-16,6.33E+11,,3000.00,770882.85,Nakayama,580,Germany,125953.83,0,1,0
2771,2011,10,MORTGAGE,3,Medium,2,23000, 60 months,2,debt_consolidation,6,High,2,Good Loan,0,20.3,E,5,8.35,35069.84354,23000,0,613.21,409000002770,29-Nov-16,6.33E+11,,7200.00,778082.85,Gardener,676,France,75465.41,0,1,0
2772,2011,6.05,OWN,2,Low,1,3825, 36 months,1,debt_consolidation,6,High,2,Good Loan,0,14.65,C,3,24.91,4747.405072,3825,0,131.95,409000002771,29-Nov-16,NEFT/ALLAH16334158721/Mr.,,8000.00,786082.85,Aksenova,714,Germany,177737.07,0,1,0
2773,2011,5,MORTGAGE,3,Low,1,11100, 36 months,1,debt_consolidation,6,High,2,Good Loan,0,16.77,D,4,14.55,14184.68133,11100,0,394.48,409000002772,29-Nov-16,6.33E+11,,8000.00,794082.85,Milne,597,Germany,7144.46,0,1,0
2774,2011,0.5,RENT,1,Low,1,12000, 36 months,1,debt_consolidation,6,Low,1,Good Loan,0,9.91,B,2,13.59,13832.87318,12000,0,386.7,409000002773,30-Nov-16,NEFT/BARBH16335651527/SHA,,8000.00,802082.85,Onwumelu,559,France,155639.76,0,1,0
2775,2011,6,OWN,2,Low,1,8900, 60 months,2,debt_consolidation,6,High,2,Bad Loan,1,18.64,E,5,11.89,6602.31,2740.62,894.56,229.12,409000002774,30-Nov-16,NEFT/0P16113016945610/SAT,,8000.00,810082.85,Kudryashova,564,France,162428.05,0,1,0
2776,2011,10,MORTGAGE,3,Medium,2,12000, 60 months,2,debt_consolidation,6,Low,1,Good Loan,0,11.71,B,2,11.81,12970.16,9232,0,265.18,409000002775,30-Nov-16,6.34E+11,,5000.00,815082.85,Hart,850,Spain,12457.76,0,1,0
2777,2011,2,RENT,1,Low,1,3000, 36 months,1,other,4,Low,1,Good Loan,0,7.51,A,1,17.68,3103.28,3000,0,93.34,409000002776,30-Nov-16,6.34E+11,,3000.00,818082.85,Teng,689,France,14917.09,0,1,0
2778,2011,3,RENT,1,Low,1,5600, 36 months,1,renewable_energy,13,Low,1,Good Loan,0,7.9,A,1,2.93,6268.0308,5600,0,175.23,409000002777,30-Nov-16,6.34E+11,,5000.00,823082.85,Kruglova,758,Germany,182184.09,0,1,0
2779,2011,6,RENT,1,Low,1,12000, 60 months,2,debt_consolidation,6,High,2,Good Loan,0,17.27,D,4,23.33,17229.06877,12000,0,299.98,409000002778,30-Nov-16,6.34E+11,,3000.00,826082.85,Palerma,604,Spain,129984.20,0,1,0
2780,2011,0.5,RENT,1,Low,1,12000, 36 months,1,credit_card,1,Low,1,Good Loan,0,11.71,B,2,21.92,14286.7667,12000,0,396.92,409000002779,30-Nov-16,NEFT/CBINH16335A07116/KAV,,8000.00,834082.85,Brookes,733,Germany,194872.97,0,1,0
2781,2011,5,MORTGAGE,3,Medium,2,25000, 60 months,2,debt_consolidation,6,High,2,Good Loan,0,15.96,C,3,13.36,28143.41,25000,0,607.43,409000002780,30-Nov-16,NEFT/SBIN716335138946/Mr,,8000.00,842082.85,Hsing,778,Spain,117507.11,0,1,0
2782,2011,10,MORTGAGE,3,Low,1,12000, 36 months,1,debt_consolidation,6,Low,1,Bad Loan,1,9.91,B,2,8.97,10266.88,7951.67,558.34,386.7,409000002781,30-Nov-16,NEFT/CBINH16335158143/Mr.,,8000.00,850082.85,Shaffer,732,Germany,157527.60,0,1,0
2783,2011,4,MORTGAGE,3,Medium,2,35000, 60 months,2,debt_consolidation,6,High,2,Good Loan,0,21.67,F,6,15.31,42716.71,35000.01,0,960.11,409000002782,30-Nov-16,NEFT/1091242044/SANWARIYA,,25500.00,875582.85,Laurie,646,France,92612.88,0,1,0
2784,2011,1,MORTGAGE,3,Low,1,30000, 60 months,2,debt_consolidation,6,High,2,Good Loan,0,14.65,C,3,17.16,34697.09,22740.84,0,708.2,409000002783,1-Dec-16,6.34E+11,,5000.00,880582.85,Chung,597,France,74850.84,0,1,0
2785,2011,10,RENT,1,Low,1,10000, 36 months,1,small_business,3,Low,1,Bad Loan,1,12.69,B,2,10.35,9748.35,6576.59,1400,335.45,409000002784,1-Dec-16,6.34E+11,,3000.00,883582.85,Whitfield,821,Germany,127413.00,0,1,0
2786,2011,10,OWN,2,Low,1,21600, 60 months,2,debt_consolidation,6,High,2,Good Loan,0,20.3,E,5,13.37,31794.21885,21600.01,0,575.88,409000002785,1-Dec-16,6.34E+11,,5000.00,888582.85,Thomas,640,France,69584.30,0,1,0
2787,2011,6.05,RENT,1,Low,1,8000, 36 months,1,credit_card,1,Low,1,Bad Loan,1,10.65,B,2,14.27,7035.93,5745.26,12.74,260.59,409000002786,1-Dec-16,6.34E+11,,3000.00,891582.85,Rioux,511,Germany,198814.24,0,1,0
2788,2011,6,RENT,1,Low,1,6000, 36 months,1,debt_consolidation,6,Low,1,Good Loan,0,9.91,B,2,22.99,6672.64,6000,0,193.35,409000002787,1-Dec-16,6.34E+11,,5000.00,896582.85,Osonduagwuike,805,France,162643.15,0,1,0
2789,2011,2,RENT,1,High,3,15000, 60 months,2,debt_consolidation,6,High,2,Good Loan,0,18.25,D,4,8.71,15453.22,15000,0,382.95,409000002788,1-Dec-16,6.34E+11,,3000.00,899582.85,Matveyev,540,Germany,114092.52,0,1,0
2790,2011,10,RENT,1,Low,1,35000, 60 months,2,debt_consolidation,6,High,2,Bad Loan,1,20.3,E,5,19.28,29456.88,12074.91,3328.96,933.14,409000002789,1-Dec-16,6.34E+11,,5000.00,904582.85,Hayward,705,Spain,68860.30,0,1,0
2791,2011,0.5,RENT,1,Low,1,14400, 60 months,2,debt_consolidation,6,High,2,Good Loan,0,20.3,E,5,14.2,18378.74,14400,0,383.92,409000002790,1-Dec-16,6.34E+11,,3000.00,907582.85,Nkemdirim,540,Germany,16150.34,0,1,0
2792,2011,10,RENT,1,Low,1,10500, 36 months,1,debt_consolidation,6,Low,1,Good Loan,0,12.69,B,2,10.76,11221.61,10500,0,352.23,409000002791,1-Dec-16,6.34E+11,,5000.00,912582.85,Brim,532,Spain,115227.02,0,1,0
2793,2011,1,RENT,1,Low,1,9000, 36 months,1,debt_consolidation,6,Low,1,Bad Loan,1,11.71,B,2,19.22,3363.2,2189.86,390.9,297.69,409000002792,1-Dec-16,6.34E+11,,3000.00,915582.85,Trevisano,535,France,170621.55,0,1,0
2794,2011,6,RENT,1,Low,1,10900, 36 months,1,debt_consolidation,6,Low,1,Good Loan,0,12.42,B,2,8.05,12507.72,10900,0,364.23,409000002793,1-Dec-16,6.34E+11,,5000.00,920582.85,Soubeiran,627,Germany,103099.22,0,1,0
2795,2011,1,OWN,2,Medium,2,17600, 36 months,1,credit_card,1,Low,1,Good Loan,0,12.42,B,2,22.35,21169.63757,17600,0,588.11,409000002794,1-Dec-16,6.34E+11,,3000.00,923582.85,Wilson,646,France,172495.81,0,1,0
2796,2011,7,RENT,1,Low,1,1800, 36 months,1,other,4,High,2,Bad Loan,1,13.49,C,3,10.56,1092,755.98,59.76,61.08,409000002795,1-Dec-16,NEFT/SBIN816336479938/Mr,,8000.00,931582.85,Helena,515,France,38772.82,0,1,0
2797,2011,0.5,MORTGAGE,3,Low,1,14000, 60 months,2,small_business,3,High,2,Bad Loan,1,18.64,E,5,23.35,5367.16,2039.5,686.9,360.41,409000002796,1-Dec-16,6.34E+11,,5000.00,936582.85,Duncan,697,France,44946.29,0,1,0
2798,2011,6.05,OWN,2,Medium,2,10000, 36 months,1,credit_card,1,Low,1,Good Loan,0,7.9,A,1,7.53,11263.01963,10000,0,312.91,409000002797,1-Dec-16,6.34E+11,,3000.00,939582.85,Hale,652,Germany,146007.70,0,1,0
2799,2011,7,RENT,1,Low,1,6000, 36 months,1,debt_consolidation,6,Low,1,Good Loan,0,7.9,A,1,27.78,6757.513608,6000,0,187.75,409000002798,1-Dec-16,6.34E+11,,5000.00,944582.85,Macdonald,579,Germany,145558.42,0,1,0
2800,2011,6.05,RENT,1,Low,1,5200, 60 months,2,vacation,11,Low,1,Bad Loan,1,8.9,A,1,8.17,5177.93,3945.87,0,107.7,409000002799,1-Dec-16,6.34E+11,,3000.00,947582.85,McKay,760,France,193312.33,0,1,0
2801,2011,4,MORTGAGE,3,Low,1,6500, 36 months,1,other,4,Low,1,Good Loan,0,6.03,A,1,2.94,6585.53,6500,0,197.84,409000002800,1-Dec-16,NEFT/SAA38581225/JITENDRA,,7000.00,954582.85,Chiekwugo,769,France,40257.79,0,1,0
2802,2011,4,RENT,1,Low,1,10000, 36 months,1,credit_card,1,High,2,Good Loan,0,16.29,D,4,13.58,12704.72947,10000,0,353.01,409000002801,1-Dec-16,6.34E+11,,5000.00,959582.85,Skinner,498,Spain,46677.90,0,1,0
2803,2011,4,MORTGAGE,3,Low,1,8000, 36 months,1,debt_consolidation,6,Low,1,Good Loan,0,9.91,B,2,18.24,9278.33764,8000,0,257.8,409000002802,1-Dec-16,6.34E+11,,3000.00,962582.85,Sorokina,774,France,153887.93,0,1,0
2804,2011,2,RENT,1,Low,1,2800, 36 months,1,other,4,High,2,Bad Loan,1,16.29,D,4,3.94,1676.09,1076.27,98.65,98.85,409000002803,1-Dec-16,6.34E+11,,5000.00,967582.85,Weller,705,Germany,103108.33,0,1,0
2805,2011,4,RENT,1,Low,1,35000, 60 months,2,debt_consolidation,6,High,2,Good Loan,0,17.27,D,4,22.75,37462.09,35000,0,874.93,409000002804,1-Dec-16,6.34E+11,,3000.00,970582.85,Bess,648,France,58652.23,0,1,0
2806,2011,0.5,MORTGAGE,3,Medium,2,12000, 60 months,2,home_improvement,7,Low,1,Good Loan,0,11.71,B,2,8.59,12787.91,12000,0,265.18,409000002805,1-Dec-16,6.34E+11,,5000.00,975582.85,MacDonald,688,France,91624.11,0,1,0
2807,2011,6.05,RENT,1,Low,1,11200, 36 months,1,debt_consolidation,6,Low,1,Good Loan,0,6.62,A,1,11.38,12378.61323,11200,0,343.89,409000002806,1-Dec-16,6.34E+11,,3000.00,978582.85,Gray,592,Spain,65986.48,0,1,0
2808,2011,0.5,RENT,1,Low,1,8000, 36 months,1,debt_consolidation,6,High,2,Bad Loan,1,13.49,C,3,7.62,2815.19,1699.1,361.84,271.45,409000002807,1-Dec-16,6.34E+11,,5000.00,983582.85,Ogbonnaya,705,France,113845.19,0,1,0
2809,2011,1,RENT,1,Low,1,14825, 60 months,2,debt_consolidation,6,High,2,Bad Loan,1,23.52,G,7,23.68,2183.83,538.4,499.1,422.37,409000002808,1-Dec-16,6.34E+11,,3000.00,986582.85,Udegbulam,654,France,67607.90,0,1,0
2810,2011,7,OWN,2,Low,1,6100, 36 months,1,debt_consolidation,6,High,2,Bad Loan,1,18.64,E,5,12.67,3997.62,2624.88,0,222.5,409000002809,1-Dec-16,6.34E+11,,8000.00,994582.85,Mai,624,France,145471.94,0,1,0
2811,2011,10,RENT,1,Low,1,17000, 36 months,1,debt_consolidation,6,High,2,Good Loan,0,15.96,C,3,15.24,17226.81,17000,0,597.34,409000002810,1-Dec-16,6.34E+11,,5000.00,999582.85,Yeh,594,France,124071.71,0,1,0
2812,2011,10,MORTGAGE,3,Low,1,16000, 60 months,2,debt_consolidation,6,High,2,Good Loan,0,15.96,C,3,16.13,19784.28,16000,0,388.75,409000002811,1-Dec-16,6.34E+11,,3000.00,1002582.85,Babbage,695,Spain,67502.12,0,1,0
2813,2011,6,MORTGAGE,3,Low,1,1500, 36 months,1,other,4,Low,1,Good Loan,0,6.03,A,1,22.05,1643.352667,1500,0,45.66,409000002812,1-Dec-16,NEFT/SAA231927480/KANTNIS,,8000.00,1010582.85,Franklin,597,France,78707.97,0,1,0
2814,2011,6,RENT,1,Low,1,6500, 36 months,1,debt_consolidation,6,Low,1,Good Loan,0,7.51,A,1,9.67,7070.88,6500,0,202.23,409000002813,2-Dec-16,NEFT/SBIN916336237712/RAK,,8000.00,1018582.85,Randell,758,France,171189.83,0,1,0
2815,2011,9,MORTGAGE,3,Medium,2,5500, 60 months,2,small_business,3,High,2,Good Loan,0,14.65,C,3,8.89,7666.909992,5500,0,129.84,409000002814,2-Dec-16,NEFT/SBIN916336236043/FAR,,8000.00,1026582.85,Paterson,737,Germany,149381.32,0,1,0
2816,2011,6.05,MORTGAGE,3,Low,1,10000, 36 months,1,credit_card,1,Low,1,Bad Loan,1,12.69,B,2,14.4,1003.53,694.46,0,335.45,409000002815,2-Dec-16,NEFT/SBIN916337969837/Mr,,8000.00,1034582.85,Pickering,694,Germany,100335.55,0,1,0
2817,2011,6.05,MORTGAGE,3,Low,1,7125, 36 months,1,small_business,3,Low,1,Good Loan,0,9.91,B,2,24.98,8264.027853,7125,0,229.61,409000002816,2-Dec-16,6.34E+11,,8000.00,1042582.85,Uspensky,683,France,152698.24,0,1,0
2818,2011,8,RENT,1,Low,1,14000, 60 months,2,credit_card,1,High,2,Good Loan,0,14.65,C,3,22.33,16192.94,10616.99,0,330.5,409000002817,2-Dec-16,6.34E+11,,1.00,1042583.85,Macleod,538,Spain,41192.95,0,1,0
2819,2011,3,RENT,1,Low,1,11000, 36 months,1,debt_consolidation,6,High,2,Good Loan,0,16.29,D,4,19.09,13236.2,10999.99,0,388.31,409000002818,2-Dec-16,6.34E+11,,1.00,1042584.85,Nnaife,669,France,132540.33,0,1,0
2820,2011,10,MORTGAGE,3,Low,1,3000, 36 months,1,debt_consolidation,6,Low,1,Good Loan,0,9.91,B,2,7.19,3478.816011,3000,0,96.68,409000002819,2-Dec-16,NEFT/SBIN116337379239/ROH,,8000.00,1050584.85,Randolph,730,France,96875.52,0,1,0
2821,2011,10,MORTGAGE,3,Low,1,15850, 60 months,2,debt_consolidation,6,High,2,Good Loan,0,21.28,F,6,22.8,21152.55,11579.16,0,431.3,409000002820,2-Dec-16,NEFT/N337160213723440/ANS,,20001.00,1070585.85,Kudryashova,622,France,152305.47,0,1,0
2822,2011,6,MORTGAGE,3,Low,1,12000, 60 months,2,debt_consolidation,6,High,2,Good Loan,0,14.65,C,3,18.67,13878.64,9099.48,0,283.28,409000002821,2-Dec-16,NEFT/SBIN116337455715/Mr,,8000.00,1078585.85,George,714,Spain,49672.01,0,1,0
2823,2011,10,MORTGAGE,3,Low,1,29700, 60 months,2,vacation,11,Low,1,Good Loan,0,11.71,B,2,16.04,36847.83824,29700,0,656.32,409000002822,2-Dec-16,NEFT/BKIDN16337187796/AJA,,8000.00,1086585.85,Robertson,569,Spain,133997.53,0,1,0
2824,2011,7,RENT,1,Low,1,6500, 36 months,1,debt_consolidation,6,Low,1,Good Loan,0,7.51,A,1,7.5,7258.584649,6500,0,202.23,409000002823,3-Dec-16,6.34E+11,,5000.00,1091585.85,Yuryeva,668,Germany,50454.80,0,1,0
2825,2011,7,MORTGAGE,3,Low,1,2800, 36 months,1,major_purchase,8,Low,1,Good Loan,0,6.03,A,1,15.23,3067.641407,2800,0,85.22,409000002824,3-Dec-16,6.34E+11,,3000.00,1094585.85,Hurst,628,France,16402.11,0,1,0
2826,2011,1,RENT,1,Low,1,10000, 36 months,1,moving,10,Low,1,Good Loan,0,6.03,A,1,4.97,10616.32,10000,0,304.36,409000002825,3-Dec-16,6.34E+11,,5000.00,1099585.85,Ch'iu,600,France,67803.83,0,1,0
2827,2011,5,MORTGAGE,3,Low,1,30000, 60 months,2,debt_consolidation,6,High,2,Good Loan,0,20.3,E,5,13.96,33441.64,30000,0,799.84,409000002826,3-Dec-16,6.34E+11,,3000.00,1102585.85,King,693,France,9241.78,0,1,0
2828,2011,3,MORTGAGE,3,Low,1,8000, 36 months,1,debt_consolidation,6,Low,1,Good Loan,0,6.62,A,1,5.83,8484.94,8000,0,245.63,409000002827,3-Dec-16,NEFT/SBHY516338879156/JAY,,8500.00,1111085.85,Esposito,704,France,100601.73,0,1,0
2829,2011,10,RENT,1,Low,1,12000, 60 months,2,debt_consolidation,6,High,2,Bad Loan,1,18.64,E,5,13.91,12008.16,5838.16,913.04,308.92,409000002828,3-Dec-16,NEFT/SBIN216338216703/Mr,,8000.00,1119085.85,Fraser,527,Spain,98734.15,0,1,0
2830,2011,0.5,MORTGAGE,3,Medium,2,35000, 60 months,2,debt_consolidation,6,Low,1,Good Loan,0,12.42,B,2,18.75,38504.35,26861.75,0,786.01,409000002829,3-Dec-16,6.34E+11,,5000.00,1124085.85,Trentini,553,Germany,160574.09,0,1,0
2831,2011,4,OWN,2,Medium,2,30000, 60 months,2,debt_consolidation,6,High,2,Good Loan,0,20.3,E,5,23.42,39162.78,22020.29,0,799.84,409000002830,3-Dec-16,6.34E+11,,3000.00,1127085.85,Nicholls,575,Spain,26015.80,0,1,0
2832,2011,3,RENT,1,Low,1,9000, 36 months,1,debt_consolidation,6,Low,1,Good Loan,0,7.51,A,1,21.11,9476.56,9000,0,280,409000002831,3-Dec-16,6.34E+11,,5000.00,1132085.85,Montalvo,626,France,187172.54,0,1,0
2833,2011,2,RENT,1,Low,1,3000, 36 months,1,moving,10,High,2,Good Loan,0,20.3,E,5,20.04,3796.27,3000,0,111.95,409000002832,3-Dec-16,6.34E+11,,3000.00,1135085.85,Tien,582,France,55763.66,0,1,0
2834,2011,4,RENT,1,Low,1,7925, 36 months,1,credit_card,1,High,2,Good Loan,0,15.27,C,3,23.6,9950.05863,7925,0,275.78,409000002833,4-Dec-16,6.34E+11,,5000.00,1140085.85,Chuang,683,Spain,75848.22,0,1,0
2835,2011,8,RENT,1,Low,1,18000, 60 months,2,debt_consolidation,6,High,2,Bad Loan,1,14.27,C,3,13.67,16308.62,8291.05,2451.06,421.36,409000002834,4-Dec-16,6.34E+11,,3000.00,1143085.85,Fang,850,France,40313.47,0,1,0
2836,2011,5,RENT,1,Low,1,24575, 60 months,2,debt_consolidation,6,High,2,Bad Loan,1,20.89,F,6,22.99,7252.13,2269.84,1291.43,663.32,409000002835,4-Dec-16,6.34E+11,,5000.00,1148085.85,Kosisochukwu,653,Spain,23864.21,0,1,0
2837,2011,9,RENT,1,Low,1,15000, 60 months,2,debt_consolidation,6,High,2,Good Loan,0,15.27,C,3,15.2,18065.65,15000,0,358.98,409000002836,4-Dec-16,6.34E+11,,3000.00,1151085.85,Young,679,France,51380.90,0,1,0
2838,2011,7,RENT,1,Low,1,15000, 60 months,2,debt_consolidation,6,High,2,Good Loan,0,17.58,D,4,23.32,18019.94,15000,0,377.49,409000002837,4-Dec-16,6.34E+11,,5000.00,1156085.85,Scott,549,Germany,93551.36,0,1,0
2839,2011,9,MORTGAGE,3,Medium,2,12000, 36 months,1,credit_card,1,Low,1,Good Loan,0,6.62,A,1,17.83,13082.8,12000,0,368.45,409000002838,4-Dec-16,6.34E+11,,3000.00,1159085.85,Yeh,850,Spain,169415.54,0,1,0
2840,2011,7,MORTGAGE,3,Low,1,15000, 36 months,1,debt_consolidation,6,High,2,Good Loan,0,14.65,C,3,9.98,18626.0901,15000,0,517.42,409000002839,5-Dec-16,6.34E+11,,1.00,1159086.85,Vigano,558,Germany,6935.31,0,1,0
2841,2011,3,RENT,1,Low,1,6400, 36 months,1,credit_card,1,Low,1,Good Loan,0,11.71,B,2,19.78,7618.839992,6400,0,211.69,409000002840,5-Dec-16,6.34E+11,,5000.00,1164086.85,Windradyne,528,Spain,25399.70,0,1,0
2842,2011,2,RENT,1,Low,1,14125, 60 months,2,credit_card,1,High,2,Good Loan,0,19.42,E,5,22.78,18073.21,10408.18,0,369.69,409000002841,5-Dec-16,6.34E+11,,3000.00,1167086.85,Curnow,801,France,66256.27,0,1,0
2843,2011,10,MORTGAGE,3,Medium,2,4000, 36 months,1,car,2,Low,1,Good Loan,0,6.03,A,1,2.71,4382.48919,4000,0,121.75,409000002842,6-Dec-16,6.34E+11,,5000.00,1172086.85,Ugonna,513,Spain,114709.13,0,1,0
2844,2011,4,MORTGAGE,3,Medium,2,35000, 60 months,2,debt_consolidation,6,High,2,Good Loan,0,21.28,F,6,11.27,46663.99,25556.53,0,952.39,409000002843,6-Dec-16,6.34E+11,,3000.00,1175086.85,De Neeve,666,Germany,158357.97,0,1,0
2845,2011,10,MORTGAGE,3,Low,1,14950, 36 months,1,credit_card,1,Low,1,Good Loan,0,9.91,B,2,19.78,17341.02747,14950,0,481.77,409000002844,6-Dec-16,6.34E+11,,5000.00,1180086.85,Ricci,606,France,164815.59,0,1,0
2846,2011,2,RENT,1,Low,1,16000, 36 months,1,debt_consolidation,6,Low,1,Good Loan,0,7.9,A,1,18.68,17950.79161,16000,0,500.65,409000002845,6-Dec-16,6.34E+11,,3000.00,1183086.85,Nnaife,599,Germany,132127.69,0,1,0
2847,2011,10,MORTGAGE,3,Low,1,2500, 36 months,1,other,4,Low,1,Good Loan,0,12.69,B,2,17.74,2956.93,2500,0,83.87,409000002846,6-Dec-16,NEFT/CBINH16341A05108/SHA,,8000.00,1191086.85,Ebelechukwu,544,Germany,146637.45,0,1,0
2848,2011,4,RENT,1,Low,1,12000, 60 months,2,credit_card,1,High,2,Good Loan,0,14.65,C,3,12.78,15412.73957,12000,0,283.28,409000002847,6-Dec-16,NEFT/CBINH16341A05041/AMR,,8000.00,1199086.85,Keating,529,Spain,90256.06,0,1,0
2849,2011,3,MORTGAGE,3,Low,1,15000, 36 months,1,debt_consolidation,6,Low,1,Good Loan,0,12.69,B,2,15.45,18107.90115,15000,0,503.18,409000002848,7-Dec-16,NEFT/ALLAH16342461607/M/s,,8000.00,1207086.85,Tuan,850,France,34827.43,0,1,0
2850,2011,7,OWN,2,Low,1,1000, 36 months,1,debt_consolidation,6,High,2,Good Loan,0,14.65,C,3,16.66,1238.698337,1000,0,34.5,409000002849,8-Dec-16,6.34E+11,,8000.00,1215086.85,Shearston,497,France,22074.48,0,1,0
2851,2011,5,MORTGAGE,3,Medium,2,1200, 36 months,1,car,2,High,2,Good Loan,0,13.49,C,3,12.38,1430.67,1200,0,40.72,409000002850,8-Dec-16,6.34E+11,,5000.00,1220086.85,Tien,764,France,109805.17,0,1,0
2852,2011,2,RENT,1,Low,1,16000, 36 months,1,credit_card,1,High,2,Good Loan,0,19.91,E,5,4.69,18802.71,16000,0,593.89,409000002851,8-Dec-16,6.34E+11,,3000.00,1223086.85,Hamilton,603,France,100478.60,0,1,0
2853,2011,4,OWN,2,Low,1,4000, 36 months,1,debt_consolidation,6,Low,1,Good Loan,0,11.71,B,2,9.02,4780.699129,4000,0,132.31,409000002852,8-Dec-16,6.34E+11,,8000.00,1231086.85,Arnold,609,France,97416.34,0,1,0
2854,2011,2,MORTGAGE,3,Low,1,9450, 60 months,2,small_business,3,High,2,Good Loan,0,22.06,F,6,16.51,14959.9304,9450,0,261.33,409000002853,10-Dec-16,6.35E+11,,8000.00,1239086.85,Ting,487,France,24207.86,0,1,0
2855,2011,1,OWN,2,Low,1,17000, 36 months,1,other,4,High,2,Good Loan,0,13.49,C,3,13.47,20763.22051,17000,0,576.82,409000002854,12-Dec-16,6.35E+11,,5000.00,1244086.85,Chao,748,France,69132.66,0,1,0
2856,2011,10,RENT,1,Low,1,13600, 60 months,2,credit_card,1,High,2,Good Loan,0,18.64,E,5,12.85,20343.49441,13600,0,350.11,409000002855,12-Dec-16,6.35E+11,,3000.00,1247086.85,Powell,710,Spain,9376.89,0,1,0
2857,2011,6,MORTGAGE,3,Low,1,7200, 36 months,1,debt_consolidation,6,Low,1,Bad Loan,1,11.71,B,2,21.55,3805.6,2888.44,0,238.15,409000002856,12-Dec-16,6.35E+11,,5000.00,1252086.85,Williams,432,Germany,43046.70,0,1,0
2858,2011,2,RENT,1,Low,1,17475, 36 months,1,credit_card,1,Low,1,Good Loan,0,9.91,B,2,17.76,18532.95,17475,0,563.14,409000002857,12-Dec-16,6.35E+11,,3000.00,1255086.85,Cheng,534,Spain,20856.31,0,1,0
2859,2011,4,MORTGAGE,3,Low,1,16000, 36 months,1,debt_consolidation,6,Low,1,Good Loan,0,12.42,B,2,14.67,17214.78,16000,0,534.65,409000002858,12-Dec-16,6.35E+11,,5000.00,1260086.85,Zhdanova,607,France,187048.72,0,1,0
2860,2011,8,MORTGAGE,3,Low,1,15000, 36 months,1,debt_consolidation,6,High,2,Good Loan,0,14.27,C,3,18.13,18525.69969,15000,0,514.64,409000002859,12-Dec-16,6.35E+11,,3000.00,1263086.85,Tsai,551,Spain,53420.53,0,1,0
2861,2011,9,RENT,1,Low,1,12000, 36 months,1,debt_consolidation,6,Low,1,Good Loan,0,11.71,B,2,7.63,14285.92671,12000,0,396.92,409000002860,13-Dec-16,NEFT/SBHY616348705420/JAY,,25000.00,1288086.85,Nebechukwu,674,France,37013.29,0,1,0
2862,2011,10,MORTGAGE,3,Low,1,35000, 60 months,2,debt_consolidation,6,High,2,Good Loan,0,19.03,E,5,24.83,51718.30395,35000,0,908.5,409000002861,14-Dec-16,NEFT/17920614C1600001/NAY,,8000.00,1296086.85,Fetherstonhaugh,525,France,89566.64,0,1,0
2863,2011,10,MORTGAGE,3,Low,1,12400, 36 months,1,debt_consolidation,6,Low,1,Good Loan,0,7.51,A,1,5.84,13132.15,12400,0,385.78,409000002862,14-Dec-16,NEFT/BKIDN16349979816/SAN,,7000.00,1303086.85,Ojiofor,645,Germany,149913.84,0,1,0
2864,2011,6,OWN,2,Low,1,2500, 36 months,1,other,4,Low,1,Good Loan,0,11.71,B,2,18.34,2972.609703,2500,0,82.69,409000002863,16-Dec-16,NEFT/AXIR163517559576/SAN,,8000.00,1311086.85,Severson,755,France,18066.69,0,1,0
2865,2011,1,RENT,1,Low,1,7200, 36 months,1,other,4,Low,1,Good Loan,0,7.9,A,1,15.96,8109.658499,7200,0,225.29,409000002864,16-Dec-16,6.35E+11,,5000.00,1316086.85,Speight,708,Germany,26912.34,0,1,0
2866,2011,3,MORTGAGE,3,Low,1,12000, 60 months,2,debt_consolidation,6,High,2,Good Loan,0,15.27,C,3,16.96,16525.01806,12000,0,287.19,409000002865,16-Dec-16,6.35E+11,,3000.00,1319086.85,Greenwalt,715,France,173511.72,0,1,0
2867,2011,4,RENT,1,Low,1,6000, 36 months,1,debt_consolidation,6,Low,1,Good Loan,0,10.65,B,2,24.79,7034.652144,6000,0,195.44,409000002866,16-Dec-16,6.35E+11,,5000.00,1324086.85,Grover,727,France,146785.44,0,1,0
2868,2011,0.5,RENT,1,Low,1,10000, 36 months,1,debt_consolidation,6,Low,1,Good Loan,0,11.71,B,2,6.43,11904.56474,10000,0,330.76,409000002867,16-Dec-16,6.35E+11,,3000.00,1327086.85,Milani,559,Spain,1050.33,0,1,0
2869,2011,10,MORTGAGE,3,Low,1,15000, 36 months,1,debt_consolidation,6,Low,1,Bad Loan,1,8.9,A,1,16.79,10478.6,8676.34,14.74,476.3,409000002868,21-Dec-16,6.36E+11,,5000.00,1332086.85,Akobundu,545,Spain,89587.34,0,1,0
2870,2011,0.5,RENT,1,Low,1,20000, 36 months,1,debt_consolidation,6,High,2,Good Loan,0,16.77,D,4,19.58,25237.64026,20000,0,710.77,409000002869,21-Dec-16,6.36E+11,,3000.00,1335086.85,Anderson,524,France,74405.34,0,1,0
2871,2011,1,MORTGAGE,3,Low,1,4000, 36 months,1,home_improvement,7,Low,1,Good Loan,0,6.03,A,1,3.37,4382.431741,4000,0,121.75,409000002870,21-Dec-16,NEFT/SBIN816356480003/SIS,,8000.00,1343086.85,Chien,707,France,54409.48,0,1,0
2872,2011,10,MORTGAGE,3,Low,1,14400, 60 months,2,credit_card,1,Low,1,Good Loan,0,12.42,B,2,9.89,18814.85304,14400,0,323.39,409000002871,22-Dec-16,6.36E+11,,5000.00,1348086.85,Kennedy,671,Spain,3647.57,0,1,0
2873,2011,4,RENT,1,Low,1,12800, 60 months,2,credit_card,1,High,2,Bad Loan,1,14.65,C,3,23.48,13222.12,7465.73,1137.4,302.17,409000002872,22-Dec-16,6.36E+11,,3000.00,1351086.85,Castiglione,439,Spain,198874.52,0,1,0
2874,2011,10,RENT,1,Low,1,12800, 60 months,2,debt_consolidation,6,High,2,Good Loan,0,18.25,D,4,20.4,16964.87,12800,0,326.78,409000002873,22-Dec-16,6.36E+11,,5000.00,1356086.85,Marshall,667,Germany,53412.54,0,1,0
2875,2011,6,RENT,1,Low,1,12000, 60 months,2,debt_consolidation,6,High,2,Bad Loan,1,17.27,D,4,18.07,2698.04,1207.66,11.72,299.98,409000002874,22-Dec-16,6.36E+11,,3000.00,1359086.85,Duncan,831,Germany,194867.78,0,1,0
2876,2011,0.5,MORTGAGE,3,Low,1,10625, 36 months,1,debt_consolidation,6,High,2,Bad Loan,1,14.27,C,3,12.54,6452.01,1986.15,3536.57,364.54,409000002875,22-Dec-16,6.36E+11,,5000.00,1364086.85,Uspenskaya,545,Spain,150452.88,0,1,0
2877,2011,2,RENT,1,Low,1,7500, 36 months,1,debt_consolidation,6,Low,1,Bad Loan,1,7.9,A,1,12.32,1173.9,747.93,235.98,234.68,409000002876,22-Dec-16,6.36E+11,,3000.00,1367086.85,Thomson,604,Spain,57807.05,0,1,0
2878,2011,10,MORTGAGE,3,Low,1,14750, 60 months,2,debt_consolidation,6,High,2,Good Loan,0,13.49,C,3,24.76,19512.42419,14750,0,339.32,409000002877,29-Dec-16,NEFT/SBIN416364533068/BIK,,8000.00,1375086.85,Calabrese,657,Spain,107534.32,0,1,0
2879,2011,2,RENT,1,Low,1,17500, 36 months,1,debt_consolidation,6,Low,1,Good Loan,0,11.71,B,2,6.25,20833.34268,17500,0,578.83,409000002878,3-Jan-17,NEFT/BKIDN17003770149/ARJ,,8000.00,1383086.85,Herrera,487,Spain,194073.33,0,1,0
2880,2011,10,MORTGAGE,3,Low,1,16000, 36 months,1,other,4,Low,1,Good Loan,0,11.71,B,2,19.95,18774.27,16000,0,529.22,409000002879,7-Jan-17,7.01E+11,,5000.00,1388086.85,Muse,750,Germany,126233.18,0,1,0
2881,2011,6,RENT,1,Low,1,6700, 60 months,2,small_business,3,High,2,Good Loan,0,15.27,C,3,16.43,7824.65,5046.3,0,160.35,409000002880,7-Jan-17,7.01E+11,,3000.00,1391086.85,Marsden,694,Germany,182354.46,0,1,0
2882,2011,10,RENT,1,Low,1,7000, 36 months,1,credit_card,1,Low,1,Good Loan,0,12.42,B,2,19.6,8416.958299,7000,0,233.91,409000002881,12-Jan-17,7.01E+11,,5000.00,1396086.85,Artemyeva,711,Germany,120586.32,0,1,0
2883,2011,10,MORTGAGE,3,Low,1,6625, 36 months,1,debt_consolidation,6,Low,1,Good Loan,0,6.62,A,1,19.96,7156.55,6625,0,203.42,409000002882,12-Jan-17,7.01E+11,,3000.00,1399086.85,McKay,551,France,50578.40,0,1,0
2884,2011,7,MORTGAGE,3,Low,1,12000, 60 months,2,debt_consolidation,6,High,2,Bad Loan,1,17.58,D,4,11.9,11475.62,6328.38,54.34,301.99,409000002883,13-Jan-17,NEFT/SBIN317013377571/NIK,,8000.00,1407086.85,Chuang,559,France,86575.46,0,1,0
2885,2011,10,RENT,1,Low,1,7000, 36 months,1,credit_card,1,Low,1,Good Loan,0,7.9,A,1,20.5,7844.977048,7000,0,219.04,409000002884,16-Jan-17,701616382504-193247227116,,8000.00,1415086.85,Nicholls,620,France,153392.28,0,1,0
2886,2011,7,MORTGAGE,3,Low,1,7000, 36 months,1,credit_card,1,Low,1,Good Loan,0,11.71,B,2,12.7,8333.565578,7000,0,231.54,409000002885,17-Jan-17,7.02E+11,,5000.00,1420086.85,Dennis,660,Spain,115509.59,0,1,0
2887,2011,10,MORTGAGE,3,Medium,2,35000, 60 months,2,credit_card,1,Low,1,Good Loan,0,11.71,B,2,19.9,37877.76,26957.05,0,773.44,409000002886,17-Jan-17,7.02E+11,,3000.00,1423086.85,Knight,449,France,82176.48,0,1,0
2888,2011,6,RENT,1,Low,1,1000, 36 months,1,moving,10,High,2,Good Loan,0,15.27,C,3,23.75,1252.69,999.99,0,34.8,409000002887,19-Jan-17,7.02E+11,,2000.00,1425086.85,Webb,703,Germany,63717.49,0,1,0
2889,2011,5,MORTGAGE,3,Low,1,16000, 36 months,1,debt_consolidation,6,Low,1,Good Loan,0,12.69,B,2,17.31,19017.09,16000,0,536.72,409000002888,23-Jan-17,7.02E+11,,5000.00,1430086.85,Pugliesi,795,Germany,198745.94,0,1,0
2890,2011,10,RENT,1,Low,1,10000, 36 months,1,debt_consolidation,6,High,2,Good Loan,0,16.77,D,4,19.13,12690.02893,10000,0,355.39,409000002889,23-Jan-17,7.02E+11,,5000.00,1435086.85,Nebechukwu,594,France,5719.11,0,1,0
2891,2011,4,MORTGAGE,3,Low,1,10500, 60 months,2,home_improvement,7,High,2,Good Loan,0,19.42,E,5,6.36,13447.23,7742.63,0,274.81,409000002890,3-Feb-17,7.03E+11,,10000.00,1445086.85,Ward,586,Spain,20058.61,0,1,0
2892,2011,1,MORTGAGE,3,Low,1,25000, 60 months,2,debt_consolidation,6,Low,1,Good Loan,0,12.69,B,2,19.38,28822.37,25000,0,564.87,409000002891,3-Feb-17,NEFT/SBIN117034378839/ROH,,1000.00,1446086.85,Nixon,613,Germany,170638.98,0,1,0
2893,2011,5,MORTGAGE,3,Low,1,3100, 36 months,1,debt_consolidation,6,Low,1,Good Loan,0,11.71,B,2,14.47,3704.744417,3100,0,102.54,409000002892,6-Feb-17,NEFT/SBIN317037483530/Mr,,5000.00,1451086.85,Chidubem,601,France,30607.11,0,1,0
2894,2011,6.05,MORTGAGE,3,Low,1,25000, 60 months,2,house,12,Low,1,Good Loan,0,11.71,B,2,8.42,25485.79,25000,0,552.46,409000002893,7-Feb-17,NEFT/SBIN417038897386/Mr,,5000.00,1456086.85,Rivers,657,France,37171.46,0,1,0
2895,2011,8,OWN,2,Low,1,2500, 36 months,1,car,2,Low,1,Good Loan,0,6.03,A,1,7.75,2716.367348,2500,0,76.09,409000002894,10-Feb-17,TRF TO  Indiaforensic SERVICES I,"1,000,000.00",,456086.85,Sochima,531,France,42589.33,0,1,0
2896,2011,3,RENT,1,Low,1,9000, 36 months,1,credit_card,1,High,2,Good Loan,0,13.49,C,3,20.62,10555.71,9000,0,305.38,409000002895,4-Mar-17,7.06E+11,,100.00,456186.85,Heydon,621,Germany,66799.28,0,1,0
2897,2011,1,RENT,1,Low,1,1600, 36 months,1,other,4,High,2,Good Loan,0,16.29,D,4,17.58,2032.650329,1600,0,56.49,409000002896,9-Mar-17,NEFT/1164947163/DILIP POP,,25000.00,481186.85,Lombardo,782,France,101866.39,0,1,0
2898,2011,0.5,RENT,1,Medium,2,10800, 36 months,1,debt_consolidation,6,High,2,Good Loan,0,14.65,C,3,7.89,13410.10041,10800,0,372.54,409000002897,10-Mar-17,NEFT/1165815732/DILIP POP,,50000.00,531186.85,Holland,528,Germany,49284.00,0,1,0
2899,2011,4,OWN,2,Low,1,20000, 60 months,2,debt_consolidation,6,High,2,Good Loan,0,13.49,C,3,25.23,22517.86,15248.78,0,460.1,409000002898,21-Mar-17,NEFT/SBIN417080713726/NAR,,8050.00,539236.85,Tien,696,France,27445.40,0,1,0
2900,2011,10,MORTGAGE,3,Low,1,8000, 36 months,1,credit_card,1,High,2,Good Loan,0,13.49,C,3,9.55,9770.790301,8000,0,271.45,409000002899,24-Mar-17,708316683155-199306494324,,1.00,539237.85,Bryant,586,France,70760.69,0,1,0
2901,2011,10,RENT,1,Low,1,12000, 60 months,2,debt_consolidation,6,High,2,Good Loan,0,19.42,E,5,19.52,16946.31325,12000,0,314.07,409000002900,31-Mar-17,7.09E+11,,2000.00,541237.85,Hao,626,Spain,104502.02,0,1,0
2902,2011,6,MORTGAGE,3,Low,1,5000, 36 months,1,other,4,Low,1,Good Loan,0,6.03,A,1,1.8,5025.59,5000,0,152.18,409000002901,3-Apr-17,TRF TO  Indiaforensic SERVICES I,"100,000.00",,441237.85,Genovesi,498,France,165407.96,0,1,0
2903,2011,0.5,MORTGAGE,3,Low,1,6000, 36 months,1,credit_card,1,Low,1,Good Loan,0,9.91,B,2,21.07,6959.138155,6000,0,193.35,409000002902,17-Apr-17,7.11E+11,,100000.00,541237.85,Kovalev,691,France,113580.79,0,1,0
2904,2011,8,MORTGAGE,3,Low,1,8600, 36 months,1,credit_card,1,Low,1,Good Loan,0,10.65,B,2,16.05,9799.68,8600,0,280.13,409000002903,3-May-17,NEFT/SBIN117123335066/GAY,,8050.00,549287.85,Hsieh,568,France,45978.39,0,1,0
2905,2011,10,RENT,1,Low,1,9450, 36 months,1,credit_card,1,High,2,Good Loan,0,16.29,D,4,15.97,12006.73536,9450,0,333.59,409000002904,19-May-17,7.14E+11,,2000.00,551287.85,Debellis,715,France,152012.36,0,1,0
2906,2011,3,RENT,1,Low,1,5200, 36 months,1,debt_consolidation,6,Low,1,Good Loan,0,12.42,B,2,12.11,6252.459426,5200,0,173.76,409000002905,31-May-17,NEFT/SBIN517151880769/DIL,,25000.00,576287.85,Chibueze,680,Germany,77349.92,0,1,0
2907,2011,6.05,MORTGAGE,3,Medium,2,6000, 36 months,1,major_purchase,8,Low,1,Good Loan,0,8.9,A,1,12.24,6857.580072,6000,0,190.52,409000002906,31-May-17,NEFT/SBIN517151881312/DIL,,25000.00,601287.85,Padovano,802,Spain,47322.05,0,1,0
2908,2011,6.05,RENT,1,Low,1,2800, 36 months,1,medical,9,High,2,Good Loan,0,14.65,C,3,3.04,3476.511346,2800,0,96.59,409000002907,12-Jun-17,Indiaforensic SERVICES INDIA PVT,200,,601087.85,Yen,539,France,38772.65,0,1,0
2909,2011,5,MORTGAGE,3,Low,1,8500, 36 months,1,car,2,High,2,Good Loan,0,15.27,C,3,18.65,9552.43,8500,0,295.79,409000002908,12-Jun-17,Indiaforensic SERVICES I P LTD F,200,,600887.85,Kibble,494,France,24489.44,0,1,0
2910,2011,10,MORTGAGE,3,Low,1,27000, 60 months,2,debt_consolidation,6,High,2,Bad Loan,1,19.91,E,5,8.99,10608.14,3822.1,1331.6,713.99,409000002909,12-Jun-17,Indiaforensic SERVICES I P LTD P,200,,600687.85,Lori,594,Germany,14466.08,0,1,0
2911,2011,7,RENT,1,Low,1,3200, 36 months,1,debt_consolidation,6,High,2,Good Loan,0,13.49,C,3,12.56,3907.758114,3200,0,108.58,409000002910,12-Jun-17,Indiaforensic SERVICES INDIA PVT,200,,600487.85,Enemuo,596,France,63142.12,0,1,0
2912,2011,7,MORTGAGE,3,Low,1,17050, 36 months,1,credit_card,1,High,2,Good Loan,0,14.27,C,3,20.38,21153.4809,17050,0,584.97,409000002911,12-Jun-17,Indiaforensic SERVICES I P LTD R,200,,600287.85,Lu,649,France,41858.43,0,1,0
2913,2011,9,RENT,1,Low,1,18000, 60 months,2,debt_consolidation,6,High,2,Good Loan,0,13.49,C,3,8.79,18987.54,18000,0,414.09,409000002912,12-Jun-17,Indiaforensic SERVICES I P LTD R,200,,600087.85,Nebeolisa,699,Germany,127443.82,0,1,0
2914,2011,2,RENT,1,Low,1,6200, 36 months,1,debt_consolidation,6,Low,1,Good Loan,0,12.69,B,2,13.91,7403.69283,6200,0,207.98,409000002913,14-Jun-17,Indiaforensic SERVICES INDIA PVT,200,,599887.85,Stewart,787,France,84151.98,0,1,0
2915,2011,0.5,MORTGAGE,3,Low,1,8000, 36 months,1,home_improvement,7,High,2,Good Loan,0,19.42,E,5,17.54,10626.2909,8000,0,294.95,409000002914,14-Jun-17,Indiaforensic SERVICES INDIA PVT,200,,599687.85,Ward,604,France,58595.64,0,1,0
2916,2011,0.5,MORTGAGE,3,Low,1,12000, 36 months,1,debt_consolidation,6,High,2,Good Loan,0,13.49,C,3,12.87,14653.40602,12000,0,407.17,409000002915,14-Jun-17,Indiaforensic SERVICES INDIA PVT,200,,599487.85,Milanesi,489,Germany,37240.11,0,1,0
2917,2011,7,MORTGAGE,3,Low,1,20000, 60 months,2,debt_consolidation,6,Low,1,Good Loan,0,11.71,B,2,6.11,21623.51,15390.94,0,441.97,409000002916,29-Jun-17,COMMISSION CHARGES,250,,599237.85,Chikwado,651,France,114522.68,0,1,0
2918,2011,3,RENT,1,Low,1,3000, 36 months,1,medical,9,Low,1,Good Loan,0,6.62,A,1,24.95,3314.801583,3000,0,92.12,409000002917,29-Jun-17,SERVICE TAX,35,,599202.85,Douglas,698,France,72549.27,0,1,0
2919,2011,10,MORTGAGE,3,Low,1,10000, 36 months,1,home_improvement,7,High,2,Bad Loan,1,15.96,C,3,24.22,9588.75,6724.48,460.93,351.38,409000002918,29-Jun-17,SWACHH BHARAT CESS,1.25,,599201.60,Sal,578,Germany,176712.59,0,1,0
2920,2011,3,RENT,1,Low,1,8000, 36 months,1,debt_consolidation,6,High,2,Good Loan,0,14.65,C,3,24.49,9455.61,8000,0,275.96,409000002919,29-Jun-17,KRISHI KALYAN CESS,1.25,,599200.35,Douglas,538,Spain,152855.96,0,1,0
2921,2011,8,MORTGAGE,3,Medium,2,14000, 36 months,1,home_improvement,7,Low,1,Good Loan,0,9.91,B,2,12.97,15028.19,14000,0,451.15,409000002920,6-Jul-17,TRF TO  Indiaforensic ONLINE SER,"100,000.00",,499200.35,Yates,696,France,73371.65,0,1,0
2922,2011,6,RENT,1,Low,1,22000, 60 months,2,debt_consolidation,6,High,2,Good Loan,0,16.77,D,4,21.81,27684.3,22000.01,0,544.04,409000002921,26-Jul-17,7.21E+11,,50000.00,549200.35,Watt,507,Germany,70323.68,0,1,0
2923,2011,2,RENT,1,Low,1,16000, 36 months,1,debt_consolidation,6,High,2,Good Loan,0,14.27,C,3,16.09,19397.5519,16000,0,548.95,409000002922,7-Apr-18,IMPS 809712134438 FROM OX,,10000.00,559200.35,P'an,685,Spain,9663.28,0,1,0
2924,2011,10,MORTGAGE,3,Low,1,4500, 36 months,1,car,2,Low,1,Good Loan,0,10.65,B,2,8.26,5275.119956,4500,0,146.58,409000002923,12-Jul-18,TRF TO  Indiaforensic SERVICES I,"100,000.00",,459200.35,H?,705,Germany,142514.66,0,1,0
2925,2011,7,MORTGAGE,3,Low,1,8000, 36 months,1,home_improvement,7,Low,1,Good Loan,0,6.62,A,1,7.77,8768.74,8000,0,245.63,409000002924,26-Oct-18,TRF TO Rajendra Kumar,"15,000,000.00",,-14540799.65,Perry,499,Germany,118623.94,0,1,0
2926,2011,10,RENT,1,Medium,2,5000, 36 months,1,debt_consolidation,6,High,2,Good Loan,0,20.89,F,6,19.53,6741.827027,5000,0,188.1,409000002925,26-Oct-18,TRF FROM  Indiaforensic SERVICES,,15000000.00,459200.35,Lavrov,717,France,68400.14,0,1,0
2927,2011,4,MORTGAGE,3,Low,1,15000, 36 months,1,debt_consolidation,6,High,2,Good Loan,0,14.27,C,3,5.54,18257.56374,15000,0,514.64,409000002926,31-Oct-18,TRF TO  Myur Joshi,"354,000,000.00",,-353540799.65,Chiekwugo,510,France,115291.86,0,1,0
2928,2011,10,MORTGAGE,3,Low,1,35000, 60 months,2,credit_card,1,High,2,Good Loan,0,14.27,C,3,17.72,47347.58276,35000,0,819.3,409000002927,31-Oct-18,TRF TO  Indiaforensic SERVICES I,"900,000.00",,-354440799.65,Macdonald,632,France,170382.99,0,1,0
2929,2011,2,RENT,1,Low,1,16000, 36 months,1,debt_consolidation,6,Low,1,Good Loan,0,6.03,A,1,23.52,17314.14,16000,0,486.97,409000002928,31-Oct-18,409000425051:Int.Coll:01-,"81,569.00",,-354522368.65,Jenkins,668,Germany,112946.67,0,1,0
2930,2011,10,OWN,2,Low,1,14400, 36 months,1,wedding,5,High,2,Good Loan,0,14.27,C,3,9.86,17781.30359,14400,0,494.05,409000002929,27-Nov-18,TRF FROM  Indiaforensic SERVICES,,81568.00,-354440800.65,Korovina,744,Germany,79812.77,0,1,0
2931,2011,3,OWN,2,High,3,35000, 36 months,1,other,4,Low,1,Good Loan,0,8.9,A,1,3.3,40003.54068,35000,0,1111.37,409000002930,27-Nov-18,TRF FROM  Indiaforensic SERVICES,,10000.00,-354430800.65,Manning,663,Germany,19862.78,0,1,0
2932,2011,1,MORTGAGE,3,Low,1,17000, 36 months,1,debt_consolidation,6,Low,1,Good Loan,0,9.91,B,2,19.99,19717.83144,17000,0,547.83,409000002931,30-Nov-18,409000425051:Int.Coll:01-,"2,447,599.00",,-356878399.65,Wilson,638,Germany,158610.89,0,1,0
2933,2011,2,MORTGAGE,3,Low,1,15000, 60 months,2,debt_consolidation,6,High,2,Good Loan,0,15.27,C,3,19.69,20946.46983,15000,0,358.98,409000002932,17-Dec-18,TRF FRM  Indiaforensic SERVICES,,2447600.00,-354430799.65,Begum,688,France,191212.63,0,1,0
2934,2011,1,RENT,1,Low,1,5600, 36 months,1,debt_consolidation,6,Low,1,Good Loan,0,7.9,A,1,12.32,6054.49,5600,0,175.23,409000002933,31-Dec-18,409000425051:Int.Coll:01-,"2,539,665.00",,-356970464.65,Ingrassia,588,Spain,61931.21,0,1,0
2935,2011,4,RENT,1,Low,1,9000, 36 months,1,debt_consolidation,6,High,2,Good Loan,0,15.96,C,3,8.27,11396.00222,9000,0,316.24,409000002934,10-Jan-19,TRF FROM  Indiaforensic SERVICES,,1539665.00,-355430799.65,Maclean,631,France,58043.02,0,1,0
2936,2011,3,MORTGAGE,3,Low,1,9000, 36 months,1,credit_card,1,Low,1,Good Loan,0,12.42,B,2,18.73,10159.91,9000,0,300.74,409000002935,11-Jan-19,TRF FROM  Indiaforensic SERVICES,,1000000.00,-354430799.65,Olejuru,687,Spain,22247.27,0,1,0
2937,2011,3,RENT,1,Low,1,8800, 36 months,1,debt_consolidation,6,Low,1,Good Loan,0,11.71,B,2,19.6,10296.14,8800,0,291.07,409000002936,31-Jan-19,409000425051:Int.Coll:01-,"2,535,326.00",,-356966125.65,Enyinnaya,599,France,31448.52,0,1,0
2938,2011,5,RENT,1,Low,1,8000, 36 months,1,debt_consolidation,6,High,2,Good Loan,0,18.25,D,4,6.27,10325.55991,8000,0,290.23,409000002937,28-Feb-19,409000425051:Int.Coll:01-,"2,303,989.00",,-359270114.65,Watson,718,Spain,146875.86,0,1,0
2939,2011,6,RENT,1,Low,1,10000, 36 months,1,credit_card,1,Low,1,Good Loan,0,11.71,B,2,19.48,11905.03725,10000,0,330.76,409000002938,2-Mar-19,FDRL/INTERNAL FUND TRANSFE,,2535326.00,-356734788.65,Langdon,730,France,116081.93,0,1,0
2940,2011,10,MORTGAGE,3,Low,1,12000, 60 months,2,debt_consolidation,6,Low,1,Bad Loan,1,8.9,A,1,5.52,3791.81,2152.63,584.84,248.52,409000002939,30-Jan-16,TRF TO Maur Joshi,"170,000,000.00",,-526734788.65,Frolov,533,France,73669.94,0,1,0
2941,2011,10,MORTGAGE,3,Low,1,5000, 36 months,1,debt_consolidation,6,Low,1,Good Loan,0,10.65,B,2,16.6,5862.092926,5000,0,162.87,409000002940,30-Jan-16,TRF TO Indiaforensic SERVICES IN,"30,000,000.00",,-556734788.65,Chikezie,711,Spain,93959.96,0,1,0
2942,2011,4,RENT,1,Low,1,16000, 36 months,1,credit_card,1,High,2,Good Loan,0,17.27,D,4,19.36,19697.09,16000,0,572.6,409000002941,31-Jan-16,409000405747:Int.Coll:01-,"126,230.00",,-556861018.65,Zetticci,555,Spain,158918.03,0,1,0
2943,2011,7,OWN,2,Low,1,1925, 36 months,1,other,4,Low,1,Good Loan,0,9.91,B,2,4.79,2000.58,1925,0,62.04,409000002942,1-Feb-16,TRF FROM  Indiaforensic SERVICES,,130000.00,-556731018.65,Yang,850,France,198193.75,0,1,0
2944,2011,2,RENT,1,Low,1,20000, 60 months,2,debt_consolidation,6,High,2,Good Loan,0,15.96,C,3,11.92,23735.4,15017.44,0,485.94,409000002943,12-Feb-16,Indiaforensic INCOME OCT-15 TO J,,20316.84,-556710701.81,Lin,678,France,13160.03,0,1,0
2945,2011,10,MORTGAGE,3,Low,1,4200, 60 months,2,debt_consolidation,6,High,2,Good Loan,0,20.89,F,6,14.91,5543.95,3069.45,0,113.37,409000002944,29-Feb-16,409000405747:Int.Coll:01-,"1,830,178.00",,-558540879.81,Goddard,576,France,4660.91,0,1,0
2946,2011,9,MORTGAGE,3,Low,1,15000, 36 months,1,other,4,Low,1,Good Loan,0,7.51,A,1,0,16212.25,15000,0,466.67,409000002945,8-Mar-16,TRF FROM  Indiaforensic SERVICES,,1900000.00,-556640879.81,Rogers,835,Germany,180197.74,0,1,0
2947,2011,0.5,RENT,1,Low,1,5200, 36 months,1,wedding,5,High,2,Good Loan,0,13.49,C,3,16.77,6060.45,5200,0,176.44,409000002946,14-Mar-16,Indiaforensic INCOME FEB - 2016,,109434.67,-556531445.14,Zubareva,592,France,63023.02,0,1,0
2948,2011,6,RENT,1,Medium,2,16000, 36 months,1,credit_card,1,High,2,Good Loan,0,15.27,C,3,6.59,19694.88011,16000,0,556.77,409000002947,31-Mar-16,409000405747:Int.Coll:01-,"1,981,741.00",,-558513186.14,Onochie,774,France,118971.74,0,1,0
2949,2011,6,RENT,1,Low,1,2700, 36 months,1,debt_consolidation,6,Low,1,Good Loan,0,12.69,B,2,20.64,3257.055514,2700,0,90.58,409000002948,28-Apr-16,TRF FROM  Indiaforensic SERVICES,,2000000.00,-556513186.14,Ts'ui,620,France,154700.61,0,1,0
2950,2011,6,MORTGAGE,3,Low,1,4500, 36 months,1,debt_consolidation,6,Low,1,Bad Loan,1,11.71,B,2,15.87,538.11,210.47,241.01,148.85,409000002949,30-Apr-16,409000405747:Int.Coll:01-,"2,238,842.00",,-558752028.14,Newsom,519,Spain,97577.17,0,1,0
2951,2011,7,MORTGAGE,3,Low,1,2100, 36 months,1,renewable_energy,13,Low,1,Good Loan,0,6.03,A,1,1.2,2217.3,2100,0,63.92,409000002950,3-May-16,TRF FROM  Indiaforensic SERVICES,,202100000.00,-356652028.14,Genovese,734,Spain,48990.50,0,1,0
2952,2011,10,MORTGAGE,3,Low,1,1000, 36 months,1,other,4,Low,1,Good Loan,0,12.69,B,2,17.13,1150.68,1000,0,33.55,409000002951,31-May-16,409000405747:Int.Coll:01-,"149,581.00",,-356801609.14,Thorpe,763,Germany,140262.96,0,1,0
2953,2011,10,OWN,2,Low,1,4000, 60 months,2,home_improvement,7,High,2,Good Loan,0,20.3,E,5,4.67,6015.97,3832.36,0,106.65,409000002952,2-Jun-16,TRF FROM  Indiaforensic SERVICES,,70000.00,-356731609.14,Horton,733,France,130189.53,0,1,0
2954,2011,3,MORTGAGE,3,Low,1,13000, 36 months,1,debt_consolidation,6,Low,1,Good Loan,0,7.9,A,1,28.31,14587.37461,13000,0,406.78,409000002953,30-Jun-16,Indiaforensic INCOME MARCH - 201,,46791.12,-356684818.02,Williamson,650,France,16301.91,0,1,0
2955,2011,0.5,MORTGAGE,3,Medium,2,28000, 60 months,2,other,4,High,2,Good Loan,0,18.64,E,5,17.76,36305.65,21760.79,0,720.81,409000002954,30-Jun-16,Indiaforensic INCOME APRIL - 201,,44327.15,-356640490.87,Shoobridge,538,France,126962.41,0,1,0
2956,2011,5,MORTGAGE,3,Low,1,22400, 60 months,2,debt_consolidation,6,High,2,Good Loan,0,18.25,D,4,16,27973.01,16624.18,0,571.87,409000002955,30-Jun-16,Indiaforensic INCOME MAY - 2016,,74988.07,-356565502.80,Peng,577,France,158750.53,0,1,0
2957,2011,10,MORTGAGE,3,Medium,2,16000, 36 months,1,medical,9,Low,1,Good Loan,0,6.03,A,1,9.94,17530.3733,16000,0,486.97,409000002956,30-Jun-16,409000405747:Int.Coll:01-,21,,-356565523.80,Gray,792,France,199644.20,0,1,0
2958,2011,10,MORTGAGE,3,Medium,2,30500, 60 months,2,debt_consolidation,6,High,2,Good Loan,0,14.27,C,3,17.2,34956.11,23158.22,0,713.96,409000002957,12-Jul-16,TRF FROM  Indiaforensic SERVICES,,500.00,-356565023.80,Watson,686,France,144272.71,0,1,0
2959,2011,0.5,MORTGAGE,3,Low,1,3000, 36 months,1,major_purchase,8,Low,1,Good Loan,0,8.9,A,1,17.78,3429.034474,3000,0,95.26,409000002958,12-Jul-16,Indiaforensic INCOME JUNE - 2016,,68746.42,-356496277.38,Fyodorova,589,France,98320.27,0,1,0
2960,2011,0.5,RENT,1,High,3,30000, 36 months,1,small_business,3,Low,1,Good Loan,0,9.91,B,2,9.4,34798.45318,30000,0,966.75,409000002959,22-Aug-16,Indiaforensic INCOME JULY - 2016,,80408.93,-356415868.45,Bazhenov,530,France,64129.03,0,1,0
2961,2011,3,MORTGAGE,3,Low,1,20000, 60 months,2,debt_consolidation,6,Low,1,Good Loan,0,12.69,B,2,5.9,24716.6954,20000,0,451.9,409000002960,29-Sep-16,VENDOR/PAYMENT/B M CHATRA,"8,626.00",,-356424494.45,Solomon,778,Germany,181221.09,0,1,0
2962,2011,5,MORTGAGE,3,Low,1,4900, 36 months,1,car,2,Low,1,Good Loan,0,6.03,A,1,12.49,5368.664519,4900,0,149.14,409000002961,25-Nov-16,TRF TO  Indiaforensic SERVICES I,"300,000.00",,-356724494.45,Layh,616,Spain,163809.08,0,1,0
2963,2011,0.5,MORTGAGE,3,Low,1,12000, 60 months,2,debt_consolidation,6,High,2,Bad Loan,1,17.58,D,4,19.41,6119.86,1632.83,2517.22,301.99,409000002962,7-Apr-18,IMPS 809712134386 FROM OX,,10000.00,-356714494.45,John,550,France,171457.06,0,1,0
2964,2011,1,RENT,1,Medium,2,20000, 60 months,2,debt_consolidation,6,High,2,Good Loan,0,14.27,C,3,24.5,22921.35,15188.58,0,468.17,409000002963,24-Sep-18,FUNDS TRF  Indiaforensic SERVICE,"10,000,000.00",,-366714494.45,Tuan,655,France,15801.02,0,1,0
2965,2011,2,RENT,1,Low,1,7000, 36 months,1,debt_consolidation,6,High,2,Good Loan,0,15.96,C,3,11.94,8541.93,7000,0,245.97,409000002964,24-Sep-18,FUNDS TRF Riskpro,"15,000,000.00",,-381714494.45,Slattery,721,France,102950.79,0,1,0
2966,2011,4,RENT,1,Low,1,3600, 36 months,1,debt_consolidation,6,Low,1,Good Loan,0,11.71,B,2,18.07,3767.28,3600,0,119.08,409000002965,24-Sep-18,TRF TO  Riskpro Management,"1,000,000.00",,-382714494.45,Onyekachi,499,Germany,174918.46,0,1,0
2967,2011,2,RENT,1,Low,1,13200, 60 months,2,other,4,High,2,Good Loan,0,13.49,C,3,4.63,14849.41,10057.03,0,303.67,409000002966,24-Sep-18,TRF TO  Riskpro Management Consulting,"10,000,000.00",,-392714494.45,Genovese,511,France,193160.25,0,1,0
2968,2011,3,RENT,1,Low,1,6000, 36 months,1,home_improvement,7,High,2,Good Loan,0,15.27,C,3,1.82,7513.825639,6000,0,208.79,409000002967,25-Sep-18,TRF TO  Rikpro Mgmt cons,"15,000,000.00",,-407714494.45,Daniels,579,Germany,5831.00,0,1,0
2969,2011,10,MORTGAGE,3,High,3,35000, 36 months,1,home_improvement,7,Low,1,Good Loan,0,7.9,A,1,9.93,39320.28079,35000,0,1095.16,409000002968,25-Sep-18,TRF TO  Reskpo Managemnt,"10,000,000.00",,-417714494.45,Caldwell,696,Spain,82298.59,0,1,0
2970,2011,8,RENT,1,Low,1,7000, 36 months,1,debt_consolidation,6,Low,1,Good Loan,0,9.91,B,2,19.42,8000.93,7000,0,225.58,409000002969,26-Sep-18,TRF TO  Riskpro Management,"5,800,000.00",,-423514494.45,Chiemenam,681,France,130686.59,0,1,0
2971,2011,0.5,MORTGAGE,3,Medium,2,35000, 36 months,1,debt_consolidation,6,Low,1,Good Loan,0,10.65,B,2,9.91,41034.33964,35000,0,1140.07,409000002970,26-Sep-18,TRF TO  Riskpro Management,"13,100,000.00",,-436614494.45,Wanliss,815,France,52885.23,0,1,0
2972,2011,7,MORTGAGE,3,Low,1,21600, 60 months,2,debt_consolidation,6,High,2,Good Loan,0,16.77,D,4,10.46,25591.84,15716.98,0,534.15,409000002971,27-Sep-18,TRF TO  Indiaforensic SERVICES I,"7,100,000.00",,-443714494.45,Bruce,681,Spain,68985.99,0,1,0
2973,2011,4,RENT,1,Low,1,7000, 36 months,1,credit_card,1,Low,1,Bad Loan,1,7.9,A,1,15.48,2071.27,1413.38,320.68,219.04,409000002972,28-Sep-18,Payments For : 9090000577,"103,020,294.20",,-546734788.65,Wright,641,Spain,35367.19,0,1,0
2974,2011,10,OWN,2,Low,1,10500, 36 months,1,home_improvement,7,High,2,Bad Loan,1,15.96,C,3,21.28,11806.4,9058.38,18.98,368.95,409000002973,29-Sep-18,TRF TO  Indiaforensic SERVICES I,"5,000,000.00",,-551734788.65,Fang,591,France,196241.94,0,1,0
2975,2011,0.5,RENT,1,Low,1,15575, 36 months,1,debt_consolidation,6,High,2,Good Loan,0,14.27,C,3,23.11,16118,15575,0,534.37,409000002974,30-Sep-18,409000405747:Int.Coll:01-,"236,963.00",,-551971751.65,Eames,565,Germany,170705.53,0,1,0
2976,2011,1,MORTGAGE,3,Medium,2,14000, 60 months,2,debt_consolidation,6,High,2,Good Loan,0,16.77,D,4,18.39,16923.21,10471.46,0,346.21,409000002975,9-Oct-18,TRF FROM  Indiaforensic SERVICES,,250000.00,-551721751.65,Sutherland,487,France,126477.41,0,1,0
2977,2011,3,RENT,1,Low,1,16000, 36 months,1,small_business,3,Low,1,Good Loan,0,7.9,A,1,6.59,17811.18,16000,0,500.65,409000002976,10-Oct-18,TRF FROM  Indiaforensic SERVICES,,5000000.00,-546721751.65,Cavenagh,729,France,159618.17,0,1,0
2978,2011,10,RENT,1,Low,1,3000, 36 months,1,debt_consolidation,6,Low,1,Good Loan,0,12.69,B,2,21.11,3622.068203,3000,0,100.64,409000002977,11-Oct-18,TRF TO  Indiaforensic SERVICES I,"10,000,000.00",,-556721751.65,Dumetolisa,505,Spain,195395.33,0,1,0
2979,2011,5,RENT,1,Low,1,7200, 36 months,1,debt_consolidation,6,High,2,Bad Loan,1,19.03,E,5,16.7,8591.47,6187.14,142.19,264.04,409000002978,31-Oct-18,409000405747:Int.Coll:01-,"1,727,846.00",,-558449597.65,Mackay,580,France,168285.85,0,1,0
2980,2011,10,RENT,1,Low,1,3200, 36 months,1,debt_consolidation,6,Low,1,Good Loan,0,12.42,B,2,16.58,3847.827513,3200,0,106.93,409000002979,27-Nov-18,TRF FROM  Indiaforensic SERVICES,,1727846.00,-556721751.65,Dellucci,642,France,138052.51,0,1,0
2981,2011,0.5,OWN,2,Medium,2,30000, 60 months,2,debt_consolidation,6,High,2,Good Loan,0,19.42,E,5,14.11,45167.3262,30000,0,785.17,409000002980,30-Nov-18,409000405747:Int.Coll:01-,"1,703,165.00",,-558424916.65,Kenyon,850,Spain,71179.31,0,1,0
2982,2011,10,MORTGAGE,3,Low,1,15600, 36 months,1,debt_consolidation,6,Low,1,Good Loan,0,11.71,B,2,16.65,18571.33646,15600,0,515.99,409000002981,19-Dec-18,TRF FROM  Indiaforensic SERVICES,,1704000.00,-556720916.65,Parry,616,Germany,55556.30,0,1,0
2983,2011,1,MORTGAGE,3,Low,1,5600, 60 months,2,car,2,High,2,Bad Loan,1,15.27,C,3,12.56,6153.42,3970.28,320.33,134.02,409000002982,24-Dec-18,FDRL/INTERNAL FUND TRANSFE,,7500000.00,-549220916.65,Kennedy,526,Spain,31705.19,0,1,0
2984,2011,2,RENT,1,Low,1,3000, 36 months,1,major_purchase,8,Low,1,Good Loan,0,11.71,B,2,16.8,3570.772929,3000,0,99.23,409000002983,24-Dec-18,FDRL/INTERNAL FUND TRANSFE,,500000.00,-548720916.65,Arnott,523,Germany,186118.93,0,1,0
2985,2011,10,OWN,2,Low,1,18000, 36 months,1,debt_consolidation,6,Low,1,Good Loan,0,7.9,A,1,12.92,19050.88,18000,0,563.23,409000002984,24-Dec-18,FDRL/INTERNAL FUND TRANSFE,,2000000.00,-546720916.65,Hanson,663,France,195580.28,0,1,0
2986,2011,5,RENT,1,Low,1,7200, 36 months,1,debt_consolidation,6,Low,1,Good Loan,0,11.71,B,2,11.8,8569.385749,7200,0,238.15,409000002985,31-Dec-18,409000405747:Int.Coll:01-,"1,751,799.00",,-548472715.65,T'ao,840,France,54113.38,0,1,0
2987,2011,10,MORTGAGE,3,Medium,2,16000, 60 months,2,debt_consolidation,6,High,2,Good Loan,0,16.77,D,4,16.44,19347.79,11971.07,0,395.67,409000002986,4-Jan-19,TRF FRM  Indiaforensic SERVICES,,1751799.00,-546720916.65,Shen,570,Germany,127528.84,0,1,0
2988,2011,6.05,MORTGAGE,3,Low,1,3000, 36 months,1,other,4,Low,1,Bad Loan,1,12.69,B,2,22.23,2708.44,2133.62,0,100.64,409000002987,31-Jan-19,409000405747:Int.Coll:01-,"1,696,058.00",,-548416974.65,Steere,676,Germany,60231.74,0,1,0
2989,2011,1,MORTGAGE,3,Low,1,24000, 60 months,2,debt_consolidation,6,High,2,Good Loan,0,19.03,E,5,22.58,29269.13,24000,0,622.97,409000002988,28-Feb-19,409000405747:Int.Coll:01-,"1,546,542.00",,-549963516.65,Abbott,689,France,156878.42,0,1,0
2990,2011,10,OWN,2,Low,1,6000, 36 months,1,home_improvement,7,Low,1,Good Loan,0,6.03,A,1,10.27,6388.25,6000,0,182.62,409000002989,2-Mar-19,FDRL/INTERNAL FUND TRANSFE,,1696058.00,-548267458.65,Sutherland,703,Spain,182784.11,0,1,0
2991,2011,7,MORTGAGE,3,Low,1,15000, 60 months,2,credit_card,1,High,2,Good Loan,0,18.25,D,4,14.35,17362.66,15000,0,382.95,409000002990,25-Feb-16,GOLD LABEL INVESTMENTS (P,,170250000.00,-378017458.65,Thurgood,491,Germany,129690.50,0,1,0
2992,2011,2,MORTGAGE,3,Medium,2,25000, 36 months,1,debt_consolidation,6,Low,1,Good Loan,0,12.42,B,2,18.46,29892.9911,25000,0,835.39,409000002991,26-Feb-16,TRF TO  M Joshi,"130,000,000.00",,-508017458.65,Johnson,584,France,113860.81,0,1,0
2993,2011,6.05,MORTGAGE,3,Low,1,10000, 36 months,1,major_purchase,8,Low,1,Good Loan,0,6.03,A,1,1.7,10105.12,10000,0,304.36,409000002992,26-Feb-16,TRF TO  Indiaforensic SERVICES I,"40,000,000.00",,-548017458.65,Lung,810,France,184524.74,0,1,0
2994,2011,1,MORTGAGE,3,Low,1,15000, 36 months,1,renewable_energy,13,Low,1,Good Loan,0,6.62,A,1,2.8,15534.99,15000,0,460.56,409000002993,1-Mar-16,NEFT/FDRL401250221/Indiaforensic,,15000000.00,-533017458.65,Cocci,745,Spain,36124.98,0,1,0
2995,2011,2,MORTGAGE,3,Low,1,5000, 60 months,2,other,4,High,2,Good Loan,0,19.91,E,5,24.76,6474.1,3678.45,0,132.22,409000002994,1-Mar-16,NEFT/FDRL401250220/Indiaforensic,,15000000.00,-518017458.65,Matveyeva,625,France,121316.07,0,1,0
2996,2011,0.5,RENT,1,Low,1,30000, 36 months,1,debt_consolidation,6,Low,1,Good Loan,0,6.62,A,1,18.65,31930.64,30000,0,921.11,409000002995,3-Mar-16,RTGS/ICICH16063341652/Indfor,,15000000.00,-503017458.65,Moore,535,France,185630.76,0,1,0
2997,2011,4,RENT,1,Low,1,5000, 36 months,1,debt_consolidation,6,Low,1,Good Loan,0,12.42,B,2,7.58,5939.007796,5000,0,167.08,409000002996,3-Mar-16,RTGS/ICICH16063341657/Indfor,,15000000.00,-488017458.65,Yobachukwu,729,Spain,71133.12,0,1,0
2998,2011,2,RENT,1,Medium,2,7500, 36 months,1,debt_consolidation,6,High,2,Good Loan,0,16.77,D,4,12.84,9607.218625,7500,0,266.54,409000002997,4-Mar-16,RTGS CHARGES AND STAX/RAT,28.63,,-488017487.28,Fleming,655,France,32020.42,0,1,0
2999,2011,5,MORTGAGE,3,Low,1,35000, 60 months,2,debt_consolidation,6,Low,1,Good Loan,0,12.42,B,2,10.05,46688.58998,35000,0,786.01,409000002998,4-Mar-16,RTGS/YESBH16064937327/Indfor,"15,000,000.00",,-503017487.28,Dickinson,751,France,162760.96,0,1,0
3000,2011,5,MORTGAGE,3,Low,1,16800, 36 months,1,debt_consolidation,6,Low,1,Good Loan,0,6.03,A,1,12.5,17982.38,16800,0,511.32,409000002999,4-Mar-16,RTGS CHARGES AND STAX/RAT,28.63,,-503017515.91,Evseyev,525,France,175178.56,0,1,0
3001,2011,5,MORTGAGE,3,Low,1,35000, 60 months,2,debt_consolidation,6,High,2,Bad Loan,1,17.27,D,4,23.84,11373.24,5252.6,0,874.93,409000003000,4-Mar-16,RTGS/YESBH16064937396/Indfor,"15,000,000.00",,-518017515.91,Aksenov,532,France,177099.71,0,1,0
3002,2011,10,MORTGAGE,3,Low,1,1800, 36 months,1,car,2,Low,1,Good Loan,0,7.51,A,1,26.92,2012.271057,1800,0,56,409000003001,4-Mar-16,RTGS CHARGES AND STAX/RAT,28.63,,-518017544.54,Fleming,696,Spain,66406.37,0,1,0
3003,2011,10,RENT,1,Low,1,16000, 36 months,1,debt_consolidation,6,High,2,Good Loan,0,17.27,D,4,17.24,20490.41304,16000,0,572.6,409000003002,4-Mar-16,RTGS/YESBH16064937414/Indfor,"15,000,000.00",,-533017544.54,Ulyanov,786,Germany,59559.81,0,1,0
3004,2011,5,RENT,1,Low,1,3000, 36 months,1,other,4,Low,1,Good Loan,0,12.42,B,2,6.25,3608.320559,3000,0,100.25,409000003003,4-Mar-16,RTGS CHARGES AND STAX/RAT,28.63,,-533017573.17,Summers,580,France,175750.21,0,1,0
3005,2011,9,MORTGAGE,3,Low,1,5000, 36 months,1,other,4,Low,1,Good Loan,0,6.62,A,1,9.24,5526.337484,5000,0,153.52,409000003004,4-Mar-16,RTGS/YESBH16064937485/Indfor,"15,000,000.00",,-548017573.17,Clements,596,Germany,174311.30,0,1,0
3006,2011,10,MORTGAGE,3,Low,1,24000, 60 months,2,debt_consolidation,6,High,2,Bad Loan,1,14.65,C,3,21.85,6328.41,2585.3,1230.27,566.56,409000003005,30-Mar-16,RTGS/YESBH16064937495/RMCPL,,15000000.00,-533017573.17,Kazakova,683,France,171716.81,0,1,0
3007,2011,0.5,RENT,1,Low,1,13000, 36 months,1,debt_consolidation,6,Low,1,Good Loan,0,8.9,A,1,14.59,14859.269,13000,0,412.8,409000003006,30-Mar-16,RTGS/YESBH16064937475/Risk Pro,,15000000.00,-518017573.17,Pirozzi,747,France,189362.39,0,1,0
3008,2011,1,MORTGAGE,3,Low,1,4000, 36 months,1,other,4,High,2,Good Loan,0,13.49,C,3,24.04,4868.638283,4000,0,135.73,409000003007,30-Mar-16,RTGS/YESBH16064937486/Riskpro,,15000000.00,-503017573.17,Jamieson,602,France,180716.10,0,1,0
3009,2011,4,RENT,1,Medium,2,25000, 60 months,2,debt_consolidation,6,High,2,Good Loan,0,19.03,E,5,11,35989.14881,25000,0,648.93,409000003008,30-Mar-16,RTGS/YESBH16064937487/Risk Pro,,15000000.00,-488017573.17,Ferri,779,France,116977.89,0,1,0
3010,2011,10,MORTGAGE,3,Low,1,15000, 36 months,1,debt_consolidation,6,Low,1,Good Loan,0,7.9,A,1,12.72,15366.94,15000,0,469.36,409000003009,30-Mar-16,RTGS/YESBH16064937985/Riskpo,,15000000.00,-473017573.17,Mai,551,France,185105.44,0,1,0
3011,2011,0.5,RENT,1,Medium,2,35000, 36 months,1,other,4,Low,1,Good Loan,0,7.9,A,1,0.94,36385.51,35000,0,1095.16,409000003010,30-Mar-16,RTGS/YESBH16064937485/Indfor,,15000000.00,-458017573.17,Hannaford,666,France,35046.97,0,1,0
3012,2011,9,MORTGAGE,3,Low,1,10000, 36 months,1,debt_consolidation,6,Low,1,Good Loan,0,12.42,B,2,12.58,10584.72,10000,0,334.16,409000003011,30-Mar-16,RTGS/YESBH16064937485/Indfor,,15000000.00,-443017573.17,Fomin,526,Spain,36251.00,0,1,0
3013,2011,4,RENT,1,Low,1,10000, 36 months,1,debt_consolidation,6,Low,1,Good Loan,0,11.71,B,2,6.87,11441.72,10000,0,330.76,409000003012,30-Mar-16,RTGS/YESBH16064937485/Indfor,,15000000.00,-428017573.17,Mahon,849,France,103174.50,0,1,0
3014,2011,4,RENT,1,Low,1,14400, 36 months,1,credit_card,1,Low,1,Good Loan,0,10.65,B,2,9.44,15471.15,14399.99,0,469.06,409000003013,30-Mar-16,RTGS/YESBH16064937485/Indfor,,15000000.00,-413017573.17,Shaw,471,France,122642.09,0,1,0
3015,2011,0.5,RENT,1,Medium,2,35000, 60 months,2,debt_consolidation,6,High,2,Bad Loan,1,23.52,G,7,21.2,9828.83,2664.9,1857.55,997.16,409000003014,30-Mar-16,RTGS/YESBH16064937485/Indfor,,15000000.00,-398017573.17,Volkova,628,Spain,122937.57,0,1,0
3016,2011,2,RENT,1,Low,1,6075, 36 months,1,wedding,5,Low,1,Bad Loan,1,12.42,B,2,7.4,4868.88,3792.92,0,203,409000003015,30-Mar-16,RTGS/YESBH16064937485/Indfor,,15000000.00,-383017573.17,Miles,674,Germany,8757.39,0,1,0
3017,2011,3,RENT,1,Low,1,8000, 36 months,1,home_improvement,7,Low,1,Good Loan,0,6.62,A,1,1.12,8860.426005,8000,0,245.63,409000003016,30-Mar-16,RTGS/YESBH16064937485/Indfor,,15000000.00,-368017573.17,Madison,797,France,125782.29,0,1,0
3018,2011,2,RENT,1,Low,1,20000, 60 months,2,debt_consolidation,6,High,2,Good Loan,0,17.27,D,4,22.86,26543.40198,20000,0,499.96,409000003017,30-Mar-16,RTGS/YESBH16064937485/Indfor,,15000000.00,-353017573.17,Scott,590,Spain,122487.73,0,1,0
3019,2011,5,MORTGAGE,3,Medium,2,35000, 36 months,1,debt_consolidation,6,Low,1,Good Loan,0,7.9,A,1,11.79,39422.28483,35000,0,1095.16,409000003018,30-Mar-16,RTGS/YESBH16064937485/Indfor,,15000000.00,-338017573.17,Voss,588,France,20066.38,0,1,0
3020,2011,3,RENT,1,Low,1,17400, 60 months,2,debt_consolidation,6,High,2,Bad Loan,1,18.25,D,4,3.8,13233.91,5648.18,1684.19,444.22,409000003019,30-Mar-16,RTGS/YESBH16064937485/Indfor,,15000000.00,-323017573.17,Colebatch,577,France,55473.15,0,1,0
3021,2011,3,RENT,1,Low,1,16000, 60 months,2,debt_consolidation,6,High,2,Good Loan,0,17.58,D,4,16.73,19696.43,11920.2,0,402.65,409000003020,30-Mar-16,RTGS/YESBH16064937485/Riks pro,,15000000.00,-308017573.17,Wilson,571,France,38962.94,0,1,0
3022,2011,6,RENT,1,Low,1,1600, 36 months,1,other,4,Low,1,Good Loan,0,12.42,B,2,12.11,1923.794213,1600,0,53.47,409000003021,31-Mar-16,RTGS CHARGES AND STAX/RAT,28.63,,-308017601.80,T'ang,680,France,63795.80,0,1,0
3023,2011,3,MORTGAGE,3,Low,1,12800, 60 months,2,debt_consolidation,6,Low,1,Good Loan,0,8.9,A,1,19.9,12944.93,9978.47,0,265.09,409000003022,31-Mar-16,RTGS/YESBH16091327977/Rikspro,"240,000,000.00",,-548017601.80,Gibson,648,Spain,163060.43,0,1,0
3024,2011,3,MORTGAGE,3,Low,1,7750, 36 months,1,car,2,Low,1,Good Loan,0,6.62,A,1,20.38,8565.479272,7750,0,237.96,409000003023,18-May-16,RUPAY POS ACQ SETTL 14051,,44.25,-548017557.55,Hs?eh,618,France,26578.69,0,1,0
3025,2011,2,OWN,2,Low,1,18000, 60 months,2,debt_consolidation,6,High,2,Bad Loan,1,22.06,F,6,16.18,12433.62,4225.07,1992.42,497.76,409000003024,27-May-16,RUPAY POS ACQ SETTL 27051,,208.81,-548017348.74,Pan,648,Germany,5066.76,0,1,0
3026,2011,7,MORTGAGE,3,Low,1,5700, 60 months,2,small_business,3,High,2,Good Loan,0,23.52,G,7,5.66,7946.94,4100.85,0,162.4,409000003025,2-Jun-16,RUPAY POS ACQ SETTL 01061,,11.94,-548017336.80,Chikelu,759,France,140497.67,0,1,0
3027,2011,0.5,RENT,1,Low,1,12000, 60 months,2,credit_card,1,High,2,Good Loan,0,15.27,C,3,16.85,16875.1465,12000,0,287.19,409000003026,3-Jun-16,RUPAY POS ACQ SETTL 02061,,238.96,-548017097.84,Allan,585,France,146156.98,0,1,0
3028,2011,0.5,RENT,1,Low,1,6000, 36 months,1,debt_consolidation,6,High,2,Good Loan,0,13.49,C,3,5.08,7180.224143,6000,0,203.59,409000003027,4-Jun-16,RUPAY POS ACQ SETTL 03061,,331.24,-548016766.60,Yefremova,774,France,199316.19,0,1,0
3029,2011,10,MORTGAGE,3,Medium,2,3000, 36 months,1,medical,9,High,2,Good Loan,0,13.49,C,3,5.65,3662.994302,3000,0,101.8,409000003028,15-Jun-16,RUPAY POS ACQ SETTL 12061,,109.65,-548016656.95,Chuang,697,Germany,103944.37,0,1,0
3030,2011,5,MORTGAGE,3,Low,1,5600, 36 months,1,debt_consolidation,6,Low,1,Good Loan,0,7.9,A,1,10.43,5922.99,5600,0,175.23,409000003029,15-Jun-16,RUPAY POS ACQ SETTL 14061,0.35,,-548016657.30,Fan,605,Spain,138021.36,0,1,0
3031,2011,10,RENT,1,Low,1,8000, 36 months,1,debt_consolidation,6,High,2,Bad Loan,1,14.65,C,3,18.36,7722.84,5903.07,0,275.96,409000003030,16-Jun-16,RUPAY POS ACQ SETTL 15061,509.65,,-548017166.95,Dellucci,676,France,68621.98,0,1,0
3032,2011,0.5,MORTGAGE,3,Low,1,30000, 36 months,1,home_improvement,7,High,2,Good Loan,0,16.77,D,4,9.49,33434.54,30000,0,1066.16,409000003031,16-Jun-16,RUPAY POS ACQ SETTL 16061,0.35,,-548017167.30,Garran,678,France,28149.06,0,1,0
3033,2011,0.5,MORTGAGE,3,Low,1,20000, 36 months,1,debt_consolidation,6,High,2,Good Loan,0,13.49,C,3,16.04,24381.30852,20000,0,678.61,409000003032,18-Jun-16,RUPAY POS ACQ SETTL 15061,,509.65,-548016657.65,Moretti,495,Spain,135169.76,0,1,0
3034,2011,10,MORTGAGE,3,Low,1,10000, 60 months,2,home_improvement,7,Low,1,Good Loan,0,9.91,B,2,6.46,10850.36,10000,0,212.03,409000003033,18-Jun-16,RUPAY POS ACQ SETTL 15061,,509.65,-548016148.00,Yao,787,France,116537.96,0,1,0
3035,2011,3,MORTGAGE,3,Low,1,24000, 36 months,1,credit_card,1,Low,1,Good Loan,0,9.91,B,2,19.36,27433.12,24000,0,773.4,409000003034,18-Jun-16,RUPAY POS ACQ SETTL 17061,,509.65,-548015638.35,Lucchesi,770,France,105922.69,0,1,0
3036,2011,7,MORTGAGE,3,Low,1,10800, 60 months,2,debt_consolidation,6,High,2,Bad Loan,1,20.3,E,5,4.07,1146.8,429.9,0,287.94,409000003035,20-Jun-16,RUPAY POS ACQ SETTL 19061,,619.31,-548015019.04,Nkemdilim,817,Germany,88211.12,0,1,0
3037,2011,3,MORTGAGE,3,Low,1,17600, 60 months,2,debt_consolidation,6,High,2,Bad Loan,1,13.49,C,3,19.05,10321.27,4852.7,1790.44,404.89,409000003036,20-Jun-16,RUPAY POS ACQ SETTL 20061,,209.65,-548014809.39,Anderson,659,France,26900.63,0,1,0
3038,2011,5,RENT,1,Low,1,5100, 36 months,1,other,4,Low,1,Good Loan,0,7.9,A,1,12.63,5744.552164,5100,0,159.59,409000003037,21-Jun-16,RUPAY POS ACQ SETTL 21061,,918.27,-548013891.12,Sagese,693,France,3494.02,0,1,0
3039,2011,10,MORTGAGE,3,Low,1,6000, 36 months,1,home_improvement,7,Low,1,Good Loan,0,12.69,B,2,22.78,7129.58,6000,0,201.27,409000003038,22-Jun-16,RUPAY POS ACQ SETTL 22061,,1409.65,-548012481.47,Rubensohn,744,France,113163.17,0,1,0
3040,2011,6,MORTGAGE,3,Low,1,1400, 36 months,1,credit_card,1,High,2,Good Loan,0,13.49,C,3,11.56,1709.085627,1400,0,47.51,409000003039,24-Jun-16,RUPAY POS ACQ SETTL 23061,,2668.57,-548009812.90,Baldwin,829,Spain,19324.50,0,1,0
3041,2011,9,MORTGAGE,3,Low,1,8000, 36 months,1,debt_consolidation,6,High,2,Good Loan,0,15.96,C,3,18.86,9263.11,8000,0,281.1,409000003040,24-Jun-16,RUPAY POS ACQ SETTL 24061,,2539.31,-548007273.59,Iqbal,716,France,189678.70,0,1,0
3042,2011,1,MORTGAGE,3,Low,1,7500, 36 months,1,debt_consolidation,6,Low,1,Good Loan,0,12.42,B,2,9.66,9019.373501,7500,0,250.62,409000003041,29-Jun-16,RUPAY POS ACQ SETTL 26061,,1538.96,-548005734.63,Monaldo,671,France,26387.71,0,1,0
3043,2011,1,RENT,1,Low,1,3175, 36 months,1,medical,9,Low,1,Good Loan,0,6.03,A,1,15.46,3474.081679,3175,0,96.64,409000003042,29-Jun-16,RUPAY POS ACQ SETTL 25061,,3435.77,-548002298.86,Mahon,835,Germany,106276.55,0,1,0
3044,2011,9,MORTGAGE,3,Low,1,18000, 36 months,1,debt_consolidation,6,Low,1,Good Loan,0,7.9,A,1,19.27,20274.95379,18000,0,563.23,409000003043,29-Jun-16,RUPAY POS ACQ SETTL 28061,,7928.96,-547994369.90,Muir,636,France,45015.38,0,1,0
3045,2011,1,RENT,1,Low,1,10000, 36 months,1,wedding,5,High,2,Good Loan,0,14.65,C,3,11.25,12416.23857,10000,0,344.95,409000003044,30-Jun-16,TRF FROM  Indiaforensic SERVICES,,15000000.00,-532994369.90,Burns,649,Spain,173495.77,0,1,0
3046,2011,2,RENT,1,Low,1,7000, 36 months,1,debt_consolidation,6,Low,1,Good Loan,0,7.9,A,1,20.43,7884.738395,7000,0,219.04,409000003045,30-Jun-16,TRF FROM  Indiaforensic SERVICES,,15000000.00,-517994369.90,Dyer,621,Germany,52581.96,0,1,0
3047,2011,10,MORTGAGE,3,Low,1,20000, 60 months,2,small_business,3,High,2,Bad Loan,1,14.65,C,3,18.14,7581.85,3453.45,950.2,472.14,409000003046,30-Jun-16,TRF FROM  Indiaforensic SERVICES,,15000000.00,-502994369.90,Lyons,658,Germany,146339.27,0,1,0
3048,2011,6,MORTGAGE,3,Low,1,20500, 60 months,2,debt_consolidation,6,Low,1,Good Loan,0,11.71,B,2,4.01,22894.24,20500,0,453.02,409000003047,30-Jun-16,RUPAY POS ACQ SETTL 30061,,18.27,-502994351.63,H?,784,Spain,182609.97,0,1,0
3049,2011,10,MORTGAGE,3,Low,1,14800, 60 months,2,debt_consolidation,6,High,2,Good Loan,0,17.27,D,4,14.4,20291.98904,14800,0,369.98,409000003048,1-Jul-16,TRF TO  Indiaforensic SERVICES I,"15,000,000.00",,-517994351.63,Gardiner,783,Spain,197890.65,0,1,0
3050,2011,10,MORTGAGE,3,Medium,2,30000, 60 months,2,small_business,3,High,2,Bad Loan,1,13.49,C,3,7.8,28376.87,16012.26,2395.87,690.15,409000003049,1-Jul-16,TRF TO  Indiaforensic SERVICES I,"15,000,000.00",,-532994351.63,Cameron,615,France,6225.63,0,1,0
3051,2011,4,MORTGAGE,3,Low,1,3000, 36 months,1,car,2,Low,1,Good Loan,0,6.03,A,1,1.18,3286.853726,3000,0,91.31,409000003050,1-Jul-16,TRF TO  Indiaforensic SERVICES I,"5,000,000.00",,-537994351.63,Chapman,791,France,123977.86,0,1,0
3052,2011,6,MORTGAGE,3,Low,1,5800, 60 months,2,other,4,High,2,Good Loan,0,17.27,D,4,23.25,8094.438689,5800,0,144.99,409000003051,1-Jul-16,TRF TO  Indiaforensic SERVICES I,"10,000,000.00",,-547994351.63,Taylor,762,France,170195.40,0,1,0
3053,2011,3,MORTGAGE,3,Low,1,4000, 36 months,1,car,2,Low,1,Good Loan,0,10.65,B,2,12.27,4689.244024,4000,0,130.3,409000003052,1-Jul-16,RUPAY POS ACQ SETTL 01071,,3039.15,-547991312.48,Namatjira,607,France,114190.30,0,1,0
3054,2011,4,MORTGAGE,3,Low,1,6000, 36 months,1,debt_consolidation,6,Low,1,Good Loan,0,12.69,B,2,5.61,6613.82,6000.01,0,201.27,409000003053,2-Jul-16,RUPAY POS ACQ SETTL 02071,,108.76,-547991203.72,He,601,France,27022.57,0,1,0
3055,2011,2,RENT,1,Low,1,32275, 60 months,2,debt_consolidation,6,Low,1,Good Loan,0,11.71,B,2,18.12,34935.24,24858.24,0,713.22,409000003054,4-Jul-16,RUPAY POS ACQ SETTL 03071,,2923.62,-547988280.10,Leibius,540,Spain,59457.00,0,1,0
3056,2011,6.05,RENT,1,Medium,2,35000, 36 months,1,debt_consolidation,6,High,2,Bad Loan,1,18.25,D,4,19.81,28924.14,17609.93,1517.25,1269.73,409000003055,4-Jul-16,RUPAY POS ACQ SETTL 04071,,619.31,-547987660.79,White,812,France,165038.41,0,1,0
3057,2011,2,MORTGAGE,3,Low,1,7800, 60 months,2,debt_consolidation,6,Low,1,Good Loan,0,9.91,B,2,10.97,8101.68,6062.84,0,165.39,409000003056,5-Jul-16,RUPAY POS ACQ SETTL 05071,,5756.55,-547981904.24,Wall,685,France,154181.41,0,1,0
3058,2011,2,OWN,2,Low,1,6000, 36 months,1,debt_consolidation,6,Low,1,Good Loan,0,8.9,A,1,21.83,6715.01,6000,0,190.52,409000003057,7-Jul-16,RUPAY POS ACQ SETTL 06071,,9915.55,-547971988.69,Moretti,680,France,134960.98,0,1,0
3059,2011,6,MORTGAGE,3,Low,1,6300, 36 months,1,car,2,High,2,Bad Loan,1,14.65,C,3,3.66,5554.14,3886.48,340.62,217.32,409000003058,7-Jul-16,RUPAY POS ACQ SETTL 07071,,7536.10,-547964452.59,Patterson,680,Spain,65708.50,0,1,0
3060,2011,7,MORTGAGE,3,Low,1,18000, 60 months,2,debt_consolidation,6,Low,1,Bad Loan,1,11.71,B,2,16.2,12114.84,5685.04,2984.53,397.77,409000003059,8-Jul-16,RUPAY POS ACQ SETTL 08071,,309.65,-547964142.94,Coppin,631,France,117374.22,0,1,0
3061,2011,3,RENT,1,Low,1,5000, 36 months,1,debt_consolidation,6,Low,1,Good Loan,0,8.9,A,1,15.99,5651.6,5000,0,158.77,409000003060,11-Jul-16,RUPAY POS ACQ SETTL 09071,,3425.86,-547960717.08,Tsao,569,France,77703.19,0,1,0
3062,2011,6.05,OWN,2,Low,1,16000, 36 months,1,debt_consolidation,6,Low,1,Bad Loan,1,12.42,B,2,11.08,6967.17,4522.62,659.56,534.65,409000003061,11-Jul-16,RUPAY POS ACQ SETTL 10071,,609.13,-547960107.95,Kao,584,Germany,177651.38,0,1,0
3063,2011,0.5,RENT,1,Low,1,5000, 36 months,1,moving,10,Low,1,Good Loan,0,8.9,A,1,9.8,5108.81,5000,0,158.77,409000003062,11-Jul-16,RUPAY POS ACQ SETTL 11071,,10094.46,-547950013.49,Stewart,582,France,60954.45,0,1,0
3064,2011,3,RENT,1,Low,1,12000, 36 months,1,debt_consolidation,6,High,2,Good Loan,0,19.03,E,5,12.39,15538.11085,12000,0,440.06,409000003063,12-Jul-16,RUPAY POS ACQ SETTL 12071,,20564.67,-547929448.82,Tuan,609,France,151924.90,0,1,0
3065,2011,1,RENT,1,Low,1,12000, 60 months,2,small_business,3,Low,1,Bad Loan,1,8.9,A,1,3.89,9262.73,6124.55,839.31,248.52,409000003064,13-Jul-16,RUPAY POS ACQ SETTL 13071,,5243.33,-547924205.49,Barnes,506,Spain,26318.73,0,1,0
3066,2011,10,MORTGAGE,3,Low,1,30000, 60 months,2,home_improvement,7,Low,1,Good Loan,0,9.91,B,2,27.53,37036.11876,30000,0,636.09,409000003065,14-Jul-16,RUPAY POS ACQ SETTL 14071,,1767.93,-547922437.56,Sun,503,France,147557.71,0,1,0
3067,2011,1,RENT,1,Low,1,1300, 36 months,1,debt_consolidation,6,Low,1,Good Loan,0,7.9,A,1,9.72,1464.2613,1300,0,40.68,409000003066,15-Jul-16,RUPAY POS ACQ SETTL 15071,,39.31,-547922398.25,Fallaci,503,France,125918.17,0,1,0
3068,2011,10,MORTGAGE,3,Low,1,16000, 36 months,1,credit_card,1,Low,1,Good Loan,0,6.03,A,1,16.73,17530.40202,16000,0,486.97,409000003067,16-Jul-16,RUPAY POS ACQ SETTL 16071,,4115.86,-547918282.39,Buccho,806,Germany,190803.37,0,1,0
3069,2011,5,MORTGAGE,3,Low,1,11250, 36 months,1,debt_consolidation,6,High,2,Good Loan,0,17.58,D,4,21.95,13678.69,11250,0,404.35,409000003068,18-Jul-16,RUPAY POS ACQ SETTL 17071,,1567.58,-547916714.81,Tien,653,France,11043.54,0,1,0
3070,2011,3,RENT,1,Low,1,7000, 36 months,1,debt_consolidation,6,High,2,Good Loan,0,17.58,D,4,19.05,9054.368742,7000,0,251.6,409000003069,18-Jul-16,RUPAY POS ACQ SETTL 18071,,3169.65,-547913545.16,Pirozzi,666,France,119100.05,0,1,0
3071,2011,7,MORTGAGE,3,Low,1,5000, 36 months,1,debt_consolidation,6,Low,1,Good Loan,0,7.51,A,1,9.53,5598.72371,5000,0,155.56,409000003070,19-Jul-16,RUPAY POS ACQ SETTL 19071,,5718.82,-547907826.34,Liu,674,Spain,140579.17,0,1,0
3072,2011,8,RENT,1,Low,1,8000, 36 months,1,debt_consolidation,6,Low,1,Good Loan,0,7.9,A,1,9.54,9010.782966,8000,0,250.33,409000003071,20-Jul-16,RUPAY POS ACQ SETTL 20071,,3068.27,-547904758.07,Long,798,France,37731.95,0,1,0
3073,2011,0.5,RENT,1,Low,1,12000, 36 months,1,debt_consolidation,6,Low,1,Good Loan,0,8.9,A,1,12.56,13565.58,12000,0,381.04,409000003072,20-Jul-16,RUPAY POS ACQ SETTL 19071,0.2,,-547904758.27,Scott,740,France,1852.58,0,1,0
3074,2011,7,RENT,1,Low,1,4000, 36 months,1,debt_consolidation,6,Low,1,Good Loan,0,6.03,A,1,11.2,4382.431741,4000,0,121.75,409000003073,21-Jul-16,RUPAY POS ACQ SETTL 21071,,1138.96,-547903619.31,Gerasimova,531,Germany,172049.84,0,1,0
3075,2011,10,MORTGAGE,3,Medium,2,7000, 36 months,1,debt_consolidation,6,Low,1,Good Loan,0,9.91,B,2,17.22,8119.116898,7000,0,225.58,409000003074,22-Jul-16,RUPAY POS ACQ SETTL 22071,,2338.62,-547901280.69,Ifeatu,614,Germany,133591.11,0,1,0
3076,2011,10,MORTGAGE,3,Low,1,7600, 36 months,1,debt_consolidation,6,Low,1,Good Loan,0,6.03,A,1,3.76,8252.1,7600,0,231.32,409000003075,25-Jul-16,RUPAY POS ACQ SETTL 23071,,1138.96,-547900141.73,De Luca,556,France,192751.18,0,1,0
3077,2011,10,MORTGAGE,3,Low,1,20000, 60 months,2,home_improvement,7,High,2,Good Loan,0,17.27,D,4,12.76,28976.99522,20000,0,499.96,409000003076,25-Jul-16,RUPAY POS ACQ SETTL 24071,,2167.83,-547897973.90,Ogbonnaya,678,Germany,193828.27,0,1,0
3078,2011,5,RENT,1,Low,1,10000, 36 months,1,debt_consolidation,6,Low,1,Good Loan,0,11.71,B,2,17.8,11902.94343,10000,0,330.76,409000003077,25-Jul-16,RUPAY POS ACQ SETTL 25071,,5660.74,-547892313.16,Humffray,587,Germany,55775.72,0,1,0
3079,2011,10,OWN,2,Low,1,8000, 36 months,1,medical,9,Low,1,Good Loan,0,6.62,A,1,26.14,8841.959349,8000,0,245.63,409000003078,26-Jul-16,RUPAY POS ACQ SETTL 26071,,778.96,-547891534.20,Degtyaryov,527,Spain,102280.29,0,1,0
3080,2011,10,MORTGAGE,3,Low,1,12000, 60 months,2,debt_consolidation,6,Low,1,Good Loan,0,12.42,B,2,23.68,14698.33562,12000,0,269.49,409000003079,27-Jul-16,RUPAY POS ACQ SETTL 27071,,768.17,-547890766.03,Monaldo,757,Germany,44965.44,0,1,0
3081,2011,4,MORTGAGE,3,Low,1,16500, 60 months,2,small_business,3,Low,1,Bad Loan,1,11.71,B,2,12.07,2003.01,824.41,548.09,364.62,409000003080,28-Jul-16,RUPAY POS ACQ SETTL 28071,,928.96,-547889837.07,Cawthorne,468,Spain,170661.02,0,1,0
3082,2011,6.05,OWN,2,Low,1,4475, 36 months,1,credit_card,1,Low,1,Good Loan,0,10.65,B,2,13.6,5261.898405,4475,0,145.77,409000003081,29-Jul-16,RUPAY POS ACQ SETTL 29071,,4603.02,-547885234.05,Graham,693,France,197145.89,0,1,0
3083,2011,3,RENT,1,Low,1,5750, 36 months,1,debt_consolidation,6,Low,1,Good Loan,0,8.9,A,1,11.58,6587.549286,5750,0,182.59,409000003082,30-Jul-16,RUPAY POS ACQ SETTL 30071,,5055.73,-547880178.32,Carpenter,483,France,192359.90,0,1,0
3084,2011,0.5,RENT,1,Low,1,14600, 60 months,2,debt_consolidation,6,High,2,Good Loan,0,19.91,E,5,3.98,19033.59,14600,0,386.08,409000003083,1-Aug-16,RUPAY POS ACQ SETTL 31071,,2097.97,-547878080.35,Kambinachi,466,France,141210.18,0,1,0
3085,2011,7,RENT,1,Low,1,11200, 60 months,2,other,4,High,2,Good Loan,0,22.06,F,6,22.9,15164.32,8136.2,0,309.72,409000003084,1-Aug-16,RUPAY POS ACQ SETTL 01081,,7539.80,-547870540.55,Tyler,770,France,100557.03,0,1,0
3086,2011,10,MORTGAGE,3,Low,1,4900, 36 months,1,credit_card,1,Low,1,Good Loan,0,6.03,A,1,4.82,5051.84,4900,0,149.14,409000003085,2-Aug-16,RUPAY POS ACQ SETTL 02071,,1454.74,-547869085.81,Martin,734,France,130805.54,0,1,0
3087,2011,7,MORTGAGE,3,Medium,2,10000, 36 months,1,home_improvement,7,Low,1,Good Loan,0,7.51,A,1,5.04,10183.3,10000,0,311.11,409000003086,3-Aug-16,RUPAY POS ACQ SETTL 03081,,7234.43,-547861851.38,Walker,716,France,92606.98,0,1,0
3088,2011,2,RENT,1,Medium,2,16000, 36 months,1,wedding,5,Low,1,Good Loan,0,6.03,A,1,13.93,17506.23417,16000,0,486.97,409000003087,4-Aug-16,RUPAY POS ACQ SETTL 04081,,11256.27,-547850595.11,Khan,439,France,123956.83,0,1,0
3089,2011,10,MORTGAGE,3,Low,1,25200, 60 months,2,home_improvement,7,High,2,Good Loan,0,15.96,C,3,0.02,28363.35,25199.99,0,612.28,409000003088,6-Aug-16,RUPAY POS ACQ SETTL 05081,,11968.12,-547838626.99,Iroawuchi,538,Germany,102758.43,0,1,0
3090,2011,10,RENT,1,Low,1,18650, 60 months,2,small_business,3,High,2,Bad Loan,1,21.67,F,6,14.19,3678.61,1095.71,613.69,511.6,409000003089,6-Aug-16,RUPAY POS ACQ SETTL 06081,,28184.69,-547810442.30,Summers,743,France,94876.65,0,1,0
3091,2011,3,MORTGAGE,3,Low,1,12000, 36 months,1,debt_consolidation,6,Low,1,Good Loan,0,11.71,B,2,22.24,14286.88001,12000,0,396.92,409000003090,8-Aug-16,RUPAY POS ACQ SETTL 08081,,1014.31,-547809427.99,Bottrill,734,Spain,94811.85,0,1,0
3092,2011,8,MORTGAGE,3,Low,1,3600, 36 months,1,other,4,Low,1,Good Loan,0,12.69,B,2,8.92,3638.26,3600,0,120.77,409000003091,8-Aug-16,RUPAY POS ACQ SETTL 08081,,9177.24,-547800250.75,Hu,656,France,67840.81,0,1,0
3093,2011,8,OWN,2,Low,1,15600, 60 months,2,major_purchase,8,High,2,Good Loan,0,17.58,D,4,21.98,19161.55,11601.98,0,392.59,409000003092,9-Aug-16,RUPAY POS ACQ SETTL 09081,,2999.62,-547797251.13,Jones,666,France,4050.57,0,1,0
3094,2011,10,RENT,1,Low,1,15000, 36 months,1,credit_card,1,Low,1,Good Loan,0,11.71,B,2,13.24,17309.06,14999.99,0,496.14,409000003093,10-Aug-16,3RUPAY POS ACQ SETTL 1008,,20034.10,-547777217.03,Vincent,627,Spain,134665.25,0,1,0
3095,2011,9,MORTGAGE,3,Low,1,19200, 36 months,1,debt_consolidation,6,High,2,Good Loan,0,14.65,C,3,12.63,19434.55,19200,0,662.29,409000003094,11-Aug-16,RUPAY POS ACQ SETT ADJ 10,,0.03,-547777217.00,Sanford,480,Germany,181647.13,0,1,0
3096,2011,0.5,RENT,1,Low,1,9600, 36 months,1,debt_consolidation,6,High,2,Good Loan,0,14.65,C,3,8.24,11920.80783,9600,0,331.15,409000003095,12-Aug-16,RUPAY POS ACQ SETTL 12081,,4016.50,-547773200.50,Brown,792,France,33282.84,0,1,0
3097,2011,6,MORTGAGE,3,Low,1,13200, 36 months,1,credit_card,1,Low,1,Good Loan,0,7.51,A,1,4.09,14259.5,13200,0,410.67,409000003096,16-Aug-16,RUPAY POS ACQ SETTL 13081,,4515.22,-547768685.28,Lei,613,Germany,27965.00,0,1,0
3098,2011,0.5,OWN,2,Low,1,16000, 36 months,1,home_improvement,7,Low,1,Good Loan,0,7.51,A,1,15.46,16563.16,16000,0,497.78,409000003097,16-Aug-16,RUPAY POS ACQ SETTL 14081,,3823.95,-547764861.33,Toscani,476,Germany,68343.53,0,1,0
3099,2011,1,RENT,1,Low,1,12000, 36 months,1,debt_consolidation,6,Low,1,Bad Loan,1,6.62,A,1,8.86,5522.65,4365.51,438.41,368.45,409000003098,16-Aug-16,RUPAY POS ACQ SETTL 15081,,9187.24,-547755674.09,Chien,539,France,198161.07,0,1,0
3100,2011,10,MORTGAGE,3,Low,1,12000, 60 months,2,debt_consolidation,6,High,2,Bad Loan,1,16.77,D,4,19.81,3198.28,1078.01,838.12,296.75,409000003099,16-Aug-16,RUPAY POS ACQ SETTL 16081,,2358.27,-547753315.82,Uchenna,696,Spain,196858.40,0,1,0
3101,2011,5,MORTGAGE,3,Low,1,4000, 36 months,1,car,2,High,2,Good Loan,0,14.27,C,3,1.84,4610.04,4000,0,137.24,409000003100,18-Aug-16,RUPAY POS ACQ SETTL 17081,,9350.56,-547743965.26,Lori,810,Germany,120511.03,0,1,0
3102,2011,6.05,RENT,1,Low,1,5000, 36 months,1,debt_consolidation,6,Low,1,Bad Loan,1,7.9,A,1,19.08,3903.74,753.28,2890.4,156.46,409000003101,18-Aug-16,RUPAY POS ACQ SETTL 18081,,13225.86,-547730739.40,Fanucci,763,Germany,30886.35,0,1,0
3103,2011,3,RENT,1,Medium,2,30000, 60 months,2,debt_consolidation,6,High,2,Bad Loan,1,23.13,G,7,22.57,7810.5,1687.56,1632.88,847.96,409000003102,19-Aug-16,RUPAY POS ACQ SETTL 19081,,4418.55,-547726320.85,Chimaobim,640,France,2743.69,0,1,0
3104,2011,5,MORTGAGE,3,Medium,2,35000, 36 months,1,debt_consolidation,6,High,2,Good Loan,0,18.64,E,5,14.91,45274.92794,35000,0,1276.6,409000003103,20-Aug-16,RUPAY POS ACQ SETTL 20081,,5047.05,-547721273.80,Jowers,655,France,167778.62,0,1,0
3105,2011,7,MORTGAGE,3,Low,1,5000, 36 months,1,debt_consolidation,6,Low,1,Good Loan,0,6.62,A,1,11.95,5526.095936,5000,0,153.52,409000003104,22-Aug-16,RUPAY POS ACQ SETTL 21081,,13148.49,-547708125.31,Miller,526,Germany,132404.64,0,1,0
3106,2011,0.5,RENT,1,Low,1,6000, 36 months,1,wedding,5,High,2,Good Loan,0,15.96,C,3,21.16,7442.32,6000,0,210.83,409000003105,23-Aug-16,RUPAY POS ACQ SETTL 23081,,1778.24,-547706347.07,Kirsova,678,France,144423.17,0,1,0
3107,2011,2,RENT,1,Low,1,5700, 60 months,2,other,4,High,2,Good Loan,0,19.03,E,5,12.27,6397.4,5700.01,0,147.96,409000003106,24-Aug-16,RUPAY POS ACQ SETTL 24081,,3357.09,-547702989.98,T'ien,554,France,181204.50,0,1,0
3108,2011,0.5,RENT,1,Low,1,5000, 36 months,1,other,4,Low,1,Good Loan,0,11.71,B,2,14.21,5951.829975,5000,0,165.38,409000003107,25-Aug-16,RUPAY POS ACQ SETTL 25081,,9693.39,-547693296.59,Ku,597,Spain,182726.22,0,1,0
3109,2011,10,MORTGAGE,3,Low,1,23000, 60 months,2,small_business,3,High,2,Bad Loan,1,13.49,C,3,2.53,4913.07,1954.13,1218.4,529.11,409000003108,26-Aug-16,RUPAY POS ACQ SETTL 26081,,7159.84,-547686136.75,Chin,560,Spain,120880.72,0,1,0
3110,2011,10,MORTGAGE,3,Low,1,12000, 60 months,2,other,4,High,2,Good Loan,0,16.77,D,4,20.5,15089.75,11999.99,0,296.75,409000003109,29-Aug-16,RUPAY POS ACQ SETTL 27081,,6616.78,-547679519.97,Law,850,Germany,26812.89,0,1,0
3111,2011,10,RENT,1,Low,1,25000, 60 months,2,debt_consolidation,6,Low,1,Good Loan,0,10.65,B,2,14.92,26342.65,19323.96,0,539.21,409000003110,29-Aug-16,RUPAY POS ACQ SETTL 28081,,3880.91,-547675639.06,Chung,546,Germany,66732.63,0,1,0
3112,2011,1,RENT,1,Low,1,6000, 36 months,1,debt_consolidation,6,Low,1,Good Loan,0,9.91,B,2,7.98,6960.089148,6000,0,193.35,409000003111,29-Aug-16,RUPAY POS ACQ SETTL 29081,,19513.84,-547656125.22,Cockrum,623,Germany,100834.22,0,1,0
3113,2011,7,RENT,1,Low,1,10000, 36 months,1,small_business,3,Low,1,Good Loan,0,7.51,A,1,20.32,11197.98285,10000,0,311.11,409000003112,30-Aug-16,RUPAY POS ACQ SETTL 30081,,4325.86,-547651799.36,Greaves,698,France,107815.31,0,1,0
3114,2011,10,MORTGAGE,3,Medium,2,7500, 60 months,2,other,4,High,2,Good Loan,0,19.03,E,5,4.5,9510.98,5535.68,0,194.68,409000003113,31-Aug-16,RUPAY POS ACQ SETTL 31081,,20825.79,-547630973.57,Grant,620,France,34665.79,0,1,0
3115,2011,10,MORTGAGE,3,Low,1,7000, 36 months,1,credit_card,1,Low,1,Good Loan,0,7.9,A,1,17.58,7884.738395,7000,0,219.04,409000003114,1-Sep-16,RUPAY POS ACQ SETTL 01091,,17498.32,-547613475.25,O'Donnell,619,France,147093.84,0,1,0
3116,2011,0.5,RENT,1,Low,1,10000, 36 months,1,debt_consolidation,6,High,2,Good Loan,0,14.27,C,3,17.54,10971.42,10000,0,343.09,409000003115,2-Sep-16,RUPAY POS ACQ SETTL 02091,,8058.43,-547605416.82,Maclean,561,France,36942.35,0,1,0
3117,2011,5,MORTGAGE,3,Low,1,20000, 36 months,1,debt_consolidation,6,High,2,Good Loan,0,13.49,C,3,20.95,24428.78866,20000,0,678.61,409000003116,3-Sep-16,RUPAY POS ACQ SETTL 03091,,1428.96,-547603987.86,Hsieh,753,France,16460.77,0,1,0
3118,2011,3,MORTGAGE,3,Medium,2,9600, 36 months,1,home_improvement,7,Low,1,Good Loan,0,7.9,A,1,7.42,10809.33545,9600,0,300.39,409000003117,6-Sep-16,RUPAY POS ACQ SETTL 06091,,3110.38,-547600877.48,Hs?,721,Spain,45610.63,0,1,0
3119,2011,2,OWN,2,Low,1,20000, 60 months,2,home_improvement,7,High,2,Good Loan,0,18.25,D,4,16.74,29867.21074,20000,0,510.6,409000003118,7-Sep-16,RUPAY POS ACQ SETTL 07091,,1397.77,-547599479.71,Mazzanti,451,France,184954.11,0,1,0
3120,2011,0.5,RENT,1,Low,1,6550, 36 months,1,debt_consolidation,6,Low,1,Good Loan,0,10.65,B,2,18.28,7271.2,6550,0,213.36,409000003119,8-Sep-16,RUPAY POS ACQ SETTL 08091,,3165.36,-547596314.35,Chiu,680,Germany,47795.43,0,1,0
3121,2011,2,OWN,2,Low,1,2500, 36 months,1,other,4,Low,1,Good Loan,0,9.91,B,2,18.43,2920.44136,2500,0,80.57,409000003120,9-Sep-16,RUPAY POS ACQ SETTL 09091,,3876.20,-547592438.15,Reeves,590,Spain,196789.90,0,1,0
3122,2011,6,MORTGAGE,3,Low,1,12000, 60 months,2,home_improvement,7,High,2,Good Loan,0,19.42,E,5,7.2,17171.22417,12000,0,314.07,409000003121,12-Sep-16,RUPAY POS ACQ SETTL 10091,,9961.95,-547582476.20,Castiglione,634,Germany,173425.68,0,1,0
3123,2011,0.5,RENT,1,Low,1,2500, 36 months,1,other,4,Low,1,Bad Loan,1,9.91,B,2,15.82,528.43,304.19,126.13,80.57,409000003122,12-Sep-16,RUPAY POS ACQ SETTL 11091,,9668.34,-547572807.86,Ferguson,676,France,36221.18,0,1,0
3124,2011,3,MORTGAGE,3,Medium,2,30400, 60 months,2,credit_card,1,High,2,Good Loan,0,21.28,F,6,7.42,40528.84,22196.79,0,827.22,409000003123,12-Sep-16,RUPAY POS ACQ SETTL 12091,,1720.05,-547571087.81,Nnamdi,642,France,174738.20,0,1,0
3125,2011,10,OWN,2,Low,1,11300, 60 months,2,debt_consolidation,6,Low,1,Good Loan,0,12.69,B,2,13.37,13113.48,11300.01,0,255.33,409000003124,14-Sep-16,RUPAY POS ACQ SETTL 13091,,60193.54,-547510894.27,Wu,760,France,67131.30,0,1,0
3126,2011,0.5,RENT,1,Low,1,8575, 36 months,1,debt_consolidation,6,High,2,Bad Loan,1,19.42,E,5,15.47,1104.38,357.42,472.44,316.15,409000003125,14-Sep-16,RUPAY POS ACQ SETTL 14091,,23012.97,-547487881.30,Chu,736,Spain,165692.03,0,1,0
3127,2011,7,RENT,1,Low,1,16000, 36 months,1,car,2,Low,1,Bad Loan,1,11.71,B,2,10.65,12130.35,8634.66,1023.63,529.22,409000003126,15-Sep-16,RUPAY POS ACQ SETTL 15091,,5353.01,-547482528.29,King,656,France,194691.95,0,1,0
3128,2011,4,RENT,1,Low,1,13000, 60 months,2,debt_consolidation,6,Low,1,Good Loan,0,11.71,B,2,11.21,16407.90967,13000,0,287.28,409000003127,16-Sep-16,RUPAY POS ACQ SETTL 16091,,19788.26,-547462740.03,Charlton,776,Germany,129525.50,0,1,0
3129,2011,10,RENT,1,Low,1,8500, 36 months,1,credit_card,1,Low,1,Good Loan,0,10.65,B,2,11.47,9879.443019,8500,0,276.88,409000003128,17-Sep-16,RUPAY POS ACQ SETTL 17091,,5376.89,-547457363.14,Marsh,832,Spain,146511.20,0,1,0
3130,2011,1,RENT,1,Low,1,6000, 36 months,1,debt_consolidation,6,Low,1,Good Loan,0,12.69,B,2,15.06,6565.59,6000,0,201.27,409000003129,19-Sep-16,RUPAY POS ACQ SETTL 18091,,6267.93,-547451095.21,Walker,631,Germany,51752.18,0,1,0
3131,2011,8,RENT,1,Low,1,8800, 36 months,1,debt_consolidation,6,Low,1,Good Loan,0,6.03,A,1,7.03,9656.786005,8800,0,267.84,409000003130,19-Sep-16,RUPAY POS ACQ SETTL 19091,,19857.93,-547431237.28,Chang,795,Spain,35418.69,0,1,0
3132,2011,10,MORTGAGE,3,Medium,2,25000, 36 months,1,debt_consolidation,6,Low,1,Good Loan,0,11.71,B,2,15.55,29765.27241,25000,0,826.9,409000003131,20-Sep-16,RUPAY POS ACQ SETTL 20091,,11750.80,-547419486.48,Pottinger,648,Germany,57995.74,0,1,0
3133,2011,10,MORTGAGE,3,Low,1,6000, 36 months,1,car,2,Low,1,Good Loan,0,7.51,A,1,29.35,6712.923852,6000,0,186.67,409000003132,21-Sep-16,RUPAY POS ACQ SETTL 21091,,15078.05,-547404408.43,Buckley,615,France,108152.75,0,1,0
3134,2011,0.5,RENT,1,Low,1,12000, 36 months,1,other,4,Low,1,Good Loan,0,10.65,B,2,1.74,12106.65,12000,0,390.88,409000003133,21-Sep-16,SHENZHEN JUSTTIDE TECH CO,"205,112.50",,-547609520.93,Folliero,682,France,166144.98,0,1,0
3135,2011,6,RENT,1,Low,1,9600, 60 months,2,major_purchase,8,High,2,Good Loan,0,16.77,D,4,8.54,11592.7,7175.11,0,237.4,409000003134,21-Sep-16,IMAR00701604290,"1,098.68",,-547610619.61,Olisanugo,694,France,101737.80,0,1,0
3136,2011,6.05,OWN,2,Low,1,8300, 36 months,1,home_improvement,7,Low,1,Good Loan,0,7.9,A,1,28.15,9364.202354,8300,0,259.71,409000003135,22-Sep-16,RUPAY POS ACQ SETTL 22091,,14875.22,-547595744.39,Kent,694,France,33326.71,0,1,0
3137,2011,3,RENT,1,Low,1,5500, 36 months,1,credit_card,1,High,2,Good Loan,0,17.58,D,4,7.61,6429.89,5500,0,197.69,409000003136,23-Sep-16,RUPAY POS ACQ SETTL 23091,,8410.57,-547587333.82,Jessop,607,France,81140.09,0,1,0
3138,2011,10,MORTGAGE,3,Low,1,35000, 36 months,1,house,12,Low,1,Good Loan,0,7.9,A,1,2.93,38590.3,35000,0,1095.16,409000003137,26-Sep-16,RUPAY POS ACQ SETTL 24091,,3662.19,-547583671.63,Hodge,664,France,140173.17,0,1,0
3139,2011,1,RENT,1,Low,1,3000, 36 months,1,debt_consolidation,6,Low,1,Good Loan,0,11.71,B,2,14.1,3381.45,3000,0,99.23,409000003138,26-Sep-16,RUPAY POS ACQ SETTL 25091,,5216.33,-547578455.30,Ignatiev,756,France,166513.49,0,1,0
3140,2011,3,RENT,1,Low,1,2500, 36 months,1,debt_consolidation,6,High,2,Good Loan,0,13.49,C,3,16.58,3051.573033,2500,0,84.83,409000003139,26-Sep-16,RUPAY POS ACQ SETTL 26091,,21626.03,-547556829.27,Chambers,645,France,103232.60,0,1,0
3141,2011,5,MORTGAGE,3,Low,1,12000, 36 months,1,debt_consolidation,6,High,2,Good Loan,0,16.77,D,4,18.32,15186.61865,12000,0,426.47,409000003140,27-Sep-16,RUPAY POS ACQ SETTL 27091,,758.27,-547556071.00,Mansom,653,Spain,120736.04,0,1,0
3142,2011,10,RENT,1,Medium,2,7200, 36 months,1,debt_consolidation,6,Low,1,Good Loan,0,7.9,A,1,13.63,8104.823194,7200,0,225.29,409000003141,28-Sep-16,RUPAY POS ACQ SETTL 28091,,8433.70,-547547637.30,Yen,710,Germany,15832.43,0,1,0
3143,2011,7,MORTGAGE,3,Low,1,2000, 36 months,1,debt_consolidation,6,Low,1,Good Loan,0,6.62,A,1,8.11,2209.207576,2000,0,61.41,409000003142,29-Sep-16,RUPAY POS ACQ SETTL 29091,,2335.17,-547545302.13,Azikiwe,697,France,188772.45,0,1,0
3144,2011,6,MORTGAGE,3,Low,1,22000, 36 months,1,debt_consolidation,6,High,2,Good Loan,0,19.91,E,5,18.24,23748.34,22000,0,816.6,409000003143,30-Sep-16,RUPAY POS ACQ SETTL 30091,,5765.13,-547539537.00,Allen,619,Germany,114323.66,0,1,0
3145,2011,2,RENT,1,Low,1,14000, 36 months,1,credit_card,1,Low,1,Good Loan,0,7.9,A,1,18.67,15772.56932,14000,0,438.07,409000003144,1-Oct-16,RUPAY POS ACQ SETTL 01101,,10923.77,-547528613.23,Komarova,648,Spain,181534.04,0,1,0
3146,2011,4,RENT,1,Low,1,7500, 36 months,1,debt_consolidation,6,High,2,Good Loan,0,14.27,C,3,12.44,8613.1,7500,0,257.32,409000003145,3-Oct-16,RUPAY POS ACQ SETTL 02101,,4746.64,-547523866.59,Mackay,482,Germany,102640.52,0,1,0
3147,2011,0.5,RENT,1,Low,1,6000, 36 months,1,debt_consolidation,6,Low,1,Good Loan,0,9.91,B,2,11.15,6955.696725,6000,0,193.35,409000003146,3-Oct-16,RUPAY POS ACQ SETTL 03101,,776.03,-547523090.56,Yu,548,France,158585.17,0,1,0
3148,2011,5,RENT,1,Low,1,15000, 60 months,2,debt_consolidation,6,High,2,Bad Loan,1,19.42,E,5,20.68,4710.53,1961.67,12.41,392.59,409000003147,4-Oct-16,RUPAY POS ACQ SETTL 04101,,10928.58,-547512161.98,Curtis,752,Spain,178722.24,0,1,0
3149,2011,10,RENT,1,Low,1,22900, 60 months,2,debt_consolidation,6,High,2,Bad Loan,1,18.25,D,4,15.91,12361.79,5563.94,0,584.63,409000003148,5-Oct-16,RUPAY POS ACQ SETTL 05101,,13038.00,-547499123.98,Fang,648,France,153955.38,0,1,0
3150,2011,10,MORTGAGE,3,Low,1,3500, 36 months,1,debt_consolidation,6,Low,1,Good Loan,0,6.03,A,1,19.94,3780.06,3500,0,106.53,409000003149,6-Oct-16,RUPAY POS ACQ SETTL 06101,,7641.87,-547491482.11,Page,643,Spain,65374.86,0,1,0
3151,2011,4,OWN,2,Low,1,35000, 60 months,2,other,4,High,2,Good Loan,0,20.89,F,6,12.58,41895.99,35000.01,0,944.71,409000003150,7-Oct-16,RUPAY POS ACQ SETTL 07101,,5373.69,-547486108.42,Olisaemeka,573,Germany,102986.15,0,1,0
3152,2011,6.05,OWN,2,Low,1,1950, 36 months,1,other,4,Low,1,Good Loan,0,12.69,B,2,20.3,2353.044625,1950,0,65.42,409000003151,7-Oct-16,TRF TO  Indiaforensic SERVICES I,"750,000.00",,-548236108.42,Brennan,686,France,136643.84,0,1,0
3153,2011,7,MORTGAGE,3,Low,1,12000, 36 months,1,debt_consolidation,6,Low,1,Good Loan,0,6.62,A,1,22.42,12813.35,12000,0,368.45,409000003152,10-Oct-16,RUPAY POS ACQ SETTL 09101,,4654.58,-548231453.84,Sutton,644,France,77063.63,0,1,0
3154,2011,6,OWN,2,Low,1,5000, 36 months,1,major_purchase,8,High,2,Good Loan,0,14.27,C,3,16.42,6171.19996,5000,0,171.55,409000003153,10-Oct-16,RUPAY POS ACQ SETTL 10101,,7347.17,-548224106.67,Hyde,702,France,9633.01,0,1,0
3155,2011,10,RENT,1,Low,1,6250, 60 months,2,debt_consolidation,6,High,2,Good Loan,0,17.27,D,4,9.49,8878.916305,6250,0,156.24,409000003154,10-Oct-16,RUPAY POS ACQ SETTL 08101,"3,960.07",,-548228066.74,Nkemakolam,652,France,43496.36,0,1,0
3156,2011,10,MORTGAGE,3,Low,1,15000, 60 months,2,small_business,3,High,2,Good Loan,0,17.58,D,4,20.32,18467.09,11143.07,0,377.49,409000003155,13-Oct-16,RUPAY POS ACQ SETTL 11101,,4645.39,-548223421.35,Chimaijem,641,Spain,24267.28,0,1,0
3157,2011,10,MORTGAGE,3,Medium,2,30000, 60 months,2,debt_consolidation,6,High,2,Good Loan,0,19.91,E,5,9.65,38866.18,22080.63,0,793.32,409000003156,13-Oct-16,RUPAY POS ACQ SETTL 12101,,16330.55,-548207090.80,Sung,692,Germany,59354.24,0,1,0
3158,2011,10,MORTGAGE,3,Low,1,7000, 36 months,1,credit_card,1,Low,1,Good Loan,0,7.9,A,1,21.12,7884.517103,7000,0,219.04,409000003157,13-Oct-16,RUPAY POS ACQ SETTL 13101,,4738.92,-548202351.88,Chiganu,574,Spain,28269.86,0,1,0
3159,2011,0.5,MORTGAGE,3,Low,1,2600, 36 months,1,vacation,11,Low,1,Good Loan,0,6.03,A,1,21.34,2679.46,2600,0,79.14,409000003158,14-Oct-16,RUPAY POS ACQ SETTL 14101,,41843.41,-548160508.47,Beneventi,643,France,143162.34,0,1,0
3160,2011,10,MORTGAGE,3,Medium,2,14000, 36 months,1,debt_consolidation,6,Low,1,Good Loan,0,6.62,A,1,9.42,15161.99,14000,0,429.86,409000003159,15-Oct-16,RUPAY POS ACQ SETTL 15101,,3032.75,-548157475.72,Esposito,834,France,20199.30,0,1,0
3161,2011,6,MORTGAGE,3,Medium,2,15000, 36 months,1,small_business,3,High,2,Good Loan,0,14.27,C,3,11.58,18522.71126,15000,0,514.64,409000003160,17-Oct-16,RUPAY POS ACQ SETTL 16101,,8865.93,-548148609.79,Owen,591,France,48606.92,0,1,0
3162,2011,10,MORTGAGE,3,Low,1,14300, 36 months,1,credit_card,1,Low,1,Good Loan,0,6.03,A,1,29.72,15667.904,14300,0,435.23,409000003161,17-Oct-16,RUPAY POS ACQ SETTL 17101,,340.00,-548148269.79,Smalley,470,Spain,89013.67,0,1,0
3163,2011,4,OWN,2,Low,1,15600, 60 months,2,wedding,5,High,2,Good Loan,0,15.96,C,3,10.22,19651.02,15600,0,379.04,409000003162,18-Oct-16,RUPAY POS ACQ SETTL 18101,,5737.19,-548142532.60,Hsiung,608,Spain,59890.29,0,1,0
3164,2011,10,MORTGAGE,3,Low,1,19000, 60 months,2,debt_consolidation,6,High,2,Good Loan,0,16.77,D,4,23.25,22981.04,14219.17,0,469.86,409000003163,19-Oct-16,RUPAY POS ACQ SETTL 19101,,3207.80,-548139324.80,Ch'ang,649,Germany,106655.88,0,1,0
3165,2011,5,MORTGAGE,3,Medium,2,6000, 36 months,1,home_improvement,7,Low,1,Bad Loan,1,10.65,B,2,14.33,4652,3433.82,357.16,195.44,409000003164,20-Oct-16,RUPAY POS ACQ SETTL 20101,,9503.77,-548129821.03,Barton,665,France,156439.56,0,1,0
3166,2011,9,RENT,1,Low,1,3000, 36 months,1,other,4,Low,1,Good Loan,0,12.42,B,2,15.04,3607.83519,3000,0,100.25,409000003165,21-Oct-16,RUPAY POS ACQ SETTL 21101,,12673.42,-548117147.61,Lucchese,651,France,24176.44,0,1,0
3167,2011,0.5,RENT,1,Low,1,3500, 36 months,1,debt_consolidation,6,Low,1,Good Loan,0,12.69,B,2,15.78,4221.381267,3500,0,117.41,409000003166,24-Oct-16,RUPAY POS ACQ SETTL 22101,,10822.18,-548106325.43,Hsia,555,Germany,43507.10,0,1,0
3168,2011,1,RENT,1,Low,1,2250, 36 months,1,debt_consolidation,6,High,2,Good Loan,0,18.25,D,4,21.69,2927.111984,2250,0,81.63,409000003167,24-Oct-16,RUPAY POS ACQ SETTL 23101,,29258.65,-548077066.78,Pope,637,France,132005.85,0,1,0
3169,2011,10,MORTGAGE,3,Low,1,8400, 60 months,2,small_business,3,Low,1,Good Loan,0,11.71,B,2,1.49,8876.14,8400,0,185.63,409000003168,24-Oct-16,RUPAY POS ACQ SETTL 24101,,2836.61,-548074230.17,Horrocks,675,France,80496.71,0,1,0
3170,2011,6.05,RENT,1,Low,1,5000, 36 months,1,vacation,11,Low,1,Good Loan,0,9.91,B,2,22.3,5791.775583,5000,0,161.13,409000003169,25-Oct-16,RUPAY POS ACQ SETTL 25101,,7792.17,-548066438.00,Tai,677,Spain,88947.56,0,1,0
3171,2011,8,MORTGAGE,3,Low,1,16000, 60 months,2,debt_consolidation,6,High,2,Good Loan,0,18.64,E,5,22.46,20141.98,11846.21,0,411.89,409000003170,26-Oct-16,RUPAY POS ACQ SETTL 26101,,13438.05,-548052999.95,Chikezie,850,Germany,12639.67,0,1,0
3172,2011,7,MORTGAGE,3,Medium,2,27575, 60 months,2,debt_consolidation,6,High,2,Good Loan,0,14.65,C,3,23.73,35796.85557,27575,0,650.96,409000003171,27-Oct-16,RUPAY POS ACQ SETTL 27101,,5435.10,-548047564.85,Frye,815,France,94248.16,0,1,0
3173,2011,2,RENT,1,Medium,2,14000, 36 months,1,debt_consolidation,6,Low,1,Bad Loan,1,7.9,A,1,7.66,8319.53,6973.3,0,438.07,409000003172,28-Oct-16,RUPAY POS ACQ SETTL 28101,,40187.74,-548007377.11,Toscani,665,Germany,11865.76,0,1,0
3174,2011,0.5,MORTGAGE,3,Medium,2,35000, 60 months,2,house,12,High,2,Bad Loan,1,20.3,E,5,17.72,25126.3,9482.39,3686.85,933.14,409000003173,29-Oct-16,RUPAY POS ACQ SETTL 29101,,5348.01,-548002029.10,Mellor,485,France,141449.86,0,1,0
3175,2011,10,OWN,2,Low,1,30000, 60 months,2,debt_consolidation,6,High,2,Good Loan,0,20.3,E,5,16.66,46922.47199,30000.01,0,799.84,409000003174,1-Nov-16,RUPAY POS ACQ SETTL 30101,,4242.88,-547997786.22,Kang,577,Spain,149457.81,0,1,0
3176,2011,10,MORTGAGE,3,Low,1,5000, 36 months,1,car,2,Low,1,Good Loan,0,6.03,A,1,17.82,5478.186893,5000,0,152.18,409000003175,1-Nov-16,RUPAY POS ACQ SETTL 31101,,36823.37,-547960962.85,Sutherland,586,France,119814.25,0,1,0
3177,2011,10,MORTGAGE,3,Medium,2,7500, 36 months,1,debt_consolidation,6,Low,1,Good Loan,0,11.71,B,2,10.72,7644.69,7500,0,248.07,409000003176,1-Nov-16,RUPAY POS ACQ SETTL 01111,,3991.39,-547956971.46,Hs?,722,Germany,24924.92,0,1,0
3178,2011,10,RENT,1,Low,1,3000, 36 months,1,medical,9,Low,1,Good Loan,0,7.9,A,1,2.76,3379.066157,3000,0,93.88,409000003177,2-Nov-16,RUPAY POS ACQ SETTL 02111,,6214.51,-547950756.95,Ting,528,France,139481.53,0,1,0
3179,2011,6,MORTGAGE,3,Low,1,9000, 36 months,1,debt_consolidation,6,High,2,Good Loan,0,18.64,E,5,6.91,11815.93851,9000,0,328.27,409000003178,3-Nov-16,RUPAY POS ACQ SETTL 03111,,7924.86,-547942832.09,Chuang,542,France,41268.65,0,1,0
3180,2011,8,RENT,1,Low,1,24000, 60 months,2,home_improvement,7,Low,1,Good Loan,0,11.71,B,2,9.8,29774.31317,24000,0,530.36,409000003179,4-Nov-16,RUPAY POS ACQ SETTL 04111,,6818.48,-547936013.61,Chu,552,France,1351.41,0,1,0
3181,2011,7,MORTGAGE,3,Low,1,13000, 60 months,2,debt_consolidation,6,High,2,Good Loan,0,14.65,C,3,12.3,15035.27,9857.83,0,306.89,409000003180,5-Nov-16,RUPAY POS ACQ SETTL 05111,,9471.36,-547926542.25,Ozoemena,678,France,147489.76,0,1,0
3182,2011,2,RENT,1,Low,1,5500, 36 months,1,debt_consolidation,6,Low,1,Good Loan,0,10.65,B,2,12.87,6382.680253,5500,0,179.16,409000003181,7-Nov-16,RUPAY POS ACQ SETTL 06111,,8875.10,-547917667.15,Howells,575,Spain,111175.09,0,1,0
3183,2011,0.5,RENT,1,Low,1,3500, 36 months,1,debt_consolidation,6,Low,1,Bad Loan,1,11.71,B,2,9.36,4098.55,1788.54,1788.75,115.77,409000003182,7-Nov-16,RUPAY POS ACQ SETTL 07111,,7326.39,-547910340.76,Lucchese,669,France,95963.14,0,1,0
3184,2011,2,MORTGAGE,3,Medium,2,35000, 60 months,2,home_improvement,7,Low,1,Good Loan,0,12.69,B,2,6.35,43028.92,35000,0,790.82,409000003183,8-Nov-16,RUPAY POS ACQ SETTL 08111,,15388.48,-547894952.28,Nnonso,636,France,43128.95,0,1,0
3185,2011,4,RENT,1,Low,1,24000, 36 months,1,debt_consolidation,6,Low,1,Good Loan,0,8.9,A,1,24.85,25965.77,24000,0,762.08,409000003184,9-Nov-16,RUPAY POS ACQ SETTL 09111,,27993.52,-547866958.76,Gerasimova,667,Germany,137674.96,0,1,0
3186,2011,10,RENT,1,Medium,2,21000, 60 months,2,wedding,5,High,2,Bad Loan,1,17.58,D,4,9.22,13333.83,5177.35,2238.49,528.48,409000003185,10-Nov-16,RUPAY POS ACQ SETTL 10111,,6939.81,-547860018.95,Woronoff,652,Germany,153383.54,0,1,0
3187,2011,4,MORTGAGE,3,Low,1,13200, 60 months,2,credit_card,1,High,2,Bad Loan,1,14.27,C,3,18.34,4942.18,2651.44,17.7,309,409000003186,11-Nov-16,RUPAY POS ACQ SETTL 11111,,12923.63,-547847095.32,Wilhelm,637,Germany,96660.76,0,1,0
3188,2011,1,MORTGAGE,3,Medium,2,30000, 36 months,1,credit_card,1,Low,1,Good Loan,0,9.91,B,2,8.16,34799.91173,30000,0,966.75,409000003187,12-Nov-16,RUPAY POS ACQ SETTL 12111,,2635.74,-547844459.58,Nebechukwu,516,Spain,115818.16,0,1,0
3189,2011,2,RENT,1,Low,1,12000, 36 months,1,debt_consolidation,6,Low,1,Good Loan,0,8.9,A,1,3.31,12820.02,12000,0,381.04,409000003188,15-Nov-16,RUPAY POS ACQ SETTL 13111,,6537.02,-547837922.56,Anenechukwu,801,France,37898.50,0,1,0
3190,2011,6,RENT,1,Low,1,5000, 36 months,1,debt_consolidation,6,Low,1,Good Loan,0,6.62,A,1,26.79,5525.845241,5000,0,153.52,409000003189,15-Nov-16,RUPAY POS ACQ SETTL 14111,,4574.53,-547833348.03,Meredith,692,France,145222.93,0,1,0
3191,2011,2,RENT,1,Low,1,6850, 60 months,2,debt_consolidation,6,High,2,Bad Loan,1,19.03,E,5,6.47,6430.34,2958.14,586.53,177.81,409000003190,15-Nov-16,RUPAY POS ACQ SETTL 15111,,16155.76,-547817192.27,Chinomso,585,France,41219.09,0,1,0
3192,2011,10,MORTGAGE,3,Low,1,12000, 36 months,1,debt_consolidation,6,Low,1,Good Loan,0,7.9,A,1,6.6,13516.62234,12000,0,375.49,409000003191,16-Nov-16,RUPAY POS ACQ SETTL 16111,,8283.65,-547808908.62,Stephenson,590,France,59249.83,0,1,0
3193,2011,5,RENT,1,Low,1,15000, 60 months,2,debt_consolidation,6,High,2,Good Loan,0,20.3,E,5,15.78,18511.29,15000,0,399.92,409000003192,17-Nov-16,RUPAY POS ACQ SETTL 17111,,55163.89,-547753744.73,Chimaoke,554,Spain,116747.62,0,1,0
3194,2011,8,RENT,1,Low,1,20000, 60 months,2,credit_card,1,High,2,Bad Loan,1,15.27,C,3,16.85,13432.51,6200.04,1947.18,478.64,409000003193,18-Nov-16,RUPAY POS ACQ SETTL 18111,,75522.70,-547678222.03,Winters,659,France,116249.72,0,1,0
3195,2011,6,RENT,1,Low,1,5000, 36 months,1,debt_consolidation,6,High,2,Bad Loan,1,16.77,D,4,13.03,354.62,216.68,0,177.7,409000003194,19-Nov-16,RUPAY POS ACQ SETTL 19111,,16890.95,-547661331.08,Napolitani,690,France,61257.83,0,1,0
3196,2011,9,MORTGAGE,3,Medium,2,35000, 60 months,2,home_improvement,7,Low,1,Good Loan,0,12.42,B,2,10.38,38498.11,26857.92,0,786.01,409000003195,21-Nov-16,RUPAY POS ACQ SETTL 20111,,70247.73,-547591083.35,L?,697,Germany,141798.98,0,1,0
3197,2011,6,MORTGAGE,3,Low,1,1500, 36 months,1,home_improvement,7,Low,1,Good Loan,0,8.9,A,1,7.53,1590.06,1500,0,47.63,409000003196,21-Nov-16,RUPAY POS ACQ SETTL 21111,,46019.96,-547545063.39,Williams,610,France,102638.35,0,1,0
3198,2011,10,MORTGAGE,3,Low,1,12000, 60 months,2,debt_consolidation,6,High,2,Bad Loan,1,14.27,C,3,10.58,7865.48,4544.13,0,280.91,409000003197,22-Nov-16,RUPAY POS ACQ SETTL 22111,,32562.37,-547512501.02,Giles,599,Spain,13210.56,0,1,0
3199,2011,10,RENT,1,Low,1,21000, 60 months,2,debt_consolidation,6,High,2,Bad Loan,1,17.58,D,4,13.91,4226.51,1847.86,0,528.48,409000003198,23-Nov-16,RUPAY POS ACQ SETTL 19111,,115.86,-547512385.16,Wang,544,France,35550.97,0,1,0
3200,2011,10,MORTGAGE,3,Low,1,6000, 36 months,1,debt_consolidation,6,Low,1,Good Loan,0,8.9,A,1,9.34,6853.259647,6000,0,190.52,409000003199,23-Nov-16,RUPAY POS ACQ SETTL 23111,,73550.28,-547438834.88,Robertson,548,France,104469.06,0,1,0
3201,2011,9,MORTGAGE,3,Low,1,35000, 60 months,2,house,12,High,2,Bad Loan,1,17.27,D,4,16.52,32471.77,16128.4,2727.98,874.93,409000003200,24-Nov-16,RUPAY POS ACQ SETTL 24111,,69922.23,-547368912.65,Murray,635,Spain,142935.83,0,1,0
3202,2011,8,MORTGAGE,3,Low,1,12400, 60 months,2,home_improvement,7,High,2,Good Loan,0,15.27,C,3,17.06,15629.89,12400,0,296.76,409000003201,25-Nov-16,TRF TO  Indiaforensic SERVICES I,"900,000.00",,-548268912.65,Greco,722,France,195486.28,0,1,0
3203,2011,7,MORTGAGE,3,Medium,2,30000, 36 months,1,debt_consolidation,6,Low,1,Good Loan,0,9.91,B,2,23.64,34682.15019,30000,0,966.75,409000003202,25-Nov-16,RUPAY POS ACQ SETTL 25111,,110234.13,-548158678.52,Marchesi,564,France,63170.00,0,1,0
3204,2011,10,MORTGAGE,3,Low,1,1200, 36 months,1,home_improvement,7,High,2,Bad Loan,1,14.27,C,3,15.7,730.63,373.54,198.67,41.18,409000003203,28-Nov-16,RUPAY POS ACQ SETTL 26111,,132067.95,-548026610.57,Chao,719,France,58320.06,0,1,0
3205,2011,10,OWN,2,Low,1,7000, 36 months,1,other,4,Low,1,Good Loan,0,7.51,A,1,17.87,7660.57,7000,0,217.78,409000003204,28-Nov-16,RUPAY POS ACQ SETTL 27111,,79605.83,-547947004.74,Hawthorn,547,Germany,177747.03,0,1,0
3206,2011,3,RENT,1,Low,1,5600, 36 months,1,credit_card,1,Low,1,Good Loan,0,7.9,A,1,5.23,6006.18,5600,0,175.23,409000003205,28-Nov-16,RUPAY POS ACQ SETTL 28111,,72961.29,-547874043.45,Bibi,850,France,19632.64,0,1,0
3207,2011,2,MORTGAGE,3,Low,1,4200, 36 months,1,vacation,11,High,2,Good Loan,0,14.27,C,3,7.65,5038.98,4200,0,144.1,409000003206,29-Nov-16,RUPAY POS ACQ SETTL 29111,,79666.42,-547794377.03,Hawdon,515,Germany,18424.24,0,1,0
3208,2011,1,OWN,2,Low,1,7000, 36 months,1,home_improvement,7,High,2,Good Loan,0,16.29,D,4,20.4,8894.237295,7000,0,247.11,409000003207,30-Nov-16,RUPAY POS ACQ SETTL 30111,,191202.09,-547603174.94,Moss,667,Spain,18897.78,0,1,0
3209,2011,6.05,MORTGAGE,3,Medium,2,25000, 36 months,1,debt_consolidation,6,Low,1,Good Loan,0,12.69,B,2,10.93,30185.63785,25000,0,838.63,409000003208,1-Dec-16,RUPAY POS ACQ SETTL 01121,,129424.36,-547473750.58,Briggs,607,Germany,97879.02,0,1,0
3210,2011,10,MORTGAGE,3,Low,1,8500, 36 months,1,car,2,Low,1,Good Loan,0,6.03,A,1,10.77,9327.901821,8500,0,258.71,409000003209,2-Dec-16,VISA POS ACQ SETTL 011216,,147025.15,-547326725.43,McIntyre,525,France,63197.88,0,1,0
3211,2011,3,MORTGAGE,3,Low,1,3000, 36 months,1,credit_card,1,Low,1,Good Loan,0,7.9,A,1,22.03,3332.8,3000,0,93.88,409000003210,2-Dec-16,RUPAY POS ACQ SETTL 02121,,147719.77,-547179005.66,Russo,606,Spain,75860.01,0,1,0
3212,2011,4,RENT,1,Low,1,1600, 36 months,1,debt_consolidation,6,Low,1,Good Loan,0,7.51,A,1,23.89,1790.977255,1600,0,49.78,409000003211,3-Dec-16,VISA POS ACQ SETTL 021216,,268194.58,-546910811.08,Ballard,686,Germany,78622.46,0,1,0
3213,2011,2,MORTGAGE,3,Low,1,35000, 60 months,2,debt_consolidation,6,High,2,Bad Loan,1,19.03,E,5,16.94,10974.1,2933.26,1842.26,908.5,409000003212,3-Dec-16,RUPAY POS ACQ SETTL 03121,,118857.60,-546791953.48,Hs?,611,France,23598.23,0,1,0
3214,2011,3,RENT,1,Low,1,3400, 36 months,1,major_purchase,8,Low,1,Good Loan,0,12.69,B,2,4.36,4103.261273,3400,0,114.06,409000003213,5-Dec-16,RUPAY POS ACQ SETTL 04121,,227553.35,-546564400.13,Pisani,827,Spain,13460.27,0,1,0
3215,2011,3,RENT,1,Low,1,10000, 36 months,1,major_purchase,8,High,2,Bad Loan,1,19.42,E,5,13.94,9737.07,6308.26,525.57,368.69,409000003214,5-Dec-16,RUPAY POS ACQ SETTL 05121,,132656.05,-546431744.08,Tao,572,France,19998.31,0,1,0
3216,2011,10,MORTGAGE,3,Low,1,10000, 36 months,1,home_improvement,7,Low,1,Good Loan,0,6.62,A,1,19.67,11052.19447,10000,0,307.04,409000003215,6-Dec-16,VISA POS ACQ SETTL 031216,,99999.48,-546331744.60,Thomson,726,France,185075.63,0,1,0
3217,2011,3,MORTGAGE,3,Low,1,3500, 36 months,1,major_purchase,8,High,2,Bad Loan,1,16.29,D,4,0,4019,3019.28,69.4,123.56,409000003216,6-Dec-16,VISA POS ACQ SETTL 051216,,318332.99,-546013411.61,Hsu,579,Germany,135815.38,0,1,0
3218,2011,5,RENT,1,Low,1,24000, 60 months,2,debt_consolidation,6,High,2,Bad Loan,1,19.42,E,5,18.46,17538.82,6947.68,2464.47,628.14,409000003217,6-Dec-16,RUPAY POS ACQ SETTL 06121,,203418.82,-545809992.79,Morrison,598,Spain,44251.33,0,1,0
3219,2011,2,RENT,1,Low,1,35000, 36 months,1,credit_card,1,Low,1,Good Loan,0,7.9,A,1,15.33,39423.28125,35000,0,1095.16,409000003218,7-Dec-16,VISA POS ACQ SETTL 061216,,165875.04,-545644117.75,Joslin,663,France,136349.55,0,1,0
3220,2011,2,RENT,1,Low,1,14000, 36 months,1,major_purchase,8,Low,1,Good Loan,0,12.69,B,2,13.98,15433.11,14000,0,469.63,409000003219,7-Dec-16,TRF TO  Indiaforensic SERVICES I,"2,600,000.00",,-548244117.75,Scott,505,Germany,52693.99,0,1,0
3221,2011,10,MORTGAGE,3,Low,1,9600, 60 months,2,debt_consolidation,6,High,2,Good Loan,0,14.27,C,3,9.35,11935.9,9600,0,224.73,409000003220,7-Dec-16,RUPAY POS ACQ SETTL 07121,,278099.33,-547966018.42,Bidwill,576,Germany,93767.03,0,1,0
3222,2011,6,RENT,1,Low,1,15000, 36 months,1,other,4,Low,1,Good Loan,0,11.71,B,2,15.54,17688.18871,15000,0,496.14,409000003221,8-Dec-16,VISA POS ACQ SETTL 071216,,251853.40,-547714165.02,Cameron,555,Spain,197866.55,0,1,0
3223,2011,0.5,MORTGAGE,3,Low,1,1000, 36 months,1,debt_consolidation,6,Low,1,Good Loan,0,11.71,B,2,13.4,1173.11,1000,0,33.08,409000003222,8-Dec-16,RUPAY POS ACQ SETTL 08121,,335647.47,-547378517.55,Cartwright,524,France,126812.85,0,1,0
3224,2011,10,MORTGAGE,3,Low,1,4000, 36 months,1,major_purchase,8,Low,1,Good Loan,0,6.62,A,1,0.7,4341.33,4000,0,122.82,409000003223,9-Dec-16,VISA POS ACQ SETTL 081216,,238412.67,-547140104.88,Yao,776,Spain,79503.05,0,1,0
3225,2011,7,OWN,2,Low,1,20000, 36 months,1,credit_card,1,Low,1,Good Loan,0,8.9,A,1,26.69,22695.3773,20000,0,635.07,409000003224,9-Dec-16,RUPAY POS ACQ SETTL 09121,,306975.27,-546833129.61,Tate,645,Germany,129936.53,0,1,0
3226,2011,8,MORTGAGE,3,Low,1,14000, 36 months,1,home_improvement,7,Low,1,Good Loan,0,7.9,A,1,18.28,15769.54715,14000,0,438.07,409000003225,9-Dec-16,FUNDS TRF  Indiaforensic SERVICE,"1,100,000.00",,-547933129.61,Neal,850,Germany,175094.62,0,1,0
3227,2011,9,MORTGAGE,3,High,3,15000, 36 months,1,debt_consolidation,6,Low,1,Good Loan,0,6.03,A,1,2.84,15290.24,15000,0,456.54,409000003226,13-Dec-16,VISA POS ACQ SETTL 101216,,133279.32,-547799850.29,Yao,603,Germany,130379.50,0,1,0
3228,2011,2,MORTGAGE,3,Low,1,20000, 60 months,2,debt_consolidation,6,Low,1,Bad Loan,1,11.71,B,2,22.22,8827.34,4820.9,888.26,441.97,409000003227,13-Dec-16,VISA POS ACQ SETTL 091216,,120573.96,-547679276.33,Burns,691,France,153228.00,0,1,0
3229,2011,6.05,RENT,1,Low,1,15000, 36 months,1,other,4,Low,1,Good Loan,0,6.62,A,1,9.04,15602.76,15000,0,460.56,409000003228,13-Dec-16,VISA POS ACQ SETTL 121216,,221790.58,-547457485.75,Onyinyechukwuka,583,France,111285.85,0,1,0
3230,2011,4,RENT,1,Low,1,23000, 60 months,2,debt_consolidation,6,High,2,Good Loan,0,14.27,C,3,21.14,26346.23,17459.29,0,538.4,409000003229,13-Dec-16,RUPAY POS ACQ SETTL 10121,,325499.39,-547131986.36,Fulks,584,France,49553.38,0,1,0
3231,2011,5,MORTGAGE,3,Low,1,6800, 36 months,1,medical,9,Low,1,Good Loan,0,12.69,B,2,18.1,7599.38,6800,0,228.11,409000003230,13-Dec-16,RUPAY POS ACQ SETTL 11121,,427787.06,-546704199.30,Christie,679,France,98015.85,0,1,0
3232,2011,1,MORTGAGE,3,Medium,2,30000, 60 months,2,debt_consolidation,6,Low,1,Good Loan,0,11.71,B,2,12.27,32459.71,23101.62,0,662.95,409000003231,13-Dec-16,RUPAY POS ACQ SETTL 12121,,391929.44,-546312269.86,Lloyd,646,France,88481.32,0,1,0
3233,2011,6,RENT,1,Low,1,26375, 60 months,2,debt_consolidation,6,High,2,Good Loan,0,19.42,E,5,18.17,39779.36973,26375,0,690.3,409000003232,14-Dec-16,RUPAY POS ACQ SETTL 13121,,330746.20,-545981523.66,Ball,559,France,66879.27,0,1,0
3234,2011,5,RENT,1,Low,1,6400, 36 months,1,debt_consolidation,6,Low,1,Good Loan,0,11.71,B,2,5.95,7616.993642,6400,0,211.69,409000003233,14-Dec-16,RUPAY POS ACQ SETTL 14121,,336749.76,-545644773.90,Genovesi,595,Spain,24802.77,0,1,0
3235,2011,1,RENT,1,Low,1,10200, 36 months,1,debt_consolidation,6,Low,1,Good Loan,0,8.9,A,1,5.48,11592.54371,10200,0,323.89,409000003234,16-Dec-16,RUPAY POS ACQ SETTL 15121,,409236.96,-545235536.94,Alexander,527,France,21312.16,0,1,0
3236,2011,10,MORTGAGE,3,Medium,2,30000, 36 months,1,debt_consolidation,6,Low,1,Good Loan,0,7.51,A,1,10.16,33597.22457,30000,0,933.33,409000003235,16-Dec-16,RUPAY POS ACQ SETTL 16121,,869207.57,-544366329.37,Siciliano,684,Spain,190263.78,0,1,0
3237,2011,10,MORTGAGE,3,Low,1,12000, 60 months,2,credit_card,1,Low,1,Good Loan,0,8.9,A,1,9.6,12126.18,9347.93,0,248.52,409000003236,17-Dec-16,RUPAY POS ACQ SETTL 17121,,1367168.03,-542999161.34,Ositadimma,673,Spain,72873.33,0,1,0
3238,2011,10,MORTGAGE,3,Low,1,12000, 60 months,2,car,2,High,2,Good Loan,0,17.27,D,4,12.46,15541.34097,12000,0,299.98,409000003237,19-Dec-16,RUPAY POS ACQ SETTL 18121,,1066934.60,-541932226.74,Kazantsev,802,Spain,57764.65,0,1,0
3239,2011,10,MORTGAGE,3,Low,1,15000, 60 months,2,debt_consolidation,6,High,2,Good Loan,0,17.27,D,4,14.83,18326.01,11185.95,0,374.97,409000003238,19-Dec-16,RUPAY POS ACQ SETTL 19121,,615789.45,-541316437.29,Giles,675,France,110273.84,0,1,0
3240,2011,10,RENT,1,Medium,2,15000, 60 months,2,debt_consolidation,6,High,2,Good Loan,0,16.77,D,4,16.28,21459.15192,15000,0,370.94,409000003239,19-Dec-16,VISA POS ACQ SETTL 141216,,62941.42,-541253495.87,Hao,762,Spain,55500.17,0,1,0
3241,2011,2,RENT,1,Low,1,8000, 36 months,1,debt_consolidation,6,Low,1,Good Loan,0,7.51,A,1,4.21,8821.46,8000,0,248.89,409000003240,19-Dec-16,VISA POS ACQ SETTL 181216,,22928.96,-541230566.91,Martin,580,France,57541.08,0,1,0
3242,2011,10,MORTGAGE,3,Low,1,19000, 60 months,2,credit_card,1,Low,1,Good Loan,0,9.91,B,2,15.21,19738.52,14779.88,0,402.86,409000003241,20-Dec-16,VISA POS ACQ SETTL 191216,,2976491.32,-538254075.59,Hartley,621,Germany,90384.26,0,1,0
3243,2011,6,MORTGAGE,3,Low,1,9250, 36 months,1,debt_consolidation,6,Low,1,Good Loan,0,7.9,A,1,7.54,10418.58949,9250,0,289.44,409000003242,20-Dec-16,RUPAY POS ACQ SETTL 20121,,620788.41,-537633287.18,Allan,411,France,120694.35,0,1,0
3244,2011,10,MORTGAGE,3,Low,1,35000, 60 months,2,debt_consolidation,6,Low,1,Good Loan,0,11.71,B,2,28.78,44983.47782,35000,0,773.44,409000003243,21-Dec-16,VISA POS ACQ SETTL 201216,,1294666.69,-536338620.49,Dolgorukova,815,France,178028.96,0,1,0
3245,2011,8,MORTGAGE,3,Medium,2,18000, 36 months,1,major_purchase,8,Low,1,Good Loan,0,12.69,B,2,6.21,20817.34,18000,0,603.81,409000003244,21-Dec-16,FUND TRF TO  Indiaforensic SERVI,"10,000,000.00",,-546338620.49,Nnamdi,631,Germany,180990.29,0,1,0
3246,2011,3,RENT,1,Low,1,4600, 60 months,2,debt_consolidation,6,High,2,Good Loan,0,17.27,D,4,24.23,5626.36,3434.05,0,115,409000003245,22-Dec-16,VISA POS ACQ SETTL 211216,,548228.46,-545790392.03,Romano,514,Germany,155407.21,0,1,0
3247,2011,6,MORTGAGE,3,Low,1,5400, 36 months,1,debt_consolidation,6,Low,1,Good Loan,0,12.42,B,2,22.92,6493.50351,5400,0,180.45,409000003246,22-Dec-16,VISA POS ACQ SETTL 211216,,9888.02,-545780504.01,Chuang,638,France,33676.48,0,1,0
3248,2011,2,MORTGAGE,3,Low,1,14400, 60 months,2,debt_consolidation,6,High,2,Bad Loan,1,15.27,C,3,16.3,1720.66,822.46,8.46,344.62,409000003247,22-Dec-16,RUPAY POS ACQ SETTL 21121,,837323.97,-544943180.04,Owen,791,Spain,89666.28,0,1,0
3249,2011,8,RENT,1,Low,1,3000, 60 months,2,other,4,High,2,Good Loan,0,15.27,C,3,4.5,3501.73,2258.52,0,71.8,409000003248,23-Dec-16,VISA POS ACQ SETTL 221216,,633697.23,-544309482.81,Singh,516,France,127558.26,0,1,0
3250,2011,10,RENT,1,Low,1,1450, 36 months,1,debt_consolidation,6,Low,1,Good Loan,0,12.42,B,2,21.53,1571.96,1450,0,48.46,409000003249,23-Dec-16,FUND TRF TO  Indiaforensic SERVI,"3,000,000.00",,-547309482.81,Nwagugheuzo,734,France,77272.62,0,1,0
3251,2011,3,RENT,1,Low,1,12000, 60 months,2,other,4,High,2,Bad Loan,1,18.25,D,4,7.45,10537.42,4772.55,1040.26,306.36,409000003250,23-Dec-16,RUPAY POS ACQ SETTL 22121,,908269.11,-546401213.70,Shipton,611,France,107665.68,0,1,0
3252,2011,3,RENT,1,Low,1,7200, 36 months,1,credit_card,1,Low,1,Good Loan,0,8.9,A,1,3.54,7775.01,7200,0,228.63,409000003251,23-Dec-16,RUPAY POS ACQ SETTL 23121,,1028863.32,-545372350.38,Paterson,850,Germany,184044.80,0,1,0
3253,2011,2,RENT,1,Low,1,6000, 60 months,2,other,4,High,2,Good Loan,0,19.03,E,5,20.47,7602.59,4425.77,0,155.75,409000003252,26-Dec-16,RUPAY POS ACQ SETTL 24121,,1264736.71,-544107613.67,Rivas,641,France,91510.71,0,1,0
3254,2011,4,MORTGAGE,3,Low,1,12000, 60 months,2,debt_consolidation,6,Low,1,Good Loan,0,12.69,B,2,15.35,14490.42,12000,0,271.14,409000003253,26-Dec-16,RUPAY POS ACQ SETTL 25121,,1226971.54,-542880642.13,Lung,585,France,87363.56,0,1,0
3255,2011,3,MORTGAGE,3,Low,1,6000, 36 months,1,car,2,Low,1,Good Loan,0,6.62,A,1,10.34,6512.85,6000,0,184.23,409000003254,26-Dec-16,RUPAY POS ACQ SETTL 26121,,794228.65,-542086413.48,Allan,552,Germany,117505.07,0,1,0
3256,2011,7,MORTGAGE,3,Low,1,8000, 36 months,1,home_improvement,7,High,2,Good Loan,0,19.42,E,5,20.05,10615.97879,8000,0,294.95,409000003255,27-Dec-16,TRF TO  Indiaforensic SERVICES I,"5,000,000.00",,-547086413.48,Fetherstonhaugh,507,France,180626.68,0,1,0
3257,2011,6,MORTGAGE,3,Low,1,12600, 60 months,2,home_improvement,7,Low,1,Good Loan,0,7.9,A,1,6.4,12451.59,9876.37,0,254.88,409000003256,27-Dec-16,VISA POS ACQ SETTL 231216,,685403.50,-546401009.98,Lung,735,Spain,93478.96,0,1,0
3258,2011,5,RENT,1,Low,1,35000, 36 months,1,debt_consolidation,6,Low,1,Good Loan,0,8.9,A,1,22.09,40007.83027,35000,0,1111.37,409000003257,27-Dec-16,VISA POS ACQ SETTL 241216,,914704.56,-545486305.42,Davidson,707,France,114672.64,0,1,0
3259,2011,0.5,RENT,1,Medium,2,8400, 36 months,1,moving,10,Low,1,Good Loan,0,7.51,A,1,16.45,9372.670004,8400,0,261.34,409000003258,27-Dec-16,VISA POS ACQ SETTL 261216,,871304.67,-544615000.75,Mai,698,Germany,13387.88,0,1,0
3260,2011,8,MORTGAGE,3,Low,1,11425, 36 months,1,debt_consolidation,6,Low,1,Good Loan,0,9.91,B,2,19.47,13251.67421,11425,0,368.18,409000003259,28-Dec-16,TRF TO  Indiaforensic SERVICES I,"3,000,000.00",,-547615000.75,Dellucci,841,France,173240.52,0,1,0
3261,2011,10,MORTGAGE,3,Low,1,20000, 60 months,2,debt_consolidation,6,Low,1,Good Loan,0,10.65,B,2,29.63,21093.93,15469.91,0,431.37,409000003260,28-Dec-16,RUPAY POS ACQ SETTL 27121,,1184576.80,-546430423.95,Mitchell,688,Spain,27557.18,0,1,0
3262,2011,10,MORTGAGE,3,Low,1,16000, 36 months,1,debt_consolidation,6,Low,1,Good Loan,0,12.42,B,2,23.91,19131.05712,16000,0,534.65,409000003261,28-Dec-16,RUPAY POS ACQ SETTL 28121,,1388962.31,-545041461.64,Sun,614,France,5552.37,0,1,0
3263,2011,10,MORTGAGE,3,Low,1,24000, 60 months,2,debt_consolidation,6,High,2,Good Loan,0,14.27,C,3,22.28,27478.47,18210.8,0,561.81,409000003262,29-Dec-16,TRF TO  Indiaforensic VIRTUAL VI,"3,000,000.00",,-548041461.64,Napolitano,511,Germany,88307.87,0,1,0
3264,2011,6.05,RENT,1,Low,1,2700, 36 months,1,debt_consolidation,6,Low,1,Bad Loan,1,11.71,B,2,22.24,1799.04,1298.19,80.25,89.31,409000003263,29-Dec-16,VISA POS ACQ SETTL 281216,,1052095.77,-546989365.87,Bailey,447,France,33879.26,0,1,0
3265,2011,10,MORTGAGE,3,Medium,2,20400, 36 months,1,debt_consolidation,6,Low,1,Good Loan,0,11.71,B,2,22.46,22326.02,20400,0,674.75,409000003264,29-Dec-16,VISA POS ACQ SETTL 271216,,1550467.97,-545438897.90,Hoolan,738,France,181429.87,0,1,0
3266,2011,2,RENT,1,Low,1,3000, 36 months,1,debt_consolidation,6,Low,1,Good Loan,0,12.69,B,2,8.19,3619.027792,3000,0,100.64,409000003265,30-Dec-16,TRF TO  Indiaforensic SERVICES I,"2,700,000.00",,-548138897.90,Kent,422,France,102655.31,0,1,0
3267,2011,2,RENT,1,Medium,2,35000, 60 months,2,debt_consolidation,6,High,2,Good Loan,0,22.06,F,6,12.94,47414.34,25434.76,0,967.86,409000003266,31-Dec-16,VISA POS ACQ SETTL 291216,,1236538.57,-546902359.33,Chou,537,Spain,96555.42,0,1,0
3268,2011,2,RENT,1,Low,1,6000, 36 months,1,credit_card,1,Low,1,Good Loan,0,12.42,B,2,11.68,7215.271321,6000,0,200.5,409000003267,31-Dec-16,VISA POS ACQ SETTL 301216,,963791.89,-545938567.44,Pepper,707,Germany,189366.03,0,1,0
3269,2011,6,RENT,1,Low,1,6000, 36 months,1,debt_consolidation,6,Low,1,Good Loan,0,6.03,A,1,14.09,6480.03,6000,0,182.62,409000003268,3-Jan-17,VISA POS ACQ SETTL 311216,,1075484.03,-544863083.41,Abramowitz,690,France,12847.61,0,1,0
3270,2011,0.5,RENT,1,Low,1,3000, 36 months,1,other,4,Low,1,Good Loan,0,11.71,B,2,17.67,3560.345741,3000,0,99.23,409000003269,3-Jan-17,VISA POS CB  SETTL 010117,"2,010.00",,-544865093.41,Lord,664,Germany,143433.33,0,1,0
3271,2011,6,RENT,1,Low,1,9000, 36 months,1,medical,9,Low,1,Good Loan,0,7.9,A,1,5.6,10138.40105,9000,0,281.62,409000003270,3-Jan-17,VISA POS ACQ SETTL 020117,,1057566.64,-543807526.77,Wilson,850,France,183983.82,0,1,0
3272,2011,6,MORTGAGE,3,Low,1,15000, 60 months,2,debt_consolidation,6,High,2,Good Loan,0,14.27,C,3,13.72,17168.65,11378.6,0,351.13,409000003271,4-Jan-17,VISA POS ACQ SETTL 030117,,1587092.70,-542220434.07,Abazu,584,Spain,169137.24,0,1,0
3273,2011,3,RENT,1,Low,1,5000, 36 months,1,debt_consolidation,6,Low,1,Good Loan,0,6.62,A,1,17.26,5520.27818,5000,0,153.52,409000003272,4-Jan-17,VISA POS ACQ SETTL 030117,,3956.00,-542216478.07,Harriman,728,France,163365.85,0,1,0
3274,2011,0.5,RENT,1,Low,1,8000, 60 months,2,debt_consolidation,6,High,2,Good Loan,0,16.77,D,4,21.02,9690.84,5996.19,0,197.84,409000003273,4-Jan-17,TRF TO  Indiaforensic SERVICES I,"4,000,000.00",,-546216478.07,Frankland,560,Spain,123181.44,0,1,0
3275,2011,9,MORTGAGE,3,Low,1,7200, 36 months,1,medical,9,Low,1,Good Loan,0,6.03,A,1,1.2,7604.5,7200,0,219.14,409000003274,5-Jan-17,VISA POS ACQ SETTL 121216,,1978.99,-546214499.08,Pinto,629,France,16447.60,0,1,0
3276,2011,10,RENT,1,Medium,2,20000, 36 months,1,debt_consolidation,6,Low,1,Good Loan,0,8.9,A,1,12.62,21832.94,20000,0,635.07,409000003275,5-Jan-17,RUPAY POS ACQ SETTL 29121,,345754.08,-545868745.00,Kwemtochukwu,658,France,173948.40,0,1,0
3277,2011,10,MORTGAGE,3,Medium,2,2300, 36 months,1,other,4,Low,1,Good Loan,0,7.9,A,1,12.76,2587.261854,2300,0,71.97,409000003276,5-Jan-17,RUPAY POS ACQ SETTL 30121,,296828.95,-545571916.05,Chiu,794,Germany,192154.66,0,1,0
3278,2011,8,MORTGAGE,3,Low,1,14400, 60 months,2,debt_consolidation,6,High,2,Good Loan,0,15.27,C,3,23.14,16820.77,10847,0,344.62,409000003277,5-Jan-17,RUPAY POS ACQ SETTL 01011,,742681.97,-544829234.08,Yu,790,France,198224.38,0,1,0
3279,2011,10,MORTGAGE,3,Medium,2,35000, 60 months,2,debt_consolidation,6,High,2,Good Loan,0,21.28,F,6,8.12,46664.14,25556.58,0,952.39,409000003278,5-Jan-17,RUPAY POS ACQ SETTL 02011,,509694.69,-544319539.39,Onyekachukwu,640,France,67202.74,0,1,0
3280,2011,0.5,RENT,1,Low,1,4375, 36 months,1,debt_consolidation,6,Low,1,Good Loan,0,12.69,B,2,15.84,4786.43,4375,0,146.76,409000003279,5-Jan-17,RUPAY POS ACQ SETTL 03011,,1598262.90,-542721276.49,Castiglione,652,Spain,68789.93,0,1,0
3281,2011,3,RENT,1,Low,1,10000, 60 months,2,credit_card,1,High,2,Good Loan,0,21.67,F,6,4.62,13378.48,10000,0,274.32,409000003280,5-Jan-17,RUPAY POS ACQ SETTL 04011,,1033639.97,-541687636.52,To Rot,583,France,147964.99,0,1,0
3282,2011,10,MORTGAGE,3,Medium,2,5600, 36 months,1,debt_consolidation,6,Low,1,Good Loan,0,7.9,A,1,24.47,6304.412129,5600,0,175.23,409000003281,5-Jan-17,RUPAY POS ACQ SETTL 05011,,927808.60,-540759827.92,Anenechukwu,775,France,161069.73,0,1,0
3283,2011,10,MORTGAGE,3,Low,1,5000, 36 months,1,vacation,11,Low,1,Good Loan,0,12.69,B,2,7.75,6034.82655,5000,0,167.73,409000003282,5-Jan-17,VISA POS ACQ SETTL 131216,,151771.14,-540608056.78,Henderson,584,France,127749.61,0,1,0
3284,2011,5,RENT,1,Medium,2,6000, 36 months,1,debt_consolidation,6,Low,1,Good Loan,0,8.9,A,1,19.54,6733.53,6000,0,190.52,409000003283,5-Jan-17,VISA POS ACQ SETTL 040117,,870800.19,-539737256.59,Ellis,635,Germany,191914.37,0,1,0
3285,2011,8,RENT,1,Low,1,8000, 36 months,1,debt_consolidation,6,Low,1,Good Loan,0,11.71,B,2,11.63,9519.200484,8000,0,264.61,409000003284,5-Jan-17,VISA POS ACQ SETTL 040117,,14835.00,-539722421.59,Nkemdirim,814,France,185791.90,0,1,0
3286,2011,10,MORTGAGE,3,Medium,2,12000, 60 months,2,home_improvement,7,High,2,Bad Loan,1,15.96,C,3,8.86,13947.29,8749.1,0,291.57,409000003285,6-Jan-17,VISA POS ACQ SETTL 050117,,858281.67,-538864139.92,Kang,735,Germany,184570.04,0,1,0
3287,2011,2,MORTGAGE,3,Low,1,5000, 36 months,1,debt_consolidation,6,Low,1,Good Loan,0,6.03,A,1,16.13,5473.313383,5000,0,152.18,409000003286,6-Jan-17,TRF TO  Indiaforensic SERVICES I,"8,000,000.00",,-546864139.92,Lear,678,France,130446.65,0,1,0
3288,2011,2,MORTGAGE,3,High,3,35000, 60 months,2,major_purchase,8,Low,1,Good Loan,0,11.71,B,2,7.87,44311.02415,35000,0,773.44,409000003287,6-Jan-17,RUPAY POS ACQ SETTL 06011,,944257.40,-545919882.52,Jamieson,693,France,82867.55,0,1,0
3289,2011,1,RENT,1,Low,1,2800, 36 months,1,debt_consolidation,6,High,2,Good Loan,0,13.49,C,3,13.08,3401.894091,2800,0,95.01,409000003288,7-Jan-17,VISA POS ACQ SETTL 060117,,1064673.02,-544855209.50,Mazzanti,640,France,187632.22,0,1,0
3290,2011,8,MORTGAGE,3,Medium,2,15000, 36 months,1,house,12,High,2,Good Loan,0,15.96,C,3,4.32,18964.80297,15000,0,527.06,409000003289,7-Jan-17,RUPAY POS ACQ SETTL 07011,,933659.33,-543921550.17,Marino,773,Spain,56759.79,0,1,0
3291,2011,8,MORTGAGE,3,Low,1,3500, 36 months,1,debt_consolidation,6,High,2,Good Loan,0,17.27,D,4,21.77,4507.349537,3500,0,125.26,409000003290,9-Jan-17,VISA POS ACQ SETTL 070117,,898030.23,-543023519.94,Winter,736,France,34180.33,0,1,0
3292,2011,10,MORTGAGE,3,Low,1,20000, 60 months,2,debt_consolidation,6,Low,1,Good Loan,0,12.42,B,2,6.36,25231.27953,20000,0,449.15,409000003291,9-Jan-17,TRF TO  Indiaforensic ONLINE SER,"4,000,000.00",,-547023519.94,T'ien,693,France,158545.25,0,1,0
3293,2011,10,MORTGAGE,3,Low,1,14000, 36 months,1,debt_consolidation,6,Low,1,Bad Loan,1,9.91,B,2,9.65,2299.69,1647.42,0,451.15,409000003292,9-Jan-17,RUPAY POS ACQ SETTL 08011,,668224.60,-546355295.34,Hughes-Jones,496,France,182337.98,0,1,0
3294,2011,7,RENT,1,Low,1,11200, 36 months,1,debt_consolidation,6,Low,1,Good Loan,0,9.91,B,2,26.87,12022.54,11200,0,360.92,409000003293,9-Jan-17,RUPAY POS ACQ SETTL 09011,,605464.20,-545749831.14,Cody,751,France,84175.34,0,1,0
3295,2011,6.05,MORTGAGE,3,Medium,2,20000, 60 months,2,other,4,High,2,Good Loan,0,19.42,E,5,14.46,25626.91,14754.07,0,523.45,409000003294,10-Jan-17,VISA POS ACQ SETTL 090117,,612482.81,-545137348.33,Hunt,528,Germany,22197.80,0,1,0
3296,2011,6,MORTGAGE,3,Low,1,14000, 36 months,1,debt_consolidation,6,Low,1,Good Loan,0,12.69,B,2,7.33,15747.95,14000,0,469.63,409000003295,10-Jan-17,VISA POSINTACQ  SET090117,,1153.53,-545136194.80,Estrada,754,Spain,189641.11,0,1,0
3297,2011,8,RENT,1,Low,1,6000, 60 months,2,other,4,Low,1,Bad Loan,1,8.9,A,1,23.75,3299.03,1882.18,588.63,124.26,409000003296,10-Jan-17,RUPAY POS ACQ SETTL 10011,,1057205.05,-544078989.75,Dickinson,568,Germany,154491.39,0,1,0
3298,2011,6.05,MORTGAGE,3,Low,1,4000, 36 months,1,debt_consolidation,6,Low,1,Good Loan,0,9.91,B,2,22.24,4241.68,4000,0,128.9,409000003297,11-Jan-17,VISA POS ACQ SETTL 100117,,1912483.18,-542166506.57,Fanucci,592,Spain,90020.74,0,1,0
3299,2011,10,MORTGAGE,3,Medium,2,24925, 60 months,2,credit_card,1,High,2,Good Loan,0,17.27,D,4,23.2,30475.3,18599.66,0,623.08,409000003298,11-Jan-17,VISA POSINTACQ  SET100117,,4495.00,-542162011.57,Yang,558,Germany,197264.35,0,1,0
3300,2011,2,RENT,1,Medium,2,5000, 36 months,1,medical,9,Low,1,Good Loan,0,6.03,A,1,0.25,5065.93,5000,0,152.18,409000003299,11-Jan-17,RUPAY POS ACQ SETTL 11011,,920316.99,-541241694.58,Forbes,825,France,31933.06,0,1,0
3301,2011,6,MORTGAGE,3,Low,1,3500, 36 months,1,major_purchase,8,Low,1,Good Loan,0,6.03,A,1,23.09,3834.799744,3500,0,106.53,409000003300,12-Jan-17,TRF TO  Indiaforensic ONLINE SER,"2,000,000.00",,-543241694.58,Heard,677,Germany,8755.69,0,1,0
3302,2011,10,RENT,1,Low,1,2700, 36 months,1,other,4,High,2,Good Loan,0,13.49,C,3,14.55,3097.82,2700,0,91.62,409000003301,12-Jan-17,TRF TO  Indiaforensic SERVICES I,"5,000,000.00",,-548241694.58,Efremova,653,France,52820.13,0,1,0
3303,2011,7,RENT,1,Low,1,12800, 60 months,2,debt_consolidation,6,High,2,Bad Loan,1,18.64,E,5,16.8,4940.98,2180.53,16.18,329.51,409000003302,12-Jan-17,VISA POS ACQ SETTL 110117,,1104399.50,-547137295.08,Morphett,593,Spain,20008.46,0,1,0
3304,2011,4,RENT,1,Low,1,14400, 60 months,2,debt_consolidation,6,High,2,Good Loan,0,17.27,D,4,11.75,17595.01,10739.96,0,359.98,409000003303,12-Jan-17,RUPAY POS ACQ SETTL 12011,,1189196.69,-545948098.39,Lenhardt,632,France,34607.14,0,1,0
3305,2011,2,RENT,1,Low,1,7800, 36 months,1,credit_card,1,Low,1,Good Loan,0,7.9,A,1,6.47,8785.638585,7800,0,244.07,409000003304,13-Jan-17,TRF TO  Indiaforensic SERVICES I,"2,000,000.00",,-547948098.39,Burns,601,Germany,177384.45,0,1,0
3306,2011,3,MORTGAGE,3,Low,1,10000, 36 months,1,credit_card,1,Low,1,Good Loan,0,9.91,B,2,13.91,11599.6899,10000,0,322.25,409000003305,13-Jan-17,VISA POS ACQ SETTL 120117,,1409250.70,-546538847.69,Ch'ien,786,France,165702.64,0,1,0
3307,2011,9,RENT,1,Medium,2,5600, 36 months,1,wedding,5,High,2,Good Loan,0,17.58,D,4,11.59,7236.28446,5600,0,201.28,409000003306,13-Jan-17,TRF TO  Indiaforensic SERVICES I,"1,500,000.00",,-548038847.69,Sun,654,France,167889.10,0,1,0
3308,2011,6.05,RENT,1,Low,1,5000, 36 months,1,debt_consolidation,6,Low,1,Bad Loan,1,9.91,B,2,17.85,586.98,240.46,265,161.13,409000003307,13-Jan-17,RUPAY POS ACQ SETTL 13011,,1192342.91,-546846504.78,Jamieson,572,France,133122.62,0,1,0
3309,2011,10,MORTGAGE,3,Medium,2,35000, 60 months,2,house,12,High,2,Good Loan,0,22.74,G,7,24,48076.74,25331.52,0,981.45,409000003308,13-Jan-17,RUPAY POS ACQ SETTL 29121,,975178.68,-545871326.10,Nolan,813,France,140454.14,0,1,0
3310,2011,10,RENT,1,Low,1,3200, 36 months,1,other,4,Low,1,Good Loan,0,11.71,B,2,17.1,3809.62187,3200,0,105.85,409000003309,13-Jan-17,RUPAY POS ACQ SETTL 30121,,991714.13,-544879611.97,Barry,523,France,59938.81,0,1,0
3311,2011,1,MORTGAGE,3,Low,1,12000, 36 months,1,home_improvement,7,Low,1,Good Loan,0,6.62,A,1,6.88,12967.13,12000,0,368.45,409000003310,13-Jan-17,RUPAY POS ACQ SETTL 31121,,900691.73,-543978920.24,Saunders,506,Spain,12016.79,0,1,0
3312,2011,10,MORTGAGE,3,Medium,2,20000, 36 months,1,small_business,3,Low,1,Good Loan,0,11.71,B,2,20,23286.32,20000,0,661.52,409000003311,16-Jan-17,TRF TO  Indiaforensic SERVICES I,"2,000,000.00",,-545978920.24,McMorran,513,Spain,81251.24,0,1,0
3313,2011,4,RENT,1,Low,1,5000, 36 months,1,other,4,Low,1,Good Loan,0,7.51,A,1,25.75,5615.367167,5000,0,155.56,409000003312,16-Jan-17,TRF TO  Indiaforensic SERVICES I,"2,000,000.00",,-547978920.24,Phelan,664,France,134169.85,0,1,0
3314,2011,0.5,RENT,1,Low,1,5500, 36 months,1,medical,9,Low,1,Good Loan,0,6.03,A,1,23.08,5887.08,5500,0,167.4,409000003313,16-Jan-17,RUPAY POS ACQ SETTL 14011,,1676324.07,-546302596.17,Fu,684,France,94888.60,0,1,0
3315,2011,3,RENT,1,Low,1,12000, 36 months,1,debt_consolidation,6,High,2,Good Loan,0,17.58,D,4,21.46,12840.28,12000,0,431.31,409000003314,16-Jan-17,RUPAY POS ACQ SETTL 15011,,736507.03,-545566089.14,Hotchin,608,Spain,175696.16,0,1,0
3316,2011,0.5,RENT,1,Low,1,7000, 36 months,1,moving,10,Low,1,Good Loan,0,8.9,A,1,7.28,7913.21,7000,0,222.28,409000003315,16-Jan-17,RUPAY POS ACQ SETTL 16011,,900361.70,-544665727.44,Aksyonov,527,France,96758.58,0,1,0
3317,2011,0.5,RENT,1,Low,1,2000, 60 months,2,debt_consolidation,6,High,2,Good Loan,0,18.64,E,5,7.89,2534.05,1480.82,0,51.49,409000003316,16-Jan-17,VISA POS ACQ SETTL 130117,,1315913.92,-543349813.52,Rossi,666,France,128019.48,0,1,0
3318,2011,10,MORTGAGE,3,Medium,2,35000, 60 months,2,debt_consolidation,6,High,2,Good Loan,0,20.89,F,6,12.11,46251.37,25599.39,0,944.71,409000003317,16-Jan-17,VISA POSINTACQSETT 130117,,59340.00,-543290473.52,Hughes,779,France,146895.36,0,1,0
3319,2011,10,RENT,1,Medium,2,35000, 60 months,2,debt_consolidation,6,High,2,Good Loan,0,22.74,G,7,14.49,44812.25,35000.01,0,981.45,409000003318,16-Jan-17,VISA POS ACQ SETTL 140117,,979280.37,-542311193.15,Duncan,629,France,139356.30,0,1,0
3320,2011,2,RENT,1,Low,1,30750, 36 months,1,home_improvement,7,High,2,Bad Loan,1,18.25,D,4,23.16,8716.7,4741.5,917.72,1115.55,409000003319,17-Jan-17,TRF TO  Indiaforensic SERVICES I,"5,500,000.00",,-547811193.15,McGarry,430,France,2923.61,0,1,0
3321,2011,4,MORTGAGE,3,Medium,2,12000, 60 months,2,car,2,Low,1,Good Loan,0,8.9,A,1,9.75,13469.27,12000,0,248.52,409000003320,17-Jan-17,RUPAY POS ACQ SETTL 17011,,1074721.24,-546736471.91,Aksenov,712,France,121232.51,0,1,0
3322,2011,5,RENT,1,Low,1,5325, 36 months,1,debt_consolidation,6,High,2,Good Loan,0,14.27,C,3,22.84,5841.85,5325,0,182.7,409000003321,18-Jan-17,VISA POS ACQ SETTL 160117,,1298911.12,-545437560.79,Akhtar,682,France,2053.42,0,1,0
3323,2011,5,MORTGAGE,3,Medium,2,6800, 36 months,1,car,2,Low,1,Good Loan,0,10.65,B,2,24.02,7776.48,6800,0,221.5,409000003322,18-Jan-17,VISA POSINTACQSETT 170117,,6923.00,-545430637.79,Pisani,634,France,6382.46,0,1,0
3324,2011,4,MORTGAGE,3,Low,1,8400, 60 months,2,debt_consolidation,6,High,2,Good Loan,0,15.96,C,3,21.32,9152.32,8400,0,204.1,409000003323,18-Jan-17,VISA POS ACQ SETTL 170117,,1237184.52,-544193453.27,Pisano,487,Spain,158750.13,0,1,0
3325,2011,4,RENT,1,Medium,2,13000, 36 months,1,debt_consolidation,6,Low,1,Good Loan,0,8.9,A,1,8.27,14859.0899,13000,0,412.8,409000003324,18-Jan-17,RUPAY POS ACQ SETTL 18011,,1386539.17,-542806914.10,McDaniels,808,Spain,74028.36,0,1,0
3326,2011,6,OWN,2,Low,1,1500, 36 months,1,home_improvement,7,Low,1,Good Loan,0,10.65,B,2,22.62,1664.88,1500,0,48.86,409000003325,19-Jan-17,TRF TO  Indiaforensic SERVICES I,"5,000,000.00",,-547806914.10,Tennant,527,France,44099.75,0,1,0
3327,2011,10,MORTGAGE,3,Low,1,30000, 60 months,2,house,12,Low,1,Good Loan,0,9.91,B,2,9.05,31166.52,23336.82,0,636.09,409000003326,19-Jan-17,VISA POSINTACQSETT 180117,,19780.00,-547787134.10,Donaghy,637,Germany,17323.00,0,1,0
3328,2011,3,MORTGAGE,3,Low,1,16950, 60 months,2,debt_consolidation,6,High,2,Bad Loan,1,13.49,C,3,20.8,10136.67,5960.31,0,389.93,409000003327,19-Jan-17,RUPAY POS ACQ SETTL 19011,,1220574.25,-546566559.85,Todd,802,Spain,175043.69,0,1,0
3329,2011,4,MORTGAGE,3,Low,1,6625, 36 months,1,debt_consolidation,6,High,2,Good Loan,0,18.25,D,4,21.83,8649.030654,6625,0,240.35,409000003328,20-Jan-17,RUPAY POS ACQ SETTL 20011,,1016261.94,-545550297.91,Tobenna,529,France,146388.85,0,1,0
3330,2011,1,RENT,1,Low,1,8000, 60 months,2,debt_consolidation,6,High,2,Bad Loan,1,19.91,E,5,21.5,9722.85,5372.89,0,211.56,409000003329,21-Jan-17,VISA POS ACQ SETTL 200117,,773403.22,-544776894.69,Vicars,850,France,2465.80,0,1,0
3331,2011,6.05,RENT,1,Low,1,10000, 36 months,1,debt_consolidation,6,Low,1,Good Loan,0,12.42,B,2,21.79,11151.45,10000,0,334.16,409000003330,21-Jan-17,VISA POS ACQ SETTL 190117,,1489313.09,-543287581.60,Chao,738,France,47799.15,0,1,0
3332,2011,5,RENT,1,Low,1,19000, 60 months,2,debt_consolidation,6,Low,1,Good Loan,0,12.69,B,2,20.84,22363.15,19000.01,0,429.3,409000003331,21-Jan-17,VISA POSINTACQSETT 190117,,2769.20,-543284812.40,Tien,817,France,165562.84,0,1,0
3333,2011,3,RENT,1,Low,1,5000, 36 months,1,small_business,3,Low,1,Good Loan,0,11.71,B,2,0.88,5232.37,5000,0,165.38,409000003332,21-Jan-17,TRF TO  Indiaforensic SERVICES I,"3,000,000.00",,-546284812.40,Hsing,735,France,72927.68,0,1,0
3334,2011,8,RENT,1,Low,1,35000, 60 months,2,debt_consolidation,6,High,2,Good Loan,0,19.91,E,5,20.45,38396.3,35000,0,925.54,409000003333,21-Jan-17,RUPAY POS ACQ SETTL 21011,,1560851.88,-544723960.52,Yang,619,Germany,38270.47,0,1,0
3335,2011,1,RENT,1,Low,1,29850, 36 months,1,debt_consolidation,6,High,2,Good Loan,0,18.25,D,4,8.36,33575.87,29850,0,1082.9,409000003334,23-Jan-17,RUPAY POS ACQ SETTL 22011,,671123.55,-544052836.97,Walker,671,France,120893.07,0,1,0
3336,2011,6,MORTGAGE,3,Low,1,10675, 36 months,1,debt_consolidation,6,Low,1,Good Loan,0,6.62,A,1,10.11,11718.15033,10675,0,327.77,409000003335,23-Jan-17,RUPAY POS ACQ SETTL 23011,,788545.91,-543264291.06,T'ang,581,Spain,188377.21,0,1,0
3337,2011,3,MORTGAGE,3,Low,1,6650, 60 months,2,debt_consolidation,6,High,2,Good Loan,0,18.25,D,4,17.12,8954.71,6650,0,169.78,409000003336,23-Jan-17,VISA POS ACQ SETTL 210117,,679701.11,-542584589.95,Chukwukere,690,Spain,55902.93,0,1,0
3338,2011,3,RENT,1,Low,1,12000, 36 months,1,debt_consolidation,6,Low,1,Good Loan,0,12.42,B,2,10.52,14424.25883,12000,0,400.99,409000003337,23-Jan-17,VISA POSINTACQSETT 210117,,1750.53,-542582839.42,Ch'iu,579,Spain,4523.74,0,1,0
3339,2011,3,MORTGAGE,3,Low,1,4150, 36 months,1,debt_consolidation,6,High,2,Good Loan,0,17.58,D,4,0.67,4328.15,4150,0,149.16,409000003338,24-Jan-17,VISA POS ACQ SETTL 230117,,633661.99,-541949177.43,Pai,688,Spain,102195.16,0,1,0
3340,2011,2,MORTGAGE,3,Low,1,13650, 36 months,1,other,4,High,2,Bad Loan,1,16.29,D,4,17.25,10692.6,7146.39,360.55,481.86,409000003339,24-Jan-17,TRF TO  Indiaforensic SERVICES I,"5,000,000.00",,-546949177.43,Franklin,599,Spain,60843.09,0,1,0
3341,2011,10,MORTGAGE,3,Medium,2,5000, 36 months,1,house,12,High,2,Good Loan,0,14.65,C,3,3.36,6207.032959,5000,0,172.48,409000003340,24-Jan-17,RUPAY POS ACQ SETTL 24011,,1027764.14,-545921413.29,Y?,729,Germany,25548.47,0,1,0
3342,2011,2,RENT,1,Low,1,15000, 36 months,1,debt_consolidation,6,Low,1,Bad Loan,1,11.71,B,2,17.56,15287.89,12083.13,421.63,496.14,409000003341,25-Jan-17,TRF TO  Indiaforensic ONLINE SER,"2,000,000.00",,-547921413.29,Peng,718,France,134462.29,0,1,0
3343,2011,4,RENT,1,Low,1,7200, 36 months,1,credit_card,1,Low,1,Bad Loan,1,10.65,B,2,16.83,7624.59,6275.38,128.27,234.53,409000003342,25-Jan-17,VISA POS ACQ SETTL 240117,,1296869.34,-546624543.95,Otitodilichukwu,712,Germany,132702.64,0,1,0
3344,2011,10,MORTGAGE,3,Low,1,24000, 36 months,1,credit_card,1,Low,1,Good Loan,0,8.9,A,1,13.85,27432.38613,24000,0,762.08,409000003343,27-Jan-17,RUPAY POS ACQ SETTL 25011,,837130.17,-545787413.78,Pagnotto,474,France,75698.44,0,1,0
3345,2011,2,MORTGAGE,3,Low,1,6400, 36 months,1,major_purchase,8,Low,1,Good Loan,0,10.65,B,2,11.64,6768.75,6400,0,208.47,409000003344,27-Jan-17,RUPAY POS ACQ SETTL 26011,,861195.95,-544926217.83,Vessels,565,Germany,105642.43,0,1,0
3346,2011,2,MORTGAGE,3,Low,1,8000, 36 months,1,other,4,High,2,Good Loan,0,17.27,D,4,8.87,10301.20283,8000,0,286.3,409000003345,27-Jan-17,RUPAY POS ACQ SETTL 27011,,678080.82,-544248137.01,Heller,658,France,102153.75,0,1,0
3347,2011,1,MORTGAGE,3,Low,1,10600, 60 months,2,car,2,High,2,Bad Loan,1,16.77,D,4,13.04,1917.93,703.99,354.75,262.13,409000003346,27-Jan-17,TRF TO  Indiaforensic SERVICES I,"1,500,000.00",,-545748137.01,Donaldson,714,France,166677.54,0,1,0
3348,2011,2,RENT,1,Low,1,7000, 36 months,1,wedding,5,High,2,Bad Loan,1,13.49,C,3,14.4,1076.24,479.53,367.13,237.52,409000003347,30-Jan-17,TRF TO  Indiaforensic SERVICES I,"2,000,000.00",,-547748137.01,Ifeanyichukwu,725,France,24218.65,0,1,0
3349,2011,2,MORTGAGE,3,Low,1,7500, 36 months,1,debt_consolidation,6,Low,1,Good Loan,0,7.9,A,1,15.77,8447.534594,7500,0,234.68,409000003348,30-Jan-17,VISA POS ACQ SETTL 260117,,602501.34,-547145635.67,Kao,825,France,117122.50,0,1,0
3350,2011,3,RENT,1,Low,1,6000, 36 months,1,wedding,5,Low,1,Good Loan,0,11.71,B,2,5.32,7139.955709,6000,0,198.46,409000003349,30-Jan-17,VISA POS ACQ SETTL 270117,,492487.62,-546653148.05,Dunn,665,Germany,51871.95,0,1,0
3351,2011,6,RENT,1,Low,1,10775, 36 months,1,debt_consolidation,6,Low,1,Good Loan,0,10.65,B,2,18.64,12633.21388,10775,0,350.98,409000003350,30-Jan-17,VISA POS ACQ SETTL 280117,,510701.12,-546142446.93,Calabresi,670,Spain,84321.03,0,1,0
3352,2011,0.5,RENT,1,Low,1,10000, 36 months,1,other,4,High,2,Good Loan,0,15.27,C,3,13,10491.05,10000,0,347.98,409000003351,30-Jan-17,RUPAY POS ACQ SETTL 28011,,808758.69,-545333688.24,Holland,474,Germany,160213.27,0,1,0
3353,2011,2,RENT,1,Low,1,2400, 36 months,1,debt_consolidation,6,Low,1,Good Loan,0,9.91,B,2,4.04,2782.995979,2400,0,77.34,409000003352,30-Jan-17,RUPAY POS ACQ SETTL 29011,,571987.24,-544761701.00,Calabresi,591,France,88695.19,0,1,0
3354,2011,0.5,RENT,1,Low,1,6600, 60 months,2,wedding,5,High,2,Good Loan,0,17.27,D,4,0.41,8065.34,4922.94,0,164.99,409000003353,30-Jan-17,RUPAY POS ACQ SETTL 30011,,750154.77,-544011546.23,Butusov,508,France,6123.15,0,1,0
3355,2011,10,MORTGAGE,3,Low,1,7500, 36 months,1,home_improvement,7,Low,1,Good Loan,0,8.9,A,1,21.41,8572.282622,7500,0,238.15,409000003354,31-Jan-17,TRF TO  Indiaforensic SERVICES I,"4,000,000.00",,-548011546.23,Atkinson,695,France,167749.54,0,1,0
3356,2011,0.5,RENT,1,Low,1,30000, 36 months,1,wedding,5,Low,1,Good Loan,0,6.62,A,1,8.37,33157.62329,30000,0,921.11,409000003355,31-Jan-17,VISA POS ACQ SETTL 300117,,591003.30,-547420542.93,Vasilyeva,660,Germany,71638.00,0,1,0
3357,2011,2,MORTGAGE,3,Medium,2,3200, 36 months,1,medical,9,High,2,Good Loan,0,16.29,D,4,9.82,3935.14,3200,0,112.97,409000003356,31-Jan-17,RUPAY POS ACQ SETTL 31011,,843245.01,-546577297.92,Mollison,687,Germany,198064.52,0,1,0
3358,2011,3,RENT,1,Low,1,8000, 36 months,1,wedding,5,High,2,Good Loan,0,14.27,C,3,15.94,9306.4,8000,0,274.48,409000003357,1-Feb-17,VISA POS ACQ SETTL 250117,,615584.61,-545961713.31,Webb,658,Germany,54914.92,0,1,0
3359,2011,6,RENT,1,Low,1,5000, 36 months,1,other,4,High,2,Bad Loan,1,18.25,D,4,15.82,1058.11,540.79,154.86,181.39,409000003358,1-Feb-17,VISA POS ACQ SETTL 310117,,1100667.85,-544861045.46,Obiajulu,705,Germany,190659.17,0,1,0
3360,2011,10,MORTGAGE,3,High,3,21000, 36 months,1,small_business,3,Low,1,Good Loan,0,12.69,B,2,8.87,25354.04165,21000,0,704.45,409000003359,1-Feb-17,RUPAY POS ACQ SETTL 01021,,775693.38,-544085352.08,Aiken,739,Spain,51637.67,0,1,0
3361,2011,10,MORTGAGE,3,Low,1,15000, 60 months,2,home_improvement,7,Low,1,Good Loan,0,12.69,B,2,4.62,16549.25,11462.89,0,338.93,409000003360,2-Feb-17,TRF TO  Indiaforensic SERVICES I,"4,000,000.00",,-548085352.08,Brabyn,844,France,119333.38,0,1,0
3362,2011,5,RENT,1,Low,1,13500, 60 months,2,debt_consolidation,6,Low,1,Good Loan,0,7.9,A,1,17.33,13338.21,10579.88,0,273.09,409000003361,2-Feb-17,RUPAY POS ACQ SETTL 02021,,453700.51,-547631651.57,Su,602,Germany,127095.14,0,1,0
3363,2011,10,OWN,2,Low,1,5000, 36 months,1,debt_consolidation,6,Low,1,Good Loan,0,7.9,A,1,12,5631.384652,5000,0,156.46,409000003362,2-Feb-17,VISA POS ACQ SETTL 010217,,645719.35,-546985932.22,Traeger,759,France,93541.14,0,1,0
3364,2011,4,MORTGAGE,3,Low,1,20000, 60 months,2,debt_consolidation,6,High,2,Good Loan,0,16.77,D,4,9.6,24156.18,14950.16,0,494.59,409000003363,3-Feb-17,VISA POS ACQ SETTL 020217,,528478.55,-546457453.67,Ekwueme,747,Germany,89289.54,0,1,0
3365,2011,7,RENT,1,Low,1,7500, 36 months,1,other,4,Low,1,Good Loan,0,6.62,A,1,12.54,7732.27,7500,0,230.28,409000003364,3-Feb-17,RUPAY POS ACQ SETTL 03021,,836219.81,-545621233.86,Thompson,673,France,108762.16,0,1,0
3366,2011,6.05,MORTGAGE,3,Low,1,14125, 36 months,1,debt_consolidation,6,High,2,Good Loan,0,13.49,C,3,24.78,17086.47406,14125,0,479.27,409000003365,4-Feb-17,TRF TO  Indiaforensic SERVICES I,"2,000,000.00",,-547621233.86,Chinwenma,671,Spain,28238.25,0,1,0
3367,2011,10,MORTGAGE,3,Medium,2,20000, 36 months,1,credit_card,1,Low,1,Good Loan,0,10.65,B,2,8.28,23449.64385,20000,0,651.47,409000003366,4-Feb-17,VISA POS ACQ SETTL 030217,,426223.73,-547195010.13,Tuan,640,Germany,34130.43,0,1,0
3368,2011,10,MORTGAGE,3,Low,1,25000, 60 months,2,debt_consolidation,6,Low,1,Good Loan,0,12.42,B,2,13.34,27487.07,19177.17,0,561.44,409000003367,4-Feb-17,RUPAY POS ACQ SETTL 04021,,580442.63,-546614567.50,Tsai,581,Germany,7926.35,0,1,0
3369,2011,8,RENT,1,Low,1,17325, 60 months,2,debt_consolidation,6,Low,1,Good Loan,0,12.69,B,2,29.44,21848.25817,17325,0,391.46,409000003368,6-Feb-17,RUPAY POS ACQ SETTL 05021,,589707.55,-546024859.95,Liu,630,France,27330.27,0,1,0
3370,2011,6.05,MORTGAGE,3,Low,1,14125, 60 months,2,debt_consolidation,6,High,2,Good Loan,0,18.25,D,4,6.87,15167.76,14125,0,360.61,409000003369,6-Feb-17,RUPAY POS ACQ SETTL 06021,,604435.18,-545420424.77,Robinson,703,France,79997.14,0,1,0
3371,2011,2,MORTGAGE,3,Low,1,7000, 36 months,1,small_business,3,Low,1,Good Loan,0,12.69,B,2,19.28,8446.883389,7000,0,234.82,409000003370,6-Feb-17,VISA POS ACQ SETTL 040217,,422384.23,-544998040.54,Carr,698,Spain,50213.81,0,1,0
3372,2011,3,MORTGAGE,3,Medium,2,14000, 60 months,2,house,12,Low,1,Good Loan,0,8.9,A,1,14.02,14138.75,10899.93,0,289.94,409000003371,7-Feb-17,RUPAY POS ACQ SETTL 07021,,747720.40,-544250320.14,Palerma,742,Germany,60920.03,0,1,0
3373,2011,8,MORTGAGE,3,Low,1,12250, 36 months,1,debt_consolidation,6,Low,1,Good Loan,0,6.03,A,1,11.94,13421.73253,12250,0,372.84,409000003372,7-Feb-17,VISA POS ACQ SETTL 060217,,974673.19,-543275646.95,Chineze,652,France,197699.80,0,1,0
3374,2011,10,MORTGAGE,3,Low,1,5200, 36 months,1,credit_card,1,Low,1,Good Loan,0,8.9,A,1,2.38,5959.732092,5200,0,165.12,409000003373,7-Feb-17,VIS POSINT ACQSETT 060217,,98000.00,-543177646.95,Fang,644,France,92809.73,0,1,0
3375,2011,9,MORTGAGE,3,Low,1,35000, 36 months,1,debt_consolidation,6,Low,1,Good Loan,0,7.9,A,1,19.11,38492.5,35000,0,1095.16,409000003374,7-Feb-17,TRF TO  Indiaforensic SERVICES I,"3,000,000.00",,-546177646.95,Simpson,735,Spain,163516.16,0,1,0
3376,2011,10,MORTGAGE,3,Low,1,7000, 36 months,1,debt_consolidation,6,High,2,Good Loan,0,13.49,C,3,12.88,8489.585463,7000,0,237.52,409000003375,8-Feb-17,VISA POS ACQ SETTL 070217,,620238.26,-545557408.69,Moretti,777,France,62449.07,0,1,0
3377,2011,7,MORTGAGE,3,Low,1,18225, 60 months,2,credit_card,1,High,2,Bad Loan,1,19.91,E,5,24.66,3012.74,927.25,605.19,481.94,409000003376,8-Feb-17,TRF TO  Indiaforensic SERVICES I,"2,700,000.00",,-548257408.69,Hale,644,Germany,115800.10,0,1,0
3378,2011,4,OWN,2,Low,1,12000, 60 months,2,debt_consolidation,6,High,2,Bad Loan,1,15.27,C,3,14.11,6283.19,3018.84,581.59,287.19,409000003377,8-Feb-17,RUPAY POS ACQ SETTL 08021,,720975.93,-547536432.76,Benson,665,Germany,110359.68,0,1,0
3379,2011,3,RENT,1,Low,1,10000, 36 months,1,credit_card,1,High,2,Good Loan,0,13.49,C,3,24.89,12210.72602,10000,0,339.31,409000003378,9-Feb-17,VISA POS ACQ SETTL 080217,,623200.47,-546913232.29,Estep,529,Germany,78695.68,0,1,0
3380,2011,5,MORTGAGE,3,Low,1,2000, 36 months,1,home_improvement,7,Low,1,Good Loan,0,7.51,A,1,20.68,2237.933505,2000,0,62.23,409000003379,9-Feb-17,RUPAY POS ACQ SETTL 09021,,665958.24,-546247274.05,Mishina,803,Spain,128378.04,0,1,0
3381,2011,0.5,RENT,1,High,3,17400, 60 months,2,debt_consolidation,6,High,2,Good Loan,0,22.35,F,6,17.64,25344.79751,17400,0,484.04,409000003380,10-Feb-17,VISA POS ACQ SETTL 090217,,800714.68,-545446559.37,Abramovich,604,Spain,155248.62,0,1,0
3382,2011,2,MORTGAGE,3,Low,1,6000, 36 months,1,major_purchase,8,Low,1,Good Loan,0,6.03,A,1,11.65,6369.87,6000,0,182.62,409000003381,10-Feb-17,RUPAY POS ACQ SETTL 10021,,798198.50,-544648360.87,Lavrentiev,738,France,123499.27,0,1,0
3383,2011,0.5,MORTGAGE,3,Low,1,5600, 36 months,1,small_business,3,Low,1,Good Loan,0,10.65,B,2,10.61,5880.23,5600,0,182.42,409000003382,10-Feb-17,TRF TO  Indiaforensic SERVICES I,"1,600,000.00",,-546248360.87,Alexeyeva,655,Germany,99920.41,0,1,0
3384,2011,4,MORTGAGE,3,Low,1,6000, 36 months,1,home_improvement,7,Low,1,Good Loan,0,9.91,B,2,14.95,6753.19,6000,0,193.35,409000003383,10-Feb-17,TRF TO  Indiaforensic SERVICES I,"1,200,000.00",,-547448360.87,T'ang,698,Germany,53289.49,0,1,0
3385,2011,10,RENT,1,Medium,2,32000, 60 months,2,debt_consolidation,6,High,2,Good Loan,0,22.74,G,7,5.44,41477.77,32000,0,897.33,409000003384,13-Feb-17,VISA POS ACQ SETTL 100217,,786724.96,-546661635.91,Kilgour,775,France,67622.34,0,1,0
3386,2011,2,RENT,1,Low,1,6000, 36 months,1,other,4,Low,1,Good Loan,0,7.51,A,1,15.6,6718.487444,6000,0,186.67,409000003385,13-Feb-17,RUPAY POS ACQ SETTL 11021,,738545.19,-545923090.72,Chin,735,France,11783.10,0,1,0
3387,2011,8,RENT,1,Low,1,6000, 36 months,1,debt_consolidation,6,Low,1,Good Loan,0,6.03,A,1,13.04,6589.686828,6000,0,182.62,409000003386,13-Feb-17,RUPAY POS ACQ SETTL 12021,,394212.02,-545528878.70,Fiorentini,766,Spain,62402.38,0,1,0
3388,2011,9,MORTGAGE,3,Medium,2,25000, 36 months,1,debt_consolidation,6,Low,1,Good Loan,0,7.9,A,1,13.59,25326.01,25000,0,782.26,409000003387,13-Feb-17,RUPAY POS ACQ SETTL 13021,,183054.08,-545345824.62,Lori,537,Germany,186235.98,0,1,0
3389,2011,10,MORTGAGE,3,Low,1,20000, 60 months,2,debt_consolidation,6,High,2,Bad Loan,1,17.58,D,4,22.31,8005.69,3217.83,961.31,503.32,409000003388,14-Feb-17,VISA POS ACQ SETTL 130217,,478467.56,-544867357.06,Marchesi,599,Germany,79005.95,0,1,0
3390,2011,4,MORTGAGE,3,Low,1,5000, 36 months,1,debt_consolidation,6,High,2,Good Loan,0,14.27,C,3,10.6,5335.96,5000,0,171.55,409000003389,14-Feb-17,TRF TO  Indiaforensic SERVICES I,"3,400,000.00",,-548267357.06,Sheppard,420,Spain,144870.28,0,1,0
3391,2011,6,MORTGAGE,3,Low,1,7000, 36 months,1,credit_card,1,High,2,Good Loan,0,14.65,C,3,13.47,8062.41,7000,0,241.46,409000003390,14-Feb-17,RUPAY POS ACQ SETTL 14021,,294331.23,-547973025.83,Nnanna,674,France,95481.00,0,1,0
3392,2011,1,RENT,1,Low,1,5000, 36 months,1,other,4,Low,1,Good Loan,0,10.65,B,2,1.89,5521.35,5000,0,162.87,409000003391,15-Feb-17,VISA POS ACQ SETTL 110217,,844652.11,-547128373.72,Norris,570,France,820.46,0,1,0
3393,2011,3,RENT,1,Low,1,15000, 36 months,1,debt_consolidation,6,Low,1,Bad Loan,1,10.65,B,2,19.08,14308.33,11492.78,484.54,488.6,409000003392,15-Feb-17,RUPAY POS ACQ SETTL 15021,,648182.82,-546480190.90,Vincent,623,Germany,174777.98,0,1,0
3394,2011,3,MORTGAGE,3,Low,1,27250, 36 months,1,credit_card,1,Low,1,Good Loan,0,8.9,A,1,23.41,31147.57524,27250,0,865.28,409000003393,15-Feb-17,TRF TO  Indiaforensic SERVICES I,"1,700,000.00",,-548180190.90,Bradley,710,France,8991.17,0,1,0
3395,2011,3,MORTGAGE,3,Low,1,12000, 36 months,1,debt_consolidation,6,Low,1,Good Loan,0,9.91,B,2,19.61,13919.29093,12000,0,386.7,409000003394,16-Feb-17,RUPAY POS ACQ SETTL 16021,,931992.66,-547248198.24,Bellucci,466,France,2797.27,0,1,0
3396,2011,10,MORTGAGE,3,Low,1,4000, 36 months,1,debt_consolidation,6,Low,1,Good Loan,0,6.62,A,1,1.13,4420.513239,4000,0,122.82,409000003395,17-Feb-17,VISA POS ACQ SETTL 140217,,382819.26,-546865378.98,Clements,759,France,22303.17,0,1,0
3397,2011,10,MORTGAGE,3,Low,1,24000, 60 months,2,debt_consolidation,6,Low,1,Bad Loan,1,12.69,B,2,6.2,10301.57,6006.42,0,542.28,409000003396,17-Feb-17,VISA POS ACQ SETTL 150217,,344613.97,-546520765.01,Knowles,581,France,197562.08,0,1,0
3398,2011,6,RENT,1,Medium,2,14400, 36 months,1,debt_consolidation,6,Low,1,Good Loan,0,12.69,B,2,12.74,17383.64646,14400,0,483.05,409000003397,17-Feb-17,VISA POS ACQ SETTL 160217,,469293.75,-546051471.26,Chidiebere,820,France,23067.97,0,1,0
3399,2011,3,RENT,1,Low,1,6550, 36 months,1,small_business,3,Low,1,Good Loan,0,7.9,A,1,7.65,7377.489535,6550,0,204.96,409000003398,17-Feb-17,RUPAY POS ACQ SETTL 17021,,756734.90,-545294736.36,Kelly,759,France,190294.12,0,1,0
3400,2011,10,MORTGAGE,3,Low,1,7000, 36 months,1,debt_consolidation,6,Low,1,Good Loan,0,11.71,B,2,6.12,8332.899621,7000,0,231.54,409000003399,18-Feb-17,TRF TO  Indiaforensic SERVICES I,"2,000,000.00",,-547294736.36,Okwukwe,628,France,113167.17,0,1,0
3401,2011,5,MORTGAGE,3,Medium,2,12000, 60 months,2,debt_consolidation,6,Low,1,Good Loan,0,9.91,B,2,16.53,12388.8,12000,0,254.44,409000003400,18-Feb-17,RUPAY POS ACQ SETTL 18021,,587677.56,-546707058.80,Onyemere,676,France,124777.14,0,1,0
3402,2011,3,RENT,1,Low,1,7500, 36 months,1,moving,10,Low,1,Good Loan,0,12.69,B,2,1.44,9011.846258,7500,0,251.59,409000003401,18-Feb-17,VISA POS ACQ SETTL 170217,,646339.68,-546060719.12,Murphy,591,France,124625.08,0,1,0
3403,2011,4,MORTGAGE,3,Low,1,6250, 36 months,1,other,4,High,2,Bad Loan,1,17.27,D,4,13.76,6688.64,4764.18,211.37,223.68,409000003402,20-Feb-17,VISA POS ACQ SETTL 180217,,605533.78,-545455185.34,Elliott,690,France,49599.27,0,1,0
3404,2011,3,RENT,1,Low,1,3000, 36 months,1,wedding,5,Low,1,Good Loan,0,6.62,A,1,20.04,3297.470956,3000,0,92.12,409000003403,20-Feb-17,VISA POS ACQ SETTL 180217,,0.98,-545455184.36,Loggia,624,France,151411.50,0,1,0
3405,2011,0.5,RENT,1,Low,1,2500, 36 months,1,debt_consolidation,6,Low,1,Good Loan,0,11.71,B,2,2.8,2976.088852,2500,0,82.69,409000003404,20-Feb-17,RUPAY POS ACQ SETTL 19021,,571340.82,-544883843.54,Walsh,573,France,122964.18,0,1,0
3406,2011,9,RENT,1,Low,1,3000, 36 months,1,debt_consolidation,6,Low,1,Good Loan,0,10.65,B,2,13.62,3026.9,3000,0,97.72,409000003405,20-Feb-17,RUPAY POS ACQ SETTL 20021,,424292.93,-544459550.61,Mahomed,694,France,57088.97,0,1,0
3407,2011,3,RENT,1,Low,1,6200, 60 months,2,debt_consolidation,6,Low,1,Good Loan,0,12.42,B,2,4.94,6813.85,4754.21,0,139.24,409000003406,21-Feb-17,VISA POS ACQ SETTL 200217,,868140.25,-543591410.36,Dolgorukova,632,Spain,7820.78,0,1,0
3408,2011,8,MORTGAGE,3,Low,1,4800, 36 months,1,home_improvement,7,Low,1,Bad Loan,1,8.9,A,1,10.03,3628.98,2776.61,280.36,152.42,409000003407,21-Feb-17,TRF TO  Indiaforensic SERVICES I,"3,800,000.00",,-547391410.36,Bogdanov,632,France,149188.41,0,1,0
3409,2011,0.5,RENT,1,Low,1,26000, 60 months,2,debt_consolidation,6,High,2,Bad Loan,1,21.28,F,6,18.76,4951.38,1819.11,0,707.49,409000003408,21-Feb-17,RUPAY POS ACQ SETTL 21021,,566805.62,-546824604.74,She,832,Germany,134638.97,0,1,0
3410,2011,2,RENT,1,Low,1,3700, 36 months,1,debt_consolidation,6,Low,1,Good Loan,0,6.03,A,1,5.89,3896.35,3700,0,112.62,409000003409,22-Feb-17,VISA POS ACQ SETTL 210217,,530437.92,-546294166.82,Cook,598,Germany,184980.23,0,1,0
3411,2011,10,RENT,1,Low,1,15000, 36 months,1,debt_consolidation,6,High,2,Good Loan,0,18.64,E,5,13.76,19610.77868,15000,0,547.12,409000003410,22-Feb-17,TRF TO  Indiaforensic SERVICES I,"1,900,000.00",,-548194166.82,Bruno,430,Germany,122373.42,0,1,0
3412,2011,10,MORTGAGE,3,Medium,2,12000, 36 months,1,small_business,3,Low,1,Good Loan,0,10.65,B,2,11.43,13918.2065,12000,0,390.88,409000003411,22-Feb-17,RUPAY POS ACQ SETTL 22021,,700200.76,-547493966.06,Moysey,711,France,80215.20,0,1,0
3413,2011,2,RENT,1,Low,1,1200, 36 months,1,small_business,3,Low,1,Good Loan,0,7.9,A,1,22.71,1349.143234,1200,0,37.55,409000003412,23-Feb-17,VISA POS ACQ SETTL 220217,,457178.09,-547036787.97,Beneventi,582,Germany,14081.64,0,1,0
3414,2011,0.5,MORTGAGE,3,Low,1,15000, 60 months,2,debt_consolidation,6,High,2,Bad Loan,1,16.77,D,4,22.08,10248.67,2077.68,5800.59,370.94,409000003413,23-Feb-17,VISA POS ACQ INT SET 2202,,98.90,-547036689.07,Ferri,605,France,199390.45,0,1,0
3415,2011,6,MORTGAGE,3,Low,1,6000, 60 months,2,debt_consolidation,6,High,2,Good Loan,0,14.65,C,3,20.02,6941.83,4549.7,0,141.64,409000003414,24-Feb-17,TRF TO  Indiaforensic SERVICES I,"1,200,000.00",,-548236689.07,Skinner,657,France,7667.48,0,1,0
3416,2011,5,RENT,1,Low,1,3000, 36 months,1,debt_consolidation,6,Low,1,Good Loan,0,11.71,B,2,7.98,3164.93,3000,0,99.23,409000003415,27-Feb-17,RUPAY POS ACQ SETTL 23021,,551744.02,-547684945.05,Angel,578,Spain,74965.61,0,1,0
3417,2011,0.5,RENT,1,Low,1,1600, 36 months,1,debt_consolidation,6,High,2,Good Loan,0,18.25,D,4,22.92,2087.992824,1600,0,58.05,409000003416,27-Feb-17,RUPAY POS ACQ SETTL 24021,,685875.92,-546999069.13,Toosey,532,France,30583.95,0,1,0
3418,2011,9,MORTGAGE,3,Low,1,6000, 36 months,1,other,4,Low,1,Good Loan,0,7.51,A,1,11,6686.455195,6000,0,186.67,409000003417,27-Feb-17,RUPAY POS ACQ SETTL 25021,,477278.52,-546521790.61,Chin,612,France,149682.78,0,1,0
3419,2011,10,MORTGAGE,3,Medium,2,20000, 60 months,2,debt_consolidation,6,High,2,Bad Loan,1,21.28,F,6,11.24,10198.37,3455.5,948.54,544.23,409000003418,27-Feb-17,RUPAY POS ACQ SETTL 26021,,641846.78,-545879943.83,Lung,792,France,92664.09,0,1,0
3420,2011,5,MORTGAGE,3,Low,1,25000, 60 months,2,debt_consolidation,6,High,2,Bad Loan,1,18.25,D,4,15.04,28076.88,14507.66,1968.3,638.25,409000003419,27-Feb-17,VISA POS ACQ SETTL 230217,,401161.13,-545478782.70,Mellor,674,France,138423.10,0,1,0
3421,2011,6.05,OWN,2,Low,1,6450, 60 months,2,debt_consolidation,6,High,2,Good Loan,0,18.64,E,5,23.17,8118.9,4774.96,0,166.05,409000003420,27-Feb-17,VISA POS ACQ SETTL 240217,,465561.38,-545013221.32,Hassall,680,France,3148.20,0,1,0
3422,2011,10,MORTGAGE,3,Medium,2,3000, 36 months,1,medical,9,High,2,Good Loan,0,17.58,D,4,12.58,3796.48,3000,0,107.83,409000003421,27-Feb-17,VISA POS ACQ SETTL 250217,,414776.10,-544598445.22,Richardson,593,France,197933.50,0,1,0
3423,2011,5,RENT,1,Low,1,6600, 36 months,1,debt_consolidation,6,Low,1,Good Loan,0,8.9,A,1,20.57,7543.349052,6600,0,209.58,409000003422,27-Feb-17,RUPAY POS ACQ SETTL 27021,,248644.16,-544349801.06,Poninski,679,Germany,37341.17,0,1,0
3424,2011,10,MORTGAGE,3,Medium,2,14400, 60 months,2,medical,9,High,2,Good Loan,0,19.91,E,5,21.53,15111.8,14400,0,380.8,409000003423,28-Feb-17,TRF TO  Indiaforensic SERVICES I,"3,900,000.00",,-548249801.06,Dore,493,Spain,79577.40,0,1,0
3425,2011,1,RENT,1,Low,1,5200, 36 months,1,debt_consolidation,6,High,2,Good Loan,0,15.96,C,3,11.72,6394.39,5200,0,182.72,409000003424,28-Feb-17,RUPAY POS ACQ SETTL 28021,,744979.89,-547504821.17,Bonham,688,Spain,197602.29,0,1,0
3426,2011,1,RENT,1,Low,1,7000, 36 months,1,medical,9,High,2,Good Loan,0,14.27,C,3,16.3,8642.936951,7000,0,240.17,409000003425,28-Feb-17,VISA POS ACQ SETTL 270217,,893285.97,-546611535.20,Ibezimako,769,Germany,87537.32,0,1,0
3427,2011,4,RENT,1,Low,1,12000, 36 months,1,debt_consolidation,6,Low,1,Good Loan,0,6.03,A,1,7.96,13163.14254,12000,0,365.23,409000003426,1-Mar-17,VISA POS ACQ SETTL 280217,,638087.13,-545973448.07,Hunter,581,Spain,41623.59,0,1,0
3428,2011,5,MORTGAGE,3,Low,1,20000, 60 months,2,credit_card,1,High,2,Bad Loan,1,21.28,F,6,17,5938.71,1831.49,1042.62,544.23,409000003427,1-Mar-17,RUPAY POS ACQ SETTL 01031,,541987.51,-545431460.56,Bold,465,France,168280.95,0,1,0
3429,2011,2,RENT,1,Low,1,12000, 60 months,2,car,2,Low,1,Good Loan,0,9.91,B,2,1.29,12466.48,9334.75,0,254.44,409000003428,2-Mar-17,TRF TO  Indiaforensic SERVICES I,"2,800,000.00",,-548231460.56,Wan,641,France,125986.18,0,1,0
3430,2011,10,MORTGAGE,3,Low,1,7200, 36 months,1,vacation,11,Low,1,Good Loan,0,6.03,A,1,21.92,7686.75,7200,0,219.14,409000003429,2-Mar-17,RUPAY POS ACQ SETTL 02031,,509322.60,-547722137.96,Bradley,731,Germany,548.52,0,1,0
3431,2011,4,RENT,1,Low,1,25000, 60 months,2,small_business,3,Low,1,Good Loan,0,12.69,B,2,20.88,27666.81,19139.82,0,564.87,409000003430,3-Mar-17,RUPAY POS ACQ SETTL 03031,,886148.90,-546835989.06,Tretyakova,625,France,96088.54,0,1,0
3432,2011,5,RENT,1,Low,1,15000, 36 months,1,debt_consolidation,6,High,2,Good Loan,0,13.49,C,3,15.55,18115.05741,15000,0,508.96,409000003431,4-Mar-17,VISA POS ACQ SETTL 020317,,546316.95,-546289672.11,Graham,468,France,107787.42,0,1,0
3433,2011,1,RENT,1,Low,1,14300, 60 months,2,debt_consolidation,6,High,2,Bad Loan,1,20.89,F,6,10.93,6174.47,2493.05,0,385.98,409000003432,4-Mar-17,VISA POS ACQ SETTL 030317,,460497.71,-545829174.40,Izmailov,790,France,20510.79,0,1,0
3434,2011,3,RENT,1,Low,1,10000, 36 months,1,debt_consolidation,6,Low,1,Good Loan,0,8.9,A,1,11.8,11429.78174,10000,0,317.54,409000003433,4-Mar-17,TRF TO  Indiaforensic SERVICES I,"1,000,000.00",,-546829174.40,Calabrese,587,Germany,192026.02,0,1,0
3435,2011,3,RENT,1,Low,1,6000, 36 months,1,credit_card,1,Low,1,Good Loan,0,9.91,B,2,11.61,6935.201514,6000,0,193.35,409000003434,4-Mar-17,RUPAY POS ACQ SETTL 04031,,532368.75,-546296805.65,Valentin,692,France,118188.15,0,1,0
3436,2011,5,MORTGAGE,3,Low,1,20000, 60 months,2,wedding,5,High,2,Bad Loan,1,20.3,E,5,8.4,4029.33,1215.25,0,533.23,409000003435,4-Mar-17,VISA POS ACQ SETTL 010317,,505766.00,-545791039.65,Osonduagwuike,676,Germany,189540.95,0,1,0
3437,2011,10,OWN,2,Low,1,15000, 36 months,1,wedding,5,Low,1,Good Loan,0,6.03,A,1,14.54,16217.4,15000,0,456.54,409000003436,6-Mar-17,RUPAY POS ACQ SETTL 05031,,706880.51,-545084159.14,Williamson,571,France,63736.17,0,1,0
3438,2011,1,MORTGAGE,3,Low,1,29000, 36 months,1,home_improvement,7,Low,1,Good Loan,0,7.51,A,1,5.03,31647.51,29000,0,902.22,409000003437,6-Mar-17,RUPAY POS ACQ SETTL 06031,,347284.15,-544736874.99,Pan,700,France,95740.37,0,1,0
3439,2011,5,MORTGAGE,3,Low,1,20800, 60 months,2,debt_consolidation,6,Low,1,Good Loan,0,10.65,B,2,14.66,25395.71792,20800,0,448.63,409000003438,6-Mar-17,VISA POS ACQ SETTL 040317,,864482.07,-543872392.92,Carpenter,445,France,127939.19,0,1,0
3440,2011,10,MORTGAGE,3,Low,1,10000, 36 months,1,debt_consolidation,6,High,2,Bad Loan,1,14.27,C,3,4.52,7230.46,4187.17,1410.17,343.09,409000003439,7-Mar-17,TRF TO  Indiaforensic SERVICES I,"4,400,000.00",,-548272392.92,McIver,746,France,193438.69,0,1,0
3441,2011,6.05,RENT,1,Low,1,3500, 60 months,2,car,2,Low,1,Good Loan,0,8.9,A,1,21.76,3532.3,2723.41,0,72.49,409000003440,7-Mar-17,VISA POS ACQ SETTL 060317,,1019115.64,-547253277.28,Trevisan,722,France,90655.94,0,1,0
3442,2011,6,RENT,1,Low,1,3600, 36 months,1,car,2,Low,1,Good Loan,0,12.42,B,2,9.2,4329.015126,3600,0,120.3,409000003441,7-Mar-17,RUPAY POS ACQ SETTL 07031,,372106.95,-546881170.33,Rozhkova,596,France,12067.39,0,1,0
3443,2011,5,RENT,1,Low,1,15000, 60 months,2,debt_consolidation,6,Low,1,Good Loan,0,12.42,B,2,12.97,18746.99469,15000,0,336.86,409000003442,8-Mar-17,TRF TO  Indiaforensic SERVICES I,"1,300,000.00",,-548181170.33,He,850,Germany,54191.38,0,1,0
3444,2011,3,RENT,1,Low,1,16000, 60 months,2,debt_consolidation,6,High,2,Good Loan,0,15.27,C,3,9.84,16404.64,16000,0,382.92,409000003443,8-Mar-17,RUPAY POS ACQ SETTL 08031,,1051890.49,-547129279.84,Moretti,597,Spain,58667.16,0,1,0
3445,2011,7,MORTGAGE,3,Medium,2,30000, 36 months,1,debt_consolidation,6,High,2,Good Loan,0,18.25,D,4,9.11,39152.40077,30000,0,1088.34,409000003444,8-Mar-17,VISA POS ACQ SETTL 070317,,431913.76,-546697366.08,Fishbourne,436,Spain,35687.43,0,1,0
3446,2011,2,RENT,1,Low,1,13575, 36 months,1,credit_card,1,Low,1,Bad Loan,1,11.71,B,2,7.68,8505.35,6187.85,433.61,449.01,409000003445,9-Mar-17,TRF TO  Indiaforensic SERVICES I,"1,500,000.00",,-548197366.08,Gibson,660,Germany,14288.93,0,1,0
3447,2011,4,OWN,2,Low,1,10000, 60 months,2,debt_consolidation,6,High,2,Good Loan,0,17.58,D,4,15.09,11124.59,10000,0,251.66,409000003446,9-Mar-17,RUPAY POS ACQ SETTL 09031,,665640.10,-547531725.98,Zikoranachidimma,649,France,247.36,0,1,0
3448,2011,5,RENT,1,Low,1,35000, 60 months,2,debt_consolidation,6,High,2,Good Loan,0,22.06,F,6,21.55,47454.29,25420.92,0,967.86,409000003447,9-Mar-17,VISA POS ACQ SETTL 080317,,521785.03,-547009940.95,Palmer,646,Germany,78111.84,0,1,0
3449,2011,2,OWN,2,Low,1,20000, 60 months,2,debt_consolidation,6,High,2,Good Loan,0,14.27,C,3,17.35,22887.68,15169.12,0,468.17,409000003448,9-Mar-17,VISA POS ACQINT SETTL 080,,1008.78,-547008932.17,Chukwueloka,560,Spain,79547.39,0,1,0
3450,2011,2,MORTGAGE,3,Medium,2,12500, 36 months,1,other,4,Low,1,Good Loan,0,6.03,A,1,6.33,13695.53172,12500,0,380.45,409000003449,10-Mar-17,TRF TO  Indiaforensic SERVICES I,"1,200,000.00",,-548208932.17,Real,710,Germany,193266.72,0,1,0
3451,2011,1,MORTGAGE,3,High,3,35000, 60 months,2,debt_consolidation,6,Low,1,Good Loan,0,12.42,B,2,6.78,38500.45,26859.31,0,786.01,409000003450,10-Mar-17,RUPAY POS ACQ SETTL 10031,,436849.81,-547772082.36,Chikelu,513,France,105028.46,0,1,0
3452,2011,10,RENT,1,Medium,2,5000, 36 months,1,other,4,High,2,Good Loan,0,19.03,E,5,22.61,6595.628046,5000,0,183.36,409000003451,14-Mar-17,VISA POS ACQ SETTL 090317,,584423.70,-547187658.66,Fiorentini,607,France,116106.52,0,1,0
3453,2011,5,RENT,1,Low,1,10000, 36 months,1,debt_consolidation,6,High,2,Good Loan,0,14.27,C,3,15.58,11154.93,10000,0,343.09,409000003452,14-Mar-17,VISA POS ACQINT SETTL 090,,104145.00,-547083513.66,Yefimova,757,France,53179.21,0,1,0
3454,2011,2,RENT,1,Low,1,3600, 36 months,1,other,4,High,2,Good Loan,0,16.77,D,4,21.01,4404.76,3600,0,127.94,409000003453,14-Mar-17,VISA POS ACQ SETTL 100317,,578571.66,-546504942.00,Ball,619,Germany,140947.05,0,1,0
3455,2011,0.5,RENT,1,Low,1,10000, 36 months,1,credit_card,1,High,2,Bad Loan,1,15.27,C,3,10,4890.35,2649.48,421.88,347.98,409000003454,14-Mar-17,VISA POS ACQ SETTL 130317,,1973288.12,-544531653.88,Ch'in,612,France,171837.06,0,1,0
3456,2011,10,MORTGAGE,3,Low,1,5200, 36 months,1,debt_consolidation,6,Low,1,Good Loan,0,12.69,B,2,20.97,6226.46904,5200,0,174.44,409000003455,14-Mar-17,RUPAY POS ACQ SETTL 11031,,972461.55,-543559192.33,Odell,842,France,123437.05,0,1,0
3457,2011,1,MORTGAGE,3,Low,1,18000, 60 months,2,debt_consolidation,6,High,2,Bad Loan,1,19.91,E,5,19.2,19982.4,10641.2,0,475.99,409000003456,14-Mar-17,RUPAY POS ACQ SETTL 12031,,724345.61,-542834846.72,Enemuo,713,France,197519.66,0,1,0
3458,2011,1,RENT,1,Low,1,9600, 36 months,1,credit_card,1,Low,1,Good Loan,0,7.9,A,1,16.13,10672.26,9600,0,300.39,409000003457,14-Mar-17,RUPAY POS ACQ SETTL 13031,,541276.50,-542293570.22,Hunter,657,Spain,183058.51,0,1,0
3459,2011,1,RENT,1,Low,1,15000, 60 months,2,debt_consolidation,6,High,2,Good Loan,0,17.27,D,4,21.62,18356.07,11186.37,0,374.97,409000003458,14-Mar-17,RUPAY POS ACQ SETTL 14031,,808448.65,-541485121.57,Nepean,770,France,22710.72,0,1,0
3460,2011,8,RENT,1,Low,1,12000, 36 months,1,debt_consolidation,6,Low,1,Good Loan,0,12.42,B,2,20.28,14433.38132,12000,0,400.99,409000003459,15-Mar-17,TRF TO  Indiaforensic SERVICES I,"6,700,000.00",,-548185121.57,Nwebube,773,France,69303.15,0,1,0
3461,2011,6.05,OWN,2,Low,1,9400, 60 months,2,home_improvement,7,Low,1,Good Loan,0,10.65,B,2,18.93,9883.16,7251.26,0,202.75,409000003460,15-Mar-17,RUPAY POS ACQ SETTL 15031,,664821.37,-547520300.20,Enticknap,470,Germany,63705.90,0,1,0
3462,2011,10,MORTGAGE,3,Low,1,12000, 60 months,2,wedding,5,High,2,Good Loan,0,13.49,C,3,8.43,15909.46912,12000,0,276.06,409000003461,16-Mar-17,VISA POS ACQ SETTL 150317,,888582.94,-546631717.26,Lu,781,Spain,116429.51,0,1,0
3463,2011,3,MORTGAGE,3,Low,1,6000, 36 months,1,other,4,Low,1,Good Loan,0,7.51,A,1,18.57,6718.702328,6000,0,186.67,409000003462,16-Mar-17,TRF TO  Indiaforensic SERVICES I,"1,600,000.00",,-548231717.26,Ugochukwu,428,France,58381.77,0,1,0
3464,2011,10,RENT,1,Low,1,10000, 36 months,1,debt_consolidation,6,Low,1,Good Loan,0,6.62,A,1,23.95,11052.90566,10000,0,307.04,409000003463,16-Mar-17,RUPAY POS ACQ SETTL 16031,,473863.41,-547757853.85,Mann,600,Germany,177378.66,0,1,0
3465,2011,3,OWN,2,Low,1,3000, 60 months,2,car,2,High,2,Good Loan,0,13.49,C,3,3.76,3253.49,3000,0,69.02,409000003464,17-Mar-17,RUPAY POS ACQ SETTL 17031,,459528.26,-547298325.59,Murphy,697,Spain,35450.53,0,1,0
3466,2011,10,MORTGAGE,3,Medium,2,29275, 60 months,2,home_improvement,7,High,2,Good Loan,0,21.67,F,6,4.35,43831.21395,29275,0,803.07,409000003465,17-Mar-17,VISA POS ACQ SETTL 160317,,515569.56,-546782756.03,Docherty,692,Germany,164621.43,0,1,0
3467,2011,3,MORTGAGE,3,Medium,2,35000, 60 months,2,debt_consolidation,6,Low,1,Bad Loan,1,12.42,B,2,10.3,34418.38,20855.22,2995.92,786.01,409000003466,18-Mar-17,VISA POS ACQINT SETTL 170,,791.20,-546781964.83,Adams,791,France,174435.48,0,1,0
3468,2011,5,MORTGAGE,3,Low,1,15600, 60 months,2,debt_consolidation,6,High,2,Bad Loan,1,19.03,E,5,5.88,17007.48,9270.5,68.72,404.94,409000003467,18-Mar-17,VISA POS ACQ SETTL 170317,,355908.81,-546426056.02,Hirst,538,Germany,94047.75,0,1,0
3469,2011,6.05,RENT,1,Low,1,10000, 36 months,1,other,4,Low,1,Good Loan,0,9.91,B,2,10.17,11544.32065,10000,0,322.25,409000003468,18-Mar-17,RUPAY POS ACQ SETTL 18031,,440598.34,-545985457.68,Horan,820,France,119087.25,0,1,0
3470,2011,10,MORTGAGE,3,Low,1,6000, 36 months,1,debt_consolidation,6,Low,1,Good Loan,0,9.91,B,2,10.9,6959.299904,6000,0,193.35,409000003469,20-Mar-17,TRF TO  Indiaforensic SERVICES I,"2,000,000.00",,-547985457.68,Cumbrae-Stewart,679,Spain,184800.27,0,1,0
3471,2011,5,OWN,2,Low,1,4725, 60 months,2,small_business,3,Low,1,Good Loan,0,12.42,B,2,25.66,5469.8,4725,0,106.12,409000003470,20-Mar-17,TRF TO  Indiaforensic SERVICES I,"150,000.00",,-548135457.68,Kinney,649,France,75035.48,0,1,0
3472,2011,6.05,RENT,1,Low,1,2000, 36 months,1,credit_card,1,Low,1,Good Loan,0,10.65,B,2,18.43,2359.719596,2000,0,65.15,409000003471,20-Mar-17,VISA POS ACQ SETTL 180317,,352681.32,-547782776.36,T'ang,632,France,62703.38,0,1,0
3473,2011,5,MORTGAGE,3,Low,1,5400, 36 months,1,debt_consolidation,6,Low,1,Good Loan,0,6.03,A,1,17.34,5639.86,5400,0,164.36,409000003472,20-Mar-17,RUPAY POS ACQ SETTL 19031,,276334.01,-547506442.35,Muir,594,France,190882.69,0,1,0
3474,2011,1,RENT,1,Low,1,16000, 60 months,2,medical,9,High,2,Bad Loan,1,18.25,D,4,12.89,7304.36,2950.83,749.1,408.48,409000003473,20-Mar-17,RUPAY POS ACQ SETTL 20031,,496300.18,-547010142.17,Toscano,682,France,91981.85,0,1,0
3475,2011,2,MORTGAGE,3,Low,1,2500, 36 months,1,house,12,Low,1,Good Loan,0,6.62,A,1,7.26,2727.700098,2500,0,76.76,409000003474,21-Mar-17,VISA POS ACQ SETTL 200317,,772317.78,-546237824.39,Wallace,720,Spain,91881.29,0,1,0
3476,2011,7,RENT,1,Low,1,24800, 60 months,2,small_business,3,High,2,Good Loan,0,14.27,C,3,3.89,28391.13,18816.33,0,580.53,409000003475,21-Mar-17,TRF TO  Indiaforensic SERVICES I,"2,000,000.00",,-548237824.39,Fraser,769,France,7118.02,0,1,0
3477,2011,9,MORTGAGE,3,Low,1,15000, 36 months,1,other,4,Low,1,Good Loan,0,7.9,A,1,9.95,16165.77,15000,0,469.36,409000003476,21-Mar-17,RUPAY POS ACQ SETTL 21031,,371865.10,-547865959.29,Iqbal,746,Spain,11710.40,0,1,0
3478,2011,3,MORTGAGE,3,Low,1,15750, 36 months,1,medical,9,Low,1,Good Loan,0,6.62,A,1,4.98,17234.85,15750,0,483.59,409000003477,22-Mar-17,TRF TO  Indiaforensic SERVICES I,"100,000.00",,-547965959.29,Nina,623,Spain,25904.12,0,1,0
3479,2011,6,OWN,2,Low,1,4800, 36 months,1,debt_consolidation,6,Low,1,Good Loan,0,8.9,A,1,6.74,5485.97813,4800,0,152.42,409000003478,22-Mar-17,VISA POS ACQ SETTL 210317,,1104495.98,-546861463.31,Chuang,537,France,86911.49,0,1,0
3480,2011,8,RENT,1,Low,1,16000, 36 months,1,debt_consolidation,6,Low,1,Good Loan,0,7.9,A,1,15.79,18017.73415,16000,0,500.65,409000003479,22-Mar-17,TRF TO  Indiaforensic SERVICES I,"1,400,000.00",,-548261463.31,Ch'ien,468,France,10958.18,0,1,0
3481,2011,10,MORTGAGE,3,Low,1,24000, 60 months,2,debt_consolidation,6,High,2,Good Loan,0,19.91,E,5,8.38,27799.63,24000,0,634.66,409000003480,22-Mar-17,RUPAY POS ACQ SETTL 22031,,681298.37,-547580164.94,Bruno,588,Germany,5790.90,0,1,0
3482,2011,2,RENT,1,Medium,2,15000, 36 months,1,house,12,Low,1,Good Loan,0,12.42,B,2,4.15,18041.77416,15000.01,0,501.23,409000003481,23-Mar-17,TRF TO  Indiaforensic SERVICES I,"100,000.00",,-547680164.94,Kennedy,729,Spain,42855.97,0,1,0
3483,2011,2,RENT,1,Low,1,28000, 36 months,1,debt_consolidation,6,Low,1,Good Loan,0,7.9,A,1,6.79,31504.42076,28000,0,876.13,409000003482,23-Mar-17,VISA POS ACQ SETTL 220317,,346439.95,-547333724.99,Lawrence,543,Spain,78915.68,0,1,0
3484,2011,3,OWN,2,Low,1,6000, 36 months,1,debt_consolidation,6,Low,1,Good Loan,0,7.9,A,1,5.84,6510.96,6000,0,187.75,409000003483,23-Mar-17,RUPAY POS ACQ SETTL 23031,,265925.86,-547067799.13,Mort,499,Spain,81409.00,0,1,0
3485,2011,6,RENT,1,Low,1,8000, 36 months,1,medical,9,Low,1,Good Loan,0,9.91,B,2,3.23,9279.17738,8000,0,257.8,409000003484,24-Mar-17,TRF TO  Indiaforensic SERVICES I,"1,200,000.00",,-548267799.13,Goliwe,784,Germany,179252.73,0,1,0
3486,2011,3,MORTGAGE,3,High,3,20000, 36 months,1,wedding,5,High,2,Good Loan,0,14.27,C,3,2.2,21776.07,20000,0,686.18,409000003485,24-Mar-17,VISA POS ACQ SETTL 230317,,472614.26,-547795184.87,Martinez,604,France,42171.13,0,1,0
3487,2011,10,MORTGAGE,3,Low,1,3000, 36 months,1,home_improvement,7,Low,1,Good Loan,0,8.9,A,1,16.38,3409.493709,3000,0,95.26,409000003486,24-Mar-17,RUPAY POS ACQ SETTL 24031,,639548.57,-547155636.30,Vasilyev,614,Spain,58965.04,0,1,0
3488,2011,10,MORTGAGE,3,Low,1,20000, 60 months,2,credit_card,1,High,2,Bad Loan,1,20.3,E,5,20.2,9164.11,1868.34,4388.62,533.23,409000003487,27-Mar-17,TRF TO  Indiaforensic SERVICES I,"1,100,000.00",,-548255636.30,Black,671,France,102681.32,0,1,0
3489,2011,3,RENT,1,Low,1,16000, 36 months,1,debt_consolidation,6,High,2,Good Loan,0,17.58,D,4,8.69,20695.30014,16000,0,575.08,409000003488,27-Mar-17,VISA POS ACQ SETTL 240317,,452707.79,-547802928.51,Napolitani,587,Spain,125553.52,0,1,0
3490,2011,6.05,RENT,1,Low,1,2000, 36 months,1,other,4,Low,1,Bad Loan,1,12.69,B,2,18.8,330.05,185.58,63.29,67.09,409000003489,27-Mar-17,VISA POS ACQ SETTL 250317,,928050.24,-546874878.27,Ch'en,593,Spain,53478.02,0,1,0
3491,2011,1,MORTGAGE,3,Low,1,10000, 36 months,1,small_business,3,Low,1,Good Loan,0,6.62,A,1,26.61,10574.13,10000,0,307.04,409000003490,27-Mar-17,RUPAY POS ACQ SETTL 25031,,591769.23,-546283109.04,Sagese,453,France,198376.02,0,1,0
3492,2011,10,MORTGAGE,3,Low,1,12000, 60 months,2,debt_consolidation,6,Low,1,Good Loan,0,12.69,B,2,14.43,12937.59,11999.99,0,271.14,409000003491,27-Mar-17,RUPAY POS ACQ SETTL 26031,,485981.32,-545797127.72,Fraser,570,Germany,105525.36,0,1,0
3493,2011,10,OWN,2,High,3,35000, 60 months,2,house,12,High,2,Good Loan,0,19.91,E,5,15.36,45341.2,25759.46,0,925.54,409000003492,27-Mar-17,RUPAY POS ACQ SETTL 27031,,209001.59,-545588126.13,Hughes,655,France,47349.00,0,1,0
3494,2011,3,MORTGAGE,3,High,3,35000, 36 months,1,small_business,3,Low,1,Good Loan,0,11.71,B,2,4.13,37777.17,35000,0,1157.66,409000003493,28-Mar-17,TRF TO  Indiaforensic SERVICES I,"2,600,000.00",,-548188126.13,Giles,632,Spain,178822.32,0,1,0
3495,2011,8,MORTGAGE,3,Low,1,25000, 60 months,2,debt_consolidation,6,High,2,Bad Loan,1,22.35,F,6,15.32,13908.18,5499.29,22.38,695.46,409000003494,29-Mar-17,VISA POS ACQ SETTL 270317,,783420.38,-547404705.75,Lacross,681,France,72127.83,0,1,0
3496,2011,5,RENT,1,Low,1,35000, 60 months,2,small_business,3,High,2,Bad Loan,1,20.3,E,5,9.15,16609.73,5758.76,1680.56,933.14,409000003495,29-Mar-17,VISA POS ACQ SETTL 280317,,522013.63,-546882692.12,Pisani,591,Germany,163504.33,0,1,0
3497,2011,3,MORTGAGE,3,Low,1,17100, 60 months,2,credit_card,1,High,2,Good Loan,0,14.27,C,3,15.03,19578.16,12969.17,0,400.29,409000003496,29-Mar-17,RUPAY POS ACQ SETTL 28031,,687313.74,-546195378.38,King,779,France,190623.02,0,1,0
3498,2011,1,RENT,1,Medium,2,20000, 60 months,2,credit_card,1,Low,1,Good Loan,0,11.71,B,2,16.4,25909.03964,20000,0,441.97,409000003497,29-Mar-17,RUPAY POS ACQ SETTL 29031,,323349.18,-545872029.20,Maughan,456,France,140758.07,0,1,0
3499,2011,5,MORTGAGE,3,Low,1,12000, 60 months,2,debt_consolidation,6,High,2,Good Loan,0,17.27,D,4,13.79,16715.49412,12000,0,299.98,409000003498,30-Mar-17,TRF TO  Indiaforensic SERVICES I,"2,400,000.00",,-548272029.20,Palerma,686,France,132374.41,0,1,0
3500,2011,2,MORTGAGE,3,Low,1,10000, 36 months,1,debt_consolidation,6,Low,1,Good Loan,0,6.03,A,1,8.88,10858.13,10000,0,304.36,409000003499,30-Mar-17,RUPAY POS ACQ SETTL 30031,,363801.94,-547908227.26,Tochukwu,617,France,53949.98,0,1,0
3501,2011,6,MORTGAGE,3,Low,1,20000, 60 months,2,home_improvement,7,Low,1,Good Loan,0,11.71,B,2,11.8,25781.85132,20000,0,441.97,409000003500,30-Mar-17,VISA POS ACQ SETTL 290317,,303873.36,-547604353.90,Slate,850,France,121982.73,0,1,0
3502,2011,4,RENT,1,Low,1,4500, 36 months,1,debt_consolidation,6,Low,1,Good Loan,0,11.71,B,2,6.35,5123.25,4500,0,148.85,409000003501,31-Mar-17,VISA POS ACQ SETTL 300317,,383034.93,-547221318.97,Ch'ang,646,Germany,136983.77,0,1,0
3503,2011,10,MORTGAGE,3,Low,1,3200, 36 months,1,debt_consolidation,6,Low,1,Good Loan,0,11.71,B,2,19.5,3808.06631,3200,0,105.85,409000003502,31-Mar-17,RUPAY POS ACQ SETTL 31031,,318855.10,-546902463.87,Romani,735,Germany,114371.33,0,1,0
3504,2011,9,RENT,1,Low,1,14000, 36 months,1,credit_card,1,Low,1,Good Loan,0,7.9,A,1,21.69,15768.96826,14000,0,438.07,409000003503,3-Apr-17,TRF TO  Indiaforensic SERVICES I,"200,000.00",,-547102463.87,Genovese,543,France,62389.35,0,1,0
3505,2011,3,MORTGAGE,3,Medium,2,21000, 60 months,2,debt_consolidation,6,High,2,Good Loan,0,21.67,F,6,11.86,32138.27102,21000,0,576.07,409000003504,3-Apr-17,TRF TO  Indiaforensic VIRTUAL VI,"1,000,000.00",,-548102463.87,Chiebuka,490,France,24435.77,0,1,0
3506,2011,1,RENT,1,Low,1,20000, 36 months,1,debt_consolidation,6,Low,1,Good Loan,0,11.71,B,2,14.52,23808.60932,20000,0,661.52,409000003505,3-Apr-17,VISA POSDOM ACQ SETTL 010,,443085.11,-547659378.76,Liao,640,France,10908.33,0,1,0
3507,2011,10,OWN,2,High,3,20000, 60 months,2,debt_consolidation,6,High,2,Good Loan,0,13.49,C,3,9.07,25032.3,20000,0,460.1,409000003506,3-Apr-17,VISA POSINT ACQ SETTL 010,,148.35,-547659230.41,Berry,445,Spain,90977.48,0,1,0
3508,2011,4,MORTGAGE,3,Low,1,10800, 36 months,1,debt_consolidation,6,Low,1,Good Loan,0,12.42,B,2,11.41,12827.63311,10800,0,360.89,409000003507,3-Apr-17,VISA POSDOM ACQ SETTL 310,,339445.51,-547319784.90,Fallaci,761,France,81062.93,0,1,0
3509,2011,3,RENT,1,Low,1,15875, 60 months,2,small_business,3,High,2,Bad Loan,1,17.58,D,4,22.74,5967.85,2359.06,775.65,399.51,409000003508,3-Apr-17,RUPAY POS ACQ SETTL 01041,,353732.93,-546966051.97,T'an,426,France,61230.83,0,1,0
3510,2011,5,RENT,1,Medium,2,14500, 36 months,1,debt_consolidation,6,Low,1,Good Loan,0,7.9,A,1,4.8,14867.97,14500,0,453.71,409000003509,3-Apr-17,RUPAY POS ACQ SETTL 02041,,390931.06,-546575120.91,Wilkinson,777,France,126837.72,0,1,0
3511,2011,4,MORTGAGE,3,Low,1,15000, 36 months,1,debt_consolidation,6,Low,1,Good Loan,0,11.71,B,2,18.84,17858.89292,15000,0,496.14,409000003510,3-Apr-17,RUPAY POS ACQ SETTL 03041,,366029.19,-546209091.72,Palerma,534,France,115668.53,0,1,0
3512,2011,10,MORTGAGE,3,Low,1,15000, 36 months,1,small_business,3,High,2,Good Loan,0,14.27,C,3,11.11,18259.30544,15000,0,514.64,409000003511,4-Apr-17,TRF TO  Indiaforensic SERVICES I,"2,000,000.00",,-548209091.72,Lazarev,777,France,38819.45,0,1,0
3513,2011,10,RENT,1,Low,1,16000, 60 months,2,credit_card,1,Low,1,Good Loan,0,12.69,B,2,20.16,21479.95,16000,0,361.52,409000003512,5-Apr-17,VISA POSDOM ACQ SETTL 030,,753816.39,-547455275.33,Boylan,806,Spain,86994.54,0,1,0
3514,2011,7,MORTGAGE,3,Low,1,12000, 36 months,1,debt_consolidation,6,Low,1,Good Loan,0,9.91,B,2,14.15,13643.63,12000,0,386.7,409000003513,5-Apr-17,VISA POSINT ACQ SETTL 030,,1288.31,-547453987.02,Warren,790,France,195204.99,0,1,0
3515,2011,5,MORTGAGE,3,Medium,2,4000, 36 months,1,other,4,Low,1,Good Loan,0,6.62,A,1,21.08,4182.27,4000,0,122.82,409000003514,5-Apr-17,VISA POSDOM ACQ SETTL 040,,401166.85,-547052820.17,Trevisani,643,Spain,131301.74,0,1,0
3516,2011,10,RENT,1,Low,1,28000, 60 months,2,debt_consolidation,6,High,2,Good Loan,0,20.3,E,5,12.76,36546.69,20550.19,0,746.52,409000003515,5-Apr-17,RUPAY POS ACQ SETTL 04041,,386903.38,-546665916.79,Trevisano,584,Spain,100835.19,0,1,0
3517,2011,7,MORTGAGE,3,Low,1,3500, 36 months,1,major_purchase,8,Low,1,Good Loan,0,6.03,A,1,4.96,3834.627027,3500,0,106.53,409000003516,5-Apr-17,TRF TO  Indiaforensic SERVICES I,"1,600,000.00",,-548265916.79,Liao,638,France,198969.78,0,1,0
3518,2011,0.5,RENT,1,Low,1,12000, 36 months,1,debt_consolidation,6,Low,1,Good Loan,0,6.62,A,1,13.99,13261.44212,12000,0,368.45,409000003517,5-Apr-17,RUPAY POS ACQ SETTL 05041,,529937.53,-547735979.26,Burgess,771,Spain,41542.95,0,1,0
3519,2011,4,RENT,1,Low,1,6800, 36 months,1,major_purchase,8,Low,1,Good Loan,0,9.91,B,2,2.99,7706.03,6800,0,219.13,409000003518,6-Apr-17,VISA POSINT ACQ SETTL 050,,613.03,-547735366.23,Liston,600,France,118272.07,0,1,0
3520,2011,10,MORTGAGE,3,Medium,2,35000, 60 months,2,small_business,3,High,2,Good Loan,0,19.42,E,5,11.15,44864.68,25827.58,0,916.03,409000003519,6-Apr-17,VISA POSDOM ACQ SETTL 050,,410334.42,-547325031.81,Thompson,661,Spain,69586.27,0,1,0
3521,2011,4,MORTGAGE,3,Low,1,10925, 36 months,1,debt_consolidation,6,Low,1,Good Loan,0,12.69,B,2,20.96,13054.18957,10925,0,366.48,409000003520,6-Apr-17,RUPAY POS ACQ SETTL 06041,,478958.67,-546846073.14,Milanesi,554,France,149629.13,0,1,0
3522,2011,10,MORTGAGE,3,Low,1,8650, 36 months,1,other,4,Low,1,Good Loan,0,8.9,A,1,23.26,9887.489966,8650,0,274.67,409000003521,6-Apr-17,TRF TO  Indiaforensic SERVICES I,"1,000,000.00",,-547846073.14,Mazure,627,Spain,146680.25,0,1,0
3523,2011,5,RENT,1,Low,1,3500, 36 months,1,medical,9,Low,1,Good Loan,0,8.9,A,1,9.17,3938.25,3500,0,111.14,409000003522,7-Apr-17,VISA POSINT ACQ SETTL 060,,6778.75,-547839294.39,Rudduck,659,France,132809.18,0,1,0
3524,2011,7,MORTGAGE,3,Low,1,35000, 36 months,1,debt_consolidation,6,Low,1,Good Loan,0,10.65,B,2,17.41,41033.67597,35000,0,1140.07,409000003523,7-Apr-17,VISA POSDOM ACQ SETTL 060,,503138.10,-547336156.29,Darwin,835,France,28707.69,0,1,0
3525,2011,6,MORTGAGE,3,Medium,2,15000, 60 months,2,major_purchase,8,Low,1,Good Loan,0,10.65,B,2,4.43,17737.69382,15000,0,323.53,409000003524,7-Apr-17,TRF TO  Indiaforensic VIRTUAL VI,"900,000.00",,-548236156.29,Uvarova,763,France,104706.29,0,1,0
3526,2011,3,OWN,2,Low,1,4950, 36 months,1,debt_consolidation,6,Low,1,Good Loan,0,7.9,A,1,15.36,5560.286726,4950,0,154.89,409000003525,7-Apr-17,RUPAY POS ACQ SETTL 07041,"7,481.25",,-548243637.54,Buccho,625,Germany,75335.68,0,1,0
3527,2011,10,RENT,1,Low,1,10000, 36 months,1,small_business,3,High,2,Bad Loan,1,14.27,C,3,11.43,5186.35,3313.39,384.03,343.09,409000003526,10-Apr-17,VISA POSDOM ACQ SETTL 070,,522650.87,-547720986.67,Gallo,799,France,136827.96,0,1,0
3528,2011,4,RENT,1,Low,1,10000, 36 months,1,debt_consolidation,6,Low,1,Good Loan,0,7.9,A,1,19.42,10426.4,10000,0,312.91,409000003527,10-Apr-17,VISA POSDOM ACQ SETTL 080,,580691.12,-547140295.55,Tomlinson,849,France,139065.94,0,1,0
3529,2011,6,RENT,1,Low,1,4800, 36 months,1,other,4,Low,1,Good Loan,0,12.69,B,2,4.22,5789.469928,4800,0,161.02,409000003528,10-Apr-17,TRF TO  Indiaforensic SERVICES I,"1,100,000.00",,-548240295.55,Carr,692,France,70179.91,0,1,0
3530,2011,10,MORTGAGE,3,Low,1,3200, 36 months,1,debt_consolidation,6,High,2,Good Loan,0,13.49,C,3,15.26,3904.960816,3200,0,108.58,409000003529,10-Apr-17,RUPAY POS ACQ SETTL 08041,,583895.68,-547656399.87,Ts'ui,623,France,116160.04,0,1,0
3531,2011,3,MORTGAGE,3,Low,1,10575, 60 months,2,debt_consolidation,6,Low,1,Good Loan,0,11.71,B,2,22.81,11434.34,8138.43,0,233.69,409000003530,10-Apr-17,RUPAY POS ACQ SETTL 09041,,650255.55,-547006144.32,Coates,453,Spain,83008.49,0,1,0
3532,2011,5,MORTGAGE,3,Low,1,3000, 36 months,1,house,12,Low,1,Good Loan,0,9.91,B,2,14.17,3072.71,3000,0,96.68,409000003531,10-Apr-17,RUPAY POS ACQ SETTL 10041,,616110.72,-546390033.60,Hickey,408,France,188484.52,0,1,0
3533,2011,3,RENT,1,Low,1,2850, 36 months,1,debt_consolidation,6,High,2,Good Loan,0,15.27,C,3,18.75,3055.98,2850,0,99.18,409000003532,11-Apr-17,VISA POSDOM ACQ SETTL 100,,1330562.29,-545059471.31,Norton,778,Germany,133699.82,0,1,0
3534,2011,10,MORTGAGE,3,Medium,2,6000, 36 months,1,vacation,11,High,2,Good Loan,0,14.27,C,3,16.47,7407.119539,6000,0,205.86,409000003533,11-Apr-17,RUPAY POS ACQ SETTL 11041,,683119.14,-544376352.17,Mancini,695,France,72172.13,0,1,0
3535,2011,10,MORTGAGE,3,Low,1,2500, 36 months,1,debt_consolidation,6,Low,1,Good Loan,0,11.71,B,2,17.3,2974.970054,2500,0,82.69,409000003534,12-Apr-17,TRF TO  Indiaforensic SERVICES I,"3,800,000.00",,-548176352.17,Tien,677,Germany,191057.76,0,1,0
3536,2011,3,MORTGAGE,3,Medium,2,15000, 36 months,1,credit_card,1,High,2,Good Loan,0,16.77,D,4,1.38,18023.07,15000,0,533.08,409000003535,12-Apr-17,VISA POSDOM ACQ SETTL 110,,1021127.44,-547155224.73,Stobie,662,Spain,48233.75,0,1,0
3537,2011,10,RENT,1,Low,1,12500, 60 months,2,debt_consolidation,6,High,2,Good Loan,0,17.58,D,4,14.44,14709.41,12500,0,314.57,409000003536,12-Apr-17,RUPAY POS ACQ SETTL 12041,,755377.88,-546399846.85,Drakeford,534,France,79178.31,0,1,0
3538,2011,10,RENT,1,Low,1,14000, 36 months,1,credit_card,1,Low,1,Good Loan,0,7.9,A,1,19.63,15099.02,14000,0,438.07,409000003537,13-Apr-17,TRF TO  Indiaforensic SERVICES I,"1,800,000.00",,-548199846.85,Pisani,602,France,162347.05,0,1,0
3539,2011,1,RENT,1,Low,1,3700, 36 months,1,debt_consolidation,6,High,2,Good Loan,0,15.96,C,3,14.34,4407.66,3700,0,130.01,409000003538,13-Apr-17,RUPAY POS ACQ SETTL 13041,,881965.60,-547317881.25,Murphy,554,Germany,7611.61,0,1,0
3540,2011,0.5,RENT,1,Low,1,3000, 36 months,1,moving,10,Low,1,Good Loan,0,7.9,A,1,4.33,3101.46,3000,0,93.88,409000003539,15-Apr-17,VISA POSDOM ACQ SETTL 140,,784827.40,-546533053.85,Kovalev,667,France,88890.05,0,1,0
3541,2011,8,MORTGAGE,3,Low,1,1800, 36 months,1,debt_consolidation,6,High,2,Good Loan,0,14.65,C,3,16.15,2234.77613,1800,0,62.09,409000003540,15-Apr-17,RUPAY POS ACQ SETTL 14041,,867524.29,-545665529.56,Crawford,672,France,63833.09,0,1,0
3542,2011,0.5,RENT,1,Low,1,5000, 36 months,1,debt_consolidation,6,Low,1,Good Loan,0,8.9,A,1,8.16,5611.6,5000,0,158.77,409000003541,15-Apr-17,RUPAY POS ACQ SETTL 15041,,491323.50,-545174206.06,Maclean,838,Spain,78310.04,0,1,0
3543,2011,2,RENT,1,Low,1,13600, 36 months,1,debt_consolidation,6,Low,1,Good Loan,0,7.9,A,1,10.42,15260.38563,13600,0,425.55,409000003542,15-Apr-17,MAS  POSDOM ACQ SETTL 140,,66712.38,-545107493.68,Blackburn,692,Spain,37898.91,0,1,0
3544,2011,10,MORTGAGE,3,Low,1,32875, 60 months,2,debt_consolidation,6,High,2,Good Loan,0,19.42,E,5,23.73,41968.74,32874.99,0,860.42,409000003543,17-Apr-17,VISA POSDOM ACQ SETTL 120,,699257.74,-544408235.94,Bermudez,675,France,179521.24,0,1,0
3545,2011,3,RENT,1,Low,1,10000, 36 months,1,debt_consolidation,6,Low,1,Good Loan,0,12.42,B,2,2.37,12027.48134,10000,0,334.16,409000003544,17-Apr-17,VISA POSINT ACQ SETTL 120,"2,959.50",,-544411195.44,Savage,731,Spain,130726.96,0,1,0
3546,2011,3,RENT,1,Low,1,20000, 60 months,2,debt_consolidation,6,High,2,Good Loan,0,13.49,C,3,19.66,23944.3,19999.99,0,460.1,409000003545,17-Apr-17,VISA POSDOM ACQ SETTL 130,,612461.58,-543798733.86,Wyatt,468,France,198714.29,0,1,0
3547,2011,2,MORTGAGE,3,Low,1,21100, 36 months,1,debt_consolidation,6,Low,1,Good Loan,0,8.9,A,1,19.2,22932.82,21100,0,670,409000003546,17-Apr-17,VISA POSDOM ACQ SETTL 150,,775329.42,-543023404.44,Chiemenam,542,Spain,89543.25,0,1,0
3548,2011,2,RENT,1,Low,1,12000, 36 months,1,debt_consolidation,6,Low,1,Good Loan,0,10.65,B,2,15.29,14069.51733,12000,0,390.88,409000003547,17-Apr-17,TRF TO  Indiaforensic SERVICES I,"3,100,000.00",,-546123404.44,Shao,662,Spain,2423.90,0,1,0
3549,2011,6,MORTGAGE,3,Medium,2,20000, 60 months,2,debt_consolidation,6,Low,1,Good Loan,0,10.65,B,2,20.92,24845.07442,20000,0,431.37,409000003548,17-Apr-17,RUPAY POS ACQ SETTL 16041,,857949.62,-545265454.82,Langdon,770,Germany,180326.83,0,1,0
3550,2011,8,OWN,2,Low,1,10000, 36 months,1,debt_consolidation,6,Low,1,Good Loan,0,6.62,A,1,12.3,10309.65,10000,0,307.04,409000003549,17-Apr-17,RUPAY POS ACQ SETTL 17041,,586125.23,-544679329.59,Napolitano,675,France,166305.16,0,1,0
3551,2011,3,MORTGAGE,3,Medium,2,24000, 60 months,2,small_business,3,High,2,Good Loan,0,17.27,D,4,6.6,33119.72119,24000,0,599.96,409000003550,18-Apr-17,VISA POSDOM ACQ SETTL 170,,1584756.82,-543094572.77,Kung,647,Germany,29883.63,0,1,0
3552,2011,10,RENT,1,Low,1,15000, 36 months,1,debt_consolidation,6,Low,1,Good Loan,0,6.03,A,1,6.6,15220.78,15000,0,456.54,409000003551,18-Apr-17,VISA POSINT ACQ SETTL 170,,1313.60,-543093259.17,Blackwood,604,France,192029.19,0,1,0
3553,2011,3,RENT,1,Low,1,5000, 36 months,1,debt_consolidation,6,High,2,Good Loan,0,13.49,C,3,15.19,6105.728305,5000,0,169.66,409000003552,18-Apr-17,MAESTRO POSDOM ACQ SETTL1,,2461.28,-543090797.89,Marcelo,833,France,1710.89,0,1,0
3554,2011,6,RENT,1,Low,1,8000, 36 months,1,debt_consolidation,6,High,2,Bad Loan,1,16.77,D,4,19.89,5676.4,3942.25,0,284.31,409000003553,18-Apr-17,MASTER POSDOM ACQ SETTL15,,725.35,-543090072.54,Yin,741,Spain,135163.76,0,1,0
3555,2011,10,MORTGAGE,3,Low,1,16000, 36 months,1,home_improvement,7,Low,1,Good Loan,0,6.03,A,1,17.11,17168.49,16000,0,486.97,409000003554,18-Apr-17,MASTER POSDOM ACQ SETTL17,,202850.17,-542887222.37,Storey,658,Spain,84927.42,0,1,0
3556,2011,10,RENT,1,Low,1,21000, 36 months,1,home_improvement,7,Low,1,Good Loan,0,7.9,A,1,10.15,23653.16122,21000,0,657.1,409000003555,18-Apr-17,MAESTRO POSDOM ACQ SETTL1,,11371.50,-542875850.87,Fomin,528,France,149912.28,0,1,0
3557,2011,10,MORTGAGE,3,High,3,4000, 36 months,1,debt_consolidation,6,Low,1,Good Loan,0,10.65,B,2,13.63,4169.04,4000,0,130.3,409000003556,18-Apr-17,MAESTRO POSDOM ACQ SETTL1,,14393.10,-542861457.77,Nkemjika,590,France,88206.04,0,1,0
3558,2011,10,MORTGAGE,3,Medium,2,4400, 36 months,1,credit_card,1,Low,1,Good Loan,0,11.71,B,2,18.07,4750.02,4400,0,145.54,409000003557,18-Apr-17,TRF TO  Indiaforensic SERVICES I,"3,400,000.00",,-546261457.77,Glasgow,675,France,163667.56,0,1,0
3559,2011,0.5,RENT,1,Low,1,12000, 60 months,2,debt_consolidation,6,High,2,Bad Loan,1,13.49,C,3,20.88,11556.39,6417.13,1368.36,276.06,409000003558,18-Apr-17,TRF TO  Indiaforensic SERVICES I,"2,000,000.00",,-548261457.77,Chen,765,France,100153.43,0,1,0
3560,2011,0.5,MORTGAGE,3,Low,1,15000, 36 months,1,wedding,5,Low,1,Good Loan,0,6.03,A,1,0.96,16353.33764,15000,0,456.54,409000003559,18-Apr-17,RUPAY POS ACQ SETTL 18041,,627593.81,-547633863.96,Ch'ang,650,France,32275.09,0,1,0
3561,2011,0.5,RENT,1,Low,1,7000, 36 months,1,debt_consolidation,6,High,2,Good Loan,0,14.65,C,3,11.28,8684.013862,7000,0,241.46,409000003560,19-Apr-17,MASTER POSDOM ACQ SETTL18,,77287.86,-547556576.10,Evans,817,France,65501.91,0,1,0
3562,2011,9,RENT,1,Low,1,4000, 60 months,2,car,2,High,2,Good Loan,0,15.27,C,3,7.13,4672.14,3012.98,0,95.73,409000003561,19-Apr-17,MAESTRO POSDOM ACQ SETTL1,,9009.70,-547547566.40,Crotty,699,Germany,189392.66,0,1,0
3563,2011,8,MORTGAGE,3,Low,1,7750, 36 months,1,credit_card,1,Low,1,Good Loan,0,12.69,B,2,13.94,8603.23,7750,0,259.98,409000003562,19-Apr-17,VISA POSDOM ACQ SETTL 180,,643699.84,-546903866.56,Cocci,495,Germany,116069.24,0,1,0
3564,2011,6,MORTGAGE,3,Low,1,11500, 36 months,1,debt_consolidation,6,Low,1,Good Loan,0,8.9,A,1,18.52,12971.51,11500,0,365.17,409000003563,19-Apr-17,TRF TO  Indiaforensic SERVICES I,"1,300,000.00",,-548203866.56,Iroawuchi,491,Spain,139861.53,0,1,0
3565,2011,10,MORTGAGE,3,Low,1,22750, 60 months,2,debt_consolidation,6,High,2,Good Loan,0,17.58,D,4,16.93,31889.19132,22750,0,572.52,409000003564,19-Apr-17,RUPAY POS ACQ SETTL 19041,,722769.57,-547481096.99,Chia,847,France,144184.06,0,1,0
3566,2011,0.5,RENT,1,Low,1,18000, 36 months,1,credit_card,1,Low,1,Good Loan,0,11.71,B,2,14.19,21428.57188,18000,0,595.37,409000003565,20-Apr-17,VISA POSDOM ACQ SETTL 190,,706828.99,-546774268.00,Hysell,676,Spain,157888.50,0,1,0
3567,2011,7,MORTGAGE,3,Low,1,12000, 60 months,2,debt_consolidation,6,Low,1,Good Loan,0,12.42,B,2,16.2,14175.51,12000,0,269.49,409000003566,20-Apr-17,MASTER POSDOM ACQ SETTL19,,121971.15,-546652296.85,Williamson,746,Spain,71911.30,0,1,0
3568,2011,1,RENT,1,Low,1,15000, 36 months,1,debt_consolidation,6,High,2,Good Loan,0,15.27,C,3,10.36,18782.98968,15000,0,521.97,409000003567,20-Apr-17,TRF TO  Indiaforensic SERVICES I,"1,600,000.00",,-548252296.85,Ginikanwa,470,Spain,45033.75,0,1,0
3569,2011,1,RENT,1,High,3,35000, 60 months,2,debt_consolidation,6,High,2,Good Loan,0,19.91,E,5,3.85,48356.61,35000,0,925.54,409000003568,20-Apr-17,RUPAY POS ACQ SETTL 20041,,666365.51,-547585931.34,Chigolum,714,Spain,150465.93,0,1,0
3570,2011,10,MORTGAGE,3,Low,1,25000, 60 months,2,debt_consolidation,6,Low,1,Good Loan,0,11.71,B,2,13.42,29255.92,25000,0,552.46,409000003569,21-Apr-17,VISA POSDOM ACQ SETTL 200,,376386.03,-547209545.31,Morley,695,France,126381.60,0,1,0
3571,2011,3,RENT,1,Low,1,22000, 36 months,1,debt_consolidation,6,Low,1,Good Loan,0,11.71,B,2,13.26,26297.79346,22000,0,727.68,409000003570,21-Apr-17,MASTER POSDOM ACQ SETTL20,,103348.81,-547106196.50,Roberts,674,France,90189.72,0,1,0
3572,2011,4,RENT,1,Low,1,25600, 60 months,2,debt_consolidation,6,High,2,Good Loan,0,14.27,C,3,26.51,32820.42757,25600,0,599.26,409000003571,21-Apr-17,MAESTRO POSDOM ACQ SETTL2,,19679.20,-547086517.30,Tokareva,664,Germany,122433.09,0,1,0
3573,2011,4,MORTGAGE,3,Low,1,9000, 36 months,1,debt_consolidation,6,Low,1,Good Loan,0,6.62,A,1,11.8,9914.313599,9000,0,276.34,409000003572,21-Apr-17,TRF TO  Indiaforensic SERVICES I,"1,100,000.00",,-548186517.30,Fleming,697,Germany,123825.83,0,1,0
3574,2011,2,MORTGAGE,3,Low,1,9500, 36 months,1,debt_consolidation,6,Low,1,Good Loan,0,11.71,B,2,22.63,10023.05,9500,0,314.23,409000003573,24-Apr-17,VISA POSDOM ACQ SETTL 210,,488152.23,-547698365.07,Chinomso,670,France,11426.70,0,1,0
3575,2011,3,RENT,1,Low,1,11200, 36 months,1,debt_consolidation,6,Low,1,Good Loan,0,11.71,B,2,10.24,13375.37534,11200,0,370.46,409000003574,24-Apr-17,VISA POSDOM ACQ SETTL 220,,506767.04,-547191598.03,Compton,541,France,114951.42,0,1,0
3576,2011,1,MORTGAGE,3,Low,1,16000, 60 months,2,debt_consolidation,6,High,2,Good Loan,0,19.42,E,5,6.2,23550.23687,16000,0,418.76,409000003575,24-Apr-17,RUPAY POS ACQ SETTL 21041,,611920.87,-546579677.16,Wan,640,France,184636.05,0,1,0
3577,2011,6,RENT,1,Low,1,4000, 36 months,1,credit_card,1,Low,1,Good Loan,0,7.9,A,1,4.96,4520.311154,4000,0,125.17,409000003576,24-Apr-17,RUPAY POS ACQ SETTL 22041,,580790.24,-545998886.92,Taylor,647,France,91055.27,0,1,0
3578,2011,3,RENT,1,Low,1,8000, 36 months,1,debt_consolidation,6,High,2,Good Loan,0,19.42,E,5,18.56,10704.05102,8000,0,294.95,409000003577,24-Apr-17,RUPAY POS ACQ SETTL 23041,,872400.28,-545126486.64,Kambinachi,757,France,93991.65,0,1,0
3579,2011,10,MORTGAGE,3,Low,1,14000, 60 months,2,debt_consolidation,6,High,2,Bad Loan,1,13.49,C,3,14.43,12979.01,3252.56,7204.43,322.07,409000003578,24-Apr-17,RUPAY POS ACQ SETTL 24041,,494217.63,-544632269.01,Chang,704,Germany,116511.12,0,1,0
3580,2011,5,MORTGAGE,3,Medium,2,6000, 36 months,1,other,4,High,2,Good Loan,0,14.27,C,3,18.47,6980.55,6000,0,205.86,409000003579,24-Apr-17,TRF TO  Indiaforensic SERVICES I,"1,000,000.00",,-545632269.01,See,778,Germany,190631.23,0,1,0
3581,2011,10,MORTGAGE,3,Medium,2,16000, 36 months,1,debt_consolidation,6,High,2,Good Loan,0,16.77,D,4,21.03,19006.54,16000,0,568.62,409000003580,25-Apr-17,VISA POSDOM ACQ SETTL 240,,1023276.80,-544608992.21,Dyer,639,Germany,199970.74,0,1,0
3582,2011,10,MORTGAGE,3,Low,1,21000, 60 months,2,small_business,3,Low,1,Good Loan,0,12.69,B,2,13.92,23216.47,16076.9,0,474.49,409000003581,25-Apr-17,MASTER POSDOM ACQ SETTL21,,119036.84,-544489955.37,Campbell,637,France,139947.17,0,1,0
3583,2011,1,RENT,1,Low,1,10000, 36 months,1,credit_card,1,Low,1,Good Loan,0,9.91,B,2,20.88,11109.85,10000,0,322.25,409000003582,25-Apr-17,MAESTRO POSDOM ACQ SETTL2,,3430.00,-544486525.37,Cremonesi,686,France,8816.37,0,1,0
3584,2011,3,MORTGAGE,3,Low,1,12000, 36 months,1,credit_card,1,Low,1,Good Loan,0,10.65,B,2,16.98,14068.13733,12000,0,390.88,409000003583,25-Apr-17,MASTER POSDOM ACQ SETTL22,,130570.66,-544355954.71,Harris,577,Spain,135650.72,0,1,0
3585,2011,0.5,RENT,1,Low,1,17200, 36 months,1,credit_card,1,High,2,Good Loan,0,14.27,C,3,12.8,18534.76,17200,0,590.12,409000003584,25-Apr-17,TRF TO  Indiaforensic SERVICES I,"2,600,000.00",,-546955954.71,Threatt,506,Germany,24577.34,0,1,0
3586,2011,10,MORTGAGE,3,Low,1,12000, 36 months,1,home_improvement,7,High,2,Good Loan,0,14.65,C,3,15.14,14334,12000,0,413.94,409000003585,25-Apr-17,MASTER POSDOM ACQ SETTL24,,345765.55,-546610189.16,Lane,757,France,131249.46,0,1,0
3587,2011,10,MORTGAGE,3,Low,1,18250, 60 months,2,debt_consolidation,6,High,2,Bad Loan,1,13.49,C,3,20.03,7134.86,3982.02,0,419.84,409000003586,25-Apr-17,MAESTRO POSDOM ACQ SETTL2,,18460.40,-546591728.76,Grave,826,France,140126.17,0,1,0
3588,2011,0.5,RENT,1,Low,1,3000, 36 months,1,other,4,Low,1,Good Loan,0,12.42,B,2,24.5,3638.134902,3000,0,100.25,409000003587,25-Apr-17,MAESTRO POSINT ACQ SETTL2,"6,485.76",,-546598214.52,Stanley,721,France,168219.75,0,1,0
3589,2011,3,MORTGAGE,3,Low,1,6700, 36 months,1,credit_card,1,Low,1,Good Loan,0,8.9,A,1,21.41,7657.89508,6700,0,212.75,409000003588,25-Apr-17,RUPAY POS ACQ SETTL 25041,,549237.57,-546048976.95,McIntosh,489,Spain,171867.08,0,1,0
3590,2011,10,MORTGAGE,3,Low,1,10000, 36 months,1,other,4,Low,1,Good Loan,0,6.62,A,1,5.85,10710.92,10000,0,307.04,409000003589,26-Apr-17,TRF TO  Indiaforensic SERVICES I,"500,000.00",,-546548976.95,Watts,446,France,70613.52,0,1,0
3591,2011,0.5,MORTGAGE,3,Low,1,23500, 36 months,1,debt_consolidation,6,High,2,Good Loan,0,13.49,C,3,12.2,27812.99,23500,0,797.37,409000003590,26-Apr-17,MAESTRO POSINT ACQ RVSL24,,6485.76,-546542491.19,Alekseyeva,677,France,117946.30,0,1,0
3592,2011,10,MORTGAGE,3,Low,1,3000, 36 months,1,home_improvement,7,Low,1,Good Loan,0,12.69,B,2,18.23,3620.288528,3000,0,100.64,409000003591,26-Apr-17,MAESTRO POSDOM ACQ SETTL2,,6475.50,-546536015.69,Davies,769,France,84872.66,0,1,0
3593,2011,3,MORTGAGE,3,Medium,2,35000, 60 months,2,debt_consolidation,6,High,2,Good Loan,0,19.42,E,5,11.23,53951.73991,35000,0,916.03,409000003592,26-Apr-17,TRF TO  Indiaforensic SERVICES I,"1,700,000.00",,-548236015.69,Matlock,677,Spain,60590.72,0,1,0
3594,2011,4,MORTGAGE,3,Medium,2,25000, 36 months,1,home_improvement,7,Low,1,Good Loan,0,7.9,A,1,0.02,28157.93359,25000,0,782.26,409000003593,26-Apr-17,RUPAY POS ACQ SETTL 26041,,688267.59,-547547748.10,Fedorova,555,Germany,8444.50,0,1,0
3595,2011,2,RENT,1,Medium,2,11050, 36 months,1,debt_consolidation,6,Low,1,Good Loan,0,12.69,B,2,8.88,13169.40169,11050,0,370.68,409000003594,26-Apr-17,VISA POSDOM ACQ SETTL 250,,631772.77,-546915975.33,Chiedozie,652,Germany,159132.83,0,1,0
3596,2011,10,OWN,2,Low,1,11200, 36 months,1,credit_card,1,High,2,Good Loan,0,14.27,C,3,19.38,12391.75,11200,0,384.26,409000003595,27-Apr-17,VISA POSDOM ACQ SETTL 260,,455854.37,-546460120.96,Marcelo,722,Germany,76998.69,0,1,0
3597,2011,10,MORTGAGE,3,Low,1,3000, 36 months,1,other,4,High,2,Good Loan,0,19.91,E,5,5.89,3367.57,3000,0,111.36,409000003596,27-Apr-17,VISA POSINT ACQ SETTL 260,,19690.00,-546440430.96,Cooper,643,France,55835.66,0,1,0
3598,2011,6,RENT,1,Low,1,8000, 36 months,1,car,2,Low,1,Good Loan,0,7.9,A,1,7.41,9010.694596,8000,0,250.33,409000003597,27-Apr-17,MASTER POSDOM ACQ SETTL25,,195804.19,-546244626.77,McMillan,796,Germany,177524.19,0,1,0
3599,2011,5,RENT,1,Low,1,12000, 60 months,2,debt_consolidation,6,High,2,Good Loan,0,14.27,C,3,22.85,13728.31,9101.27,0,280.91,409000003598,27-Apr-17,MAESTRO POSDOM ACQ SETTL2,,21940.70,-546222686.07,Hardy,720,Germany,45985.52,0,1,0
3600,2011,10,MORTGAGE,3,Medium,2,8000, 36 months,1,wedding,5,High,2,Good Loan,0,14.27,C,3,10.8,9878.490759,8000,0,274.48,409000003599,27-Apr-17,MASTER POSDOM ACQ SETTL26,,103943.39,-546118742.68,Madukwe,613,France,60297.72,0,1,0
3601,2011,2,MORTGAGE,3,Low,1,8000, 36 months,1,debt_consolidation,6,Low,1,Bad Loan,1,12.69,B,2,23.13,2771.77,1722.79,360.4,268.36,409000003600,27-Apr-17,MAESTRO POSDOM ACQ SETTL2,,22395.90,-546096346.78,Adamson,506,France,194421.12,0,1,0
3602,2011,3,RENT,1,Low,1,6000, 36 months,1,other,4,Low,1,Good Loan,0,6.62,A,1,18.45,6630.844534,6000,0,184.23,409000003601,27-Apr-17,TRF TO  Indiaforensic SERVICES I,"2,100,000.00",,-548196346.78,Watt,608,France,93568.77,0,1,0
3603,2011,2,RENT,1,Low,1,8500, 36 months,1,credit_card,1,High,2,Good Loan,0,14.27,C,3,12.53,10496.02728,8500,0,291.63,409000003602,27-Apr-17,RUPAY POS ACQ SETTL 27041,,691638.58,-547504708.20,Mazzanti,667,Spain,34702.92,0,1,0
3604,2011,1,MORTGAGE,3,Medium,2,14000, 36 months,1,credit_card,1,Low,1,Good Loan,0,7.9,A,1,23.11,15751.53521,14000,0,438.07,409000003603,28-Apr-17,VISA POSDOM ACQ SETTL 270,,489271.39,-547015436.81,Mishin,750,France,54473.60,0,1,0
3605,2011,3,MORTGAGE,3,Low,1,18000, 36 months,1,debt_consolidation,6,Low,1,Good Loan,0,7.9,A,1,10.17,20274.08151,18000,0,563.23,409000003604,28-Apr-17,MASTER POSDOM ACQ SETTL27,,139713.84,-546875722.97,Feng,610,France,113943.17,0,1,0
3606,2011,1,MORTGAGE,3,Low,1,3650, 36 months,1,other,4,Low,1,Good Loan,0,9.91,B,2,6.39,4233.201516,3650,0,117.63,409000003605,28-Apr-17,MAESTRO POSDOM ACQ SETTL2,,6506.21,-546869216.76,Kang,588,Germany,153727.32,0,1,0
3607,2011,0.5,MORTGAGE,3,Low,1,22575, 60 months,2,small_business,3,High,2,Bad Loan,1,20.89,F,6,2.41,8529.18,3390,15.08,609.34,409000003606,28-Apr-17,RUPAY POS ACQ SETTL 28041,,702993.38,-546166223.38,Kelly,479,France,19116.97,0,1,0
3608,2011,10,MORTGAGE,3,Medium,2,35000, 60 months,2,major_purchase,8,High,2,Good Loan,0,15.96,C,3,14.61,46120.46053,35000,0,850.39,409000003607,28-Apr-17,TRF TO  Indiaforensic SERVICES I,"1,400,000.00",,-547566223.38,Yu,682,France,112554.68,0,1,0
3609,2011,10,RENT,1,Low,1,16000, 60 months,2,debt_consolidation,6,High,2,Good Loan,0,19.03,E,5,8.4,18583.03,16000,0,415.32,409000003608,29-Apr-17,VISA POSDOM ACQ SETTL 280,,371656.61,-547194566.77,Bull,677,France,47318.75,0,1,0
3610,2011,6.05,RENT,1,Low,1,2400, 36 months,1,credit_card,1,Low,1,Good Loan,0,9.91,B,2,8.12,2724.269339,2400,0,77.34,409000003609,29-Apr-17,MASTER POSDOM ACQ SETTL28,,180337.82,-547014228.95,Serra,850,Germany,36690.49,0,1,0
3611,2011,10,MORTGAGE,3,Medium,2,20000, 60 months,2,small_business,3,High,2,Good Loan,0,14.27,C,3,8.46,22888.01,15171.18,0,468.17,409000003610,29-Apr-17,MAESTRO POSDOM ACQ SETTL2,,7117.54,-547007111.41,Ferguson,580,France,106918.67,0,1,0
3612,2011,3,RENT,1,Low,1,8000, 36 months,1,debt_consolidation,6,High,2,Good Loan,0,14.27,C,3,9.68,9673.21,8000,0,274.48,409000003611,29-Apr-17,RUPAY POS ACQ SETTL 29041,,701820.68,-546305290.73,She,746,France,194563.65,0,1,0
3613,2011,5,MORTGAGE,3,Low,1,24000, 60 months,2,small_business,3,Low,1,Good Loan,0,12.69,B,2,17.8,26521.49,18367.34,0,542.28,409000003612,2-May-17,MASTER POSDOM ACQ SETTL29,,152793.79,-546152496.94,Hamilton,635,Spain,91086.73,0,1,0
3614,2011,4,RENT,1,Low,1,35000, 60 months,2,debt_consolidation,6,Low,1,Good Loan,0,11.71,B,2,22.61,44995.65105,35000,0,773.44,409000003613,2-May-17,MAESTRO POSDOM ACQ SETTL2,,7866.22,-546144630.72,Nnanna,664,Germany,108008.65,0,1,0
3615,2011,10,OWN,2,Low,1,17000, 60 months,2,debt_consolidation,6,High,2,Good Loan,0,18.64,E,5,19.2,25825.35995,17000,0,437.63,409000003614,2-May-17,MASTER POSDOM ACQ SETTL01,,284180.85,-545860449.87,Summerville,558,Germany,172363.52,0,1,0
3616,2011,10,MORTGAGE,3,Low,1,12500, 36 months,1,other,4,High,2,Good Loan,0,19.03,E,5,17.82,15699.75,12500,0,458.39,409000003615,2-May-17,MAESTRO POSDOM ACQ SETTL0,,38434.50,-545822015.37,Allan,415,France,178587.36,0,1,0
3617,2011,6.05,RENT,1,Low,1,12000, 60 months,2,debt_consolidation,6,High,2,Bad Loan,1,18.25,D,4,10.4,7657.7,3716.47,0,306.36,409000003616,2-May-17,TRF TO  Indiaforensic SERVICES I,"1,900,000.00",,-547722015.37,Tobenna,798,France,31907.44,0,1,0
3618,2011,6.05,RENT,1,Low,1,6400, 36 months,1,wedding,5,Low,1,Good Loan,0,8.9,A,1,18.45,7314.804626,6400,0,203.23,409000003617,2-May-17,VISA POSDOM ACQ SETTL 290,,489582.02,-547232433.35,Volkova,792,Germany,18922.18,0,1,0
3619,2011,1,RENT,1,Low,1,2400, 36 months,1,debt_consolidation,6,High,2,Good Loan,0,14.65,C,3,2.71,2926.28,2400,0,82.79,409000003618,2-May-17,VISA POSDOM ACQ SETTL 010,,870957.34,-546361476.01,Nucci,489,Germany,147222.95,0,1,0
3620,2011,6,MORTGAGE,3,Medium,2,5000, 36 months,1,debt_consolidation,6,Low,1,Good Loan,0,8.9,A,1,20.86,5714.596188,5000,0,158.77,409000003619,2-May-17,RUPAY POS ACQ SETTL 30041,,641241.66,-545720234.35,Wright,730,France,1474.79,0,1,0
3621,2011,3,RENT,1,Medium,2,20000, 36 months,1,debt_consolidation,6,Low,1,Good Loan,0,12.42,B,2,11.5,22708.45,20000,0,668.31,409000003620,2-May-17,RUPAY POS ACQ SETTL 01051,,585663.75,-545134570.60,Astorga,773,France,24924.92,0,1,0
3622,2011,10,RENT,1,Low,1,6000, 36 months,1,credit_card,1,Low,1,Good Loan,0,9.91,B,2,16.43,6980.006353,6000,0,193.35,409000003621,2-May-17,RUPAY POS ACQ SETTL 02051,,605579.02,-544528991.58,Pokrovsky,711,France,46884.10,0,1,0
3623,2011,4,RENT,1,Low,1,11500, 36 months,1,debt_consolidation,6,Low,1,Good Loan,0,12.42,B,2,16.56,13791.95024,11500,0,384.28,409000003622,3-May-17,VISA POSDOM ACQ SETTL 020,,550919.87,-543978071.71,Mazzanti,592,Spain,128918.42,0,1,0
3624,2011,3,RENT,1,Low,1,25000, 36 months,1,debt_consolidation,6,Low,1,Good Loan,0,9.91,B,2,15.38,27805.73,25000,0,805.63,409000003623,3-May-17,VISA POSINT ACQ SETTL 020,,1524.37,-543976547.34,Blesing,695,Germany,105291.26,0,1,0
3625,2011,10,RENT,1,Low,1,5300, 36 months,1,debt_consolidation,6,High,2,Good Loan,0,14.65,C,3,24.88,6440.78,5300,0,182.82,409000003624,3-May-17,MASTER POSDOM ACQ SETTL02,,208683.34,-543767864.00,Ku,640,France,145381.65,0,1,0
3626,2011,5,RENT,1,Low,1,6400, 60 months,2,major_purchase,8,High,2,Bad Loan,1,18.25,D,4,9.05,366.75,0,366.75,163.39,409000003625,3-May-17,MAESTRO POSDOM ACQ SETTL0,,24667.28,-543743196.72,Pisani,470,Spain,103792.53,0,1,0
3627,2011,5,RENT,1,Low,1,16000, 60 months,2,debt_consolidation,6,High,2,Good Loan,0,15.27,C,3,22.94,16204.53,16000,0,382.92,409000003626,3-May-17,TRF TO  Indiaforensic SERVICES I,"3,700,000.00",,-547443196.72,Hsueh,789,Germany,71121.04,0,1,0
3628,2011,5,MORTGAGE,3,Low,1,20375, 60 months,2,debt_consolidation,6,High,2,Good Loan,0,17.27,D,4,21.52,24891.28,20375,0,509.34,409000003627,3-May-17,RUPAY POS ACQ SETTL 03051,,743843.92,-546699352.80,Ricci,604,Spain,52327.57,0,1,0
3629,2011,2,MORTGAGE,3,Low,1,15000, 36 months,1,credit_card,1,High,2,Good Loan,0,14.65,C,3,13.07,18624.33616,15000,0,517.42,409000003628,4-May-17,MASTER POSDOM ACQ SETTL03,,227976.16,-546471376.64,Azubuike,493,Germany,197428.64,0,1,0
3630,2011,1,RENT,1,High,3,30000, 60 months,2,debt_consolidation,6,High,2,Good Loan,0,22.35,F,6,7.26,40864.92,21744.91,0,834.55,409000003629,4-May-17,MAESTRO POSDOM ACQ SETTL0,,41711.40,-546429665.24,Nevzorova,671,France,83210.84,0,1,0
3631,2011,2,MORTGAGE,3,Low,1,21600, 36 months,1,debt_consolidation,6,Low,1,Good Loan,0,7.51,A,1,7.87,23682.32,21600.01,0,672,409000003630,4-May-17,TRF TO  Indiaforensic SERVICES I,"1,800,000.00",,-548229665.24,Odili,656,France,193099.43,0,1,0
3632,2011,10,MORTGAGE,3,Low,1,21000, 60 months,2,debt_consolidation,6,High,2,Good Loan,0,14.27,C,3,21.63,24620.29,21000,0,491.58,409000003631,4-May-17,RUPAY POS ACQ SETTL 04051,,683412.74,-547546252.50,Kung,739,Spain,193008.52,0,1,0
3633,2011,2,MORTGAGE,3,Low,1,35000, 60 months,2,debt_consolidation,6,Low,1,Good Loan,0,12.42,B,2,22.43,38497.75,26857.64,0,786.01,409000003632,5-May-17,VISA POSDOM ACQ SETTL 040,,1382384.03,-546163868.47,Lei,560,Spain,157567.37,0,1,0
3634,2011,2,RENT,1,Low,1,12000, 60 months,2,debt_consolidation,6,High,2,Good Loan,0,17.27,D,4,14.11,14661.92,8950.51,0,299.98,409000003633,5-May-17,MASTER POSDOM ACQ SETTL04,,124028.47,-546039840.00,Sheehan,827,Germany,108977.50,0,1,0
3635,2011,0.5,RENT,1,Low,1,5000, 36 months,1,debt_consolidation,6,Low,1,Good Loan,0,8.9,A,1,16.74,5714.556301,5000,0,158.77,409000003634,5-May-17,MAESTRO POSDOM ACQ SETTL0,,60511.99,-545979328.01,Kung,681,France,147759.84,0,1,0
3636,2011,4,MORTGAGE,3,Medium,2,24000, 36 months,1,debt_consolidation,6,Low,1,Good Loan,0,7.9,A,1,17.82,27031.02127,24000,0,750.97,409000003635,5-May-17,RUPAY POS ACQ SETTL 05051,,685215.82,-545294112.19,Kelechi,740,France,27528.40,0,1,0
3637,2011,0.5,RENT,1,Low,1,4500, 36 months,1,debt_consolidation,6,Low,1,Good Loan,0,6.62,A,1,9.43,4845.35,4500,0,138.17,409000003636,5-May-17,TRF TO  Indiaforensic SERVICES I,"2,200,000.00",,-547494112.19,Anenechi,663,Spain,36479.27,0,1,0
3638,2011,1,RENT,1,Low,1,3500, 36 months,1,debt_consolidation,6,High,2,Good Loan,0,15.27,C,3,7.05,4414.649223,3500,0,121.8,409000003637,6-May-17,VISA POSDOM ACQ SETTL 050,,648678.88,-546845433.31,McElhone,845,Spain,31726.76,0,1,0
3639,2011,4,MORTGAGE,3,Low,1,5000, 60 months,2,car,2,High,2,Good Loan,0,15.27,C,3,22.84,5063.95,5000,0,119.66,409000003638,6-May-17,TRF TO  Indiaforensic SERVICES I,"1,000,000.00",,-547845433.31,Chigbogu,555,Spain,96398.51,0,1,0
3640,2011,10,RENT,1,Low,1,2500, 36 months,1,debt_consolidation,6,High,2,Good Loan,0,14.65,C,3,14.68,3118.866498,2500,0,86.24,409000003639,6-May-17,MASTER POSDOM ACQ SETTL05,,126197.57,-547719235.74,Atkins,680,Germany,139558.60,0,1,0
3641,2011,8,RENT,1,Low,1,20000, 60 months,2,debt_consolidation,6,High,2,Bad Loan,1,22.35,F,6,14.1,8224.9,2666.4,994.22,556.37,409000003640,6-May-17,MAESTRO POSDOM ACQ SETTL0,,62559.92,-547656675.82,Colombo,638,Germany,95007.80,0,1,0
3642,2011,2,MORTGAGE,3,Low,1,5000, 36 months,1,debt_consolidation,6,Low,1,Good Loan,0,10.65,B,2,15.11,5395.03,5000,0,162.87,409000003641,6-May-17,RUPAY POS ACQ SETTL 06051,,565765.75,-547090910.07,Tilley,640,Spain,101663.47,0,1,0
3643,2011,6.05,RENT,1,Low,1,4000, 36 months,1,debt_consolidation,6,Low,1,Good Loan,0,11.71,B,2,14.93,4762.096269,4000,0,132.31,409000003642,8-May-17,VISA POSDOM ACQ SETTL 060,,628897.26,-546462012.81,Sopuluchi,778,France,106197.44,0,1,0
3644,2011,4,MORTGAGE,3,Low,1,9325, 60 months,2,small_business,3,Low,1,Good Loan,0,11.71,B,2,27.99,10081.77,7175.9,0,206.07,409000003643,8-May-17,MASTER POSDOM ACQ SETTL06,,152290.83,-546309721.98,Udinesi,679,France,48466.89,0,1,0
3645,2011,4,MORTGAGE,3,Low,1,21600, 36 months,1,debt_consolidation,6,High,2,Bad Loan,1,15.27,C,3,9.51,7744.75,4505.53,995.74,751.64,409000003644,8-May-17,MAESTRO POSDOM ACQ SETTL0,,30740.75,-546278981.23,Onyekachi,593,France,151978.36,0,1,0
3646,2011,1,MORTGAGE,3,Medium,2,10000, 36 months,1,debt_consolidation,6,Low,1,Good Loan,0,12.69,B,2,13.23,12000.02722,10000,0,335.45,409000003645,8-May-17,TRF TO  Indiaforensic SERVICES I,"1,900,000.00",,-548178981.23,McCartney,788,France,13288.46,0,1,0
3647,2011,6.05,RENT,1,Low,1,6000, 36 months,1,debt_consolidation,6,Low,1,Bad Loan,1,6.62,A,1,25.23,1396.17,918.43,291.93,184.23,409000003646,8-May-17,RUPAY POS ACQ SETTL 07051,,863568.51,-547315412.72,Thompson,770,France,22666.77,0,1,0
3648,2011,2,MORTGAGE,3,Medium,2,20000, 60 months,2,debt_consolidation,6,Low,1,Good Loan,0,12.42,B,2,9.54,21985.94,15339.37,0,449.15,409000003647,8-May-17,RUPAY POS ACQ SETTL 08051,,627832.73,-546687579.99,Onyeoruru,729,France,102391.06,0,1,0
3649,2011,4,RENT,1,Low,1,24000, 36 months,1,debt_consolidation,6,Low,1,Good Loan,0,7.9,A,1,5.08,26659.58,24000,0,750.97,409000003648,9-May-17,VISA POSDOM ACQ SETTL 080,,622216.59,-546065363.40,Shih,545,France,67830.20,0,1,0
3650,2011,6.05,MORTGAGE,3,Low,1,17000, 36 months,1,debt_consolidation,6,Low,1,Good Loan,0,6.03,A,1,4.63,17553.02,17000,0,517.41,409000003649,9-May-17,MASTER POSDOM ACQ SETTL08,,321850.64,-545743512.76,Golibe,597,France,92090.36,0,1,0
3651,2011,3,RENT,1,Low,1,2400, 36 months,1,credit_card,1,Low,1,Good Loan,0,7.9,A,1,14.73,2502.31,2400,0,75.1,409000003650,9-May-17,MAESTRO POSDOM ACQ SETTL0,,57912.40,-545685600.36,Lucchesi,537,France,141023.01,0,1,0
3652,2011,2,MORTGAGE,3,Low,1,10000, 36 months,1,home_improvement,7,Low,1,Good Loan,0,10.65,B,2,10.39,11724.35479,10000,0,325.74,409000003651,9-May-17,TRF TO  Indiaforensic SERVICES I,"2,500,000.00",,-548185600.36,Townsend,732,France,104222.80,0,1,0
3653,2011,10,RENT,1,Low,1,14000, 36 months,1,debt_consolidation,6,Low,1,Good Loan,0,6.62,A,1,20.18,14366.46,14000,0,429.86,409000003652,10-May-17,RUPAY POS ACQ SETTL 09051,,833714.84,-547351885.52,Chao,542,France,196395.05,0,1,0
3654,2011,3,MORTGAGE,3,Low,1,6700, 36 months,1,debt_consolidation,6,Low,1,Good Loan,0,10.65,B,2,6.6,7771.003179,6700,0,218.25,409000003653,11-May-17,MASTER POSDOM ACQ SETTL09,,137941.35,-547213944.17,Shen,688,Germany,6866.31,0,1,0
3655,2011,5,OWN,2,Low,1,7000, 36 months,1,moving,10,High,2,Bad Loan,1,19.03,E,5,13.36,6326.11,4001.59,428.22,256.7,409000003654,11-May-17,MAESTRO POSDOM ACQ SETTL0,,18971.00,-547194973.17,Booth,542,Germany,77737.86,0,1,0
3656,2011,4,RENT,1,Low,1,9000, 36 months,1,credit_card,1,Low,1,Good Loan,0,7.51,A,1,12.34,9848.76,9000,0,280,409000003655,11-May-17,MASTER POSDOM ACQ SETTL10,,197531.00,-546997442.17,Chan,754,Germany,106116.84,0,1,0
3657,2011,10,MORTGAGE,3,Low,1,7400, 60 months,2,credit_card,1,High,2,Good Loan,0,17.58,D,4,11.25,9101.87,5509.3,0,186.23,409000003656,11-May-17,MAESTRO POSDOM ACQ SETTL1,,11735.50,-546985706.67,Yeh,750,France,117948.00,0,1,0
3658,2011,2,MORTGAGE,3,Low,1,14500, 60 months,2,credit_card,1,High,2,Bad Loan,1,18.64,E,5,7.42,7465.41,3430.63,23.21,373.28,409000003657,11-May-17,VISA POSDOM ACQ SETTL 090,,1522399.02,-545463307.65,Badgery,731,France,184581.68,0,1,0
3659,2011,2,RENT,1,Low,1,16950, 36 months,1,debt_consolidation,6,High,2,Good Loan,0,18.25,D,4,21.23,22129.75962,16950,0,614.92,409000003658,11-May-17,VISA POSDOM ACQ SETTL 100,,680958.49,-544782349.16,Hsia,699,France,199378.58,0,1,0
3660,2011,2,RENT,1,Low,1,3600, 36 months,1,debt_consolidation,6,High,2,Good Loan,0,15.27,C,3,3.33,4392.75,3600,0,125.28,409000003659,11-May-17,TRF TO  Indiaforensic SERVICES I,"3,400,000.00",,-548182349.16,Zarate,534,France,12483.39,0,1,0
3661,2011,5,RENT,1,Low,1,15000, 36 months,1,debt_consolidation,6,High,2,Good Loan,0,18.25,D,4,3.13,19502.68042,15000,0,544.17,409000003660,11-May-17,RUPAY POS ACQ SETTL 10051,,868608.33,-547313740.83,Congreve,494,Spain,22404.64,0,1,0
3662,2011,5,MORTGAGE,3,Medium,2,24000, 60 months,2,debt_consolidation,6,High,2,Good Loan,0,17.58,D,4,14.83,29522.15,17869.2,0,603.98,409000003661,11-May-17,RUPAY POS ACQ SETTL 11051,,1035578.59,-546278162.24,Hayslett,497,Germany,92887.06,0,1,0
3663,2011,10,MORTGAGE,3,Low,1,4950, 36 months,1,debt_consolidation,6,Low,1,Bad Loan,1,11.71,B,2,22.63,1541.46,915.75,231.8,163.73,409000003662,12-May-17,VISA POSDOM ACQ SETTL 110,,897094.99,-545381067.25,Robinson,632,France,145157.97,0,1,0
3664,2011,4,RENT,1,Low,1,5875, 36 months,1,debt_consolidation,6,Low,1,Good Loan,0,12.69,B,2,23.94,7080.412603,5875,0,197.08,409000003663,12-May-17,MASTER POSDOM ACQ SETTL11,,185438.61,-545195628.64,Wong,724,France,134889.95,0,1,0
3665,2011,5,RENT,1,Low,1,20000, 60 months,2,debt_consolidation,6,High,2,Good Loan,0,18.64,E,5,21.07,25185.52,14810.7,0,514.86,409000003664,12-May-17,MAESTRO POSDOM ACQ SETTL1,,24456.50,-545171172.14,Nevzorova,751,Germany,109309.29,0,1,0
3666,2011,3,RENT,1,Medium,2,10000, 36 months,1,wedding,5,Low,1,Good Loan,0,6.03,A,1,8.67,10956.36694,10000,0,304.36,409000003665,12-May-17,RUPAY POS ACQ SETTL 12051,,1200473.02,-543970699.12,Page,733,France,169964.12,0,1,0
3667,2011,6.05,RENT,1,Low,1,3000, 36 months,1,vacation,11,High,2,Good Loan,0,16.29,D,4,7.09,3811.724747,3000,0,105.91,409000003666,12-May-17,TRF TO  Indiaforensic SERVICES I,"3,100,000.00",,-547070699.12,Quinn,701,Spain,26327.42,0,1,0
3668,2011,7,RENT,1,Medium,2,25000, 60 months,2,debt_consolidation,6,High,2,Good Loan,0,23.91,G,7,9.55,41412.90627,25000,0,717.9,409000003667,15-May-17,VISA POSDOM ACQ SETTL 120,,934408.83,-546136290.29,O'Donnell,525,Germany,55072.93,0,1,0
3669,2011,10,MORTGAGE,3,Medium,2,35000, 60 months,2,debt_consolidation,6,Low,1,Bad Loan,1,12.42,B,2,13.72,39047.31,5380.16,29623.35,786.01,409000003668,15-May-17,VISA POSDOM ACQ SETTL 130,,981427.92,-545154862.37,Pisano,666,Germany,68574.88,0,1,0
3670,2011,7,RENT,1,Low,1,12000, 60 months,2,other,4,High,2,Good Loan,0,18.25,D,4,11.33,12184.59,12000,0,306.36,409000003669,15-May-17,VISA POSINT ACQ SETTL 140,,494.50,-545154367.87,Sinclair,653,France,41671.81,0,1,0
3671,2011,10,MORTGAGE,3,Low,1,5000, 36 months,1,debt_consolidation,6,Low,1,Good Loan,0,6.03,A,1,5.05,5185.69,5000,0,152.18,409000003670,15-May-17,MASTER POSDOM ACQ SETTL12,,423191.32,-544731176.55,Loving,850,France,12409.01,0,1,0
3672,2011,0.5,RENT,1,Low,1,5825, 36 months,1,other,4,Low,1,Good Loan,0,6.62,A,1,11,6350.4,5825,0,178.85,409000003671,15-May-17,MAESTRO POSDOM ACQ SETTL1,,55040.13,-544676136.42,Artemova,646,Germany,68367.18,0,1,0
3673,2011,2,MORTGAGE,3,Low,1,2000, 36 months,1,debt_consolidation,6,Low,1,Good Loan,0,7.9,A,1,10.08,2105.68,2000,0,62.59,409000003672,15-May-17,MASTER POSDOM ACQ SETTL13,,225243.13,-544450893.29,Robertson,750,France,74564.41,0,1,0
3674,2011,3,MORTGAGE,3,Low,1,17500, 60 months,2,house,12,Low,1,Good Loan,0,11.71,B,2,15.15,18931.19,13473.61,0,386.72,409000003673,15-May-17,MAESTRO POSDOM ACQ SETTL1,,17108.40,-544433784.89,Genovese,764,France,26843.76,0,1,0
3675,2011,10,MORTGAGE,3,Low,1,30000, 60 months,2,home_improvement,7,High,2,Good Loan,0,13.49,C,3,20,40628.11912,30000,0,690.15,409000003674,15-May-17,TRF TO  Indiaforensic SERVICES I,"3,800,000.00",,-548233784.89,Ugonnatubelum,658,France,156774.75,0,1,0
3676,2011,7,MORTGAGE,3,Low,1,12500, 36 months,1,credit_card,1,Low,1,Good Loan,0,7.9,A,1,7.13,14079.37187,12500,0,391.13,409000003675,16-May-17,VISA POSDOM ACQ SETTL 150,,2061504.15,-546172280.74,Corbett,727,France,46019.43,0,1,0
3677,2011,0.5,MORTGAGE,3,Medium,2,12000, 36 months,1,debt_consolidation,6,Low,1,Good Loan,0,6.03,A,1,6.7,13003.2,12000,0,365.23,409000003676,16-May-17,MASTER POSDOM ACQ SETTL15,,694188.25,-545478092.49,Reilly,687,France,145411.39,0,1,0
3678,2011,0.5,RENT,1,Low,1,4600, 36 months,1,credit_card,1,Low,1,Good Loan,0,6.03,A,1,9.17,5037.8055,4600,0,140.01,409000003677,16-May-17,MAESTRO POSDOM ACQ SETTL1,,84159.00,-545393933.49,Wright,631,Spain,158268.84,0,1,0
3679,2011,10,MORTGAGE,3,Low,1,12000, 60 months,2,debt_consolidation,6,High,2,Good Loan,0,13.49,C,3,23.66,13503.18,9144.74,0,276.06,409000003678,16-May-17,RUPAY POS ACQ SETTL 13051,,1027106.05,-544366827.44,Vincent,797,France,74637.57,0,1,0
3680,2011,0.5,MORTGAGE,3,Low,1,12000, 36 months,1,debt_consolidation,6,Low,1,Good Loan,0,6.62,A,1,15.77,13262.39828,12000,0,368.45,409000003679,16-May-17,RUPAY POS ACQ SETTL 14051,,1213559.37,-543153268.07,Carr,650,Spain,28391.52,0,1,0
3681,2011,5,MORTGAGE,3,Low,1,1000, 36 months,1,other,4,High,2,Good Loan,0,16.29,D,4,9.03,1270.079145,1000,0,35.31,409000003680,16-May-17,RUPAY POS ACQ SETTL 15051,,1008293.15,-542144974.92,Eiland,850,Spain,144385.54,0,1,0
3682,2011,9,OWN,2,Low,1,8000, 36 months,1,debt_consolidation,6,Low,1,Good Loan,0,6.03,A,1,9.42,8765.092693,8000,0,243.49,409000003681,16-May-17,RUPAY POS ACQ SETTL 16051,,1051190.62,-541093784.30,Omeokachie,676,France,95181.06,0,1,0
3683,2011,0.5,OWN,2,Low,1,7500, 60 months,2,debt_consolidation,6,Low,1,Good Loan,0,12.42,B,2,10.28,9373.291242,7500,0,168.43,409000003682,16-May-17,TRF TO  Indiaforensic SERVICES I,"6,100,000.00",,-547193784.30,Mackenzie,620,Spain,15627.51,0,1,0
3684,2011,1,RENT,1,Low,1,5800, 36 months,1,credit_card,1,Low,1,Good Loan,0,10.65,B,2,23.91,6798.317659,5800,0,188.93,409000003683,17-May-17,VISA POSDOM ACQ SETTL 160,,990018.62,-546203765.68,Pinto,576,France,148477.57,0,1,0
3685,2011,3,RENT,1,Low,1,2400, 36 months,1,major_purchase,8,Low,1,Good Loan,0,8.9,A,1,13.26,2742.503966,2400,0,76.21,409000003684,17-May-17,MASTER POSDOM ACQ SETTL16,,242440.59,-545961325.09,Gardener,482,France,79957.95,0,1,0
3686,2011,2,RENT,1,Medium,2,20000, 60 months,2,other,4,Low,1,Good Loan,0,11.71,B,2,6.51,21646,15397.91,0,441.97,409000003685,17-May-17,MAESTRO POSDOM ACQ SETTL1,,46835.92,-545914489.17,Fang,695,Spain,102763.69,0,1,0
3687,2011,7,MORTGAGE,3,Low,1,9375, 60 months,2,debt_consolidation,6,High,2,Good Loan,0,21.67,F,6,14.59,12597.16,6819.34,0,257.18,409000003686,17-May-17,TRF TO  Indiaforensic SERVICES I,"2,300,000.00",,-548214489.17,Cattaneo,706,France,129654.22,0,1,0
3688,2011,10,MORTGAGE,3,Low,1,6000, 36 months,1,other,4,Low,1,Good Loan,0,6.03,A,1,17.1,6548.486364,6000,0,182.62,409000003687,17-May-17,RUPAY POS ACQ SETTL 17051,,1211655.35,-547002833.82,Labrador,668,France,40652.33,0,1,0
3689,2011,10,OWN,2,Low,1,24000, 60 months,2,other,4,Low,1,Good Loan,0,12.69,B,2,0.65,27015.38,24000,0,542.28,409000003688,18-May-17,VISA POSDOM ACQ SETTL 170,,1030178.51,-545972655.31,Dettmann,679,Germany,178291.09,0,1,0
3690,2011,6.05,RENT,1,Low,1,3825, 36 months,1,debt_consolidation,6,High,2,Bad Loan,1,17.27,D,4,12.25,2457.18,1663.34,0,136.89,409000003689,18-May-17,MASTER POSDOM ACQ SETTL17,,320277.23,-545652378.08,Gibson,703,France,131906.44,0,1,0
3691,2011,1,RENT,1,Low,1,10200, 36 months,1,wedding,5,Low,1,Good Loan,0,12.69,B,2,15.5,10808.48,10200,0,342.16,409000003690,18-May-17,MAESTRO POSDOM ACQ SETTL1,,42598.52,-545609779.56,Hope,670,Spain,118607.40,0,1,0
3692,2011,3,RENT,1,Low,1,17500, 60 months,2,debt_consolidation,6,High,2,Bad Loan,1,18.64,E,5,12.24,8545.2,3309.47,813.68,450.51,409000003691,18-May-17,TRF TO  Indiaforensic SERVICES I,"2,600,000.00",,-548209779.56,Ives,590,France,13848.58,0,1,0
3693,2011,10,MORTGAGE,3,Low,1,9250, 36 months,1,debt_consolidation,6,Low,1,Good Loan,0,7.9,A,1,24.56,10418.70205,9250,0,289.44,409000003692,18-May-17,RUPAY POS ACQ SETTL 18051,,1163698.84,-547046080.72,Greece,613,Spain,170903.40,0,1,0
3694,2011,3,MORTGAGE,3,Medium,2,21500, 36 months,1,debt_consolidation,6,Low,1,Good Loan,0,6.62,A,1,8.97,22239.26,21500,0,660.13,409000003693,19-May-17,VISA POSDOM ACQ SETTL 180,,711897.70,-546334183.02,Omeokachie,742,France,13161.66,0,1,0
3695,2011,2,RENT,1,Low,1,4000, 36 months,1,renewable_energy,13,High,2,Bad Loan,1,14.27,C,3,14.14,4151.16,2874.44,317.28,137.24,409000003694,19-May-17,MASTER POSDOM ACQ SETTL18,,293583.26,-546040599.76,Mao,608,France,79304.38,0,1,0
3696,2011,3,MORTGAGE,3,Low,1,35000, 60 months,2,debt_consolidation,6,High,2,Bad Loan,1,19.03,E,5,17.82,10900.11,4620.91,0,908.5,409000003695,19-May-17,MAESTRO POSDOM ACQ SETTL1,,57336.25,-545983263.51,Savage,571,France,121402.53,0,1,0
3697,2011,2,RENT,1,Low,1,12000, 60 months,2,debt_consolidation,6,High,2,Good Loan,0,20.3,E,5,13.23,18839.97997,12000,0,319.94,409000003696,19-May-17,RUPAY POS ACQ SETTL 19051,,1021173.53,-544962089.98,Brierly,595,France,23305.01,0,1,0
3698,2011,3,RENT,1,Low,1,3200, 36 months,1,debt_consolidation,6,Low,1,Good Loan,0,10.65,B,2,6.19,3718.156964,3200,0,104.24,409000003697,19-May-17,TRF TO  Indiaforensic SERVICES I,"2,200,000.00",,-547162089.98,Docherty,745,Germany,74510.65,0,1,0
3699,2011,1,RENT,1,Low,1,5000, 36 months,1,debt_consolidation,6,Low,1,Good Loan,0,7.9,A,1,10.12,5631.643917,5000,0,156.46,409000003698,20-May-17,VISA POSDOM ACQ SETTL 190,,916416.31,-546245673.67,McDonald,589,France,55601.44,0,1,0
3700,2011,6.05,RENT,1,Low,1,4350, 36 months,1,credit_card,1,Low,1,Good Loan,0,6.03,A,1,13.88,4559.57,4350,0,132.4,409000003699,20-May-17,VISA POSINT ACQ SETTL 190,,588.18,-546245085.49,Rapuokwu,749,France,134526.87,0,1,0
3701,2011,3,OWN,2,Low,1,7475, 36 months,1,debt_consolidation,6,Low,1,Bad Loan,1,7.9,A,1,14.29,3038.36,2496.21,0,233.9,409000003700,20-May-17,MASTER POSDOM ACQ SETTL19,,196555.97,-546048529.52,Bergamaschi,678,France,195424.01,0,1,0
3702,2011,10,MORTGAGE,3,Low,1,2800, 36 months,1,other,4,Low,1,Bad Loan,1,7.51,A,1,13.75,1128.53,936.18,0,87.12,409000003701,20-May-17,MAESTRO POSDOM ACQ SETTL1,,43796.56,-546004732.96,Manfrin,603,France,59563.49,0,1,0
3703,2011,8,RENT,1,Low,1,5300, 36 months,1,debt_consolidation,6,Low,1,Good Loan,0,7.9,A,1,9.67,5969.497724,5300,0,165.84,409000003702,20-May-17,TRF TO Indiaforensic SERVICES IN,"1,200,000.00",,-547204732.96,Bergamaschi,504,France,34595.58,0,1,0
3704,2011,0.5,RENT,1,Low,1,4000, 36 months,1,moving,10,Low,1,Bad Loan,1,8.9,A,1,6.11,1648.79,1321.49,0,127.02,409000003703,20-May-17,TRF TO Indiaforensic SERVICES IN,"1,000,000.00",,-548204732.96,MacDonald,739,Germany,60036.99,0,1,0
3705,2011,10,MORTGAGE,3,Low,1,9000, 36 months,1,home_improvement,7,Low,1,Good Loan,0,6.03,A,1,9.06,9608.48,9000,0,273.92,409000003704,20-May-17,RUPAY POS ACQ SETTL 20051,,1192986.81,-547011746.15,Lees,604,France,193021.49,0,1,0
3706,2011,5,RENT,1,Low,1,8300, 60 months,2,debt_consolidation,6,High,2,Good Loan,0,14.65,C,3,19.23,9599.44,6294.01,0,195.94,409000003705,22-May-17,MASTER POSDOM ACQ SETTL20,,373233.14,-546638513.01,Senior,612,France,48108.72,0,1,0
3707,2011,5,RENT,1,Low,1,12000, 60 months,2,debt_consolidation,6,Low,1,Good Loan,0,12.42,B,2,19.2,15821.25006,12000,0,269.49,409000003706,22-May-17,MAESTRO POSDOM ACQ SETTL2,,51393.72,-546587119.29,Nwokezuike,629,Spain,79082.76,0,1,0
3708,2011,7,MORTGAGE,3,Medium,2,16000, 36 months,1,major_purchase,8,Low,1,Good Loan,0,6.03,A,1,14.86,17239.62,16000,0,486.97,409000003707,22-May-17,VISA POSDOM ACQ SETTL 200,,948872.37,-545638246.92,Ekwueme,652,Spain,37914.12,0,1,0
3709,2011,6,MORTGAGE,3,Low,1,25000, 60 months,2,debt_consolidation,6,High,2,Good Loan,0,18.25,D,4,15.31,36449.56369,25000,0,638.25,409000003708,22-May-17,VISA POSDOM ACQ SETTL 210,"1,719.35",,-545639966.27,Garmon,565,France,74593.84,0,1,0
3710,2011,3,RENT,1,Low,1,15000, 36 months,1,other,4,Low,1,Good Loan,0,9.91,B,2,18.7,17398.952,15000,0,483.38,409000003709,22-May-17,VISA POSINT ACQ SETTL 210,,452.70,-545639513.57,Enyinnaya,707,France,82967.97,0,1,0
3711,2011,4,MORTGAGE,3,Low,1,20000, 60 months,2,credit_card,1,Low,1,Bad Loan,1,11.71,B,2,16.36,4139.2,1773.56,1054.93,441.97,409000003710,22-May-17,TRF TO  Indiaforensic SERVICES I,"2,600,000.00",,-548239513.57,Chizuoke,645,France,193441.23,0,1,0
3712,2011,6.05,MORTGAGE,3,Low,1,2500, 36 months,1,major_purchase,8,Low,1,Good Loan,0,7.51,A,1,8.82,2777.695988,2500,0,77.78,409000003711,22-May-17,RUPAY POS ACQ SETTL 21051,,765386.96,-547474126.61,Hyde,762,Germany,191790.29,0,1,0
3713,2011,6,MORTGAGE,3,Low,1,25600, 36 months,1,debt_consolidation,6,High,2,Good Loan,0,14.65,C,3,16.86,31680.19894,25600,0,883.06,409000003712,22-May-17,RUPAY POS ACQ SETTL 22051,,1163045.59,-546311081.02,Cameron,639,Spain,92455.96,0,1,0
3714,2011,10,RENT,1,Low,1,15000, 60 months,2,wedding,5,High,2,Good Loan,0,18.25,D,4,14.25,18717.94,11125.77,0,382.95,409000003713,23-May-17,VISA POSDOM ACQ SETTL 220,,1572124.86,-544738956.16,Lord,709,Germany,155231.55,0,1,0
3715,2011,4,MORTGAGE,3,Low,1,12000, 36 months,1,debt_consolidation,6,Low,1,Good Loan,0,6.62,A,1,20.67,12683.06,12000,0,368.45,409000003714,23-May-17,MASTER POSDOM ACQ SETTL22,,550380.45,-544188575.71,Biryukova,823,France,9217.92,0,1,0
3716,2011,10,RENT,1,Low,1,35000, 36 months,1,debt_consolidation,6,High,2,Bad Loan,1,14.27,C,3,16.63,19288.26,12759.8,1294.42,1200.82,409000003715,23-May-17,MAESTRO POSDOM ACQ SETTL2,,40023.72,-544148551.99,Carpenter,817,Germany,87941.85,0,1,0
3717,2011,3,OWN,2,Low,1,11325, 36 months,1,debt_consolidation,6,High,2,Good Loan,0,15.96,C,3,22.59,11623.16,11325,0,397.93,409000003716,23-May-17,MAESTRO POSDOM ACQ SETTL2,,21858.51,-544126693.48,Lorenzo,665,Germany,187508.06,0,1,0
3718,2011,10,MORTGAGE,3,Low,1,21000, 60 months,2,house,12,High,2,Good Loan,0,13.49,C,3,7.51,23622.76,15998.48,0,483.1,409000003717,23-May-17,TRF TO  Indiaforensic SERVICES I,"4,100,000.00",,-548226693.48,Madukwe,646,Germany,171519.06,0,1,0
3719,2011,6.05,RENT,1,Low,1,2500, 36 months,1,other,4,Low,1,Good Loan,0,6.62,A,1,26.12,2762.876134,2500,0,76.76,409000003718,24-May-17,VISA POSDOM ACQ SETTL 230,,976440.69,-547250252.79,Hutcheon,568,France,27012.00,0,1,0
3720,2011,3,RENT,1,Low,1,10625, 36 months,1,credit_card,1,Low,1,Good Loan,0,7.9,A,1,21.85,11967.50698,10625,0,332.46,409000003719,24-May-17,MASTER POSDOM ACQ SETTL23,,287734.97,-546962517.82,Sleeman,850,France,70916.00,0,1,0
3721,2011,4,RENT,1,Low,1,14400, 60 months,2,debt_consolidation,6,High,2,Bad Loan,1,18.64,E,5,12.11,4079.62,1403.39,755.29,370.7,409000003720,24-May-17,MAESTRO POSDOM ACQ SETTL2,,24109.55,-546938408.27,Milne,473,Germany,73073.68,0,1,0
3722,2011,7,MORTGAGE,3,Medium,2,21250, 60 months,2,small_business,3,High,2,Good Loan,0,17.27,D,4,10.11,28795.97818,21250,0,531.21,409000003721,24-May-17,RUPAY POS ACQ SETTL 23051,,1099643.60,-545838764.67,Williamson,731,France,88783.59,0,1,0
3723,2011,10,RENT,1,Low,1,35000, 60 months,2,debt_consolidation,6,High,2,Bad Loan,1,17.58,D,4,21.95,30828,16637.4,71.01,880.8,409000003722,25-May-17,VISA POSDOM ACQ SETTL 240,,789844.94,-545048919.73,Bruno,619,France,145524.36,0,1,0
3724,2011,4,RENT,1,Low,1,4000, 36 months,1,debt_consolidation,6,High,2,Bad Loan,1,17.27,D,4,10.44,3349.15,2071.26,272.09,143.15,409000003723,25-May-17,RUPAY POS ACQ SETTL 24051,,855123.96,-544193795.77,Palerma,715,Germany,21333.22,0,1,0
3725,2011,10,RENT,1,Low,1,3000, 36 months,1,other,4,Low,1,Good Loan,0,12.42,B,2,5.39,3175.35,3000,0,100.25,409000003724,25-May-17,MASTER POSDOM ACQ SETTL24,,257608.44,-543936187.33,Wang,772,Germany,46675.51,0,1,0
3726,2011,5,RENT,1,Low,1,4800, 36 months,1,moving,10,Low,1,Good Loan,0,12.42,B,2,5.31,5765.939872,4800,0,160.4,409000003725,25-May-17,MAESTRO POSDOM ACQ SETTL2,,54664.09,-543881523.24,Onyemere,686,France,4802.25,0,1,0
3727,2011,10,MORTGAGE,3,Low,1,12000, 60 months,2,debt_consolidation,6,Low,1,Good Loan,0,9.91,B,2,3.31,14957.93527,12000,0,254.44,409000003726,25-May-17,TRF TO  Indiaforensic SERVICES I,"4,300,000.00",,-548181523.24,Dawson,749,Germany,102975.72,0,1,0
3728,2011,3,RENT,1,Low,1,12000, 60 months,2,debt_consolidation,6,High,2,Bad Loan,1,17.27,D,4,9.21,2570.29,399.73,1645.81,299.98,409000003727,26-May-17,VISA POSDOM ACQ SETTL 250,,632696.24,-547548827.00,Nebechukwu,781,France,175071.29,0,1,0
3729,2011,4,MORTGAGE,3,Low,1,6000, 36 months,1,debt_consolidation,6,Low,1,Good Loan,0,7.9,A,1,14.99,6615.32,6000,0,187.75,409000003728,26-May-17,MASTER POSDOM ACQ SETTL25,,176482.92,-547372344.08,Bateman,675,Spain,131970.86,0,1,0
3730,2011,1,RENT,1,Low,1,6000, 36 months,1,debt_consolidation,6,Low,1,Good Loan,0,12.69,B,2,16.72,7240.288527,6000,0,201.27,409000003729,26-May-17,MAESTRO POSDOM ACQ SETTL2,,47179.29,-547325164.79,Lord,730,Spain,14174.09,0,1,0
3731,2011,2,MORTGAGE,3,High,3,14000, 36 months,1,debt_consolidation,6,Low,1,Good Loan,0,12.42,B,2,9.9,15611.83,14000,0,467.82,409000003730,26-May-17,RUPAY POS ACQ SETTL 25051,,966195.18,-546358969.61,Loggia,683,Spain,15378.75,0,1,0
3732,2011,1,MORTGAGE,3,Low,1,22125, 60 months,2,debt_consolidation,6,High,2,Bad Loan,1,13.49,C,3,27.43,4062.48,2160.87,0,508.98,409000003731,26-May-17,TRF TO  Indiaforensic SERVICES I,"1,900,000.00",,-548258969.61,Graham,554,Germany,179797.79,0,1,0
3733,2011,10,MORTGAGE,3,Low,1,24000, 60 months,2,debt_consolidation,6,Low,1,Bad Loan,1,12.69,B,2,18.42,4336.03,2382.37,20.83,542.28,409000003732,29-May-17,VISA POSDOM ACQ SETTL 270,,723751.54,-547535218.07,Dean,722,France,93917.68,0,1,0
3734,2011,0.5,RENT,1,Low,1,12000, 36 months,1,debt_consolidation,6,Low,1,Good Loan,0,10.65,B,2,14.45,14036.66764,12000,0,390.88,409000003733,29-May-17,MASTER POSDOM ACQ SETTL27,,223088.13,-547312129.94,Jarvis,689,Germany,99490.01,0,1,0
3735,2011,3,RENT,1,Low,1,9450, 36 months,1,major_purchase,8,Low,1,Good Loan,0,6.62,A,1,22.61,10254.76,9450,0,290.15,409000003734,29-May-17,MAESTRO POSDOM ACQ SETTL2,,39364.76,-547272765.18,Haugh,796,Germany,46415.09,0,1,0
3736,2011,10,MORTGAGE,3,Low,1,8000, 36 months,1,home_improvement,7,Low,1,Good Loan,0,6.03,A,1,7.97,8765.063478,8000,0,243.49,409000003735,29-May-17,RUPAY POS ACQ SETTL 27051,,765511.39,-546507253.79,Micklem,447,France,151815.76,0,1,0
3737,2011,10,MORTGAGE,3,Low,1,5600, 36 months,1,debt_consolidation,6,High,2,Good Loan,0,15.96,C,3,13.07,7025.330422,5600,0,196.77,409000003736,29-May-17,RUPAY POS ACQ SETTL 28051,,719692.95,-545787560.84,Bennett,498,Germany,14865.05,0,1,0
3738,2011,9,MORTGAGE,3,Medium,2,30000, 36 months,1,home_improvement,7,Low,1,Good Loan,0,7.9,A,1,9.86,30391.02,30000,0,938.71,409000003737,29-May-17,TRF TO  Indiaforensic SERVICES I,"2,000,000.00",,-547787560.84,Roberts,663,Spain,188007.99,0,1,0
3739,2011,10,MORTGAGE,3,Medium,2,23200, 60 months,2,debt_consolidation,6,High,2,Good Loan,0,20.89,F,6,23.37,31358.93,23200,0,626.21,409000003738,30-May-17,MASTER POSDOM ACQ SETTL29,,436751.96,-547350808.88,Onyekaozulu,498,Germany,98175.74,0,1,0
3740,2011,0.5,RENT,1,Low,1,9300, 60 months,2,other,4,High,2,Bad Loan,1,14.65,C,3,14.52,1187.34,431.76,309.38,219.55,409000003739,30-May-17,MAESTRO POSDOM ACQ SETTL2,,43956.20,-547306852.68,Kegley,627,France,106851.70,0,1,0
3741,2011,0.5,OWN,2,Low,1,15000, 60 months,2,debt_consolidation,6,High,2,Good Loan,0,14.27,C,3,18.32,18772.71,15000,0,351.13,409000003740,30-May-17,MAESTRO POSDOM ACQ SETTL2,,24555.26,-547282297.42,Manna,649,France,75204.21,0,1,0
3742,2011,0.5,RENT,1,Low,1,6075, 36 months,1,credit_card,1,Low,1,Good Loan,0,11.71,B,2,15.45,7200.068098,6075,0,200.94,409000003741,30-May-17,RUPAY POS ACQ SETTL 29051,,692078.62,-546590218.80,Thompson,738,Germany,141872.05,0,1,0
3743,2011,6,MORTGAGE,3,Low,1,4000, 36 months,1,credit_card,1,High,2,Good Loan,0,14.27,C,3,19.2,4936.709336,4000,0,137.24,409000003742,30-May-17,VISA POSDOM ACQ SETTL 290,,1295751.99,-545294466.81,Romano,587,Germany,7103.71,0,1,0
3744,2011,1,RENT,1,Low,1,4350, 36 months,1,credit_card,1,High,2,Bad Loan,1,15.27,C,3,12.24,4018.92,2790.05,220.34,151.37,409000003743,30-May-17,TRF TO  Indiaforensic SERVICES I,"400,000.00",,-545694466.81,Brown,655,Germany,9241.83,0,1,0
3745,2011,2,OWN,2,Low,1,11000, 60 months,2,small_business,3,High,2,Good Loan,0,15.96,C,3,0.55,11394.1,11000,0,267.27,409000003744,30-May-17,TRF TO  Indiaforensic SERVICES I,"2,500,000.00",,-548194466.81,Su,647,Germany,149517.71,0,1,0
3746,2011,7,MORTGAGE,3,Low,1,5750, 60 months,2,debt_consolidation,6,Low,1,Good Loan,0,8.9,A,1,21.82,6968.800436,5750,0,119.09,409000003745,31-May-17,VISA POSDOM ACQ SETTL 300,,726439.28,-547468027.53,Mackay,776,Germany,196079.32,0,1,0
3747,2011,8,MORTGAGE,3,Low,1,10375, 60 months,2,debt_consolidation,6,Low,1,Good Loan,0,8.9,A,1,18.36,11159.06,10375,0,214.87,409000003746,31-May-17,MASTER POSDOM ACQ SETTL30,,289989.60,-547178037.93,Watt,688,Germany,166165.93,0,1,0
3748,2011,5,MORTGAGE,3,Medium,2,9000, 36 months,1,home_improvement,7,High,2,Good Loan,0,14.27,C,3,5.61,11110.3673,9000,0,308.79,409000003747,31-May-17,MAESTRO POSDOM ACQ SETTL3,,52713.31,-547125324.62,Milani,605,France,55724.24,0,1,0
3749,2011,5,MORTGAGE,3,Low,1,10000, 60 months,2,debt_consolidation,6,High,2,Good Loan,0,17.27,D,4,14.71,12551.49,10000,0,249.98,409000003748,31-May-17,RUPAY POS ACQ SETTL 30051,,1334215.80,-545791108.82,Hsu,596,France,131768.98,0,1,0
3750,2011,0.5,RENT,1,Low,1,20000, 36 months,1,credit_card,1,Low,1,Bad Loan,1,11.71,B,2,18.2,3303.4,2374.7,0,661.52,409000003749,31-May-17,TRF TO  Indiaforensic SERVICES I,"2,000,000.00",,-547791108.82,Valenzuela,427,France,13858.95,0,1,0
3751,2011,1,RENT,1,Low,1,16000, 60 months,2,debt_consolidation,6,Low,1,Good Loan,0,12.69,B,2,21.48,18025.51,12555.94,0,361.52,409000003750,1-Jun-17,VISA POSDOM ACQ SETTL 310,,802079.58,-546989029.24,Sung,629,France,82774.07,0,1,0
3752,2011,10,MORTGAGE,3,Low,1,10000, 36 months,1,debt_consolidation,6,Low,1,Good Loan,0,8.9,A,1,8.12,10818.73,10000,0,317.54,409000003751,1-Jun-17,RUPAY POS ACQ SETTL 31051,,1101021.03,-545888008.21,Lo,496,Spain,55389.59,0,1,0
3753,2011,6.05,MORTGAGE,3,Low,1,10000, 36 months,1,major_purchase,8,Low,1,Good Loan,0,12.69,B,2,24.12,12071.88898,10000,0,335.45,409000003752,1-Jun-17,MASTER POSDOM ACQ SETTL31,,295830.16,-545592178.05,Giordano,717,Spain,82336.73,0,1,0
3754,2011,10,RENT,1,Low,1,12875, 36 months,1,debt_consolidation,6,Low,1,Good Loan,0,12.42,B,2,23.14,14923.27,12875,0,430.23,409000003753,1-Jun-17,MAESTRO POSDOM ACQ SETTL3,,123866.03,-545468312.02,Connolly,777,France,163225.48,0,1,0
3755,2011,0.5,OWN,2,Low,1,4000, 36 months,1,credit_card,1,Low,1,Good Loan,0,6.03,A,1,4.53,4360.866456,4000,0,121.75,409000003754,1-Jun-17,VISA POSDOM ACQ SETTL 260,,522421.78,-544945890.24,Bellucci,535,Spain,135536.72,0,1,0
3756,2011,10,RENT,1,Low,1,1000, 36 months,1,car,2,Low,1,Good Loan,0,11.71,B,2,15.27,1038.93,1000,0,33.08,409000003755,1-Jun-17,TRF TO  Indiaforensic SERVICES I,"2,800,000.00",,-547745890.24,Jamieson,744,France,82422.97,0,1,0
3757,2011,9,RENT,1,Low,1,3500, 36 months,1,debt_consolidation,6,High,2,Good Loan,0,13.49,C,3,22.15,4173.24,3500,0,118.76,409000003756,1-Jun-17,MASTER POSDOM ACQ SETTL26,,210467.47,-547535422.77,Fomina,755,France,194660.78,0,1,0
3758,2011,9,MORTGAGE,3,Low,1,10200, 60 months,2,car,2,Low,1,Good Loan,0,7.9,A,1,4.54,12243.97742,10200,0,206.34,409000003757,1-Jun-17,MAESTRO POSDOM ACQ SETTL2,,61795.57,-547473627.20,Aksenov,593,Spain,55347.28,0,1,0
3759,2011,4,RENT,1,Low,1,8875, 36 months,1,home_improvement,7,High,2,Good Loan,0,19.03,E,5,24.69,11336.79,8875,0,325.46,409000003758,1-Jun-17,RUPAY POS ACQ SETTL 26051,,856211.12,-546617416.08,Turnbull,514,France,16717.11,0,1,0
3760,2011,7,RENT,1,Low,1,2300, 36 months,1,debt_consolidation,6,Low,1,Good Loan,0,11.71,B,2,12.08,2737.360009,2300,0,76.08,409000003759,2-Jun-17,VISA POSDOM ACQ SETTL 010,,813029.34,-545804386.74,Dixon,721,France,160277.65,0,1,0
3761,2011,3,RENT,1,Low,1,6850, 36 months,1,credit_card,1,Low,1,Bad Loan,1,10.65,B,2,22.42,3834.49,2951.62,0,223.13,409000003760,2-Jun-17,VISA POSINT ACQ SETTL 010,,204.72,-545804182.02,White,835,Spain,175905.97,0,1,0
3762,2011,6,MORTGAGE,3,Low,1,6000, 36 months,1,debt_consolidation,6,Low,1,Good Loan,0,7.9,A,1,10.69,6288.19,6000,0,187.75,409000003761,2-Jun-17,MASTER POSDOM ACQ SETTL01,,280490.90,-545523691.12,Long,682,France,66040.83,0,1,0
3763,2011,1,OWN,2,Low,1,12300, 36 months,1,debt_consolidation,6,Low,1,Good Loan,0,6.62,A,1,16.51,13381.74,12300,0,377.66,409000003762,2-Jun-17,MAESTRO POSDOM ACQ SETTL0,,78543.85,-545445147.27,Han,590,Germany,92198.05,0,1,0
3764,2011,6,RENT,1,Low,1,14000, 60 months,2,debt_consolidation,6,High,2,Good Loan,0,18.64,E,5,8.46,19654.86233,14000,0,360.41,409000003763,2-Jun-17,RUPAY POS ACQ SETTL 01061,,1061320.64,-544383826.63,Belov,653,Germany,134625.09,0,1,0
3765,2011,7,OWN,2,Low,1,14000, 36 months,1,credit_card,1,High,2,Good Loan,0,16.29,D,4,16.76,16947.77,14000,0,494.21,409000003764,2-Jun-17,17825-INTL-SETTLEMENT-260,,1914.01,-544381912.62,MacDonald,837,France,50974.57,0,1,0
3766,2011,3,RENT,1,Medium,2,16000, 36 months,1,debt_consolidation,6,Low,1,Good Loan,0,7.9,A,1,3.25,16106.05,16000,0,500.65,409000003765,2-Jun-17,TRF TO  Indiaforensic SERVICES I,"3,800,000.00",,-548181912.62,Parsons,841,France,171922.72,0,1,0
3767,2011,10,MORTGAGE,3,Low,1,6000, 36 months,1,small_business,3,High,2,Good Loan,0,15.27,C,3,15.38,7506.264121,6000,0,208.79,409000003766,3-Jun-17,MASTER POSDOM ACQ SETTL02,,351440.17,-547830472.45,Cross,584,Spain,83058.14,0,1,0
3768,2011,10,MORTGAGE,3,Low,1,6300, 36 months,1,medical,9,Low,1,Good Loan,0,11.71,B,2,20.88,7391.71,6300,0,208.38,409000003767,3-Jun-17,MAESTRO POSDOM ACQ SETTL0,,140930.80,-547689541.65,Milanesi,769,France,188382.77,0,1,0
3769,2011,5,MORTGAGE,3,High,3,35000, 60 months,2,debt_consolidation,6,High,2,Good Loan,0,14.27,C,3,8.54,40932.06,27299.63,0,819.3,409000003768,3-Jun-17,VISA POSDOM ACQ SETTL 020,,896188.45,-546793353.20,Lombardo,599,Spain,198030.24,0,1,0
3770,2011,7,MORTGAGE,3,Low,1,6200, 36 months,1,credit_card,1,Low,1,Good Loan,0,6.03,A,1,22.61,6732.13,6200,0,188.71,409000003769,3-Jun-17,RUPAY POS ACQ SETTL 02061,,747780.95,-546045572.25,Collins,698,France,1055.66,0,1,0
3771,2011,0.5,MORTGAGE,3,Low,1,7200, 36 months,1,debt_consolidation,6,Low,1,Good Loan,0,8.9,A,1,14.29,8229.061747,7200,0,228.63,409000003770,3-Jun-17,TRF TO  Indiaforensic SERVICES I,"2,200,000.00",,-548245572.25,Alexeieva,477,France,133173.19,0,1,0
3772,2011,0.5,RENT,1,Low,1,4600, 36 months,1,debt_consolidation,6,Low,1,Good Loan,0,11.71,B,2,18.87,5473.586699,4600,0,152.15,409000003771,5-Jun-17,RUPAY POS ACQ SETTL 03061,,1367044.69,-546878527.56,Cullen,477,Germany,189875.83,0,1,0
3773,2011,2,RENT,1,Low,1,10625, 36 months,1,credit_card,1,Low,1,Good Loan,0,6.03,A,1,20.8,11177.59,10625,0,323.38,409000003772,5-Jun-17,RUPAY POS ACQ SETTL 04061,,1085596.88,-545792930.68,Johnson,745,Spain,31802.92,0,1,0
3774,2011,6,MORTGAGE,3,Low,1,1800, 36 months,1,home_improvement,7,Low,1,Good Loan,0,11.71,B,2,13.97,2141.760758,1800,0,59.54,409000003773,5-Jun-17,MASTER POSDOM ACQ SETTL03,,308367.71,-545484562.97,Rudd,749,France,132649.85,0,1,0
3775,2011,10,MORTGAGE,3,Low,1,15000, 60 months,2,debt_consolidation,6,High,2,Good Loan,0,14.27,C,3,5.08,19597.99599,15000,0,351.13,409000003774,5-Jun-17,MAESTRO POSDOM ACQ SETTL0,,61263.68,-545423299.29,Findlay,850,France,53067.83,0,1,0
3776,2011,0.5,MORTGAGE,3,Medium,2,18550, 60 months,2,debt_consolidation,6,High,2,Bad Loan,1,19.42,E,5,22.03,15877.65,4318.03,6168.5,485.5,409000003775,5-Jun-17,VISA POSDOM ACQ SETTL 030,,911713.67,-544511585.62,Mai,528,Germany,961.57,0,1,0
3777,2011,5,RENT,1,Low,1,7000, 36 months,1,debt_consolidation,6,Low,1,Good Loan,0,6.03,A,1,21.05,7397.14,7000,0,213.05,409000003776,5-Jun-17,VISA POSINT ACQ SETTL 040,,1512.73,-544510072.89,Morrison,750,France,71333.44,0,1,0
3778,2011,0.5,MORTGAGE,3,Low,1,10200, 36 months,1,debt_consolidation,6,High,2,Good Loan,0,17.27,D,4,15.39,11282.31,10200,0,365.03,409000003777,5-Jun-17,TRF TO  Indiaforensic SERVICES I,"3,700,000.00",,-548210072.89,Monaldo,543,France,16658.76,0,1,0
3779,2011,7,RENT,1,Low,1,16000, 60 months,2,debt_consolidation,6,Low,1,Good Loan,0,12.69,B,2,6.05,19225.14109,16000,0,361.52,409000003778,6-Jun-17,VISA POSDOM ACQ SETTL 050,,1656193.13,-546553879.76,Gidney,579,Spain,74878.22,0,1,0
3780,2011,0.5,RENT,1,Low,1,2000, 36 months,1,debt_consolidation,6,Low,1,Bad Loan,1,11.71,B,2,21.56,326.84,188.58,63.24,66.16,409000003779,6-Jun-17,MASTER POSDOM ACQ SETTL05,,489570.59,-546064309.17,Sagese,624,France,112104.55,0,1,0
3781,2011,0.5,RENT,1,Low,1,13000, 36 months,1,debt_consolidation,6,Low,1,Good Loan,0,12.42,B,2,18.26,15622.75532,13000,0,434.4,409000003780,6-Jun-17,MAESTRO POSDOM ACQ SETTL0,,201271.73,-545863037.44,Wall,595,Germany,48421.40,0,1,0
3782,2011,2,MORTGAGE,3,Low,1,8000, 36 months,1,debt_consolidation,6,Low,1,Good Loan,0,6.03,A,1,16.49,8757.786649,8000,0,243.49,409000003781,6-Jun-17,RUPAY POS ACQ SETTL 05061,,940088.08,-544922949.36,Dalton,596,Germany,170320.58,0,1,0
3783,2011,2,RENT,1,Low,1,7200, 36 months,1,credit_card,1,Low,1,Good Loan,0,9.91,B,2,12.78,8350.682706,7200,0,232.02,409000003782,6-Jun-17,TRF TO  Indiaforensic ONLINE SER,"3,200,000.00",,-548122949.36,Hsing,431,Germany,37688.31,0,1,0
3784,2011,10,MORTGAGE,3,Low,1,35000, 60 months,2,credit_card,1,Low,1,Bad Loan,1,11.71,B,2,12.23,25295.29,14381.9,2888.48,773.44,409000003783,7-Jun-17,VISA POSDOM ACQ SETTL 060,,1282721.93,-546840227.43,Warner,647,Spain,136592.24,0,1,0
3785,2011,6.05,OWN,2,Low,1,4400, 36 months,1,credit_card,1,Low,1,Good Loan,0,6.62,A,1,8.96,4775.36,4400,0,135.1,409000003784,7-Jun-17,VISA POSINT ACQ SETTL 060,,867.11,-546839360.32,Williams,640,France,48640.77,0,1,0
3786,2011,8,MORTGAGE,3,Medium,2,24000, 36 months,1,credit_card,1,Low,1,Good Loan,0,8.9,A,1,16.91,27432.00973,24000,0,762.08,409000003785,7-Jun-17,MASTER POSDOM ACQ SETTL06,,408942.01,-546430418.31,Dunn,752,Germany,89773.45,0,1,0
3787,2011,3,RENT,1,Low,1,31825, 60 months,2,credit_card,1,High,2,Good Loan,0,21.67,F,6,24.29,49202.38855,31825,0,873.02,409000003786,7-Jun-17,MAESTRO POSDOM ACQ SETTL0,,80912.23,-546349506.08,Kerr,710,Germany,42131.26,0,1,0
3788,2011,0.5,MORTGAGE,3,Low,1,14000, 36 months,1,credit_card,1,High,2,Good Loan,0,14.27,C,3,22.78,16864.76,14000,0,480.33,409000003787,7-Jun-17,RUPAY POS ACQ SETTL 06061,,823459.68,-545526046.40,Marchesi,638,Germany,186523.72,0,1,0
3789,2011,7,MORTGAGE,3,Low,1,10000, 36 months,1,home_improvement,7,High,2,Good Loan,0,13.49,C,3,13.02,10222.96,10000,0,339.31,409000003788,7-Jun-17,TRF TO  Indiaforensic SERVICES I,"2,700,000.00",,-548226046.40,Endrizzi,660,Germany,41758.90,0,1,0
3790,2011,10,MORTGAGE,3,Low,1,6000, 36 months,1,credit_card,1,Low,1,Good Loan,0,7.51,A,1,21.52,6178.27,6000,0,186.67,409000003789,8-Jun-17,VISA POSDOM ACQ SETTL 070,"47,565.60",,-548273612.00,King,609,Spain,199256.98,0,1,0
3791,2011,6,MORTGAGE,3,Low,1,12000, 36 months,1,home_improvement,7,Low,1,Good Loan,0,9.91,B,2,15.16,13640.02,12000.01,0,386.7,409000003790,8-Jun-17,VISA POSINT ACQ SETTL 070,,229.79,-548273382.21,Griffiths,596,Spain,153482.91,0,1,0
3792,2011,0.5,RENT,1,Low,1,8000, 36 months,1,other,4,High,2,Good Loan,0,17.58,D,4,6.04,8223.17,8000,0,287.54,409000003791,8-Jun-17,RUPAY POS ACQ SETTL 07061,,1285362.51,-546988019.70,Hartzler,705,France,21177.10,0,1,0
3793,2011,4,MORTGAGE,3,Low,1,25000, 60 months,2,debt_consolidation,6,High,2,Good Loan,0,16.77,D,4,21.27,30829.15,19224.6,0,618.23,409000003792,8-Jun-17,MASTER POSDOM ACQ SETTL07,,281884.39,-546706135.31,Chukwudi,444,France,138743.86,0,1,0
3794,2011,5,RENT,1,Low,1,8000, 36 months,1,home_improvement,7,Low,1,Good Loan,0,12.42,B,2,2.21,9620.896406,8000,0,267.33,409000003793,8-Jun-17,MAESTRO POSDOM ACQ SETTL0,,67591.15,-546638544.16,Denisov,727,Germany,25881.00,0,1,0
3795,2011,6,MORTGAGE,3,Low,1,8000, 36 months,1,major_purchase,8,Low,1,Good Loan,0,6.62,A,1,14.63,8285.21,8000,0,245.63,409000003794,8-Jun-17,TRF TO  Indiaforensic SERVICES I,"1,600,000.00",,-548238544.16,Endrizzi,496,France,66469.20,0,1,0
3796,2011,6,RENT,1,High,3,35000, 60 months,2,house,12,High,2,Good Loan,0,21.67,F,6,14.25,45366.46,35000.01,0,960.11,409000003795,9-Jun-17,VISA POSDOM ACQ SETTL 080,,1887980.35,-546350563.81,Baresi,554,France,142670.61,0,1,0
3797,2011,0.5,RENT,1,Low,1,12000, 36 months,1,debt_consolidation,6,Low,1,Good Loan,0,11.71,B,2,24.18,14284.86996,12000,0,396.92,409000003796,9-Jun-17,MASTER POSDOM ACQ SETTL08,,287743.11,-546062820.70,Nnachetam,537,France,103563.23,0,1,0
3798,2011,10,RENT,1,Low,1,14000, 36 months,1,home_improvement,7,Low,1,Good Loan,0,6.03,A,1,9.14,15057.11,14000,0,426.1,409000003797,9-Jun-17,MAESTRO POSDOM ACQ SETTL0,,92027.81,-545970792.89,Lambert,839,France,69101.23,0,1,0
3799,2011,10,RENT,1,Low,1,27525, 60 months,2,debt_consolidation,6,High,2,Good Loan,0,22.06,F,6,10.57,38037.79,20621.27,0,761.15,409000003798,9-Jun-17,RUPAY POS ACQ SETTL 08061,,1514400.74,-544456392.15,Game,700,Spain,59475.35,0,1,0
3800,2011,9,MORTGAGE,3,Low,1,4400, 36 months,1,credit_card,1,High,2,Good Loan,0,16.29,D,4,22.92,5590.290343,4400,0,155.33,409000003799,9-Jun-17,TRF TO  Indiaforensic SERVICES I,"3,400,000.00",,-547856392.15,Chinagorom,458,Spain,135287.74,0,1,0
3801,2011,0.5,MORTGAGE,3,Low,1,8000, 36 months,1,home_improvement,7,Low,1,Good Loan,0,7.51,A,1,9.04,8146.79,8000,0,248.89,409000003800,12-Jun-17,VISA POSDOM ACQ SETTL 090,,1019588.97,-546836803.18,Noble,850,France,38773.74,0,1,0
3802,2011,6,MORTGAGE,3,Medium,2,30000, 60 months,2,other,4,Low,1,Good Loan,0,11.71,B,2,12.61,36334.17,30000,0,662.95,409000003801,12-Jun-17,VISA POSDOM ACQ SETTL 100,,983554.04,-545853249.14,Haynes,699,Spain,138396.32,0,1,0
3803,2011,10,MORTGAGE,3,Low,1,30000, 60 months,2,debt_consolidation,6,High,2,Good Loan,0,14.27,C,3,0.2,39305.56416,30000,0,702.26,409000003802,12-Jun-17,VISA POSINT ACQ SETTL 100,,3962.71,-545849286.43,Cattaneo,615,Germany,110718.02,0,1,0
3804,2011,3,MORTGAGE,3,Medium,2,14000, 36 months,1,small_business,3,Low,1,Good Loan,0,6.03,A,1,0.87,15338.79857,14000,0,426.1,409000003803,12-Jun-17,VISA POSINT ACQ SETTL 110,,8901.00,-545840385.43,Yobanna,850,Germany,118545.49,0,1,0
3805,2011,10,MORTGAGE,3,Medium,2,10000, 36 months,1,major_purchase,8,Low,1,Good Loan,0,7.9,A,1,10.39,11263.29695,10000,0,312.91,409000003804,12-Jun-17,MASTER POSDOM ACQ SETTL09,,235345.57,-545605039.86,Fraser,604,France,123207.17,0,1,0
3806,2011,10,RENT,1,Low,1,4900, 36 months,1,debt_consolidation,6,Low,1,Good Loan,0,11.71,B,2,23.72,5767.168301,4900,0,162.08,409000003805,12-Jun-17,MAESTRO POSDOM ACQ SETTL0,,110928.27,-545494111.59,Rhodes,668,Spain,99984.86,0,1,0
3807,2011,7,MORTGAGE,3,Low,1,14000, 60 months,2,other,4,High,2,Good Loan,0,20.3,E,5,5.95,18620.88,10570.6,0,373.26,409000003806,12-Jun-17,MASTER POSDOM ACQ SETTL10,,458351.12,-545035760.47,Jimenez,594,Spain,58332.91,0,1,0
3808,2011,10,MORTGAGE,3,Low,1,4500, 36 months,1,major_purchase,8,Low,1,Good Loan,0,6.62,A,1,1.54,4639.39,4500,0,138.17,409000003807,12-Jun-17,MAESTRO POSDOM ACQ SETTL1,,94697.30,-544941063.17,Pharr,470,France,50906.65,0,1,0
3809,2011,10,MORTGAGE,3,Medium,2,15000, 36 months,1,debt_consolidation,6,Low,1,Good Loan,0,7.9,A,1,16.36,16893.8713,15000,0,469.36,409000003808,12-Jun-17,RUPAY POS ACQ SETTL 09061,,994956.79,-543946106.38,Jerger,701,Germany,127623.36,0,1,0
3810,2011,0.5,MORTGAGE,3,Low,1,22800, 60 months,2,small_business,3,High,2,Good Loan,0,22.06,F,6,23.41,35576.69816,22800,0,630.49,409000003809,12-Jun-17,RUPAY POS ACQ SETTL 10061,,1314498.75,-542631607.63,McIntyre,664,Spain,169665.79,0,1,0
3811,2011,2,MORTGAGE,3,Low,1,12000, 36 months,1,debt_consolidation,6,Low,1,Bad Loan,1,11.71,B,2,8.57,11536.99,8938.77,423.23,396.92,409000003810,12-Jun-17,RUPAY POS ACQ SETTL 11061,,1663076.60,-540968531.03,Onio,477,France,194144.45,0,1,0
3812,2011,6.05,RENT,1,Low,1,20000, 60 months,2,debt_consolidation,6,High,2,Good Loan,0,19.42,E,5,20.59,26130.11,15183.2,0,523.45,409000003811,12-Jun-17,TRF TO  Indiaforensic SERVICES I,"7,300,000.00",,-548268531.03,Tomlinson,756,France,35673.42,0,1,0
3813,2011,6,MORTGAGE,3,Low,1,25500, 60 months,2,small_business,3,High,2,Bad Loan,1,14.65,C,3,17.69,4175.78,1183.96,850.18,601.97,409000003812,13-Jun-17,MASTER POSDOM ACQ SETTL12,,902613.64,-547365917.39,Onuoha,625,France,177397.49,0,1,0
3814,2011,6.05,RENT,1,Low,1,12000, 36 months,1,medical,9,Low,1,Good Loan,0,8.9,A,1,10.64,13572.94252,12000,0,381.04,409000003813,13-Jun-17,MAESTRO POSDOM ACQ SETTL1,,175810.39,-547190107.00,Panicucci,703,Spain,159677.46,0,1,0
3815,2011,4,RENT,1,Low,1,14000, 36 months,1,other,4,Low,1,Good Loan,0,12.69,B,2,20.19,16685.26055,14000,0,469.63,409000003814,13-Jun-17,RUPAY POS ACQ SETTL 12061,,1609239.90,-545580867.10,Piccio,646,France,153566.97,0,1,0
3816,2011,7,RENT,1,Medium,2,35000, 60 months,2,small_business,3,High,2,Bad Loan,1,22.06,F,6,13.56,6310.03,1055.97,0,967.86,409000003815,13-Jun-17,VISA POSDOM ACQ SETTL 120,,2487188.85,-543093678.25,Ramsden,650,France,52411.99,0,1,0
3817,2011,6,MORTGAGE,3,Low,1,17750, 60 months,2,debt_consolidation,6,High,2,Bad Loan,1,20.3,E,5,13.73,8044.5,3319.3,0,473.24,409000003816,13-Jun-17,VISA POSINT ACQ SETTL 120,,11880.00,-543081798.25,Vorobyova,664,France,79222.02,0,1,0
3818,2011,0.5,RENT,1,Low,1,2400, 36 months,1,other,4,Low,1,Good Loan,0,11.71,B,2,22.33,2856.11745,2400,0,79.39,409000003817,13-Jun-17,TRF TO  Indiaforensic SERVICES I,"5,100,000.00",,-548181798.25,Todd,682,Germany,32589.89,0,1,0
3819,2011,10,MORTGAGE,3,Low,1,35000, 60 months,2,debt_consolidation,6,High,2,Good Loan,0,22.06,F,6,21.81,47404.6,25431.6,0,967.86,409000003818,14-Jun-17,MASTER POSDOM ACQ SETTL13,,570350.53,-547611447.72,Cremonesi,725,France,93777.61,0,1,0
3820,2011,4,MORTGAGE,3,Low,1,14000, 36 months,1,credit_card,1,Low,1,Good Loan,0,6.03,A,1,11.19,14271.57,14000,0,426.1,409000003819,14-Jun-17,MAESTRO POSDOM ACQ SETTL1,,133999.38,-547477448.34,Bradley,553,Germany,112549.99,0,1,0
3821,2011,10,MORTGAGE,3,Low,1,8000, 36 months,1,credit_card,1,High,2,Good Loan,0,14.27,C,3,13.77,9763.430333,8000,0,274.48,409000003820,14-Jun-17,VISA POSDOM ACQ SETTL 130,,1308245.28,-546169203.06,Stanley,576,France,191063.36,0,1,0
3822,2011,5,RENT,1,Low,1,6000, 36 months,1,major_purchase,8,Low,1,Good Loan,0,9.91,B,2,8.35,6958.101957,6000,0,193.35,409000003821,14-Jun-17,TRF TO  Indiaforensic SERVICES I,"2,100,000.00",,-548269203.06,Jowett,608,Spain,153810.41,0,1,0
3823,2011,5,RENT,1,Low,1,4400, 36 months,1,other,4,Low,1,Good Loan,0,11.71,B,2,3.01,5237.223329,4400,0,145.54,409000003822,15-Jun-17,MASTER POSDOM ACQ SETTL14,,287311.13,-547981891.93,Yefremova,850,France,105886.77,0,1,0
3824,2011,4,RENT,1,Low,1,15000, 60 months,2,debt_consolidation,6,High,2,Bad Loan,1,15.96,C,3,16.59,9998.93,3732.18,2711.84,364.46,409000003823,15-Jun-17,MAESTRO POSDOM ACQ SETTL1,,139277.81,-547842614.12,Wilson,627,France,96131.47,0,1,0
3825,2011,4,MORTGAGE,3,Low,1,2100, 36 months,1,major_purchase,8,Low,1,Good Loan,0,9.91,B,2,14.28,2435.195222,2100,0,67.68,409000003824,15-Jun-17,VISA POSDOM ACQ SETTL 140,,1105773.09,-546736841.03,Abramovich,667,France,15120.86,0,1,0
3826,2011,4,MORTGAGE,3,Low,1,18550, 60 months,2,small_business,3,High,2,Bad Loan,1,17.27,D,4,17.93,6933.65,2780.23,928.04,463.72,409000003825,15-Jun-17,TRF TO  Indiaforensic SERVICES I,"1,500,000.00",,-548236841.03,Venables,548,Spain,16989.77,0,1,0
3827,2011,2,RENT,1,Low,1,6000, 36 months,1,other,4,Low,1,Bad Loan,1,6.62,A,1,19.45,922.13,607.16,188.09,184.23,409000003826,15-Jun-17,RUPAY POS ACQ SETTL 14061,,1773990.76,-546462850.27,Monnier,774,France,143133.18,0,1,0
3828,2011,7,RENT,1,Low,1,6000, 36 months,1,other,4,Low,1,Good Loan,0,12.42,B,2,16.4,7221.796929,6000,0,200.5,409000003827,16-Jun-17,MASTER POSDOM ACQ SETTL15,,304806.89,-546158043.38,Hsieh,794,Germany,93336.93,0,1,0
3829,2011,3,MORTGAGE,3,Low,1,6000, 36 months,1,debt_consolidation,6,High,2,Good Loan,0,13.49,C,3,12.48,7035.03,6000,0,203.59,409000003828,16-Jun-17,MAESTRO POSDOM ACQ SETTL1,,178278.28,-545979765.10,Gadsden,497,Germany,9972.64,0,1,0
3830,2011,4,MORTGAGE,3,Low,1,14000, 60 months,2,debt_consolidation,6,Low,1,Good Loan,0,8.9,A,1,11.94,14436.25,11172.59,0,289.94,409000003829,16-Jun-17,VISA POSDOM ACQ SETTL 150,,1143929.05,-544835836.05,Ni,587,France,30579.82,0,1,0
3831,2011,10,RENT,1,Low,1,9500, 60 months,2,debt_consolidation,6,High,2,Good Loan,0,19.42,E,5,16.95,14332.43223,9500,0,248.64,409000003830,16-Jun-17,TRF TO  Indiaforensic SERVICES I,"3,400,000.00",,-548235836.05,Chibueze,850,France,199775.67,0,1,0
3832,2011,3,RENT,1,Low,1,6000, 36 months,1,debt_consolidation,6,Low,1,Good Loan,0,12.42,B,2,15.36,6214.1,6000,0,200.5,409000003831,16-Jun-17,RUPAY POS ACQ SETTL 13061,,1663156.87,-546572679.18,Chinwemma,722,France,179908.71,0,1,0
3833,2011,3,RENT,1,Low,1,4200, 36 months,1,debt_consolidation,6,Low,1,Good Loan,0,7.9,A,1,9.43,4729.956661,4200,0,131.42,409000003832,17-Jun-17,MASTER POSDOM ACQ SETTL16,,289730.64,-546282948.54,Kang,555,Spain,101667.00,0,1,0
3834,2011,7,RENT,1,Low,1,20000, 36 months,1,debt_consolidation,6,Low,1,Good Loan,0,10.65,B,2,2.35,23446.99075,20000,0,651.47,409000003833,17-Jun-17,MAESTRO POSDOM ACQ SETTL1,,58311.72,-546224636.82,Kuo,609,Germany,171430.16,0,1,0
3835,2011,1,RENT,1,Low,1,1000, 36 months,1,other,4,High,2,Good Loan,0,14.27,C,3,14.13,1233.970281,1000,0,34.31,409000003834,17-Jun-17,VISA POSDOM ACQ SETTL 160,,881191.85,-545343444.97,Ositadimma,734,Spain,112973.34,0,1,0
3836,2011,10,RENT,1,Medium,2,18400, 36 months,1,other,4,Low,1,Good Loan,0,8.9,A,1,2.1,20877.54689,18400,0,584.26,409000003835,17-Jun-17,VISA POSINT ACQ SETTL 160,,3956.00,-545339488.97,Smith,718,Germany,190746.38,0,1,0
3837,2011,10,RENT,1,Low,1,12400, 36 months,1,debt_consolidation,6,Low,1,Good Loan,0,6.62,A,1,26.67,13704.11656,12400,0,380.73,409000003836,17-Jun-17,RUPAY POS ACQ SETTL 15061,,2059078.96,-543280410.01,Okwudilichukwu,645,Spain,187689.91,0,1,0
3838,2011,10,MORTGAGE,3,Low,1,15000, 36 months,1,vacation,11,Low,1,Good Loan,0,6.03,A,1,8.35,16411.87252,15000,0,456.54,409000003837,17-Jun-17,TRF TO  Indiaforensic SERVICES I,"1,500,000.00",,-544780410.01,Porter,598,Spain,153229.19,0,1,0
3839,2011,10,MORTGAGE,3,High,3,8000, 36 months,1,other,4,Low,1,Good Loan,0,9.91,B,2,4.53,9278.486257,8000,0,257.8,409000003838,17-Jun-17,TRF TO  Indiaforensic SERVICES I,"1,000,000.00",,-545780410.01,Kung,628,Germany,14217.77,0,1,0
3840,2011,6,RENT,1,Low,1,2000, 36 months,1,credit_card,1,Low,1,Good Loan,0,6.62,A,1,27.22,2209.92698,2000,0,61.41,409000003839,19-Jun-17,MASTER POSDOM ACQ SETTL17,,209929.75,-545570480.26,Trevisano,629,Germany,64849.74,0,1,0
3841,2011,9,RENT,1,Low,1,10000, 36 months,1,debt_consolidation,6,Low,1,Good Loan,0,12.69,B,2,10.75,12068.73687,10000,0,335.45,409000003840,19-Jun-17,MAESTRO POSDOM ACQ SETTL1,,42545.50,-545527934.76,Naylor,739,Germany,160122.66,0,1,0
3842,2011,7,RENT,1,Low,1,16750, 60 months,2,debt_consolidation,6,High,2,Good Loan,0,14.27,C,3,22.36,21472.80959,16750,0,392.1,409000003841,19-Jun-17,VISA POSDOM ACQ SETTL 170,,461168.87,-545066765.89,Ponomarev,653,France,138160.11,0,1,0
3843,2011,1,MORTGAGE,3,Low,1,14000, 60 months,2,debt_consolidation,6,High,2,Good Loan,0,14.27,C,3,5.6,18262.99471,14000,0,327.72,409000003842,19-Jun-17,TRF TO  Indiaforensic SERVICES I,"3,200,000.00",,-548266765.89,Udinese,711,France,64286.39,0,1,0
3844,2011,9,MORTGAGE,3,Medium,2,30000, 36 months,1,debt_consolidation,6,Low,1,Good Loan,0,8.9,A,1,15.19,33912.55,30000,0,952.6,409000003843,19-Jun-17,RUPAY POS ACQ SETTL 16061,,1472745.36,-546794020.53,Aliyeva,783,Spain,80178.54,0,1,0
3845,2011,6,RENT,1,Low,1,10000, 36 months,1,debt_consolidation,6,Low,1,Good Loan,0,7.9,A,1,9.38,10275.58,10000,0,312.91,409000003844,19-Jun-17,RUPAY POS ACQ SETTL 17061,,1264197.49,-545529823.04,Bailey,681,France,101319.76,0,1,0
3846,2011,10,MORTGAGE,3,Low,1,10375, 36 months,1,debt_consolidation,6,Low,1,Good Loan,0,11.71,B,2,19.52,11867.84,10375,0,343.17,409000003845,19-Jun-17,RUPAY POS ACQ SETTL 19061,,1279247.82,-544250575.22,Jackson,712,France,92794.61,0,1,0
3847,2011,1,RENT,1,Low,1,5000, 36 months,1,debt_consolidation,6,High,2,Good Loan,0,15.96,C,3,10.91,6319.034689,5000,0,175.69,409000003846,20-Jun-17,MASTER POSDOM ACQ SETTL19,,588471.58,-543662103.64,Yin,554,France,63708.07,0,1,0
3848,2011,7,MORTGAGE,3,Low,1,9200, 36 months,1,debt_consolidation,6,Low,1,Good Loan,0,6.03,A,1,8.03,10003.36699,9200,0,280.01,409000003847,20-Jun-17,MAESTRO POSDOM ACQ SETTL1,,186420.18,-543475683.46,Akobundu,611,France,110782.88,0,1,0
3849,2011,0.5,MORTGAGE,3,Medium,2,34000, 60 months,2,debt_consolidation,6,High,2,Good Loan,0,14.27,C,3,4.97,42983.63002,34000,0,795.89,409000003848,20-Jun-17,VISA POSDOM ACQ SETTL 190,,1597825.81,-541877857.65,Byrne,560,Germany,10779.69,0,1,0
3850,2011,9,RENT,1,Low,1,35000, 60 months,2,debt_consolidation,6,Low,1,Good Loan,0,12.42,B,2,21,41880.49,35000,0,786.01,409000003849,20-Jun-17,TRF TO  Indiaforensic SERVICES I,"6,300,000.00",,-548177857.65,Robinson,646,Spain,183289.22,0,1,0
3851,2011,10,MORTGAGE,3,Medium,2,12000, 60 months,2,debt_consolidation,6,Low,1,Bad Loan,1,12.42,B,2,16.81,13205.97,9186.8,0,269.49,409000003850,21-Jun-17,MASTER POSDOM ACQ SETTL20,,278030.87,-547899826.78,Stephenson,680,France,66526.01,0,1,0
3852,2011,6.05,RENT,1,Low,1,5000, 36 months,1,debt_consolidation,6,Low,1,Bad Loan,1,9.91,B,2,28.77,1465.07,361.01,983.66,161.13,409000003851,21-Jun-17,MAESTRO POSDOM ACQ SETTL2,,91367.50,-547808459.28,Chiemenam,631,France,123697.95,0,1,0
3853,2011,6.05,OWN,2,Low,1,6350, 60 months,2,debt_consolidation,6,Low,1,Bad Loan,1,11.71,B,2,23.41,6879.52,730.57,5621.5,140.33,409000003852,21-Jun-17,RUPAY POS ACQ SETTL 20061,,1363569.72,-546444889.56,Forbes,746,France,155700.15,0,1,0
3854,2011,10,MORTGAGE,3,Low,1,13000, 60 months,2,medical,9,High,2,Bad Loan,1,16.77,D,4,9.37,2962.59,1020.24,687.62,321.48,409000003853,21-Jun-17,VISA POSDOM ACQ SETTL 200,,913734.38,-545531155.18,Douglas,654,Germany,82081.35,0,1,0
3855,2011,10,MORTGAGE,3,Low,1,35000, 60 months,2,medical,9,High,2,Bad Loan,1,15.27,C,3,21.45,16632.6,7857.03,1558.07,837.62,409000003854,21-Jun-17,TRF TO  Indiaforensic SERVICES I,"2,700,000.00",,-548231155.18,Okechukwu,687,Germany,121747.96,0,1,0
3856,2011,2,MORTGAGE,3,Low,1,20000, 60 months,2,debt_consolidation,6,Low,1,Good Loan,0,10.65,B,2,21,25467.15139,20000,0,431.37,409000003855,21-Jun-17,RUPAY POS ACQ SETTL 21061,,1685079.09,-546546076.09,Russell,708,Germany,172810.51,0,1,0
3857,2011,10,MORTGAGE,3,Medium,2,25000, 60 months,2,home_improvement,7,High,2,Good Loan,0,18.25,D,4,7.31,31852.83,19091.66,0,638.25,409000003856,21-Jun-17,17825-INTL-SETTLEMENT-090,,14756.43,-546531319.66,Ermakova,679,Germany,159584.81,0,1,0
3858,2011,10,MORTGAGE,3,Low,1,14000, 60 months,2,debt_consolidation,6,High,2,Good Loan,0,13.49,C,3,8.65,17619.6341,14000,0,322.07,409000003857,21-Jun-17,17825-INTL-SETTLEMENT-100,,4919.24,-546526400.42,Oster,636,France,108402.54,0,1,0
3859,2011,5,MORTGAGE,3,Medium,2,25000, 60 months,2,debt_consolidation,6,Low,1,Good Loan,0,12.69,B,2,5.56,25942.51,25000,0,564.87,409000003858,21-Jun-17,17825-INTL-SETTLEMENT-170,,16176.25,-546510224.17,Chizoba,695,France,77330.35,0,1,0
3860,2011,2,MORTGAGE,3,Low,1,3600, 36 months,1,major_purchase,8,High,2,Good Loan,0,16.29,D,4,14.24,4573.849262,3600,0,127.09,409000003859,21-Jun-17,17825-INTL-SETTLEMENT-190,,4901.89,-546505322.28,Bianchi,677,France,21007.96,0,1,0
3861,2011,5,MORTGAGE,3,Low,1,5500, 36 months,1,debt_consolidation,6,Low,1,Bad Loan,1,10.65,B,2,13.5,3397.77,2679.79,0,179.16,409000003860,22-Jun-17,MASTER POSDOM ACQ SETTL21,,228413.78,-546276908.50,Peyser,720,France,9398.45,0,1,0
3862,2011,2,RENT,1,Low,1,3600, 36 months,1,debt_consolidation,6,Low,1,Good Loan,0,7.51,A,1,29.25,3706.92,3600,0,112,409000003861,22-Jun-17,MAESTRO POSDOM ACQ SETTL2,,55726.22,-546221182.28,Cocci,780,France,182156.81,0,1,0
3863,2011,4,RENT,1,Low,1,5000, 36 months,1,debt_consolidation,6,Low,1,Good Loan,0,10.65,B,2,15.34,5653.08,5000,0,162.87,409000003862,22-Jun-17,VISA POSDOM ACQ SETTL 210,,792765.78,-545428416.50,Seleznev,653,Spain,110525.60,0,1,0
3864,2011,2,RENT,1,Low,1,12000, 36 months,1,debt_consolidation,6,Low,1,Good Loan,0,11.71,B,2,2.13,14283.80146,12000,0,396.92,409000003863,22-Jun-17,RUPAY POS ACQ SETTL 18061,,965683.90,-544462732.60,Huang,674,France,51536.99,0,1,0
3865,2011,5,MORTGAGE,3,Medium,2,16000, 36 months,1,credit_card,1,High,2,Good Loan,0,14.65,C,3,13.34,19683.23641,16000,0,551.91,409000003864,22-Jun-17,RUPAY POS ACQ SETTL 22061,,1756734.67,-542705997.93,Alleyne,620,Germany,49722.34,0,1,0
3866,2011,9,MORTGAGE,3,Low,1,15000, 36 months,1,home_improvement,7,Low,1,Good Loan,0,6.03,A,1,9.35,16074.53,15000,0,456.54,409000003865,22-Jun-17,TRF TO  Indiaforensic SERVICES I,"2,800,000.00",,-545505997.93,McKenzie,623,France,66119.07,0,1,0
3867,2011,3,RENT,1,Low,1,20000, 60 months,2,debt_consolidation,6,High,2,Good Loan,0,17.58,D,4,20.61,25080.95,15307.28,0,503.32,409000003866,23-Jun-17,MASTER POSDOM ACQ SETTL22,,266219.91,-545239778.02,Zikoranachukwudimma,547,France,37160.28,0,1,0
3868,2011,4,RENT,1,Low,1,10625, 36 months,1,debt_consolidation,6,Low,1,Good Loan,0,6.62,A,1,27.38,11597.65026,10625,0,326.23,409000003867,23-Jun-17,MAESTRO POSDOM ACQ SETTL2,,63473.77,-545176304.25,King,530,France,197923.05,0,1,0
3869,2011,2,MORTGAGE,3,Low,1,3600, 36 months,1,small_business,3,Low,1,Good Loan,0,9.91,B,2,10.37,4175.523024,3600,0,116.01,409000003868,23-Jun-17,VISA POSDOM ACQ SETTL 220,,671759.15,-544504545.10,Nkemdilim,746,France,65166.60,0,1,0
3870,2011,5,RENT,1,Low,1,8000, 36 months,1,other,4,High,2,Bad Loan,1,14.27,C,3,3.37,8235.98,6886.22,13.38,274.48,409000003869,23-Jun-17,TRF TO  Indiaforensic SERVICES I,"1,000,000.00",,-545504545.10,Anderson,512,France,49326.07,0,1,0
3871,2011,3,RENT,1,Low,1,8000, 36 months,1,other,4,Low,1,Good Loan,0,7.51,A,1,3.1,8550.57,8000,0,248.89,409000003870,23-Jun-17,TRF TO  Indiaforensic SERVICES I,"2,700,000.00",,-548204545.10,Ejikemeifeuwa,630,France,42495.81,0,1,0
3872,2011,7,MORTGAGE,3,Low,1,17000, 36 months,1,home_improvement,7,Low,1,Good Loan,0,6.03,A,1,6.72,18625.91231,17000,0,517.41,409000003871,23-Jun-17,RUPAY POS ACQ SETTL 23061,,1350219.75,-546854325.35,Adams,570,Spain,148087.62,0,1,0
3873,2011,6.05,MORTGAGE,3,Low,1,3500, 36 months,1,car,2,Low,1,Good Loan,0,9.91,B,2,23.2,4059.452882,3500,0,112.79,409000003872,27-Jun-17,VISA POSDOM ACQ SETTL 240,,1041531.44,-545812793.91,Christie,605,France,9641.40,0,1,0
3874,2011,3,RENT,1,Low,1,23000, 36 months,1,debt_consolidation,6,Low,1,Good Loan,0,11.71,B,2,19.86,27373.30006,23000,0,760.75,409000003873,27-Jun-17,VISA POSDOM ACQ SETTL 260,,1670723.01,-544142070.90,Yeh,530,Spain,164844.37,0,1,0
3875,2011,2,RENT,1,Low,1,15000, 36 months,1,debt_consolidation,6,Low,1,Good Loan,0,9.91,B,2,9,17398.21441,15000,0,483.38,409000003874,27-Jun-17,VISA POSINT ACQ SETTL 240,,4945.00,-544137125.90,McGregor,813,Germany,132959.33,0,1,0
3876,2011,2,MORTGAGE,3,Medium,2,25000, 36 months,1,small_business,3,Low,1,Good Loan,0,7.9,A,1,12.02,27932.44786,25000,0,782.26,409000003875,27-Jun-17,VISA POSINT ACQ SETTL 260,,1008.78,-544136117.12,Pisano,704,Spain,135088.58,0,1,0
3877,2011,10,RENT,1,Low,1,16000, 36 months,1,debt_consolidation,6,Low,1,Good Loan,0,11.71,B,2,7.8,19047.45406,16000,0,529.22,409000003876,27-Jun-17,VISA POSINT ACQ SETTL 250,,32209.94,-544103907.18,Ginikanwa,565,Germany,4441.54,0,1,0
3878,2011,1,MORTGAGE,3,Low,1,6625, 36 months,1,credit_card,1,Low,1,Good Loan,0,6.62,A,1,8.38,7174.35,6625,0,203.42,409000003877,27-Jun-17,MASTER POSDOM ACQ SETTL24,,297054.76,-543806852.42,Hawkins,645,Spain,174916.85,0,1,0
3879,2011,2,RENT,1,Low,1,3000, 36 months,1,debt_consolidation,6,Low,1,Good Loan,0,7.9,A,1,18.18,3378.593344,3000,0,93.88,409000003878,27-Jun-17,MAESTRO POSDOM ACQ SETTL2,,64345.72,-543742506.70,Otutodilichukwu,526,Germany,1795.93,0,1,0
3880,2011,10,MORTGAGE,3,Low,1,26375, 60 months,2,debt_consolidation,6,High,2,Good Loan,0,19.91,E,5,23.22,30544.76,26375,0,697.46,409000003879,27-Jun-17,MASTER POSDOM ACQ SETTL26,,485980.24,-543256526.46,Rickard,778,France,180249.94,0,1,0
3881,2011,2,RENT,1,Medium,2,25000, 36 months,1,credit_card,1,Low,1,Good Loan,0,8.9,A,1,6.99,28573.36632,25000,0,793.84,409000003880,27-Jun-17,MAESTRO POSDOM ACQ SETTL2,,69073.19,-543187453.27,Andreev,677,France,153604.44,0,1,0
3882,2011,4,RENT,1,Low,1,9000, 36 months,1,debt_consolidation,6,Low,1,Good Loan,0,7.51,A,1,7.33,9726.91,9000,0,280,409000003881,27-Jun-17,MAESTRO POSDOM ACQ SETTL2,,67004.89,-543120448.38,Steele,588,France,189703.65,0,1,0
3883,2011,4,OWN,2,Low,1,12600, 36 months,1,debt_consolidation,6,Low,1,Good Loan,0,11.71,B,2,23.59,14938.95775,12600,0,416.76,409000003882,27-Jun-17,RUPAY POS ACQ SETTL 24061,,864400.28,-542256048.10,Black,488,France,66393.89,0,1,0
3884,2011,0.5,RENT,1,Low,1,4850, 36 months,1,debt_consolidation,6,Low,1,Good Loan,0,6.62,A,1,11.19,5359.747003,4850,0,148.92,409000003883,27-Jun-17,RUPAY POS ACQ SETTL 25061,,1392151.03,-540863897.07,Shand,519,France,30709.03,0,1,0
3885,2011,10,RENT,1,Low,1,5000, 36 months,1,credit_card,1,Low,1,Good Loan,0,12.69,B,2,23.28,6035.389287,5000,0,167.73,409000003884,27-Jun-17,RUPAY POS ACQ SETTL 26061,,1342623.01,-539521274.06,Chiagoziem,709,France,71009.84,0,1,0
3886,2011,10,RENT,1,Low,1,20000, 60 months,2,debt_consolidation,6,Low,1,Good Loan,0,12.69,B,2,22.16,24006,20000.01,0,451.9,409000003885,27-Jun-17,TRF TO  Indiaforensic SERVICES I,"8,000,000.00",,-547521274.06,Fedorov,642,Germany,143049.72,0,1,0
3887,2011,10,MORTGAGE,3,Low,1,15000, 36 months,1,debt_consolidation,6,Low,1,Bad Loan,1,7.51,A,1,26.26,11530.76,9167.8,798.2,466.67,409000003886,27-Jun-17,TRF TO  Indiaforensic SERVICES I,"500,000.00",,-548021274.06,Tien,710,Germany,1561.58,0,1,0
3888,2011,5,MORTGAGE,3,Low,1,10000, 36 months,1,credit_card,1,Low,1,Good Loan,0,6.03,A,1,7.03,10956.4838,10000,0,304.36,409000003887,27-Jun-17,RUPAY POS ACQ SETTL 27061,,778825.15,-547242448.91,Stehle,653,France,49707.85,0,1,0
3889,2011,8,MORTGAGE,3,Low,1,35000, 60 months,2,debt_consolidation,6,High,2,Good Loan,0,13.49,C,3,11.34,40219.35,27401.73,0,805.17,409000003888,28-Jun-17,VISA POSDOM ACQ SETTL 230,,574780.79,-546667668.12,Sung,743,France,29837.65,0,1,0
3890,2011,2,OWN,2,Low,1,6000, 36 months,1,home_improvement,7,Low,1,Good Loan,0,8.9,A,1,13.15,6796.03,6000,0,190.52,409000003889,28-Jun-17,VISA POSDOM ACQ SETTL 270,,522836.45,-546144831.67,Alexander,418,France,9041.71,0,1,0
3891,2011,10,MORTGAGE,3,Medium,2,15600, 36 months,1,home_improvement,7,High,2,Bad Loan,1,19.42,E,5,6.42,19279.61,13869.66,253.02,575.16,409000003890,28-Jun-17,MASTER POSDOM ACQ SETTL23,,238570.71,-545906260.96,McIntosh,670,Germany,198017.05,0,1,0
3892,2011,0.5,RENT,1,Low,1,1000, 36 months,1,small_business,3,Low,1,Bad Loan,1,10.65,B,2,20.18,164.92,71.32,52.63,32.58,409000003891,28-Jun-17,MAESTRO POSDOM ACQ SETTL2,,35122.42,-545871138.54,Sung,723,Germany,143481.85,0,1,0
3893,2011,5,MORTGAGE,3,Low,1,27600, 60 months,2,small_business,3,Low,1,Bad Loan,1,11.71,B,2,17.45,8068.72,3928.05,1370.93,609.91,409000003892,28-Jun-17,MASTER POSDOM ACQ SETTL27,,214040.55,-545657097.99,Yao,549,Germany,146372.51,0,1,0
3894,2011,5,OWN,2,Low,1,15600, 36 months,1,wedding,5,Low,1,Good Loan,0,7.9,A,1,20.4,16178.19,15600,0,488.13,409000003893,28-Jun-17,MAESTRO POSDOM ACQ SETTL2,,61690.72,-545595407.27,Chinweuba,543,France,101905.34,0,1,0
3895,2011,10,MORTGAGE,3,Low,1,8000, 36 months,1,debt_consolidation,6,Low,1,Good Loan,0,6.03,A,1,3.6,8761.419559,8000,0,243.49,409000003894,28-Jun-17,TRF TO  Indiaforensic SERVICES I,"2,600,000.00",,-548195407.27,Chinweuba,595,Spain,134767.13,0,1,0
3896,2011,2,RENT,1,Low,1,27600, 36 months,1,credit_card,1,Low,1,Good Loan,0,7.9,A,1,15.77,30588.60437,27600,0,863.62,409000003895,28-Jun-17,17825-INTL-SETTLEMENT-210,,1994.96,-548193412.31,T'ao,673,Germany,103573.96,0,1,0
3897,2011,4,RENT,1,Low,1,8000, 36 months,1,other,4,High,2,Bad Loan,1,16.29,D,4,9.5,2647.33,1456.44,375.72,282.41,409000003896,28-Jun-17,17825-INTL-SETTLEMENT-220,,1477.63,-548191934.68,Ch'ien,741,France,139259.54,0,1,0
3898,2011,3,RENT,1,Low,1,7200, 36 months,1,debt_consolidation,6,Low,1,Good Loan,0,10.65,B,2,14.77,8434.531594,7200,0,234.53,409000003897,28-Jun-17,17825-INTL-SETTLEMENT-270,,4924.19,-548187010.49,Su,508,Germany,187776.49,0,1,0
3899,2011,6,MORTGAGE,3,Low,1,13600, 60 months,2,debt_consolidation,6,High,2,Bad Loan,1,17.27,D,4,22.64,16305.05,9854.26,0,339.98,409000003898,28-Jun-17,RUPAY POS ACQ SETTL 28061,,1256321.57,-546930688.92,Yu,662,Germany,8059.44,0,1,0
3900,2011,10,MORTGAGE,3,Low,1,18000, 60 months,2,debt_consolidation,6,Low,1,Good Loan,0,10.65,B,2,11.12,21759.84635,18000,0,388.23,409000003899,29-Jun-17,TRF TO  Indiaforensic SERVICES I,"500,000.00",,-547430688.92,Loyau,752,France,124354.92,0,1,0
3901,2011,7,RENT,1,Low,1,10000, 36 months,1,credit_card,1,Low,1,Good Loan,0,7.51,A,1,2.81,11197.30528,10000,0,311.11,409000003900,29-Jun-17,VISA POSDOM ACQ SETTL 280,,737042.52,-546693646.40,Conti,809,France,109135.11,0,1,0
3902,2011,6,RENT,1,Low,1,7800, 36 months,1,debt_consolidation,6,High,2,Good Loan,0,16.77,D,4,8.09,7909.16,7800,0,277.2,409000003901,29-Jun-17,MASTER POSDOM ACQ SETTL28,,223065.25,-546470581.15,Alexeeva,575,Spain,82222.86,0,1,0
3903,2011,9,RENT,1,Low,1,15200, 60 months,2,debt_consolidation,6,High,2,Good Loan,0,19.91,E,5,23.44,16617.55,12103.01,0,336.39,409000003902,29-Jun-17,MAESTRO POSDOM ACQ SETTL2,,62936.23,-546407644.92,Power,591,Spain,136767.16,0,1,0
3904,2011,1,RENT,1,Low,1,7000, 36 months,1,debt_consolidation,6,Low,1,Good Loan,0,7.51,A,1,10.77,7838.294424,7000,0,217.78,409000003903,29-Jun-17,TRF TO  Indiaforensic SERVICES I,"1,800,000.00",,-548207644.92,Hill,643,Spain,155516.35,0,1,0
3905,2011,1,RENT,1,Low,1,6000, 36 months,1,vacation,11,Low,1,Good Loan,0,12.42,B,2,10.98,7215.329862,6000,0,200.5,409000003904,30-Jun-17,RUPAY POS ACQ SETTL 29061,,765355.74,-547442289.18,Freeman,698,Germany,144584.29,0,1,0
3906,2011,5,RENT,1,Low,1,25000, 60 months,2,other,4,High,2,Good Loan,0,18.25,D,4,8.13,27215.5,25000,0,638.25,409000003905,30-Jun-17,VISA POSDOM ACQ SETTL 290,,549469.32,-546892819.86,Hsing,496,France,164806.89,0,1,0
3907,2011,9,MORTGAGE,3,Low,1,20000, 60 months,2,other,4,High,2,Good Loan,0,18.25,D,4,13.61,27317.38621,20000,0,510.6,409000003906,30-Jun-17,VISA POSINT ACQ SETTL 290,,1483.50,-546891336.36,Esposito,597,France,109153.04,0,1,0
3908,2011,10,MORTGAGE,3,Low,1,18000, 60 months,2,home_improvement,7,Low,1,Good Loan,0,12.42,B,2,24.02,22709.21551,18000,0,404.24,409000003907,30-Jun-17,MASTER POSDOM ACQ SETTL29,,185192.01,-546706144.35,Belonwu,603,Germany,86190.34,0,1,0
3909,2011,1,RENT,1,Low,1,12000, 60 months,2,credit_card,1,High,2,Good Loan,0,14.27,C,3,16.73,15200.91756,12000,0,280.91,409000003908,30-Jun-17,MAESTRO POSDOM ACQ SETTL2,,59538.47,-546646605.88,Tsao,655,Spain,106040.97,0,1,0
3910,2011,2,RENT,1,Low,1,2400, 36 months,1,credit_card,1,Low,1,Bad Loan,1,11.71,B,2,10.5,2414.37,1977.74,0,79.39,409000003909,30-Jun-17,TRF TO  Indiaforensic SERVICES I,"1,600,000.00",,-548246605.88,P'eng,431,France,168008.17,0,1,0
3911,2011,10,MORTGAGE,3,Low,1,35000, 60 months,2,debt_consolidation,6,High,2,Good Loan,0,14.27,C,3,13.62,43525.66,35000,0,819.3,409000003910,30-Jun-17,RUPAY POS ACQ SETTL 30061,,1195386.94,-547051218.94,Baker,620,France,33350.26,0,1,0
3912,2011,10,RENT,1,Medium,2,30000, 36 months,1,debt_consolidation,6,Low,1,Good Loan,0,7.9,A,1,12.05,33849.95091,30000,0,938.71,409000003911,1-Jul-17,VISA POSDOM ACQ SETTL 300,,544574.72,-546506644.22,Matthews,782,France,119565.34,0,1,0
3913,2011,0.5,MORTGAGE,3,Low,1,14400, 36 months,1,small_business,3,Low,1,Bad Loan,1,10.65,B,2,17.01,3696.22,2449.92,417.42,469.06,409000003912,1-Jul-17,MASTER POSDOM ACQ SETTL30,,198080.07,-546308564.15,Garcia,581,Spain,188492.82,0,1,0
3914,2011,3,MORTGAGE,3,Low,1,8675, 36 months,1,credit_card,1,Low,1,Good Loan,0,7.51,A,1,10.11,9678.57408,8675,0,269.89,409000003913,1-Jul-17,MAESTRO POSDOM ACQ SETTL3,,66631.52,-546241932.63,Field,553,Germany,165378.66,0,1,0
3915,2011,3,MORTGAGE,3,High,3,35000, 60 months,2,small_business,3,High,2,Good Loan,0,22.35,F,6,3.9,47258.34,35000,0,973.64,409000003914,1-Jul-17,RUPAY POS ACQ SETTL 01071,,1132699.32,-545109233.31,Gordon,658,France,14178.73,0,1,0
3916,2011,7,MORTGAGE,3,Low,1,15000, 60 months,2,credit_card,1,High,2,Good Loan,0,13.49,C,3,12.05,17217.28,11732.24,0,345.08,409000003915,3-Jul-17,MASTER POSDOM ACQ SETTL01,,297397.96,-544811835.35,Jefferies,686,Germany,97847.05,0,1,0
3917,2011,8,RENT,1,Low,1,4200, 36 months,1,debt_consolidation,6,Low,1,Good Loan,0,11.71,B,2,15.97,4927.1,4200,0,138.92,409000003916,3-Jul-17,MAESTRO POSDOM ACQ SETTL0,,90926.10,-544720909.25,Palermo,539,Spain,118959.64,0,1,0
3918,2011,3,RENT,1,Low,1,6500, 36 months,1,debt_consolidation,6,Low,1,Good Loan,0,7.9,A,1,24.93,7294.406555,6500,0,203.39,409000003917,3-Jul-17,RUPAY POS ACQ SETTL 01071,,1132699.32,-543588209.93,Chou,685,France,50664.07,0,1,0
3919,2011,3,RENT,1,Medium,2,14950, 36 months,1,debt_consolidation,6,Low,1,Good Loan,0,6.62,A,1,7.57,16149.29,14950,0,459.02,409000003918,3-Jul-17,VISA POSDOM ACQ SETTL 010,,696183.96,-542892025.97,Ewing,850,France,152996.89,0,1,0
3920,2011,10,MORTGAGE,3,Medium,2,24000, 60 months,2,debt_consolidation,6,High,2,Bad Loan,1,17.58,D,4,20.96,6675.19,2399.76,1260.61,603.98,409000003919,3-Jul-17,RUPAY POS ACQ SETTL 02071,,958630.79,-541933395.18,Mazzi,763,Spain,19458.75,0,1,0
3921,2011,2,RENT,1,Low,1,9250, 60 months,2,debt_consolidation,6,High,2,Good Loan,0,17.27,D,4,19.53,13310.23003,9250,0,231.24,409000003920,3-Jul-17,TRF TO  Indiaforensic SERVICES I,"3,100,000.00",,-545033395.18,Thomson,634,Germany,115268.86,0,1,0
3922,2011,2,RENT,1,Low,1,4500, 36 months,1,debt_consolidation,6,High,2,Good Loan,0,14.27,C,3,2.23,5554.408448,4500,0,154.4,409000003921,3-Jul-17,RUPAY POS ACQ SETTL 03071,,648858.81,-544384536.37,Nkemdirim,567,France,25843.70,0,1,0
3923,2011,2,RENT,1,Low,1,6000, 36 months,1,debt_consolidation,6,Low,1,Good Loan,0,12.42,B,2,23.1,6455.23,6000,0,200.5,409000003922,3-Jul-17,RUPAY POS ACQ RVSL 010717,"1,132,699.32",,-545517235.69,Lockyer,539,France,147662.33,0,1,0
3924,2011,0.5,RENT,1,Low,1,12375, 60 months,2,debt_consolidation,6,High,2,Good Loan,0,13.49,C,3,28.54,14198.29,9676.52,0,284.69,409000003923,4-Jul-17,MASTER POSDOM ACQ SETTL03,,417187.90,-545100047.79,Murray,764,France,134878.34,0,1,0
3925,2011,6,MORTGAGE,3,Low,1,12250, 60 months,2,debt_consolidation,6,High,2,Good Loan,0,14.27,C,3,21.43,15874.08898,12250,0,286.76,409000003924,4-Jul-17,MAESTRO POSDOM ACQ SETTL0,,62973.55,-545037074.24,Black,653,France,35795.85,0,1,0
3926,2011,6,OWN,2,High,3,35000, 60 months,2,debt_consolidation,6,High,2,Good Loan,0,19.03,E,5,6.16,50134.06772,35000,0,908.5,409000003925,4-Jul-17,MAESTRO POSDOM ACQ SETTL0,,65754.21,-544971320.03,Torreggiani,566,Spain,66462.79,0,1,0
3927,2011,5,RENT,1,Low,1,7200, 36 months,1,debt_consolidation,6,Low,1,Bad Loan,1,11.71,B,2,15.63,4729.65,3479.44,213.54,238.15,409000003926,4-Jul-17,VISA POSDOM ACQ SETTL 030,,1062565.50,-543908754.53,Atkinson,714,Germany,69578.49,0,1,0
3928,2011,3,RENT,1,Low,1,3000, 36 months,1,other,4,High,2,Bad Loan,1,14.65,C,3,12.7,2736.93,1938.81,152.68,103.49,409000003927,4-Jul-17,VISA POSINT ACQ SETTL 030,,9900.00,-543898854.53,Richards,580,Spain,103182.46,0,1,0
3929,2011,3,MORTGAGE,3,High,3,35000, 60 months,2,debt_consolidation,6,High,2,Bad Loan,1,21.67,F,6,12.9,18686.37,5584.02,4287.85,960.11,409000003928,4-Jul-17,TRF TO  Indiaforensic SERVICES I,"4,300,000.00",,-548198854.53,Azubuike,548,France,177017.39,0,1,0
3930,2011,10,RENT,1,Low,1,24000, 36 months,1,debt_consolidation,6,Low,1,Good Loan,0,7.9,A,1,15.56,27032.28572,24000,0,750.97,409000003929,4-Jul-17,RUPAY POS ACQ SETTL 04071,,1298984.79,-546899869.74,Ignatiev,646,Germany,53217.30,0,1,0
3931,2011,3,RENT,1,Low,1,9000, 36 months,1,debt_consolidation,6,Low,1,Good Loan,0,12.42,B,2,19.53,10778.24792,9000,0,300.74,409000003930,5-Jul-17,MASTER POSDOM ACQ SETTL04,,344432.50,-546555437.24,Miller,622,Germany,162756.29,0,1,0
3932,2011,4,MORTGAGE,3,Medium,2,18000, 36 months,1,debt_consolidation,6,High,2,Good Loan,0,14.65,C,3,15.79,22349.72052,18000,0,620.9,409000003931,5-Jul-17,MAESTRO POSDOM ACQ SETTL0,,153687.49,-546401749.75,Cox,706,France,42181.68,0,1,0
3933,2011,1,RENT,1,Low,1,15000, 36 months,1,debt_consolidation,6,Low,1,Good Loan,0,8.9,A,1,11.76,17171.47419,15000,0,476.3,409000003932,5-Jul-17,VISA POSDOM ACQ SETTL 040,,607280.80,-545794468.95,McMillan,680,France,31714.08,0,1,0
3934,2011,10,MORTGAGE,3,Low,1,18000, 36 months,1,debt_consolidation,6,Low,1,Good Loan,0,9.91,B,2,8.84,19644.89,18000,0,580.05,409000003933,5-Jul-17,TRF TO  Indiaforensic SERVICES I,"2,400,000.00",,-548194468.95,Napolitano,698,France,25017.28,0,1,0
3935,2011,10,MORTGAGE,3,Low,1,5000, 36 months,1,other,4,Low,1,Good Loan,0,12.69,B,2,18.63,6037.323632,5000,0,167.73,409000003934,5-Jul-17,RUPAY POS ACQ SETTL 05071,,1123203.49,-547071265.46,Lane,581,Spain,104272.04,0,1,0
3936,2011,3,RENT,1,Low,1,7000, 36 months,1,debt_consolidation,6,Low,1,Good Loan,0,7.51,A,1,16.58,7246.39,7000,0,217.78,409000003935,6-Jul-17,MASTER POSDOM ACQ SETTL05,,234781.48,-546836483.98,Kennedy,728,Germany,84300.40,0,1,0
3937,2011,0.5,RENT,1,Low,1,21250, 60 months,2,debt_consolidation,6,High,2,Good Loan,0,17.27,D,4,21.57,21859.08,21250,0,531.21,409000003936,6-Jul-17,MAESTRO POSDOM ACQ SETTL0,,86464.16,-546750019.82,T'ao,707,Spain,136877.24,0,1,0
3938,2011,10,MORTGAGE,3,Medium,2,22400, 60 months,2,debt_consolidation,6,Low,1,Good Loan,0,11.71,B,2,29.25,24715.44,17683.72,0,495,409000003937,6-Jul-17,VISA POSDOM ACQ SETTL 050,,614771.62,-546135248.20,Hsiung,761,France,199409.19,0,1,0
3939,2011,6,MORTGAGE,3,Low,1,8500, 36 months,1,debt_consolidation,6,Low,1,Good Loan,0,6.62,A,1,1.76,8982.66,8500,0,260.99,409000003938,6-Jul-17,TRF TO  Indiaforensic ONLINE SER,"1,200,000.00",,-547335248.20,Heath,483,Germany,163147.99,0,1,0
3940,2011,2,MORTGAGE,3,Low,1,15000, 36 months,1,debt_consolidation,6,Low,1,Good Loan,0,6.03,A,1,15.45,15776.6,15000,0,456.54,409000003939,6-Jul-17,RUPAY POS ACQ SETTL 06071,,995297.55,-546339950.65,Parry,736,Germany,136497.28,0,1,0
3941,2011,3,MORTGAGE,3,Low,1,14800, 60 months,2,debt_consolidation,6,Low,1,Good Loan,0,12.69,B,2,12.28,16271.89,14800.01,0,334.41,409000003940,7-Jul-17,MASTER POSDOM ACQ SETTL06,,314108.56,-546025842.09,Herbert,716,Germany,10070.40,0,1,0
3942,2011,7,RENT,1,Low,1,12000, 60 months,2,debt_consolidation,6,High,2,Good Loan,0,14.65,C,3,23.01,14846.24,12000,0,283.28,409000003941,7-Jul-17,MAESTRO POSDOM ACQ SETTL0,,37225.00,-545988617.09,Kang,654,France,190068.53,0,1,0
3943,2011,6.05,RENT,1,Low,1,16000, 60 months,2,debt_consolidation,6,Low,1,Good Loan,0,11.71,B,2,22.55,17647.71,12629.26,0,353.58,409000003942,7-Jul-17,VISA POSDOM ACQ SETTL 060,,832352.85,-545156264.24,Andreyeva,649,Spain,58309.54,0,1,0
3944,2011,5,RENT,1,Low,1,6000, 36 months,1,debt_consolidation,6,High,2,Bad Loan,1,16.29,D,4,23.78,3384.96,2309.45,0,211.81,409000003943,7-Jul-17,RUPAY POS ACQ SETTL 07071,,1411420.36,-543744843.88,Bowen,649,France,76946.60,0,1,0
3945,2011,5,RENT,1,Low,1,2400, 36 months,1,other,4,Low,1,Good Loan,0,11.71,B,2,14.32,2835.485313,2400,0,79.39,409000003944,7-Jul-17,TRF TO  Indiaforensic SERVICES I,"4,500,000.00",,-548244843.88,Golubev,612,France,54129.86,0,1,0
3946,2011,7,MORTGAGE,3,Medium,2,25000, 60 months,2,house,12,High,2,Good Loan,0,18.25,D,4,5.85,32151.46,19656.85,0,638.25,409000003945,10-Jul-17,MASTER POSDOM ACQ SETTL07,,198284.91,-548046558.97,Hancock,657,Spain,52990.70,0,1,0
3947,2011,7,RENT,1,Low,1,20000, 36 months,1,debt_consolidation,6,Low,1,Good Loan,0,11.71,B,2,13.67,23398.92,20000,0,661.52,409000003946,10-Jul-17,MAESTRO POSDOM ACQ SETTL0,,35265.01,-548011293.96,Fowler,511,France,161854.98,0,1,0
3948,2011,6,MORTGAGE,3,Low,1,12000, 60 months,2,debt_consolidation,6,High,2,Bad Loan,1,18.25,D,4,12.56,9667.95,4264.3,1089.87,306.36,409000003947,10-Jul-17,VISA POSDOM ACQ SETTL 070,,654868.00,-547356425.96,Sutherland,682,France,172141.33,0,1,0
3949,2011,0.5,RENT,1,Medium,2,12000, 36 months,1,wedding,5,High,2,Good Loan,0,13.49,C,3,13.18,14653.08395,12000,0,407.17,409000003948,10-Jul-17,RUPAY POS ACQ SETTL 08071,,1413430.57,-545942995.39,Rowley,748,Spain,124429.19,0,1,0
3950,2011,7,RENT,1,Low,1,15000, 36 months,1,debt_consolidation,6,Low,1,Good Loan,0,12.42,B,2,7.47,16726.53,15000,0,501.23,409000003949,10-Jul-17,RUPAY POS ACQ SETTL 09071,,1152702.64,-544790292.75,Gibbons,554,Germany,24983.39,0,1,0
3951,2011,8,OWN,2,Low,1,12000, 36 months,1,debt_consolidation,6,Low,1,Good Loan,0,6.03,A,1,23.35,13147.81649,12000,0,365.23,409000003950,10-Jul-17,RUPAY POS ACQ SETTL 10071,,1421223.42,-543369069.33,Lockett,794,Spain,86699.98,0,1,0
3952,2011,10,RENT,1,Low,1,15000, 60 months,2,debt_consolidation,6,High,2,Bad Loan,1,15.96,C,3,18.26,10881.47,5049.36,1407.58,364.46,409000003951,11-Jul-17,MASTER POSDOM ACQ SETTL08,,286742.33,-543082327.00,Akabueze,807,France,125440.11,0,1,0
3953,2011,6,MORTGAGE,3,Low,1,15000, 60 months,2,debt_consolidation,6,High,2,Bad Loan,1,15.27,C,3,17.9,11704.26,5812.65,1293.84,358.98,409000003952,11-Jul-17,MAESTRO POSDOM ACQ SETTL0,,55681.74,-543026645.26,Phelps,594,France,9443.15,0,1,0
3954,2011,3,MORTGAGE,3,Low,1,18825, 60 months,2,debt_consolidation,6,Low,1,Good Loan,0,11.71,B,2,21.98,23472.01676,18825,0,416,409000003953,11-Jul-17,VISA POSDOM ACQ SETTL 080,,687629.24,-542339016.02,Frederick,652,Spain,195877.06,0,1,0
3955,2011,1,RENT,1,Low,1,1500, 36 months,1,wedding,5,Low,1,Bad Loan,1,11.71,B,2,2.22,148.32,105.59,0,49.62,409000003954,11-Jul-17,VISA POSINT ACQ SETTL 090,,33626.00,-542305390.02,Beneventi,729,France,105409.31,0,1,0
3956,2011,6,OWN,2,Medium,2,28000, 36 months,1,debt_consolidation,6,Low,1,Good Loan,0,9.91,B,2,24.97,31729.8,28000,0,902.3,409000003955,11-Jul-17,TRF TO  Indiaforensic SERVICES I,"5,900,000.00",,-548205390.02,Bruce,625,France,100403.05,0,1,0
3957,2011,7,MORTGAGE,3,Low,1,13200, 36 months,1,debt_consolidation,6,High,2,Good Loan,0,16.77,D,4,20.69,16878.21806,13200,0,469.11,409000003956,11-Jul-17,MASTER POSDOM ACQ SETTL10,,672041.86,-547533348.16,Green,597,Germany,48502.88,0,1,0
3958,2011,10,OWN,2,Medium,2,4800, 36 months,1,other,4,Low,1,Good Loan,0,11.71,B,2,14.18,5713.567641,4800,0,158.77,409000003957,11-Jul-17,MAESTRO POSDOM ACQ SETTL1,,143831.00,-547389517.16,Carlson,657,Germany,47019.66,0,1,0
3959,2011,10,MORTGAGE,3,Medium,2,12000, 36 months,1,debt_consolidation,6,Low,1,Good Loan,0,9.91,B,2,13.04,13918.64046,12000,0,386.7,409000003958,11-Jul-17,VISA POSDOM ACQ SETTL 100,,1518642.83,-545870874.33,Tang,633,France,48249.88,0,1,0
3960,2011,10,RENT,1,Low,1,1500, 36 months,1,debt_consolidation,6,Low,1,Good Loan,0,9.91,B,2,17.55,1709.57,1500,0,48.34,409000003959,11-Jul-17,RUPAY POS ACQ SETTL 11071,,1290741.85,-544580132.48,Yudin,663,Germany,84358.71,0,1,0
3961,2011,10,RENT,1,Low,1,30000, 60 months,2,debt_consolidation,6,High,2,Bad Loan,1,22.06,F,6,18.99,6232.41,2056.02,429.13,829.6,409000003960,12-Jul-17,TRF TO  Indiaforensic SERVICES I,"3,600,000.00",,-548180132.48,MacDonald,535,France,145986.35,0,1,0
3962,2011,8,RENT,1,Low,1,15000, 60 months,2,car,2,Low,1,Good Loan,0,12.42,B,2,8.83,16825.72,11804.87,0,336.86,409000003961,12-Jul-17,RUPAY POS ACQ SETTL 12071,,1044215.51,-547135916.97,Watt,702,France,88550.28,0,1,0
3963,2011,3,MORTGAGE,3,High,3,16000, 36 months,1,medical,9,Low,1,Good Loan,0,7.9,A,1,6.6,18021.58395,16000,0,500.65,409000003962,12-Jul-17,MASTER POSDOM ACQ SETTL11,,248537.46,-546887379.51,Mbadiwe,712,France,3061.00,0,1,0
3964,2011,7,MORTGAGE,3,Low,1,1000, 36 months,1,home_improvement,7,Low,1,Good Loan,0,12.42,B,2,21.29,1201.958793,1000,0,33.42,409000003963,12-Jul-17,MAESTRO POSDOM ACQ SETTL1,,73750.10,-546813629.41,Chuang,607,France,43196.50,0,1,0
3965,2011,3,MORTGAGE,3,Low,1,5250, 36 months,1,home_improvement,7,Low,1,Good Loan,0,7.51,A,1,9.7,5674.16,5250,0,163.34,409000003964,12-Jul-17,VISA POSDOM ACQ SETTL 110,,896869.21,-545916760.20,Sabbatini,476,France,55775.84,0,1,0
3966,2011,2,MORTGAGE,3,Low,1,1500, 36 months,1,car,2,Low,1,Good Loan,0,6.03,A,1,14.46,1529.13,1500,0,45.66,409000003965,12-Jul-17,VISA POSINT ACQ SETTL 110,,1972.00,-545914788.20,Caldwell,748,Spain,134077.71,0,1,0
3967,2011,5,RENT,1,Low,1,12000, 60 months,2,other,4,High,2,Bad Loan,1,15.96,C,3,22.23,1257.54,131.14,674.92,291.57,409000003966,13-Jul-17,MASTER POSDOM ACQ SETTL12,,366395.16,-545548393.04,Ewers,815,France,198490.33,0,1,0
3968,2011,4,MORTGAGE,3,Low,1,13000, 60 months,2,other,4,High,2,Good Loan,0,13.49,C,3,5.91,17014.73651,13000,0,299.07,409000003967,13-Jul-17,MAESTRO POSDOM ACQ SETTL1,,60558.25,-545487834.79,Tsao,602,France,116052.92,0,1,0
3969,2011,6.05,RENT,1,Low,1,2400, 36 months,1,credit_card,1,Low,1,Good Loan,0,11.71,B,2,21.7,2856.642657,2400,0,79.39,409000003968,13-Jul-17,VISA POSDOM ACQ SETTL 120,,834395.32,-544653439.47,Hannam,649,Germany,123202.99,0,1,0
3970,2011,6,OWN,2,Low,1,14000, 36 months,1,credit_card,1,Low,1,Bad Loan,1,11.71,B,2,13.51,5680.4,3763.45,597.41,463.07,409000003969,13-Jul-17,TRF TO  Indiaforensic SERVICES I,"3,600,000.00",,-548253439.47,Wood,551,Spain,85129.77,0,1,0
3971,2011,8,RENT,1,Low,1,14800, 60 months,2,debt_consolidation,6,High,2,Good Loan,0,17.58,D,4,21.25,20984.41181,14800,0,372.45,409000003970,13-Jul-17,RUPAY POS ACQ SETTL 13071,,1639929.29,-546613510.18,Ko,509,France,180598.86,0,1,0
3972,2011,0.5,RENT,1,Low,1,15000, 36 months,1,debt_consolidation,6,Low,1,Bad Loan,1,11.71,B,2,16.42,6945,5208.71,13.74,496.14,409000003971,14-Jul-17,MASTER POSDOM ACQ SETTL13,,462296.26,-546151213.92,Lo Duca,685,Spain,198694.20,0,1,0
3973,2011,7,RENT,1,Low,1,8250, 36 months,1,wedding,5,Low,1,Good Loan,0,7.51,A,1,27.2,9238.632773,8250,0,256.67,409000003972,14-Jul-17,MAESTRO POSDOM ACQ SETTL1,,54304.33,-546096909.59,Endrizzi,536,France,42934.43,0,1,0
3974,2011,1,MORTGAGE,3,Low,1,7450, 36 months,1,wedding,5,Low,1,Good Loan,0,12.69,B,2,6.61,7716.78,7450,0,249.91,409000003973,14-Jul-17,RUPAY POS ACQ SETTL 14071,,1547925.97,-544548983.62,Ch'iu,711,Spain,114793.45,0,1,0
3975,2011,10,MORTGAGE,3,Medium,2,22000, 36 months,1,small_business,3,Low,1,Good Loan,0,7.51,A,1,0.31,24632.43641,22000,0,684.44,409000003974,14-Jul-17,TRF TO  Indiaforensic SERVICES I,"2,100,000.00",,-546648983.62,Mofflin,761,Spain,63297.70,0,1,0
3976,2011,10,MORTGAGE,3,Low,1,3250, 36 months,1,credit_card,1,High,2,Good Loan,0,13.49,C,3,10.71,3984.1142,3250,0,110.28,409000003975,15-Jul-17,MASTER POSDOM ACQ SETTL14,,212861.84,-546436121.78,Fiorentini,535,France,61820.41,0,1,0
3977,2011,1,RENT,1,Medium,2,10000, 36 months,1,debt_consolidation,6,Low,1,Good Loan,0,10.65,B,2,2.88,11597.07469,10000,0,325.74,409000003976,15-Jul-17,MAESTRO POSDOM ACQ SETTL1,,96229.30,-546339892.48,Chiekwugo,566,Germany,102246.00,0,1,0
3978,2011,2,MORTGAGE,3,Low,1,4900, 36 months,1,debt_consolidation,6,High,2,Good Loan,0,15.27,C,3,8.07,6133.667584,4900,0,170.51,409000003977,15-Jul-17,VISA POSDOM ACQ SETTL 140,,1732503.61,-544607388.87,Bogle,620,Spain,154882.79,0,1,0
3979,2011,10,MORTGAGE,3,Medium,2,35000, 60 months,2,small_business,3,Low,1,Bad Loan,1,11.71,B,2,1.06,11599.19,6926.82,20.09,773.44,409000003978,15-Jul-17,RUPAY POS ACQ SETTL 15071,,1447607.86,-543159781.01,Ifeanacho,837,Germany,140723.05,0,1,0
3980,2011,10,RENT,1,Low,1,9500, 36 months,1,other,4,High,2,Good Loan,0,14.65,C,3,17.69,9616.54,9500,0,327.7,409000003979,17-Jul-17,MASTER POSDOM ACQ SETTL15,,253983.81,-542905797.20,Owens,685,France,72852.74,0,1,0
3981,2011,0.5,MORTGAGE,3,Low,1,3800, 36 months,1,car,2,Low,1,Bad Loan,1,7.51,A,1,22.52,1061.37,869.42,0,118.23,409000003980,17-Jul-17,MAESTRO POSDOM ACQ SETTL1,,60830.19,-542844967.01,Ch'ien,673,France,85733.33,0,1,0
3982,2011,9,OWN,2,Low,1,12400, 60 months,2,debt_consolidation,6,High,2,Bad Loan,1,22.06,F,6,6.26,2124.05,595.32,412.25,342.9,409000003981,17-Jul-17,VISA POSDOM ACQ SETTL 150,,703552.47,-542141414.54,Chung,638,France,162597.15,0,1,0
3983,2011,4,RENT,1,Low,1,4000, 60 months,2,other,4,High,2,Bad Loan,1,17.27,D,4,7.37,826.88,309.36,128.7,100,409000003982,17-Jul-17,MASTER POSINT ACQ SETTL15,,1012.85,-542140401.69,Sung,614,France,74379.57,0,1,0
3984,2011,1,RENT,1,High,3,7500, 36 months,1,medical,9,Low,1,Good Loan,0,6.03,A,1,3.7,7835.74,7500,0,228.27,409000003983,17-Jul-17,VISA POSDOM ACQ SETTL 160,,49037.69,-542091364.00,Wang,626,France,173117.22,0,1,0
3985,2011,10,RENT,1,Medium,2,12000, 36 months,1,medical,9,Low,1,Good Loan,0,7.51,A,1,6.44,12665.04,12000,0,373.33,409000003984,17-Jul-17,RUPAY POS ACQ SETTL 16071,,1290068.14,-540801295.86,Sun,834,Spain,66485.26,0,1,0
3986,2011,10,RENT,1,Low,1,18000, 60 months,2,debt_consolidation,6,Low,1,Good Loan,0,11.71,B,2,18.65,23436.15352,18000,0,397.77,409000003985,17-Jul-17,RUPAY POS ACQ SETTL 17071,,798108.87,-540003186.99,Maitland,691,France,92811.20,0,1,0
3987,2011,6,MORTGAGE,3,Low,1,8875, 36 months,1,debt_consolidation,6,Low,1,Bad Loan,1,10.65,B,2,11.31,3560.68,2413.13,370.81,289.09,409000003986,17-Jul-17,TRF TO  Indiaforensic SERVICES I,"5,000,000.00",,-545003186.99,Ma,706,Spain,46635.11,0,1,0
3988,2011,10,RENT,1,Medium,2,30000, 60 months,2,small_business,3,High,2,Good Loan,0,15.96,C,3,2.61,43039.3099,30000,0,728.91,409000003987,17-Jul-17,TRF TO  Indiaforensic SERVICES I,"3,200,000.00",,-548203186.99,Pollard,633,France,124830.11,0,1,0
3989,2011,7,MORTGAGE,3,Low,1,24625, 60 months,2,debt_consolidation,6,High,2,Good Loan,0,22.06,F,6,23.62,31686.82,24625,0,680.96,409000003988,18-Jul-17,MASTER POSDOM ACQ SETTL17,,535530.11,-547667656.88,Hsieh,644,Germany,167087.34,0,1,0
3990,2011,6.05,OWN,2,Low,1,5000, 36 months,1,debt_consolidation,6,Low,1,Good Loan,0,6.03,A,1,29.86,5478.095824,5000,0,152.18,409000003989,18-Jul-17,MAESTRO POSDOM ACQ SETTL1,,134754.94,-547532901.94,Gerasimov,666,France,163625.56,0,1,0
3991,2011,4,RENT,1,Low,1,12000, 60 months,2,debt_consolidation,6,High,2,Good Loan,0,19.91,E,5,11.73,13764.96,12000,0,317.33,409000003990,18-Jul-17,VISA POSDOM ACQ SETTL 170,,705166.10,-546827735.84,Johnson,708,France,172129.26,0,1,0
3992,2011,6.05,MORTGAGE,3,Low,1,6000, 36 months,1,other,4,Low,1,Good Loan,0,7.9,A,1,21.24,6534.13,6000,0,187.75,409000003991,18-Jul-17,RUPAY POS ACQ SETTL 18071,,1413935.28,-545413800.56,Fiorentino,496,Germany,163141.18,0,1,0
3993,2011,10,MORTGAGE,3,Low,1,10000, 36 months,1,credit_card,1,Low,1,Good Loan,0,7.9,A,1,17.94,11263.67018,10000,0,312.91,409000003992,18-Jul-17,TRF TO  Indiaforensic SERVICES I,"1,400,000.00",,-546813800.56,Chioke,730,Germany,94003.11,0,1,0
3994,2011,2,RENT,1,Low,1,18200, 36 months,1,credit_card,1,Low,1,Good Loan,0,9.91,B,2,12.82,21109.14539,18200,0,586.5,409000003993,19-Jul-17,MASTER POSDOM ACQ SETTL18,,250911.45,-546562889.11,Rossi,696,Spain,138351.68,0,1,0
3995,2011,3,MORTGAGE,3,Low,1,12000, 36 months,1,wedding,5,Low,1,Good Loan,0,11.71,B,2,15.32,13598.49,12000,0,396.92,409000003994,19-Jul-17,MAESTRO POSDOM ACQ SETTL1,,115202.28,-546447686.83,Siciliano,809,Spain,34164.05,0,1,0
3996,2011,10,MORTGAGE,3,Low,1,6250, 36 months,1,home_improvement,7,Low,1,Good Loan,0,12.69,B,2,21.53,7545.143674,6250,0,209.66,409000003995,19-Jul-17,VISA POSDOM ACQ SETTL 180,,1313723.65,-545133963.18,Efremov,701,Spain,97794.71,0,1,0
3997,2011,8,MORTGAGE,3,Low,1,3600, 36 months,1,major_purchase,8,Low,1,Good Loan,0,7.9,A,1,19.71,4034.654127,3600,0,112.65,409000003996,19-Jul-17,RUPAY POS ACQ SETTL 19071,,1240446.02,-543893517.16,Brigstocke,604,France,75786.55,0,1,0
3998,2011,0.5,RENT,1,Low,1,17900, 36 months,1,debt_consolidation,6,Low,1,Good Loan,0,7.9,A,1,21.32,19883.75,17900,0,560.1,409000003997,19-Jul-17,RUPAY POS  QR SETTL 19071,,1.29,-543893515.87,Olisaemeka,665,France,136812.02,0,1,0
3999,2011,4,RENT,1,Low,1,18000, 60 months,2,debt_consolidation,6,High,2,Bad Loan,1,19.03,E,5,5.43,0,0,0,467.23,409000003998,19-Jul-17,TRF TO  Indiaforensic SERVICES I,"3,100,000.00",,-546993515.87,Tang,639,France,84361.72,0,1,0
4000,2011,1,RENT,1,Low,1,8000, 36 months,1,debt_consolidation,6,Low,1,Good Loan,0,6.03,A,1,15.55,8292.84,8000,0,243.49,409000003999,20-Jul-17,MASTER POSDOM ACQ SETTL19,,201443.65,-546792072.22,Lucchese,696,France,2766.63,0,1,0
4001,2011,0.5,RENT,1,Low,1,30000, 60 months,2,debt_consolidation,6,High,2,Bad Loan,1,20.3,E,5,15.64,797.83,291.61,0,799.84,409000004000,20-Jul-17,MAESTRO POSDOM ACQ SETTL1,,49676.00,-546742396.22,West,520,France,163185.76,0,1,0
4002,2011,1,MORTGAGE,3,Low,1,7125, 36 months,1,debt_consolidation,6,Low,1,Good Loan,0,7.9,A,1,21,7946.97,7125,0,222.95,409000004001,20-Jul-17,RUPAY POS ACQ SETTL 20071,,1380456.02,-545361940.20,Pai,545,Germany,180598.28,0,1,0
4003,2011,1,RENT,1,Low,1,6400, 36 months,1,debt_consolidation,6,Low,1,Good Loan,0,7.51,A,1,8.88,7165.758097,6400,0,199.11,409000004002,20-Jul-17,TRF TO  Indiaforensic SERVICES I,"2,900,000.00",,-548261940.20,Tang,634,Germany,69849.55,0,1,0
4004,2011,5,RENT,1,Medium,2,17400, 36 months,1,medical,9,Low,1,Good Loan,0,11.71,B,2,5.29,19719.46,17400,0,575.53,409000004003,20-Jul-17,RUPAY POS  QR SETTL 20071,,0.65,-548261939.55,Fedorov,750,France,19921.72,0,1,0
4005,2011,4,RENT,1,Medium,2,6000, 36 months,1,debt_consolidation,6,Low,1,Good Loan,0,10.65,B,2,7.26,6205.6,6000,0,195.44,409000004004,21-Jul-17,MASTER POSDOM ACQ SETTL20,,380272.20,-547881667.35,Gboliwe,530,Spain,147606.71,0,1,0
4006,2011,10,RENT,1,Medium,2,16000, 60 months,2,debt_consolidation,6,Low,1,Good Loan,0,12.42,B,2,3.39,17944.67,12590.24,0,359.32,409000004005,21-Jul-17,MAESTRO POSDOM ACQ SETTL2,,27342.15,-547854325.20,Ko,589,France,126160.24,0,1,0
4007,2011,2,RENT,1,Low,1,20000, 60 months,2,debt_consolidation,6,Low,1,Bad Loan,1,12.69,B,2,22.43,1350.39,726,0,451.9,409000004006,21-Jul-17,VISA POSDOM ACQ SETTL 200,,1131303.38,-546723021.82,Le Gallienne,654,France,47046.72,0,1,0
4008,2011,5,MORTGAGE,3,Medium,2,14000, 36 months,1,credit_card,1,Low,1,Good Loan,0,8.9,A,1,6.2,16001.54386,14000,0,444.55,409000004007,21-Jul-17,VISA POSINT ACQ SETTL 200,,3032.91,-546719988.91,Seleznyova,648,France,143668.58,0,1,0
4009,2011,6,MORTGAGE,3,Medium,2,35000, 60 months,2,credit_card,1,High,2,Good Loan,0,17.27,D,4,21.84,47398.5972,35000,0,874.93,409000004008,21-Jul-17,RUPAY POS ACQ SETTL 21071,,1025452.06,-545694536.85,Joseph,835,Spain,152577.62,0,1,0
4010,2011,2,MORTGAGE,3,Low,1,7000, 36 months,1,debt_consolidation,6,Low,1,Good Loan,0,12.69,B,2,2.76,7716.7,7000,0,234.82,409000004009,21-Jul-17,TRF TO  Indiaforensic SERVICES I,"1,500,000.00",,-547194536.85,Bevan,446,France,191350.48,0,1,0
4011,2011,4,MORTGAGE,3,Low,1,9000, 36 months,1,debt_consolidation,6,High,2,Good Loan,0,16.77,D,4,12.59,9694.03,9000,0,319.85,409000004010,24-Jul-17,MASTER POSDOM ACQ SETTL21,,261898.93,-546932637.92,Allan,514,Spain,14234.31,0,1,0
4012,2011,5,RENT,1,Low,1,10000, 36 months,1,other,4,High,2,Bad Loan,1,15.27,C,3,7.99,6404.43,4475.97,316.88,347.98,409000004011,24-Jul-17,MAESTRO POSDOM ACQ SETTL2,,79456.17,-546853181.75,Lavrentiev,694,Germany,77906.87,0,1,0
4013,2011,0.5,RENT,1,Low,1,5500, 36 months,1,debt_consolidation,6,Low,1,Good Loan,0,8.9,A,1,8.48,5862.16,5500,0,174.65,409000004012,24-Jul-17,MASTER POSDOM ACQ SETTL22,,192093.81,-546661087.94,Walton,554,Spain,57320.92,0,1,0
4014,2011,0.5,RENT,1,Low,1,5000, 36 months,1,debt_consolidation,6,Low,1,Good Loan,0,8.9,A,1,3.68,5711.267827,5000,0,158.77,409000004013,24-Jul-17,MAESTRO POSDOM ACQ SETTL2,,54149.44,-546606938.50,Salier,720,Germany,27145.73,0,1,0
4015,2011,10,RENT,1,Low,1,11000, 36 months,1,debt_consolidation,6,Low,1,Good Loan,0,9.91,B,2,15.28,12759.48156,11000,0,354.48,409000004014,24-Jul-17,VISA POSDOM ACQ SETTL 210,,465023.53,-546141914.97,Evdokimov,641,Germany,26912.72,0,1,0
4016,2011,10,MORTGAGE,3,Low,1,22000, 60 months,2,debt_consolidation,6,High,2,Bad Loan,1,22.06,F,6,20.03,2429.56,837.17,0,608.37,409000004015,24-Jul-17,VISA POSDOM ACQ SETTL 210,,593485.35,-545548429.62,Ponomaryova,813,France,26476.18,0,1,0
4017,2011,10,MORTGAGE,3,Low,1,34000, 60 months,2,credit_card,1,Low,1,Good Loan,0,11.71,B,2,11.39,40954.38,34000,0,751.34,409000004016,24-Jul-17,RUPAY POS ACQ SETTL 22071,,950687.78,-544597741.84,Millar,480,France,79329.70,0,1,0
4018,2011,10,MORTGAGE,3,Medium,2,15000, 36 months,1,debt_consolidation,6,High,2,Good Loan,0,13.49,C,3,15.9,18319.93996,15000,0,508.96,409000004017,24-Jul-17,RUPAY POS ACQ SETTL 23071,,960555.10,-543637186.74,Grosse,811,France,13464.64,0,1,0
4019,2011,10,MORTGAGE,3,Low,1,12000, 60 months,2,credit_card,1,Low,1,Good Loan,0,7.9,A,1,12.55,14344.89999,12000,0,242.75,409000004018,24-Jul-17,RUPAY POS ACQ SETTL 24071,,569188.97,-543067997.77,Hsiao,715,Germany,114149.80,0,1,0
4020,2011,3,RENT,1,Medium,2,12075, 36 months,1,debt_consolidation,6,Low,1,Good Loan,0,12.42,B,2,4.15,14050.47,12074.99,0,403.49,409000004019,25-Jul-17,MASTER POSDOM ACQ SETTL24,,241747.92,-542826249.85,Belbin,620,Spain,135171.60,0,1,0
4021,2011,8,RENT,1,Low,1,6725, 36 months,1,debt_consolidation,6,Low,1,Good Loan,0,6.62,A,1,13.92,7432.432279,6725,0,206.49,409000004020,25-Jul-17,MAESTRO POSDOM ACQ SETTL2,,119357.04,-542706892.81,Ifeajuna,721,France,1187.88,0,1,0
4022,2011,6,MORTGAGE,3,Low,1,15000, 36 months,1,credit_card,1,Low,1,Good Loan,0,6.03,A,1,18.45,16434.66728,15000,0,456.54,409000004021,25-Jul-17,VISA POSDOM ACQ SETTL 240,,779834.03,-541927058.78,Wright,772,Germany,184564.67,0,1,0
4023,2011,6,RENT,1,Low,1,18000, 60 months,2,debt_consolidation,6,High,2,Bad Loan,1,15.96,C,3,20.07,5279,2086.84,909.94,437.35,409000004022,25-Jul-17,TRF TO  Indiaforensic SERVICES I,"5,200,000.00",,-547127058.78,Komarova,680,Germany,33391.38,0,1,0
4024,2011,4,MORTGAGE,3,Low,1,10000, 36 months,1,debt_consolidation,6,Low,1,Good Loan,0,6.03,A,1,10.03,10956.45459,10000,0,304.36,409000004023,25-Jul-17,TRF TO  Indiaforensic SERVICES I,"1,100,000.00",,-548227058.78,Titheradge,535,France,9238.35,0,1,0
4025,2011,6,MORTGAGE,3,Low,1,6500, 36 months,1,other,4,Low,1,Good Loan,0,6.03,A,1,3.2,7121.650538,6500,0,197.84,409000004024,25-Jul-17,RUPAY POS ACQ SETTL 25071,,878134.03,-547348924.75,Dellucci,655,France,28029.54,0,1,0
4026,2011,10,MORTGAGE,3,Low,1,16000, 60 months,2,debt_consolidation,6,High,2,Good Loan,0,13.49,C,3,4.67,18369.93,12517.07,0,368.08,409000004025,26-Jul-17,MASTER POSDOM ACQ SETTL25,,154619.19,-547194305.56,Hobbs,660,France,42790.29,0,1,0
4027,2011,6,MORTGAGE,3,Low,1,24400, 36 months,1,debt_consolidation,6,Low,1,Good Loan,0,8.9,A,1,2.43,25572.82,24400,0,774.78,409000004026,26-Jul-17,MAESTRO POSDOM ACQ SETTL2,,58319.66,-547135985.90,Beggs,762,Germany,77142.42,0,1,0
4028,2011,0.5,RENT,1,Low,1,25450, 60 months,2,debt_consolidation,6,High,2,Bad Loan,1,17.58,D,4,24.4,8035.4,810.95,6122.84,640.47,409000004027,26-Jul-17,VISA POSDOM ACQ SETTL 250,,595974.76,-546540011.14,Luffman,662,Germany,146219.90,0,1,0
4029,2011,0.5,RENT,1,Low,1,12000, 36 months,1,debt_consolidation,6,High,2,Good Loan,0,14.27,C,3,6.76,13689.9,12000,0,411.71,409000004028,26-Jul-17,VISA POSINT ACQ SETTL 250,,13648.20,-546526362.94,Caldwell,463,Germany,70127.93,0,1,0
4030,2011,8,MORTGAGE,3,Low,1,20000, 60 months,2,small_business,3,High,2,Bad Loan,1,17.58,D,4,8.37,18008.22,10095.07,1411.94,503.32,409000004029,26-Jul-17,RUPAY POS ACQ SETTL 26071,,1365734.42,-545160628.52,Mancini,501,Germany,132104.76,0,1,0
4031,2011,1,RENT,1,Low,1,10000, 36 months,1,credit_card,1,Low,1,Bad Loan,1,12.69,B,2,16.53,4815.68,3178.18,400.7,335.45,409000004030,27-Jul-17,TRF TO  Indiaforensic SERVICES I,"3,100,000.00",,-548260628.52,Evseev,603,Spain,90437.87,0,1,0
4032,2011,2,RENT,1,Low,1,6000, 36 months,1,debt_consolidation,6,High,2,Good Loan,0,15.27,C,3,19.36,7440.477718,6000,0,208.79,409000004031,27-Jul-17,MASTER POSDOM ACQ SETTL26,,339656.47,-547920972.05,Hs?eh,688,Spain,113926.31,0,1,0
4033,2011,5,RENT,1,Low,1,3000, 36 months,1,medical,9,High,2,Good Loan,0,17.58,D,4,11.48,3878.150211,3000,0,107.83,409000004032,27-Jul-17,MAESTRO POSDOM ACQ SETTL2,,66559.25,-547854412.80,Chinedum,430,France,12050.77,0,1,0
4034,2011,2,OWN,2,Low,1,9600, 36 months,1,credit_card,1,Low,1,Good Loan,0,7.9,A,1,3.35,10813.44562,9600,0,300.39,409000004033,27-Jul-17,VISA POSDOM ACQ SETTL 260,,539555.61,-547314857.19,Hagins,632,Germany,64345.61,0,1,0
4035,2011,0.5,MORTGAGE,3,Low,1,12000, 36 months,1,debt_consolidation,6,Low,1,Good Loan,0,7.9,A,1,7.57,13407.98,12000,0,375.49,409000004034,27-Jul-17,RUPAY POS ACQ SETTL 27071,,1050039.60,-546264817.59,Kirwan,601,Spain,199242.65,0,1,0
4036,2011,6,MORTGAGE,3,Low,1,21000, 60 months,2,small_business,3,High,2,Bad Loan,1,18.25,D,4,13.31,18764.55,9874.77,95.54,536.13,409000004035,28-Jul-17,TRF TO  Indiaforensic SERVICES I,"2,000,000.00",,-548264817.59,Little,769,France,75578.67,0,1,0
4037,2011,6,MORTGAGE,3,Low,1,18000, 60 months,2,other,4,Low,1,Good Loan,0,10.65,B,2,13.62,19336.25,14251.69,0,388.23,409000004036,28-Jul-17,MASTER POSDOM ACQ SETTL27,,199379.39,-548065438.20,Milligan,551,France,43435.43,0,1,0
4038,2011,10,MORTGAGE,3,Low,1,12000, 36 months,1,debt_consolidation,6,Low,1,Good Loan,0,9.91,B,2,6.69,13756.41199,12000,0,386.7,409000004037,28-Jul-17,MAESTRO POSDOM ACQ SETTL2,,49204.33,-548016233.87,Ch'iu,841,France,183239.71,0,1,0
4039,2011,6,RENT,1,Low,1,10000, 36 months,1,major_purchase,8,Low,1,Good Loan,0,6.62,A,1,8.4,10773.51,10000,0,307.04,409000004038,28-Jul-17,VISA POSDOM ACQ SETTL 270,,580364.98,-547435868.89,McKay,469,Spain,146213.75,0,1,0
4040,2011,2,MORTGAGE,3,Low,1,13000, 36 months,1,other,4,High,2,Good Loan,0,15.27,C,3,9.12,16278.44584,13000,0,452.38,409000004039,28-Jul-17,RUPAY POS ACQ SETTL 28071,,992950.49,-546442918.40,Crawford,479,Spain,40315.27,0,1,0
4041,2011,10,RENT,1,Medium,2,13000, 36 months,1,debt_consolidation,6,Low,1,Good Loan,0,11.71,B,2,3.41,15475.47732,13000,0,429.99,409000004040,28-Jul-17,RUPAY POS  QR SETTL 28071,,0.65,-546442917.75,Onyemere,701,France,16966.73,0,1,0
4042,2011,5,MORTGAGE,3,Low,1,14125, 60 months,2,debt_consolidation,6,High,2,Good Loan,0,19.42,E,5,23.32,21615.69886,14125,0,369.69,409000004041,29-Jul-17,MASTER POSDOM ACQ SETTL28,,136686.78,-546306230.97,Azuka,593,France,80608.12,0,1,0
4043,2011,3,OWN,2,Low,1,4200, 36 months,1,debt_consolidation,6,Low,1,Good Loan,0,9.91,B,2,6.36,4871.276749,4200,0,135.35,409000004042,29-Jul-17,MAESTRO POSDOM ACQ SETTL2,,62274.92,-546243956.05,Ch'en,738,Spain,19233.41,0,1,0
4044,2011,2,MORTGAGE,3,Low,1,10000, 36 months,1,car,2,Low,1,Good Loan,0,6.03,A,1,15.34,10956.51302,10000,0,304.36,409000004043,29-Jul-17,VISA POSDOM ACQ SETTL 280,,705263.37,-545538692.68,Royster,635,Spain,135382.23,0,1,0
4045,2011,1,RENT,1,Low,1,9500, 36 months,1,credit_card,1,Low,1,Good Loan,0,11.71,B,2,8.53,11115.84,9500,0,314.23,409000004044,29-Jul-17,RUPAY POS ACQ SETTL 29071,,1008603.43,-544530089.25,Parkin,658,France,80410.68,0,1,0
4046,2011,5,RENT,1,Low,1,17000, 60 months,2,debt_consolidation,6,Low,1,Good Loan,0,8.9,A,1,7.47,20661.4378,17000,0,352.07,409000004045,29-Jul-17,TRANSFER TO  Indiaforensic SERVI,"3,000,000.00",,-547530089.25,Kozlova,687,Spain,17696.22,0,1,0
4047,2011,5,OWN,2,Medium,2,30000, 36 months,1,major_purchase,8,Low,1,Bad Loan,1,7.51,A,1,1.08,5574.67,3767.98,916.52,933.33,409000004046,31-Jul-17,MASTER POSDOM ACQ SETTL29,,165391.98,-547364697.27,Hu,650,France,17974.08,0,1,0
4048,2011,3,MORTGAGE,3,Low,1,30000, 36 months,1,debt_consolidation,6,High,2,Good Loan,0,14.27,C,3,17.8,35840.33,30000,0,1029.27,409000004047,31-Jul-17,MAESTRO POSDOM ACQ SETTL2,,52102.85,-547312594.42,Ma,720,Spain,180712.28,0,1,0
4049,2011,6,MORTGAGE,3,Low,1,5375, 36 months,1,other,4,Low,1,Good Loan,0,8.9,A,1,19.89,6143.41889,5375,0,170.68,409000004048,31-Jul-17,VISA POSDOM ACQ SETTL 290,,371625.19,-546940969.23,Coates,602,France,56323.21,0,1,0
4050,2011,10,MORTGAGE,3,Low,1,14500, 36 months,1,debt_consolidation,6,Low,1,Good Loan,0,10.65,B,2,19.04,16635.13,14500,0,472.32,409000004049,31-Jul-17,RUPAY POS ACQ SETTL 30071,,1147703.58,-545793265.65,Burns,618,Spain,77550.18,0,1,0
4051,2011,3,MORTGAGE,3,Low,1,30000, 60 months,2,debt_consolidation,6,Low,1,Bad Loan,1,11.71,B,2,8.12,14573.26,8112.66,1316.9,662.95,409000004050,31-Jul-17,RUPAY POS ACQ SETTL 31071,,507485.00,-545285780.65,Gouger,803,Germany,166957.82,0,1,0
4052,2011,10,RENT,1,Low,1,28000, 60 months,2,debt_consolidation,6,High,2,Good Loan,0,19.91,E,5,17.3,37029.69,28000,0,740.43,409000004051,1-Aug-17,MASTER POSDOM ACQ SETTL31,,272447.42,-545013333.23,Ignatyev,793,France,184243.25,0,1,0
4053,2011,6.05,MORTGAGE,3,Low,1,20000, 60 months,2,home_improvement,7,High,2,Good Loan,0,19.03,E,5,10.96,25871.64,15196.31,0,519.15,409000004052,1-Aug-17,MAESTRO POSDOM ACQ SETTL3,,107534.77,-544905798.46,Douglas,616,Germany,114072.91,0,1,0
4054,2011,5,OWN,2,Low,1,5000, 36 months,1,debt_consolidation,6,Low,1,Good Loan,0,7.51,A,1,15.44,5598.631523,5000,0,155.56,409000004053,1-Aug-17,VISA POSDOM ACQ SETTL 310,,801204.83,-544104593.63,Fiorentino,550,Spain,153917.41,0,1,0
4055,2011,0.5,RENT,1,Low,1,15000, 36 months,1,debt_consolidation,6,Low,1,Good Loan,0,7.9,A,1,18.23,16895.5839,15000,0,469.36,409000004054,1-Aug-17,RUPAY POS ACQ SETTL 01081,,1117815.70,-542986777.93,Ignatiev,602,France,4176.17,0,1,0
4056,2011,1,RENT,1,Low,1,13000, 36 months,1,debt_consolidation,6,Low,1,Good Loan,0,9.91,B,2,23.71,15099.73673,13000,0,418.93,409000004055,1-Aug-17,TRF TO  Indiaforensic SERVICES I,"5,200,000.00",,-548186777.93,Munz,452,France,142963.29,0,1,0
4057,2011,3,MORTGAGE,3,High,3,28000, 36 months,1,home_improvement,7,Low,1,Good Loan,0,6.62,A,1,5.59,30941.75828,28000,0,859.71,409000004056,2-Aug-17,MASTER POSDOM ACQ SETTL01,,173253.81,-548013524.12,Paling,655,Spain,76844.23,0,1,0
4058,2011,6.05,RENT,1,Low,1,7200, 36 months,1,debt_consolidation,6,High,2,Good Loan,0,15.27,C,3,21.16,7710.61,7200,0,250.55,409000004057,2-Aug-17,MAESTRO POSDOM ACQ SETTL0,,54071.90,-547959452.22,Clark,510,France,159742.33,0,1,0
4059,2011,1,MORTGAGE,3,Low,1,5225, 36 months,1,credit_card,1,Low,1,Good Loan,0,9.91,B,2,23.08,6060.657071,5225,0,168.38,409000004058,2-Aug-17,VISA POSDOM ACQ SETTL 010,,365184.85,-547594267.37,Akobundu,557,France,177944.64,0,1,0
4060,2011,4,MORTGAGE,3,Medium,2,16000, 60 months,2,other,4,High,2,Good Loan,0,17.27,D,4,12.84,19952.06,12277.2,0,399.97,409000004059,2-Aug-17,VISA POSINT ACQ SETTL 010,,8505.40,-547585761.97,Fanucci,676,France,166678.28,0,1,0
4061,2011,4,RENT,1,Low,1,5000, 36 months,1,debt_consolidation,6,High,2,Good Loan,0,16.77,D,4,10.67,6300.059491,5000,0,177.7,409000004060,2-Aug-17,RUPAY POS ACQ SETTL 02081,,1081983.63,-546503778.34,Hsiao,640,France,44904.26,0,1,0
4062,2011,10,MORTGAGE,3,Low,1,25000, 36 months,1,debt_consolidation,6,High,2,Bad Loan,1,16.77,D,4,20.69,16913.35,7567.19,2737.51,888.46,409000004061,3-Aug-17,MASTER POSDOM ACQ SETTL02,,205868.95,-546297909.39,Clancy,529,Spain,10625.91,0,1,0
4063,2011,6,MORTGAGE,3,Low,1,20000, 36 months,1,credit_card,1,High,2,Good Loan,0,15.96,C,3,10.52,23674.03,20000,0,702.75,409000004062,3-Aug-17,MAESTRO POSDOM ACQ SETTL0,,67567.62,-546230341.77,Macdonald,559,France,169781.45,0,1,0
4064,2011,10,MORTGAGE,3,Low,1,10000, 36 months,1,debt_consolidation,6,Low,1,Good Loan,0,6.03,A,1,11.32,10730.2,10000,0,304.36,409000004063,3-Aug-17,VISA POSDOM ACQ SETTL 020,,575919.60,-545654422.17,Palerma,689,France,49848.86,0,1,0
4065,2011,3,RENT,1,Low,1,14000, 36 months,1,debt_consolidation,6,Low,1,Good Loan,0,8.9,A,1,19.88,15991.96168,14000,0,444.55,409000004064,3-Aug-17,TRF TO  Indiaforensic SERVICES I,"1,700,000.00",,-547354422.17,Holden,626,Germany,51467.92,0,1,0
4066,2011,4,RENT,1,Low,1,12000, 60 months,2,credit_card,1,High,2,Good Loan,0,15.27,C,3,11.65,14296.45,9286.1,0,287.19,409000004065,3-Aug-17,RUPAY POS ACQ SETTL 03081,,1252762.97,-546101659.20,Moore,697,Spain,735.79,0,1,0
4067,2011,10,MORTGAGE,3,Low,1,4600, 36 months,1,credit_card,1,Low,1,Good Loan,0,7.9,A,1,16.52,5180.969131,4600,0,143.94,409000004066,4-Aug-17,MASTER POSDOM ACQ SETTL03,,229748.52,-545871910.68,Gallo,823,France,182495.70,0,1,0
4068,2011,10,MORTGAGE,3,Low,1,7000, 36 months,1,debt_consolidation,6,Low,1,Good Loan,0,7.9,A,1,12.61,7884.506943,7000,0,219.04,409000004067,4-Aug-17,MAESTRO POSDOM ACQ SETTL0,,59886.76,-545812023.92,Otutodilinna,565,Germany,118740.37,0,1,0
4069,2011,10,MORTGAGE,3,Low,1,12000, 36 months,1,debt_consolidation,6,Low,1,Good Loan,0,7.9,A,1,14.1,13516.4957,12000,0,375.49,409000004068,4-Aug-17,VISA POSDOM ACQ SETTL 030,,465726.71,-545346297.21,Rios,631,Spain,13813.24,0,1,0
4070,2011,3,RENT,1,Medium,2,20000, 60 months,2,debt_consolidation,6,High,2,Bad Loan,1,14.65,C,3,22.21,11042.06,458.59,10098.06,472.14,409000004069,4-Aug-17,TRF TO  Indiaforensic SERVICES I,"2,100,000.00",,-547446297.21,McGregor,646,France,130500.65,0,1,0
4071,2011,10,MORTGAGE,3,Medium,2,35000, 60 months,2,other,4,High,2,Bad Loan,1,18.25,D,4,5.36,16996.46,4704.15,4626.63,893.54,409000004070,4-Aug-17,RUPAY POS ACQ SETTL 04081,,1443745.46,-546002551.75,Hill,676,Spain,14152.15,0,1,0
4072,2011,3,MORTGAGE,3,Low,1,20000, 60 months,2,debt_consolidation,6,High,2,Good Loan,0,15.96,C,3,6.87,21543.14,20000,0,485.94,409000004071,5-Aug-17,MASTER POSDOM ACQ SETTL04,,338457.26,-545664094.49,H?,850,Spain,66963.15,0,1,0
4073,2011,4,RENT,1,Low,1,18225, 60 months,2,debt_consolidation,6,High,2,Good Loan,0,19.91,E,5,15.38,25573.37018,18225,0,481.94,409000004072,5-Aug-17,MAESTRO POSDOM ACQ SETTL0,,54928.37,-545609166.12,Ferrari,810,France,93261.69,0,1,0
4074,2011,0.5,RENT,1,Medium,2,6500, 36 months,1,wedding,5,Low,1,Good Loan,0,10.65,B,2,10.49,7056.89,6500,0,211.73,409000004073,5-Aug-17,VISA POSDOM ACQ SETTL 040,,629805.53,-544979360.59,Onyemauchechi,581,Spain,196582.28,0,1,0
4075,2011,5,MORTGAGE,3,Medium,2,20000, 60 months,2,home_improvement,7,High,2,Good Loan,0,14.65,C,3,9.03,24603.22,16966.86,0,472.14,409000004074,5-Aug-17,TRF TO  Indiaforensic SERVICES I,"3,000,000.00",,-547979360.59,Nkemakonam,718,France,43024.64,0,1,0
4076,2011,4,OWN,2,Low,1,25000, 60 months,2,credit_card,1,Low,1,Good Loan,0,10.65,B,2,22.47,26880.21,19810.69,0,539.21,409000004075,5-Aug-17,RUPAY POS ACQ SETTL 05081,,1242659.12,-546736701.47,White,713,France,130001.13,0,1,0
4077,2011,5,RENT,1,Low,1,8500, 36 months,1,debt_consolidation,6,Low,1,Good Loan,0,7.51,A,1,16.26,8605.17,8500,0,264.45,409000004076,7-Aug-17,TRF TO  Indiaforensic SERVICES I,"1,000,000.00",,-547736701.47,Kirillov,672,France,12106.82,0,1,0
4078,2011,3,MORTGAGE,3,Low,1,4000, 60 months,2,car,2,Low,1,Good Loan,0,10.65,B,2,11.34,5026.009182,4000,0,86.28,409000004077,7-Aug-17,MASTER POSDOM ACQ SETTL05,,321684.13,-547415017.34,Iadanza,781,Spain,42556.33,0,1,0
4079,2011,0.5,RENT,1,Low,1,12000, 36 months,1,debt_consolidation,6,High,2,Good Loan,0,13.49,C,3,9.98,13502.63,12000,0,407.17,409000004078,7-Aug-17,MAESTRO POSDOM ACQ SETTL0,,77844.76,-547337172.58,Stiles,656,Spain,197961.93,0,1,0
4080,2011,6.05,MORTGAGE,3,Low,1,6400, 36 months,1,debt_consolidation,6,Low,1,Good Loan,0,7.9,A,1,12.87,7036.77,6400,0,200.26,409000004079,7-Aug-17,VISA POSDOM ACQ SETTL 050,,560277.55,-546776895.03,Ankudinov,583,France,12538.92,0,1,0
4081,2011,10,MORTGAGE,3,Medium,2,35000, 60 months,2,debt_consolidation,6,High,2,Good Loan,0,20.3,E,5,19.88,54121.67011,35000,0,933.14,409000004080,7-Aug-17,VISA POSINT ACQ SETTL 050,,12250.00,-546764645.03,Gaffney,808,Germany,35140.49,0,1,0
4082,2011,2,RENT,1,Low,1,16000, 36 months,1,debt_consolidation,6,Low,1,Good Loan,0,11.71,B,2,17.31,19047.40064,16000,0,529.22,409000004081,7-Aug-17,VISA POSINT ACQ SETTL 060,,24942.80,-546739702.23,Udinese,721,Spain,117626.90,0,1,0
4083,2011,3,RENT,1,Medium,2,11000, 36 months,1,debt_consolidation,6,High,2,Good Loan,0,16.77,D,4,7.85,13987.61163,11000,0,390.93,409000004082,7-Aug-17,RUPAY POS ACQ SETTL 06081,,1412400.46,-545327301.77,Romani,778,Germany,62454.01,0,1,0
4084,2011,5,RENT,1,Low,1,3200, 36 months,1,debt_consolidation,6,Low,1,Good Loan,0,11.71,B,2,17.79,3291.64,3200,0,105.85,409000004083,7-Aug-17,RUPAY POS ACQ SETTL 07081,,1541528.86,-543785772.91,Kambinachi,850,Spain,109089.04,0,1,0
4085,2011,1,RENT,1,Low,1,3300, 36 months,1,wedding,5,Low,1,Good Loan,0,11.71,B,2,16.08,3332.45,3300,0,109.16,409000004084,7-Aug-17,TRANSFER TO  Indiaforensic SERVI,"3,000,000.00",,-546785772.91,Hawkins,693,France,142331.39,0,1,0
4086,2011,7,MORTGAGE,3,Low,1,9400, 36 months,1,credit_card,1,Low,1,Good Loan,0,6.62,A,1,6.19,10389.26605,9400,0,288.62,409000004085,7-Aug-17,TRANSFER TO  Indiaforensic SERVI,"1,000,000.00",,-547785772.91,Tsui,520,France,193209.11,0,1,0
4087,2011,6,MORTGAGE,3,Medium,2,4000, 36 months,1,car,2,High,2,Good Loan,0,13.49,C,3,17.32,4869.562645,4000,0,135.73,409000004086,8-Aug-17,MASTER POSDOM ACQ SETTL07,,611744.71,-547174028.20,Ifeatu,759,Germany,47832.82,0,1,0
4088,2011,6,MORTGAGE,3,Low,1,25000, 60 months,2,debt_consolidation,6,Low,1,Bad Loan,1,12.42,B,2,15.92,19099.48,9358.42,3964.63,561.44,409000004087,8-Aug-17,MAESTRO POSDOM ACQ SETTL0,,132762.32,-547041265.88,McIntosh,637,France,70174.03,0,1,0
4089,2011,2,RENT,1,Low,1,12000, 60 months,2,debt_consolidation,6,Low,1,Bad Loan,1,10.65,B,2,12.29,2846.04,1736.25,0,258.82,409000004088,8-Aug-17,VISA POSDOM ACQ SETTL 070,,1434129.27,-545607136.61,Armit,755,Germany,176768.59,0,1,0
4090,2011,10,OWN,2,Low,1,10000, 36 months,1,home_improvement,7,Low,1,Good Loan,0,12.42,B,2,7.78,12028.09231,10000,0,334.16,409000004089,8-Aug-17,RUPAY POS ACQ SETTL 08081,,1003826.62,-544603309.99,Fang,662,France,129392.75,0,1,0
4091,2011,10,MORTGAGE,3,Low,1,12000, 36 months,1,debt_consolidation,6,Low,1,Good Loan,0,6.03,A,1,10.95,13147.8457,12000,0,365.23,409000004090,9-Aug-17,MASTER POSDOM ACQ SETTL08,,173279.29,-544430030.70,Chou,503,France,97893.32,0,1,0
4092,2011,6,OWN,2,Low,1,18000, 36 months,1,debt_consolidation,6,Low,1,Good Loan,0,7.9,A,1,4.69,20275.53503,18000,0,563.23,409000004091,9-Aug-17,MAESTRO POSDOM ACQ SETTL0,,58458.07,-544371572.63,Okeke,599,Germany,176142.09,0,1,0
4093,2011,2,RENT,1,Low,1,15000, 60 months,2,debt_consolidation,6,High,2,Good Loan,0,21.28,F,6,7.53,23087.67808,15000,0,408.17,409000004092,9-Aug-17,VISA POSDOM ACQ SETTL 080,,782471.36,-543589101.27,Ramsbotham,583,Spain,114093.73,0,1,0
4094,2011,8,MORTGAGE,3,Low,1,14075, 36 months,1,debt_consolidation,6,Low,1,Good Loan,0,9.91,B,2,22.53,16293.74673,14075,0,453.57,409000004093,9-Aug-17,VISA POSINT ACQ SETTL 080,,2373.60,-543586727.67,Scannell,764,Spain,158323.81,0,1,0
4095,2011,5,RENT,1,Low,1,14125, 60 months,2,debt_consolidation,6,High,2,Bad Loan,1,21.28,F,6,16.49,16443.5,12191.77,110.62,384.36,409000004094,9-Aug-17,RUPAY POS ACQ SETTL 09081,,1333441.18,-542253286.49,Edman,513,France,25514.77,0,1,0
4096,2011,0.5,OWN,2,Low,1,4800, 60 months,2,debt_consolidation,6,High,2,Good Loan,0,17.58,D,4,9.83,6862.539917,4800,0,120.8,409000004095,9-Aug-17,TRFT O  Indiaforensic SERVICES I,"4,600,000.00",,-546853286.49,De Luca,730,Spain,61513.87,0,1,0
4097,2011,4,MORTGAGE,3,Low,1,17175, 60 months,2,house,12,High,2,Good Loan,0,18.25,D,4,10.75,24907.36117,17175,0,438.48,409000004096,10-Aug-17,MASTER POSDOM ACQ SETTL09,,198025.35,-546655261.14,Vasilyeva,820,Spain,59553.34,0,1,0
4098,2011,6.05,MORTGAGE,3,Low,1,8000, 36 months,1,home_improvement,7,Low,1,Good Loan,0,6.03,A,1,4.11,8721.869598,8000,0,243.49,409000004097,10-Aug-17,MAESTRO POSDOM ACQ SETTL0,,35201.86,-546620059.28,Tuan,597,Spain,110253.20,0,1,0
4099,2011,0.5,MORTGAGE,3,Low,1,7125, 36 months,1,debt_consolidation,6,Low,1,Bad Loan,1,11.71,B,2,20.05,1166.52,673.16,225.52,235.67,409000004098,10-Aug-17,VISA POSDOM ACQ SETTL 090,"6,174.00",,-546626233.28,Ejimofor,637,France,148769.08,0,1,0
4100,2011,2,MORTGAGE,3,Low,1,6500, 36 months,1,debt_consolidation,6,Low,1,Good Loan,0,10.65,B,2,0,7265.4,6500,0,211.73,409000004099,10-Aug-17,RUPAY POS ACQ SETTL 10081,,1402738.41,-545223494.87,Hs?,696,France,8236.78,0,1,0
4101,2011,0.5,MORTGAGE,3,Low,1,19000, 60 months,2,debt_consolidation,6,High,2,Good Loan,0,17.58,D,4,9.53,28251.60003,19000,0,478.15,409000004100,10-Aug-17,TRF TO  Indiaforensic SERVICES I,"1,600,000.00",,-546823494.87,Shaver,635,Germany,11407.58,0,1,0
4102,2011,3,MORTGAGE,3,Low,1,21000, 60 months,2,small_business,3,Low,1,Good Loan,0,12.42,B,2,7.04,26247.63844,21000,0,471.61,409000004101,10-Aug-17,17825-INT-SETTLEMENT-0108,,10081.91,-546813412.96,Wallis,673,Spain,49684.09,0,1,0
4103,2011,0.5,MORTGAGE,3,Low,1,12000, 60 months,2,other,4,Low,1,Good Loan,0,10.65,B,2,12,12901.2,9494.74,0,258.82,409000004102,10-Aug-17,17825-INT-SETTLE E/G-0108,48,,-546813460.96,Coupp,662,Spain,68064.83,0,1,0
4104,2011,10,MORTGAGE,3,Low,1,2850, 36 months,1,credit_card,1,Low,1,Good Loan,0,7.51,A,1,21.43,3190.662208,2850,0,88.67,409000004103,10-Aug-17,17825-INT-SETTLEMENT-0408,,8878.46,-546804582.50,Perry,683,Spain,163911.32,0,1,0
4105,2011,4,RENT,1,Low,1,13000, 60 months,2,debt_consolidation,6,High,2,Good Loan,0,14.27,C,3,18.08,15181.38,10125.8,0,304.32,409000004104,10-Aug-17,17825-INT-SETTLE E/G-0408,,1.39,-546804581.11,Bezrukova,850,France,944.41,0,1,0
4106,2011,3,RENT,1,Low,1,8000, 36 months,1,debt_consolidation,6,High,2,Good Loan,0,13.49,C,3,15.11,9769.682647,8000,0,271.45,409000004105,10-Aug-17,17825-INT-SETTLEMENT-0508,,25260.14,-546779320.97,Lucciano,815,Spain,185547.71,0,1,0
4107,2011,0.5,RENT,1,Low,1,1500, 36 months,1,vacation,11,High,2,Good Loan,0,18.64,E,5,9.93,1968.796062,1500,0,54.72,409000004106,10-Aug-17,17825-INT-SETTLE E/G-0508,,43.65,-546779277.32,Ingram,671,Spain,140509.86,0,1,0
4108,2011,2,MORTGAGE,3,Low,1,30000, 36 months,1,debt_consolidation,6,Low,1,Good Loan,0,10.65,B,2,19.21,32010.72,30000,0,977.2,409000004107,11-Aug-17,MASTER POSDOM ACQ SETTL10,,232196.05,-546547081.27,Lo Duca,601,France,164652.02,0,1,0
4109,2011,0.5,MORTGAGE,3,Low,1,9475, 36 months,1,debt_consolidation,6,Low,1,Good Loan,0,6.03,A,1,28.26,10271.07,9475,0,288.38,409000004108,11-Aug-17,MAESTRO POSDOM ACQ SETTL1,,61392.89,-546485688.38,Wan,709,Germany,73641.86,0,1,0
4110,2011,5,RENT,1,Low,1,9975, 60 months,2,car,2,High,2,Good Loan,0,17.58,D,4,15.83,10539,9975,0,251.03,409000004109,11-Aug-17,VISA POSDOM ACQ SETTL 100,,1439185.25,-545046503.13,Cohn,702,Germany,40321.87,0,1,0
4111,2011,4,MORTGAGE,3,Low,1,3000, 36 months,1,home_improvement,7,High,2,Good Loan,0,14.65,C,3,9.93,3724.893517,3000,0,103.49,409000004110,11-Aug-17,RUPAY POS ACQ SETTL 11081,,1205588.08,-543840915.05,Yen,558,France,173844.89,0,1,0
4112,2011,2,RENT,1,Low,1,20900, 36 months,1,credit_card,1,Low,1,Good Loan,0,12.69,B,2,9.62,22700.63,20900,0,701.09,409000004111,11-Aug-17,TRF TO  Indiaforensic SERVICES I,"3,200,000.00",,-547040915.05,Peng,691,Spain,145613.17,0,1,0
4113,2011,3,MORTGAGE,3,Medium,2,30000, 60 months,2,debt_consolidation,6,High,2,Good Loan,0,22.74,G,7,16.56,42033.65,22390.06,0,841.24,409000004112,11-Aug-17,17825-INT-SETTLEMENT-3107,,75892.37,-546965022.68,Little,700,France,174971.64,0,1,0
4114,2011,2,RENT,1,Low,1,8000, 36 months,1,credit_card,1,Low,1,Good Loan,0,6.62,A,1,16.03,8385.39,8000,0,245.63,409000004113,11-Aug-17,17825-INT-SETTLE E/G-3107,254.12,,-546965276.80,Meng,667,France,131834.75,0,1,0
4115,2011,1,OWN,2,Low,1,6000, 36 months,1,wedding,5,High,2,Good Loan,0,15.96,C,3,5.75,7586.526286,6000,0,210.83,409000004114,11-Aug-17,17825-INT-SETTLEMENT-0808,,98.08,-546965178.72,Adams,624,Germany,110498.10,0,1,0
4116,2011,10,RENT,1,Low,1,2600, 36 months,1,major_purchase,8,High,2,Good Loan,0,15.27,C,3,5.27,3257,2599.99,0,90.48,409000004115,14-Aug-17,MASTER POSDOM ACQ SETTL11,,370387.45,-546594791.27,Hill,580,France,196241.43,0,1,0
4117,2011,5,MORTGAGE,3,Low,1,11500, 36 months,1,debt_consolidation,6,Low,1,Good Loan,0,7.9,A,1,21.93,12953.78117,11500,0,359.84,409000004116,14-Aug-17,MASTER POSDOM ACQ SETTL12,,269057.94,-546325733.33,Boyle,571,Spain,194667.92,0,1,0
4118,2011,5,OWN,2,Low,1,5000, 36 months,1,major_purchase,8,Low,1,Good Loan,0,12.69,B,2,10.97,6035.561211,5000,0,167.73,409000004117,14-Aug-17,MAESTRO POSDOM ACQ SETTL1,,47739.92,-546277993.41,Pagnotto,561,France,83093.25,0,1,0
4119,2011,3,MORTGAGE,3,Low,1,6500, 36 months,1,other,4,Low,1,Good Loan,0,10.65,B,2,13.28,7169.96,6500,0,211.73,409000004118,14-Aug-17,MAESTRO POSDOM ACQ SETTL1,,91552.96,-546186440.45,Feng,529,France,52545.24,0,1,0
4120,2011,10,OWN,2,Medium,2,14000, 60 months,2,debt_consolidation,6,High,2,Good Loan,0,14.65,C,3,18.85,16486.41,14000,0,330.5,409000004119,14-Aug-17,VISA POSDOM ACQ SETTL 110,,564059.80,-545622380.65,Endrizzi,670,France,59571.50,0,1,0
4121,2011,2,MORTGAGE,3,Low,1,24000, 36 months,1,home_improvement,7,Low,1,Good Loan,0,7.9,A,1,15.23,24750.63,24000,0,750.97,409000004120,14-Aug-17,VISA POSDOM ACQ SETTL 120,,868253.04,-544754127.61,Shen,666,Germany,99818.31,0,1,0
4122,2011,5,RENT,1,Low,1,12150, 60 months,2,debt_consolidation,6,High,2,Bad Loan,1,18.25,D,4,20.31,4323.69,1627.15,624.69,310.19,409000004121,14-Aug-17,VISA POSINT ACQ SETTL 120,,2062.20,-544752065.41,Lay,628,Spain,172967.87,0,1,0
4123,2011,10,MORTGAGE,3,Low,1,5800, 36 months,1,debt_consolidation,6,Low,1,Good Loan,0,12.42,B,2,11.75,6949.59918,5800,0,193.81,409000004122,14-Aug-17,RUPAY POS ACQ SETTL 12081,,1359847.60,-543392217.81,Wu,577,France,178616.73,0,1,0
4124,2011,2,MORTGAGE,3,Low,1,12000, 60 months,2,other,4,High,2,Good Loan,0,13.49,C,3,9.3,16069.52136,12000,0,276.06,409000004123,14-Aug-17,RUPAY POS ACQ SETTL 13081,,1548259.58,-541843958.23,Shephard,652,Spain,159649.44,0,1,0
4125,2011,7,MORTGAGE,3,Low,1,6000, 60 months,2,car,2,Low,1,Good Loan,0,8.9,A,1,2.62,7331.777448,6000,0,124.26,409000004124,14-Aug-17,RUPAY POS ACQ SETTL 14081,,779349.53,-541064608.70,Schmidt,678,France,60941.27,0,1,0
4126,2011,6,MORTGAGE,3,Low,1,12000, 60 months,2,home_improvement,7,High,2,Good Loan,0,15.96,C,3,18.65,15381.7,12000,0,291.57,409000004125,14-Aug-17,TRF TO  Indiaforensic SERVICES I,"7,200,000.00",,-548264608.70,Davidson,692,Spain,178342.63,0,1,0
4127,2011,5,MORTGAGE,3,Low,1,5000, 36 months,1,debt_consolidation,6,Low,1,Bad Loan,1,6.62,A,1,18.31,3197.83,2648.81,134.83,153.52,409000004126,16-Aug-17,MASTER POSDOM ACQ SETTL14,,525636.09,-547738972.61,Lamb,675,Spain,191545.65,0,1,0
4128,2011,1,MORTGAGE,3,Low,1,23000, 60 months,2,debt_consolidation,6,Low,1,Good Loan,0,10.65,B,2,14.45,27975.33413,23000,0,496.08,409000004127,16-Aug-17,MASTER POSDOM ACQ SETTL15,,331944.50,-547407028.11,Hussey,712,Spain,117977.45,0,1,0
4129,2011,6.05,RENT,1,Low,1,2600, 36 months,1,debt_consolidation,6,High,2,Good Loan,0,16.29,D,4,7.12,3181.83,2600,0,91.79,409000004128,16-Aug-17,MAESTRO POSDOM ACQ SETTL1,,151081.67,-547255946.44,Ferrari,639,Germany,49637.65,0,1,0
4130,2011,10,MORTGAGE,3,Low,1,3000, 36 months,1,home_improvement,7,Low,1,Good Loan,0,6.62,A,1,14.07,3314.909256,3000,0,92.12,409000004129,16-Aug-17,MAESTRO POSDOM ACQ SETTL1,,50776.67,-547205169.77,Macfarlan,618,France,13921.82,0,1,0
4131,2011,6,MORTGAGE,3,Low,1,10375, 36 months,1,debt_consolidation,6,Low,1,Good Loan,0,6.62,A,1,15.28,11177.2,10375,0,318.56,409000004130,16-Aug-17,VISA POSDOM ACQ SETTL 140,,1325634.90,-545879534.87,Szabados,554,France,173197.12,0,1,0
4132,2011,7,MORTGAGE,3,Low,1,7200, 36 months,1,major_purchase,8,Low,1,Good Loan,0,6.62,A,1,17.52,7859.19,7200,0,221.07,409000004131,16-Aug-17,VISA POSDOM ACQ SETTL 150,,828095.73,-545051439.14,Yuan,533,France,137696.25,0,1,0
4133,2011,10,MORTGAGE,3,Low,1,17725, 60 months,2,debt_consolidation,6,Low,1,Good Loan,0,11.71,B,2,28.25,19547.94,13989.24,0,391.7,409000004132,16-Aug-17,VISA POSINT ACQ SETTL 150,,392.80,-545051046.34,Matveyev,540,Spain,80698.54,0,1,0
4134,2011,10,MORTGAGE,3,Low,1,15350, 60 months,2,debt_consolidation,6,High,2,Good Loan,0,13.49,C,3,25.93,19819.12089,15350,0,353.13,409000004133,16-Aug-17,RUPAY POS ACQ SETTL 15081,,1699242.32,-543351804.02,Cheng,704,Spain,73018.74,0,1,0
4135,2011,9,MORTGAGE,3,Low,1,4200, 36 months,1,home_improvement,7,Low,1,Good Loan,0,12.42,B,2,13,5051.107748,4200,0,140.35,409000004134,16-Aug-17,RUPAY POS ACQ SETTL 16081,,997690.50,-542354113.52,Palerma,678,France,79649.62,0,1,0
4136,2011,6,RENT,1,Low,1,4200, 36 months,1,car,2,Low,1,Good Loan,0,6.62,A,1,11.08,4641.833062,4200,0,128.96,409000004135,16-Aug-17,TRF TO  Indiaforensic SERVICES I,"5,900,000.00",,-548254113.52,Wang,712,France,166194.53,0,1,0
4137,2011,7,RENT,1,Low,1,10000, 36 months,1,debt_consolidation,6,Low,1,Good Loan,0,7.51,A,1,15.34,11027.37,10000,0,311.11,409000004136,18-Aug-17,MASTER POSDOM ACQ SETTL16,,284873.08,-547969240.44,Teng,651,France,102530.35,0,1,0
4138,2011,2,MORTGAGE,3,Low,1,5000, 36 months,1,major_purchase,8,Low,1,Good Loan,0,6.03,A,1,10.58,5314.715888,5000,0,152.18,409000004137,18-Aug-17,MASTER POSDOM ACQ SETTL17,,231430.30,-547737810.14,K'ung,789,Germany,74265.38,0,1,0
4139,2011,6.05,OWN,2,Low,1,14125, 36 months,1,debt_consolidation,6,Low,1,Good Loan,0,6.62,A,1,21.24,15174.92,14125,0,433.69,409000004138,18-Aug-17,MAESTRO POSDOM ACQ SETTL1,,69120.39,-547668689.75,Sinclair,775,Germany,125898.39,0,1,0
4140,2011,10,OWN,2,Low,1,20000, 60 months,2,debt_consolidation,6,High,2,Good Loan,0,18.25,D,4,17.79,25459.25,15263.01,0,510.6,409000004139,18-Aug-17,MAESTRO POSDOM ACQ SETTL1,,79723.35,-547588966.40,McKelvey,564,Germany,83681.20,0,1,0
4141,2011,2,RENT,1,Low,1,9000, 60 months,2,small_business,3,High,2,Bad Loan,1,18.25,D,4,0.33,6000.75,2320.23,946.56,229.77,409000004140,18-Aug-17,VISA POSDOM ACQ SETTL 160,,486808.08,-547102158.32,Yuan,841,Germany,99505.75,0,1,0
4142,2011,4,RENT,1,Low,1,10000, 36 months,1,debt_consolidation,6,Low,1,Good Loan,0,6.62,A,1,21.05,10977.70995,10000,0,307.04,409000004141,18-Aug-17,VISA POSDOM ACQ SETTL 160,,572907.34,-546529250.98,Moran,850,Spain,92748.16,0,1,0
4143,2011,10,OWN,2,Medium,2,10000, 36 months,1,debt_consolidation,6,Low,1,Good Loan,0,11.71,B,2,14.75,11792.21485,10000,0,330.76,409000004142,18-Aug-17,VISA POSINT ACQ SETTL 160,,297.00,-546528953.98,McConnell,637,France,28092.77,0,1,0
4144,2011,10,MORTGAGE,3,Low,1,5400, 36 months,1,other,4,Low,1,Good Loan,0,8.9,A,1,29.03,6172.74451,5400,0,171.47,409000004143,18-Aug-17,VISA POSINT ACQ SETTL 170,,606.43,-546528347.55,Iheatu,500,France,126145.08,0,1,0
4145,2011,6,MORTGAGE,3,Low,1,9000, 36 months,1,credit_card,1,Low,1,Good Loan,0,10.65,B,2,3.22,9584.63,9000,0,293.16,409000004144,18-Aug-17,RUPAY POS ACQ SETTL 17081,,1691557.74,-544836789.81,Giordano,655,France,188593.98,0,1,0
4146,2011,1,RENT,1,Low,1,4800, 60 months,2,car,2,High,2,Bad Loan,1,18.25,D,4,5.73,3308.22,1347.38,499.69,122.55,409000004145,18-Aug-17,RUPAY POS ACQ SETTL 18081,,1343545.82,-543493243.99,Alexander,666,France,56410.17,0,1,0
4147,2011,9,MORTGAGE,3,Medium,2,24000, 36 months,1,debt_consolidation,6,High,2,Good Loan,0,15.96,C,3,10.46,29166.24,24000,0,843.3,409000004146,19-Aug-17,TRF TO  Indiaforensic SERVICES I,"2,000,000.00",,-545493243.99,Gordon,658,France,84694.49,0,1,0
4148,2011,3,MORTGAGE,3,Low,1,17600, 60 months,2,debt_consolidation,6,High,2,Good Loan,0,17.27,D,4,15.57,18834.51,17600,0,439.97,409000004147,19-Aug-17,TRF TO  Indiaforensic SERVICES I,"2,000,000.00",,-547493243.99,Tang,749,Germany,195429.92,0,1,0
4149,2011,8,MORTGAGE,3,Low,1,12000, 36 months,1,credit_card,1,Low,1,Good Loan,0,7.9,A,1,19.56,13517.30178,12000,0,375.49,409000004148,19-Aug-17,MASTER POSDOM ACQ SETTL18,,295521.56,-547197722.43,T'an,654,France,137898.57,0,1,0
4150,2011,9,OWN,2,Low,1,4925, 36 months,1,debt_consolidation,6,Low,1,Good Loan,0,11.71,B,2,10.33,5315.24,4925,0,162.9,409000004149,19-Aug-17,MAESTRO POSDOM ACQ SETTL1,,41721.62,-547156000.81,Davies,623,France,78774.36,0,1,0
4151,2011,0.5,RENT,1,Low,1,7200, 36 months,1,car,2,Low,1,Bad Loan,1,11.71,B,2,2.01,4932.23,3579.38,207.84,238.15,409000004150,19-Aug-17,VISA POSDOM ACQ SETTL 180,,600535.19,-546555465.62,Sanders,761,France,148779.41,0,1,0
4152,2011,10,MORTGAGE,3,Low,1,30000, 36 months,1,debt_consolidation,6,High,2,Good Loan,0,19.03,E,5,16.35,34656.02,30000,0,1100.14,409000004151,19-Aug-17,RUPAY POS ACQ SETTL 19081,,1517348.25,-545038117.37,Winifred,627,France,35300.08,0,1,0
4153,2011,1,RENT,1,Low,1,15000, 60 months,2,wedding,5,High,2,Good Loan,0,13.49,C,3,1.17,17207.47,11727.93,0,345.08,409000004152,21-Aug-17,MASTER POSDOM ACQ SETTL19,,278082.20,-544760035.17,Holmes,757,Germany,197077.36,0,1,0
4154,2011,3,RENT,1,Medium,2,20000, 36 months,1,credit_card,1,Low,1,Good Loan,0,7.9,A,1,7.27,22295.01,20000,0,625.81,409000004153,21-Aug-17,MAESTRO POSDOM ACQ SETTL1,,40154.82,-544719880.35,Riddle,695,Germany,70140.80,0,1,0
4155,2011,7,RENT,1,Low,1,8000, 36 months,1,debt_consolidation,6,High,2,Bad Loan,1,16.77,D,4,13.2,2646.99,1447.11,376.27,284.31,409000004154,21-Aug-17,VISA POSDOM ACQ SETTL 190,,610738.35,-544109142.00,Chinedum,726,France,196288.46,0,1,0
4156,2011,6,MORTGAGE,3,Low,1,18000, 36 months,1,debt_consolidation,6,Low,1,Good Loan,0,7.9,A,1,2.95,18234.29,18000,0,563.23,409000004155,21-Aug-17,RUPAY POS ACQ SETTL 20081,,1466357.55,-542642784.45,Aleksandrova,587,Spain,1557.82,0,1,0
4157,2011,3,MORTGAGE,3,Low,1,6400, 36 months,1,home_improvement,7,Low,1,Good Loan,0,11.71,B,2,13.2,7618.596406,6400,0,211.69,409000004156,21-Aug-17,RUPAY POS ACQ SETTL 21081,,950572.14,-541692212.31,Conti,605,Germany,23970.13,0,1,0
4158,2011,4,MORTGAGE,3,Low,1,9600, 36 months,1,debt_consolidation,6,Low,1,Good Loan,0,6.62,A,1,2.78,10609.79322,9600,0,294.76,409000004157,21-Aug-17,TRF TO  Indiaforensic SERVICES I,"3,000,000.00",,-544692212.31,Watson,850,Spain,180243.56,0,1,0
4159,2011,10,MORTGAGE,3,Low,1,7000, 36 months,1,home_improvement,7,Low,1,Good Loan,0,6.03,A,1,13.39,7588.1,7000,0,213.05,409000004158,21-Aug-17,TRF TO  Indiaforensic SERVICES I,"3,000,000.00",,-547692212.31,Davison,850,France,148977.72,0,1,0
4160,2011,1,RENT,1,Low,1,7000, 36 months,1,other,4,Low,1,Good Loan,0,10.65,B,2,7.63,7240.93,7000,0,228.02,409000004159,22-Aug-17,MASTER POSDOM ACQ SETTL21,,616333.78,-547075878.53,Cook,751,France,39934.41,0,1,0
4161,2011,10,RENT,1,Low,1,9600, 36 months,1,wedding,5,Low,1,Good Loan,0,9.91,B,2,13,11136.06941,9600,0,309.36,409000004160,22-Aug-17,MAESTRO POSDOM ACQ SETTL2,,105799.30,-546970079.23,Udinesi,627,Germany,133031.96,0,1,0
4162,2011,2,MORTGAGE,3,Low,1,10000, 36 months,1,home_improvement,7,Low,1,Good Loan,0,7.9,A,1,1.82,10851.78,10000,0,312.91,409000004161,22-Aug-17,VISA POSDOM ACQ SETTL 210,,1174501.99,-545795577.24,Siciliani,736,France,52856.88,0,1,0
4163,2011,7,MORTGAGE,3,Medium,2,18000, 36 months,1,credit_card,1,Low,1,Good Loan,0,7.9,A,1,8.17,19668.89,18000,0,563.23,409000004162,22-Aug-17,RUPAY POS ACQ SETTL 22081,,1448935.17,-544346642.07,Bell,652,France,937.15,0,1,0
4164,2011,10,MORTGAGE,3,Low,1,8400, 36 months,1,debt_consolidation,6,Low,1,Good Loan,0,6.62,A,1,12.32,9262.031858,8400,0,257.92,409000004163,23-Aug-17,MASTER POSDOM ACQ SETTL22,,216685.77,-544129956.30,Jackson,627,France,193022.44,0,1,0
4165,2011,5,RENT,1,Medium,2,33600, 60 months,2,debt_consolidation,6,High,2,Good Loan,0,13.49,C,3,17.6,38995.28,26742.49,0,772.96,409000004164,23-Aug-17,MAESTRO POSDOM ACQ SETTL2,,59585.46,-544070370.84,Onyemere,636,France,37490.84,0,1,0
4166,2011,2,MORTGAGE,3,Medium,2,7200, 36 months,1,debt_consolidation,6,Low,1,Good Loan,0,10.65,B,2,5.28,7951,7200,0,234.53,409000004165,23-Aug-17,VISA POSDOM ACQ SETTL 220,,552543.67,-543517827.17,McClemans,775,France,111558.70,0,1,0
4167,2011,0.5,RENT,1,Low,1,4550, 60 months,2,moving,10,High,2,Good Loan,0,16.77,D,4,5.56,5616.09,3488.22,0,112.52,409000004166,23-Aug-17,RUPAY POS ACQ SETTL 23081,,1039917.32,-542477909.85,Ma,850,Spain,5669.31,0,1,0
4168,2011,10,OWN,2,Low,1,18750, 60 months,2,debt_consolidation,6,High,2,Good Loan,0,16.77,D,4,20.26,19012.47,18750,0,463.68,409000004167,23-Aug-17,TRF TO  Indiaforensic SERVICES I,"4,700,000.00",,-547177909.85,Morrison,850,Spain,68106.29,0,1,0
4169,2011,10,MORTGAGE,3,Medium,2,5600, 36 months,1,home_improvement,7,Low,1,Good Loan,0,7.9,A,1,10.34,6307.569473,5600,0,175.23,409000004168,24-Aug-17,TRF TO  Indiaforensic SERVICES I,"1,000,000.00",,-548177909.85,Chambers,516,France,101834.58,0,1,0
4170,2011,4,RENT,1,Low,1,4200, 36 months,1,credit_card,1,Low,1,Good Loan,0,12.69,B,2,21.38,5026.441934,4200,0,140.89,409000004169,24-Aug-17,RUPAY POS ACQ SETTL 24081,,1349974.78,-546827935.07,Basedow,513,Spain,73151.25,0,1,0
4171,2011,10,OWN,2,Low,1,12600, 36 months,1,home_improvement,7,Low,1,Bad Loan,1,12.42,B,2,23.73,13044.41,10552.74,0,421.04,409000004170,25-Aug-17,TRF TO  Indiaforensic SERVICES I,"1,400,000.00",,-548227935.07,Nwora,673,Germany,37196.15,0,1,0
4172,2011,10,MORTGAGE,3,Low,1,4800, 36 months,1,debt_consolidation,6,Low,1,Good Loan,0,12.42,B,2,17.98,5080.68,4800,0,160.4,409000004171,28-Aug-17,MASTER POSDOM ACQ SETTL24,,76279.13,-548151655.94,Howey,564,France,7819.76,0,1,0
4173,2011,0.5,MORTGAGE,3,Low,1,3000, 36 months,1,car,2,Low,1,Good Loan,0,7.9,A,1,0.19,3375.120228,3000,0,93.88,409000004172,28-Aug-17,MAESTRO POSDOM ACQ SETTL2,,84368.56,-548067287.38,Pai,636,France,23129.46,0,1,0
4174,2011,5,MORTGAGE,3,Medium,2,22000, 36 months,1,debt_consolidation,6,Low,1,Good Loan,0,12.42,B,2,18.6,25117.01,22000,0,735.14,409000004173,28-Aug-17,VISA POSDOM ACQ SETTL 240,,489854.31,-547577433.07,Ni,712,France,189680.79,0,1,0
4175,2011,10,RENT,1,Low,1,20000, 60 months,2,debt_consolidation,6,High,2,Good Loan,0,13.49,C,3,14.97,24581.4,20000,0,460.1,409000004174,28-Aug-17,MASTER POSDOM ACQ SETTL25,,221278.63,-547356154.44,Forbes,568,France,66586.56,0,1,0
4176,2011,6.05,MORTGAGE,3,Low,1,4750, 36 months,1,other,4,Low,1,Good Loan,0,7.9,A,1,13.96,5050.5,4750,0,148.63,409000004175,28-Aug-17,MAESTRO POSDOM ACQ SETTL2,,75853.79,-547280300.65,Baryshnikov,741,Spain,2920.63,0,1,0
4177,2011,2,RENT,1,Low,1,7500, 36 months,1,credit_card,1,Low,1,Good Loan,0,6.62,A,1,5.71,7541.55,7500,0,230.28,409000004176,28-Aug-17,VISA POSDOM ACQ SETTL 250,,448516.24,-546831784.41,Kramer,754,Germany,87684.93,0,1,0
4178,2011,0.5,RENT,1,Low,1,15000, 60 months,2,debt_consolidation,6,High,2,Good Loan,0,17.58,D,4,15.49,18810.99,11466.08,0,377.49,409000004177,28-Aug-17,MASTER POSDOM ACQ SETTL26,,338614.50,-546493169.91,Sochima,709,France,199418.02,0,1,0
4179,2011,10,MORTGAGE,3,Low,1,30000, 60 months,2,debt_consolidation,6,High,2,Good Loan,0,18.64,E,5,8.52,33696.26,30000,0,772.29,409000004178,28-Aug-17,MAESTRO POSDOM ACQ SETTL2,,68123.41,-546425046.50,Marchesi,510,France,28515.17,0,1,0
4180,2011,8,MORTGAGE,3,Low,1,9000, 36 months,1,debt_consolidation,6,Low,1,Good Loan,0,7.9,A,1,22.47,10137.40749,9000,0,281.62,409000004179,28-Aug-17,VISA POSDOM ACQ SETTL 260,,589534.62,-545835511.88,Todd,716,Spain,92916.53,0,1,0
4181,2011,2,MORTGAGE,3,Medium,2,35000, 36 months,1,debt_consolidation,6,Low,1,Good Loan,0,10.65,B,2,10.99,41038.47625,35000,0,1140.07,409000004180,28-Aug-17,RUPAY POS ACQ SETTL 25081,,1256429.96,-544579081.92,Mai,607,Germany,198313.69,0,1,0
4182,2011,10,RENT,1,Low,1,26000, 60 months,2,debt_consolidation,6,High,2,Bad Loan,1,18.64,E,5,14.5,15393.35,7247.02,0,669.32,409000004181,28-Aug-17,RUPAY POS ACQ SETTL 26081,,1441952.72,-543137129.20,Pinto,656,Spain,36308.93,0,1,0
4183,2011,4,MORTGAGE,3,Low,1,6400, 36 months,1,debt_consolidation,6,Low,1,Good Loan,0,7.9,A,1,12.2,7208.476004,6400,0,200.26,409000004182,28-Aug-17,RUPAY POS ACQ SETTL 27081,,934301.98,-542202827.22,Reynolds,550,Germany,41730.37,0,1,0
4184,2011,6,RENT,1,Low,1,10800, 36 months,1,debt_consolidation,6,High,2,Good Loan,0,16.29,D,4,17.27,13723.40791,10800,0,381.25,409000004183,28-Aug-17,RUPAY POS ACQ SETTL 28081,,705502.27,-541497324.95,Sal,486,France,31399.40,0,1,0
4185,2011,2,RENT,1,Low,1,3000, 36 months,1,debt_consolidation,6,High,2,Good Loan,0,14.27,C,3,15.27,3689.64563,3000,0,102.93,409000004184,29-Aug-17,TRF TO  Indiaforensic SERVICES I,"6,700,000.00",,-548197324.95,Miller,598,Germany,60192.14,0,1,0
4186,2011,1,RENT,1,Low,1,4500, 60 months,2,car,2,High,2,Good Loan,0,13.49,C,3,18.16,5565.96,4500,0,103.53,409000004185,29-Aug-17,MASTER POSDOM ACQ SETTL28,,287755.33,-547909569.62,Scott,675,Spain,29062.25,0,1,0
4187,2011,10,MORTGAGE,3,Low,1,15000, 36 months,1,debt_consolidation,6,Low,1,Good Loan,0,7.9,A,1,7.92,15844.83,15000,0,469.36,409000004186,29-Aug-17,MAESTRO POSDOM ACQ SETTL2,,168954.85,-547740614.77,Herrin,755,France,28805.09,0,1,0
4188,2011,3,RENT,1,Low,1,12600, 60 months,2,credit_card,1,High,2,Good Loan,0,19.42,E,5,17.74,16445.32,9560.12,0,329.77,409000004187,29-Aug-17,VISA POSDOM ACQ SETTL 280,,578095.14,-547162519.63,Stevenson,656,Spain,133814.28,0,1,0
4189,2011,9,MORTGAGE,3,Medium,2,25000, 60 months,2,home_improvement,7,Low,1,Good Loan,0,12.42,B,2,14.27,28047.7,19677.99,0,561.44,409000004188,29-Aug-17,VISA POSINT ACQ SETTL 280,,4890.36,-547157629.27,McKenzie,644,Germany,151902.78,0,1,0
4190,2011,10,MORTGAGE,3,Medium,2,10200, 36 months,1,credit_card,1,Low,1,Good Loan,0,7.51,A,1,21.04,11316.61,10200,0,317.34,409000004189,29-Aug-17,RUPAY POS ACQ SETTL 29081,,1644454.54,-545513174.73,Gardiner,598,France,167376.26,0,1,0
4191,2011,0.5,RENT,1,Low,1,20000, 36 months,1,debt_consolidation,6,Low,1,Good Loan,0,12.69,B,2,15.55,24146.69338,20000,0,670.9,409000004190,29-Aug-17,TRF TO  Indiaforensic SERVICES I,"2,700,000.00",,-548213174.73,Atkinson,850,Spain,31022.56,0,1,0
4192,2011,2,MORTGAGE,3,Low,1,7000, 36 months,1,debt_consolidation,6,Low,1,Good Loan,0,11.71,B,2,5.25,8332.897657,7000,0,231.54,409000004191,30-Aug-17,MASTER POSDOM ACQ SETTL29,,343287.00,-547869887.73,Onyemauchechi,679,France,188997.08,0,1,0
4193,2011,9,MORTGAGE,3,Medium,2,20000, 36 months,1,debt_consolidation,6,Low,1,Good Loan,0,12.69,B,2,16.01,22496.63,20000,0,670.9,409000004192,30-Aug-17,MAESTRO POSDOM ACQ SETTL2,,76966.75,-547792920.98,Ross,632,France,2085.32,0,1,0
4194,2011,4,RENT,1,Medium,2,17000, 60 months,2,small_business,3,High,2,Good Loan,0,19.03,E,5,2.48,24157.95536,17000,0,441.28,409000004193,30-Aug-17,VISA POSDOM ACQ SETTL 290,,1008713.48,-546784207.50,Newland,550,Spain,70399.71,0,1,0
4195,2011,10,MORTGAGE,3,Low,1,5000, 60 months,2,car,2,Low,1,Good Loan,0,10.65,B,2,22.53,5370.63,3958.47,0,107.85,409000004194,30-Aug-17,RUPAY POS ACQ SETTL 30081,,1589467.46,-545194740.04,Hu,572,Germany,195771.95,0,1,0
4196,2011,1,RENT,1,Low,1,21000, 36 months,1,debt_consolidation,6,Low,1,Good Loan,0,9.91,B,2,27.47,24343.17191,21000,0,676.73,409000004195,30-Aug-17,TRF TO  Indiaforensic SERVICES I,"3,000,000.00",,-548194740.04,Sanders,626,Germany,166475.44,0,1,0
4197,2011,10,MORTGAGE,3,Low,1,12000, 36 months,1,debt_consolidation,6,Low,1,Good Loan,0,6.03,A,1,13.44,13147.8457,12000,0,365.23,409000004196,31-Aug-17,MASTER POSDOM ACQ SETTL30,,167864.17,-548026875.87,Tsui,625,Spain,84106.17,0,1,0
4198,2011,8,RENT,1,High,3,24000, 60 months,2,major_purchase,8,High,2,Good Loan,0,18.25,D,4,9.13,25081.25,24000,0,612.72,409000004197,31-Aug-17,MAESTRO POSDOM ACQ SETTL3,,73333.07,-547953542.80,Marino,515,France,81436.68,0,1,0
4199,2011,1,RENT,1,Low,1,5400, 36 months,1,debt_consolidation,6,High,2,Good Loan,0,14.27,C,3,15.62,6643.937359,5400,0,185.27,409000004198,31-Aug-17,VISA POSDOM ACQ SETTL 300,,602593.85,-547350948.95,Akobundu,612,Spain,83256.26,0,1,0
4200,2011,0.5,MORTGAGE,3,Low,1,9400, 60 months,2,debt_consolidation,6,High,2,Good Loan,0,14.27,C,3,24.15,10975,7321.4,0,220.04,409000004199,31-Aug-17,RUPAY POS ACQ SETTL 31081,,1518582.14,-545832366.81,Morrison,628,Spain,117523.41,0,1,0
4201,2011,8,RENT,1,Low,1,15125, 60 months,2,debt_consolidation,6,High,2,Good Loan,0,13.49,C,3,19.7,18457.5647,15125,0,347.95,409000004200,31-Aug-17,MASTER POSDOM ACQ SETTL23,,207294.09,-545625072.72,Mai,529,Spain,79476.63,0,1,0
4202,2011,3,RENT,1,Medium,2,12000, 36 months,1,debt_consolidation,6,Low,1,Good Loan,0,9.91,B,2,10.16,13919.19673,12000,0,386.7,409000004201,31-Aug-17,MAESTRO POSDOM ACQ SETTL2,,78955.51,-545546117.21,Hs?eh,668,Germany,173052.19,0,1,0
4203,2011,8,RENT,1,Low,1,12000, 60 months,2,house,12,Low,1,Good Loan,0,9.91,B,2,8.8,14950.93527,12000,0,254.44,409000004202,31-Aug-17,VISA POSDOM ACQ SETTL 230,,591711.78,-544954405.43,Wright,526,France,100995.68,0,1,0
4204,2011,6,MORTGAGE,3,Low,1,10000, 36 months,1,debt_consolidation,6,Low,1,Good Loan,0,7.9,A,1,20.33,11263.55763,10000,0,312.91,409000004203,31-Aug-17,VISA POSINT ACQ SETTL 230,,876.26,-544953529.17,Demaine,791,France,122782.50,0,1,0
4205,2011,7,MORTGAGE,3,Medium,2,30000, 60 months,2,home_improvement,7,Low,1,Bad Loan,1,12.42,B,2,8.05,11451.62,6704.28,14.02,673.72,409000004204,1-Sep-17,MASTER POSDOM ACQ SETTL31,,290472.19,-544663056.98,Chien,573,France,11631.34,0,1,0
4206,2011,10,MORTGAGE,3,Low,1,6500, 36 months,1,other,4,Low,1,Good Loan,0,11.71,B,2,18.21,7675.074509,6500,0,215,409000004205,1-Sep-17,MAESTRO POSDOM ACQ SETTL3,,76308.17,-544586748.81,Dickinson,565,France,168303.55,0,1,0
4207,2011,2,MORTGAGE,3,Low,1,8000, 36 months,1,home_improvement,7,Low,1,Good Loan,0,10.65,B,2,21.6,8519.62,8000,0,260.59,409000004206,1-Sep-17,VISA POSDOM ACQ SETTL 310,,641503.42,-543945245.39,Kazantseva,604,France,9308.10,0,1,0
4208,2011,0.5,RENT,1,Low,1,3600, 36 months,1,moving,10,Low,1,Good Loan,0,12.42,B,2,10.73,3945.46,3600,0,120.3,409000004207,1-Sep-17,RUPAY POS ACQ SETTL 01091,,1553779.41,-542391465.98,Marchesi,656,France,153157.97,0,1,0
4209,2011,0.5,RENT,1,Low,1,7100, 60 months,2,debt_consolidation,6,High,2,Bad Loan,1,18.25,D,4,8.68,3764.36,1509.66,333.73,181.27,409000004208,1-Sep-17,TRF TO  Indiaforensic SERVICES I,"4,000,000.00",,-546391465.98,Pan,447,France,75408.24,0,1,0
4210,2011,6,RENT,1,Low,1,2400, 36 months,1,moving,10,Low,1,Good Loan,0,9.91,B,2,2,2744.607562,2400,0,77.34,409000004209,1-Sep-17,TRF TO  Indiaforensic SERVICES I,"300,000.00",,-546691465.98,Harewood,682,France,153356.80,0,1,0
4211,2011,6.05,MORTGAGE,3,Low,1,10950, 60 months,2,other,4,High,2,Bad Loan,1,14.27,C,3,6.52,9054.24,4859.25,881.11,256.33,409000004210,1-Sep-17,TRF TO  Indiaforensic SERVICES I,"1,500,000.00",,-548191465.98,Kao,437,Spain,152987.42,0,1,0
4212,2011,6,MORTGAGE,3,Low,1,4000, 36 months,1,car,2,Low,1,Bad Loan,1,7.51,A,1,6.48,2479.39,1986.81,129.47,124.45,409000004211,4-Sep-17,VISA POSDOM ACQ SETTL 010,,571191.62,-547620274.36,Yeh,792,Spain,5557.88,0,1,0
4213,2011,10,RENT,1,Low,1,12600, 60 months,2,other,4,Low,1,Good Loan,0,12.69,B,2,18.04,14183.16,9880.6,0,284.7,409000004212,4-Sep-17,VISA POSDOM ACQ SETTL 020,,601851.00,-547018423.36,Bischof,627,Spain,194313.93,0,1,0
4214,2011,2,MORTGAGE,3,Low,1,12000, 60 months,2,other,4,High,2,Good Loan,0,18.64,E,5,13.74,15030.07,12000,0,308.92,409000004213,4-Sep-17,VISA POSDOM ACQ SETTL 040,,742776.21,-546275647.15,Ashton,767,France,94767.77,0,1,0
4215,2011,3,MORTGAGE,3,Medium,2,35000, 60 months,2,home_improvement,7,High,2,Good Loan,0,20.3,E,5,2.56,35591.56,35000,0,933.14,409000004214,4-Sep-17,RUPAY POS ACQ SETTL 02091,,1174963.74,-545100683.41,Napolitani,686,France,1540.89,0,1,0
4216,2011,8,RENT,1,Low,1,25000, 60 months,2,credit_card,1,High,2,Good Loan,0,14.27,C,3,13.13,34687.87,25000,0,585.22,409000004215,4-Sep-17,RUPAY POS ACQ SETTL 03091,,1360016.98,-543740666.43,Wilson,789,France,5036.39,0,1,0
4217,2011,3,MORTGAGE,3,Low,1,5200, 36 months,1,debt_consolidation,6,Low,1,Good Loan,0,7.51,A,1,13.34,5821.349184,5200,0,161.78,409000004216,4-Sep-17,RUPAY POS ACQ SETTL 04091,,920341.42,-542820325.01,Uren,794,France,71776.76,0,1,0
4218,2011,6.05,OWN,2,Low,1,8500, 36 months,1,other,4,Low,1,Good Loan,0,6.03,A,1,9.07,9312.924788,8500,0,258.71,409000004217,5-Sep-17,TRF TO  Indiaforensic SERVICES I,"5,400,000.00",,-548220325.01,Okechukwu,587,Germany,23481.69,0,1,0
4219,2011,4,MORTGAGE,3,Low,1,12000, 60 months,2,debt_consolidation,6,Low,1,Bad Loan,1,12.42,B,2,23.78,8321.82,4488.45,1062.87,269.49,409000004218,5-Sep-17,MASTER POSDOM ACQ SETTL02,,257935.74,-547962389.27,Ku,589,Germany,143022.31,0,1,0
4220,2011,0.5,RENT,1,Low,1,13000, 60 months,2,debt_consolidation,6,Low,1,Good Loan,0,8.9,A,1,16.19,15856.8777,13000,0,269.23,409000004219,5-Sep-17,MAESTRO POSDOM ACQ SETTL0,,114909.98,-547847479.29,Onyemachukwu,543,Germany,161407.48,0,1,0
4221,2011,9,RENT,1,Low,1,1800, 36 months,1,wedding,5,Low,1,Bad Loan,1,8.9,A,1,2.64,1800,0,1800,57.16,409000004220,5-Sep-17,MASTER POSDOM ACQ SETTL04,,431323.40,-547416155.89,Kao,589,Spain,125939.22,0,1,0
4222,2011,10,MORTGAGE,3,Low,1,10000, 36 months,1,debt_consolidation,6,High,2,Good Loan,0,16.77,D,4,6.46,12787.57194,10000,0,355.39,409000004221,5-Sep-17,MAESTRO POSDOM ACQ SETTL0,,207382.52,-547208773.37,Russell,701,Germany,76611.33,0,1,0
4223,2011,10,MORTGAGE,3,Low,1,12475, 36 months,1,home_improvement,7,Low,1,Good Loan,0,6.03,A,1,10.04,13668.19519,12475,0,379.69,409000004222,5-Sep-17,VISA POSDOM ACQ SETTL 040,,742776.21,-546465997.16,Woronoff,850,France,136985.08,0,1,0
4224,2011,4,MORTGAGE,3,Low,1,3200, 36 months,1,debt_consolidation,6,Low,1,Good Loan,0,7.51,A,1,7.8,3519.16,3200,0,99.56,409000004223,5-Sep-17,RUPAY POS ACQ SETTL 05091,,1863100.02,-544602897.14,Ferri,726,Germany,140937.91,0,1,0
4225,2011,10,RENT,1,Low,1,5500, 36 months,1,other,4,Low,1,Good Loan,0,6.62,A,1,20.49,6078.553311,5500,0,168.88,409000004224,5-Sep-17,MASTER POSDOM ACQ SETTL01,,190690.42,-544412206.72,Ruggiero,767,Spain,48161.18,0,1,0
4226,2011,1,RENT,1,Low,1,14675, 60 months,2,debt_consolidation,6,High,2,Bad Loan,1,19.42,E,5,22.66,10011.3,3821.64,1563.61,384.08,409000004225,5-Sep-17,MAESTRO POSDOM ACQ SETTL0,,87492.42,-544324714.30,Wilding,648,Spain,130041.45,0,1,0
4227,2011,6.05,RENT,1,Low,1,2100, 36 months,1,vacation,11,Low,1,Good Loan,0,7.51,A,1,7.5,2343.760029,2100,0,65.34,409000004226,6-Sep-17,TRF TO  Indiaforensic SERVICES I,"3,900,000.00",,-548224714.30,Yashina,651,Spain,91652.43,0,1,0
4228,2011,3,RENT,1,Low,1,3825, 36 months,1,debt_consolidation,6,High,2,Bad Loan,1,15.96,C,3,23.54,1246.55,695.15,179.11,134.41,409000004227,6-Sep-17,VISA POSDOM ACQ SETTL 050,,1537565.04,-546687149.26,Yevseyev,633,France,125961.48,0,1,0
4229,2011,10,MORTGAGE,3,Low,1,23200, 60 months,2,debt_consolidation,6,High,2,Bad Loan,1,23.52,G,7,7.89,28274.45,12827.79,200,660.97,409000004228,6-Sep-17,RUPAY POS ACQ SETTL 06091,,1573030.24,-545114119.02,Rapuokwu,740,France,73225.31,0,1,0
4230,2011,5,RENT,1,Low,1,5000, 36 months,1,debt_consolidation,6,Low,1,Good Loan,0,6.03,A,1,2.4,5477.920529,5000,0,152.18,409000004229,6-Sep-17,VISA POSDOM ACQ RVSL 0209,"601,851.00",,-545715970.02,Maslov,592,France,20460.20,0,1,0
4231,2011,3,MORTGAGE,3,Low,1,12000, 36 months,1,debt_consolidation,6,High,2,Good Loan,0,14.65,C,3,19.13,14401.91,12000,0,413.94,409000004230,6-Sep-17,VISA POSDOM ACQ SETT 0209,,610851.00,-545105119.02,Cole,670,France,81602.02,0,1,0
4232,2011,6,RENT,1,Low,1,8500, 36 months,1,credit_card,1,Low,1,Good Loan,0,11.71,B,2,14.42,10117.05047,8500,0,281.15,409000004231,6-Sep-17,MASTER POSDOM ACQ SETTL05,,239340.99,-544865778.03,Sullivan,628,France,8742.91,0,1,0
4233,2011,4,MORTGAGE,3,Low,1,12000, 36 months,1,credit_card,1,Low,1,Good Loan,0,8.9,A,1,18.94,13688.40598,12000,0,381.04,409000004232,6-Sep-17,MAESTRO POSDOM ACQ SETTL0,,121568.24,-544744209.79,Hsiao,745,France,145789.71,0,1,0
4234,2011,10,MORTGAGE,3,Low,1,31000, 60 months,2,credit_card,1,Low,1,Good Loan,0,12.42,B,2,14.14,32866.58,31000,0,696.18,409000004233,6-Sep-17,MASTER POSINT ACQ SETTL01,,1970.91,-544742238.88,Rossi,705,France,129576.99,0,1,0
4235,2011,10,MORTGAGE,3,Low,1,12600, 60 months,2,debt_consolidation,6,Low,1,Good Loan,0,10.65,B,2,19.36,13036.46,12600,0,271.77,409000004234,6-Sep-17,ATOM MASTER INT 04-050917,,29583.59,-544712655.29,Allsop,559,France,190040.29,0,1,0
4236,2011,2,RENT,1,Low,1,7600, 36 months,1,major_purchase,8,High,2,Good Loan,0,15.27,C,3,23.78,9509.470775,7600,0,264.47,409000004235,6-Sep-17,ATOM MASTER INT 04-050917,"29,583.59",,-544742238.88,Chamberlain,595,France,87771.06,0,1,0
4237,2011,2,RENT,1,Low,1,2750, 36 months,1,credit_card,1,High,2,Good Loan,0,16.77,D,4,19.71,2933.09,2750,0,97.74,409000004236,7-Sep-17,TRF TO  Indiaforensic SERVICES I,"3,500,000.00",,-548242238.88,Jackson,492,France,39519.53,0,1,0
4238,2011,6,RENT,1,Low,1,20000, 36 months,1,debt_consolidation,6,Low,1,Good Loan,0,11.71,B,2,16.12,23808.65739,20000,0,661.52,409000004237,7-Sep-17,VISA POSDOM ACQ SETTL 060,,604670.93,-547637567.95,Dumetochukwu,498,France,190035.83,0,1,0
4239,2011,10,MORTGAGE,3,Low,1,7000, 36 months,1,car,2,Low,1,Good Loan,0,6.62,A,1,12.92,7735.773947,7000,0,214.93,409000004238,7-Sep-17,MASTER POSDOM ACQ SETTL06,,225461.86,-547412106.09,Uspensky,655,France,148948.52,0,1,0
4240,2011,6,RENT,1,Low,1,7000, 36 months,1,debt_consolidation,6,Low,1,Good Loan,0,10.65,B,2,22.37,7808.69,7000,0,228.02,409000004239,7-Sep-17,MAESTRO POSDOM ACQ SETTL0,,115423.94,-547296682.15,Garcia,636,France,184691.77,0,1,0
4241,2011,2,RENT,1,Low,1,24000, 60 months,2,small_business,3,High,2,Good Loan,0,22.06,F,6,9.05,33173.47,17983.82,0,663.68,409000004240,7-Sep-17,RUPAY POS ACQ SETTL 07091,,1450612.08,-545846070.07,Soto,634,France,143458.31,0,1,0
4242,2011,10,MORTGAGE,3,Low,1,13200, 36 months,1,debt_consolidation,6,Low,1,Good Loan,0,6.62,A,1,3.03,14588.90248,13200,0,405.29,409000004241,8-Sep-17,TRF TO  Indiaforensic SERVICES I,"2,400,000.00",,-548246070.07,McDonald,793,Spain,27166.75,0,1,0
4243,2011,7,RENT,1,Low,1,6000, 36 months,1,debt_consolidation,6,Low,1,Good Loan,0,11.71,B,2,13.1,6762.68,6000,0,198.46,409000004242,8-Sep-17,RUPAY POS ACQ SETTL 08091,,1793147.82,-546452922.25,Castles,526,Germany,159456.87,0,1,0
4244,2011,6.05,MORTGAGE,3,Medium,2,35000, 36 months,1,small_business,3,Low,1,Good Loan,0,12.42,B,2,8.9,41054.08,35000.01,0,1169.54,409000004243,8-Sep-17,VISA POSDOM ACQ SETTL 070,,723159.19,-545729763.06,Stephenson,768,France,70454.79,0,1,0
4245,2011,4,MORTGAGE,3,Low,1,4625, 36 months,1,medical,9,Low,1,Good Loan,0,12.42,B,2,5.7,5560.00989,4625,0,154.55,409000004244,8-Sep-17,MASTER POSDOM ACQ SETTL07,,316147.41,-545413615.65,Davidson,540,Germany,95421.00,0,1,0
4246,2011,10,MORTGAGE,3,Low,1,13000, 60 months,2,debt_consolidation,6,High,2,Good Loan,0,19.42,E,5,8.62,19946.37292,13000,0,340.24,409000004245,8-Sep-17,MAESTRO POSDOM ACQ SETTL0,,126526.09,-545287089.56,Tu,732,France,187985.85,0,1,0
4247,2011,4,RENT,1,Low,1,11200, 60 months,2,other,4,High,2,Good Loan,0,14.65,C,3,4.97,11997.25,11200,0,264.4,409000004246,11-Sep-17,TRF TO  Indiaforensic SERVICES I,"2,900,000.00",,-548187089.56,Colbert,617,France,92621.90,0,1,0
4248,2011,10,MORTGAGE,3,Medium,2,6000, 36 months,1,home_improvement,7,Low,1,Good Loan,0,6.03,A,1,8.1,6573.643156,6000,0,182.62,409000004247,11-Sep-17,VISA POSDOM ACQ SETTL 080,,775129.91,-547411959.65,Owens,637,Spain,150836.98,0,1,0
4249,2011,10,MORTGAGE,3,Low,1,17600, 60 months,2,small_business,3,High,2,Bad Loan,1,18.64,E,5,11.21,3360.74,361.29,2456.8,453.08,409000004248,11-Sep-17,VISA POSINT ACQ SETTL 080,,166.60,-547411793.05,Chimezie,573,France,90177.30,0,1,0
4250,2011,2,OWN,2,Low,1,2500, 36 months,1,major_purchase,8,Low,1,Good Loan,0,11.71,B,2,1.48,2685.51,2500,0,82.69,409000004249,11-Sep-17,MASTER POSDOM ACQ SETTL08,,266193.00,-547145600.05,Genovese,531,France,34416.79,0,1,0
4251,2011,0.5,RENT,1,Medium,2,15000, 36 months,1,debt_consolidation,6,Low,1,Good Loan,0,6.03,A,1,2.23,16240.06899,15000,0,456.54,409000004250,11-Sep-17,MAESTRO POSDOM ACQ SETTL0,,97387.69,-547048212.36,Daluchi,489,France,85231.88,0,1,0
4252,2011,6,RENT,1,Low,1,8000, 36 months,1,debt_consolidation,6,High,2,Bad Loan,1,14.27,C,3,7.3,7739.58,5657.92,345.36,274.48,409000004251,11-Sep-17,TRF TO  Indiaforensic SERVICES I,"1,200,000.00",,-548248212.36,Sheffield,601,France,118983.18,0,1,0
4253,2011,10,MORTGAGE,3,Low,1,15000, 36 months,1,debt_consolidation,6,Low,1,Good Loan,0,9.91,B,2,20.88,17399.41233,15000,0,483.38,409000004252,11-Sep-17,VISA POSDOM ACQ SETTL 090,,776742.57,-547471469.79,Bailey,452,Germany,111868.23,0,1,0
4254,2011,1,RENT,1,Low,1,14000, 60 months,2,other,4,Low,1,Good Loan,0,10.65,B,2,14.15,15037.5,11084.12,0,301.96,409000004253,11-Sep-17,MASTER POSDOM ACQ SETTL09,,205616.43,-547265853.36,Dyson,728,Spain,83056.22,0,1,0
4255,2011,10,OWN,2,Low,1,3800, 36 months,1,home_improvement,7,Low,1,Good Loan,0,6.62,A,1,3.91,4014.92,3800,0,116.68,409000004254,11-Sep-17,MAESTRO POSDOM ACQ SETTL0,,108900.15,-547156953.21,Davide,590,Germany,1676.92,0,1,0
4256,2011,5,OWN,2,Medium,2,35000, 60 months,2,other,4,Low,1,Bad Loan,1,12.69,B,2,6.25,19666.35,6295.93,8595.11,790.82,409000004255,11-Sep-17,RUPAY POS ACQ SETTL 09091,,1198343.41,-545958609.80,Uwaezuoke,490,France,32089.57,0,1,0
4257,2011,0.5,OWN,2,Low,1,3000, 36 months,1,debt_consolidation,6,Low,1,Good Loan,0,12.69,B,2,4.25,3164.52,3000,0,100.64,409000004256,11-Sep-17,RUPAY POS ACQ SETTL 10091,,2189742.90,-543768866.90,Hs?,596,Spain,13455.43,0,1,0
4258,2011,3,RENT,1,Low,1,5600, 36 months,1,credit_card,1,High,2,Good Loan,0,14.27,C,3,23.66,6686.14,5600,0,192.13,409000004257,11-Sep-17,RUPAY POS ACQ SETTL 11091,,1474234.57,-542294632.33,Onwuka,635,France,24865.54,0,1,0
4259,2011,5,RENT,1,Low,1,12000, 36 months,1,debt_consolidation,6,High,2,Good Loan,0,15.27,C,3,23.39,15014.40129,12000,0,417.58,409000004258,12-Sep-17,VISA POSDOM ACQ SETTL 110,,1922228.99,-540372403.34,Flores,782,Germany,117644.36,0,1,0
4260,2011,6.05,RENT,1,Low,1,6000, 36 months,1,debt_consolidation,6,Low,1,Good Loan,0,10.65,B,2,17.31,7034.1439,6000,0,195.44,409000004259,12-Sep-17,MASTER POSDOM ACQ SETTL11,,646172.19,-539726231.15,Nicoll,790,Spain,98897.32,0,1,0
4261,2011,10,MORTGAGE,3,Low,1,27250, 60 months,2,debt_consolidation,6,High,2,Good Loan,0,18.64,E,5,14.74,35026.67,20775.86,0,701.5,409000004260,12-Sep-17,MAESTRO POSDOM ACQ SETTL1,,249452.24,-539476778.91,Hughes,587,France,106174.70,0,1,0
4262,2011,9,OWN,2,Low,1,12000, 36 months,1,debt_consolidation,6,Low,1,Good Loan,0,6.03,A,1,20.91,13097.11777,12000,0,365.23,409000004261,12-Sep-17,RUPAY POS ACQ SETTL 12091,,1758353.60,-537718425.31,Romano,794,Spain,46386.37,0,1,0
4263,2011,10,MORTGAGE,3,Low,1,25000, 60 months,2,debt_consolidation,6,Low,1,Good Loan,0,10.65,B,2,17.06,31955.08,25000,0,539.21,409000004262,12-Sep-17,TRF TO  Indiaforensic SERVICES I,"10,500,000.00",,-548218425.31,Norman,515,France,185054.14,0,1,0
4264,2011,8,MORTGAGE,3,Low,1,13000, 36 months,1,debt_consolidation,6,Low,1,Good Loan,0,6.62,A,1,12.71,14365.09246,13000,0,399.15,409000004263,13-Sep-17,VISA POSDOM ACQ SETTL 120,,747417.31,-547471008.00,Davison,746,Spain,47997.39,0,1,0
4265,2011,0.5,RENT,1,Low,1,8000, 36 months,1,major_purchase,8,Low,1,Good Loan,0,7.9,A,1,1.33,8426.18,8000,0,250.33,409000004264,13-Sep-17,MASTER POSDOM ACQ SETTL12,,327666.93,-547143341.07,Manna,667,Germany,130846.79,0,1,0
4266,2011,10,MORTGAGE,3,Medium,2,13600, 36 months,1,home_improvement,7,Low,1,Good Loan,0,6.03,A,1,0.35,14900.62965,13600,0,413.93,409000004265,13-Sep-17,MAESTRO POSDOM ACQ SETTL1,,119714.43,-547023626.64,Reed,709,France,40861.55,0,1,0
4267,2011,1,MORTGAGE,3,Medium,2,30000, 60 months,2,home_improvement,7,Low,1,Good Loan,0,12.69,B,2,3.99,35321.77,29999.99,0,677.85,409000004266,13-Sep-17,VISA POSINT ACQ SETTL 120,,1970.10,-547021656.54,Daniels,536,France,171840.24,0,1,0
4268,2011,4,MORTGAGE,3,Low,1,8000, 36 months,1,debt_consolidation,6,Low,1,Good Loan,0,8.9,A,1,4.08,9104.107807,8000,0,254.03,409000004267,13-Sep-17,RUPAY POS ACQ SETTL 13091,,2329216.85,-544692439.69,Hunt,711,France,101455.07,0,1,0
4269,2011,3,MORTGAGE,3,Medium,2,30000, 36 months,1,debt_consolidation,6,Low,1,Good Loan,0,8.9,A,1,6.71,32142.39,30000,0,952.6,409000004268,13-Sep-17,TRF TO  Indiaforensic SERVICES I,"1,200,000.00",,-545892439.69,Feng,753,France,90747.94,0,1,0
4270,2011,7,RENT,1,Low,1,3000, 36 months,1,car,2,Low,1,Good Loan,0,10.65,B,2,9.16,3027.12,3000,0,97.72,409000004269,14-Sep-17,VISA POSDOM ACQ SETTL 130,,876469.30,-545015970.39,Waters,748,France,2048.55,0,1,0
4271,2011,10,MORTGAGE,3,Medium,2,24000, 60 months,2,debt_consolidation,6,High,2,Good Loan,0,19.03,E,5,18.53,24382.41,24000,0,622.97,409000004270,14-Sep-17,MASTER POSDOM ACQ SETTL13,,349804.76,-544666165.63,Yuan,623,France,84421.34,0,1,0
4272,2011,10,RENT,1,Low,1,15000, 36 months,1,credit_card,1,High,2,Good Loan,0,17.58,D,4,15.96,17307.63,15000,0,539.14,409000004271,14-Sep-17,MAESTRO POSDOM ACQ SETTL1,,75977.74,-544590187.89,Yudin,465,France,78698.09,0,1,0
4273,2011,0.5,OWN,2,Low,1,9400, 60 months,2,other,4,High,2,Good Loan,0,21.67,F,6,13.26,10231.28,9400,0,257.86,409000004272,14-Sep-17,TRF TO  Indiaforensic SERVICES I,"3,600,000.00",,-548190187.89,Calabresi,640,Spain,168544.85,0,1,0
4274,2011,6.05,MORTGAGE,3,Low,1,20000, 60 months,2,home_improvement,7,High,2,Good Loan,0,14.65,C,3,19.73,23604.84,15580.12,0,472.14,409000004273,14-Sep-17,RUPAY POS ACQ SETTL 14091,,1945546.17,-546244641.72,Onyemauchechukwu,562,France,39351.64,0,1,0
4275,2011,1,MORTGAGE,3,Low,1,20000, 60 months,2,debt_consolidation,6,High,2,Good Loan,0,14.27,C,3,12.58,26584.52356,20000,0,468.17,409000004274,15-Sep-17,VISA POSDOM ACQ SETTL 140,,812129.69,-545432512.03,Martin,502,Germany,28204.98,0,1,0
4276,2011,3,OWN,2,Low,1,1300, 36 months,1,other,4,Low,1,Good Loan,0,6.03,A,1,24.4,1424.224084,1300,0,39.57,409000004275,15-Sep-17,VISA POSINT ACQ SETTL 140,,771.42,-545431740.61,Hung,536,France,22375.14,0,1,0
4277,2011,2,RENT,1,Low,1,10000, 36 months,1,debt_consolidation,6,Low,1,Good Loan,0,7.51,A,1,23.44,11129.22637,10000,0,311.11,409000004276,15-Sep-17,MASTER POSDOM ACQ SETTL14,,246403.21,-545185337.40,Maslova,670,Germany,134942.45,0,1,0
4278,2011,4,RENT,1,Low,1,8000, 36 months,1,debt_consolidation,6,Low,1,Good Loan,0,6.62,A,1,15.96,8841.278249,8000,0,245.63,409000004277,15-Sep-17,MAESTRO POSDOM ACQ SETTL1,,101644.16,-545083693.24,Zetticci,775,Germany,134901.57,0,1,0
4279,2011,5,RENT,1,Low,1,2800, 60 months,2,debt_consolidation,6,Low,1,Good Loan,0,9.91,B,2,1.08,2968.23,2232.37,0,59.37,409000004278,15-Sep-17,TRF TO  Indiaforensic SERVICES I,"2,000,000.00",,-547083693.24,Pisano,759,Germany,8693.80,0,1,0
4280,2011,8,RENT,1,Low,1,35000, 36 months,1,medical,9,Low,1,Good Loan,0,12.42,B,2,8.9,38025.17,35000,0,1169.54,409000004279,15-Sep-17,RUPAY POS ACQ SETTL 15091,,2009330.89,-545074362.35,Sutherland,604,France,42437.75,0,1,0
4281,2011,2,RENT,1,Low,1,2700, 36 months,1,other,4,High,2,Good Loan,0,13.49,C,3,13.54,3295.68142,2700,0,91.62,409000004280,16-Sep-17,VISA POSDOM ACQ SETTL 150,,614642.81,-544459719.54,Lai,766,Germany,5893.23,0,1,0
4282,2011,10,MORTGAGE,3,Low,1,35000, 60 months,2,debt_consolidation,6,High,2,Bad Loan,1,19.42,E,5,21.97,32388.5,8160.02,14068.45,916.03,409000004281,16-Sep-17,MASTER POSDOM ACQ SETTL15,,239253.31,-544220466.23,Watson,554,Spain,36242.19,0,1,0
4283,2011,7,MORTGAGE,3,Low,1,19000, 60 months,2,debt_consolidation,6,Low,1,Good Loan,0,11.71,B,2,11.37,24739.39128,19000,0,419.87,409000004282,16-Sep-17,MAESTRO POSDOM ACQ SETTL1,,116343.12,-544104123.11,Gorbunov,487,France,90076.85,0,1,0
4284,2011,10,MORTGAGE,3,Low,1,23000, 60 months,2,debt_consolidation,6,Low,1,Bad Loan,1,12.42,B,2,16.48,24792.19,17184.54,0,516.52,409000004283,16-Sep-17,RUPAY POS ACQ SETTL 16091,,1836165.76,-542267957.35,Padovano,725,France,150507.43,0,1,0
4285,2011,10,MORTGAGE,3,Medium,2,12175, 60 months,2,debt_consolidation,6,Low,1,Good Loan,0,10.65,B,2,15.5,13064.39,9629.79,0,262.6,409000004284,16-Sep-17,TRF TO  Indiaforensic SERVICES I,"2,000,000.00",,-544267957.35,Raynor,732,Germany,87422.15,0,1,0
4286,2011,10,RENT,1,Low,1,25000, 60 months,2,debt_consolidation,6,High,2,Good Loan,0,14.27,C,3,24.45,33186.68771,25000,0,585.22,409000004285,16-Sep-17,TRF TO  Indiaforensic SERVICES I,"2,000,000.00",,-546267957.35,Ting,623,France,192867.40,0,1,0
4287,2011,6.05,RENT,1,Low,1,10000, 36 months,1,house,12,Low,1,Good Loan,0,6.03,A,1,10,10099.43,10000,0,304.36,409000004286,18-Sep-17,TRF TO  Indiaforensic SERVICES I,"2,000,000.00",,-548267957.35,Eberegbulam,781,France,175674.01,0,1,0
4288,2011,3,RENT,1,Low,1,5000, 36 months,1,debt_consolidation,6,Low,1,Good Loan,0,11.71,B,2,8.95,5357,5000,0,165.38,409000004287,18-Sep-17,VISA POSDOM ACQ SETTL 160,,731107.81,-547536849.54,Chin,714,Germany,72496.05,0,1,0
4289,2011,2,MORTGAGE,3,Low,1,12000, 60 months,2,debt_consolidation,6,High,2,Bad Loan,1,19.91,E,5,8.86,9681.26,3447.4,2075,317.33,409000004288,18-Sep-17,VISA POSINT ACQ SETTL 160,,9900.00,-547526949.54,Manna,577,Germany,145250.43,0,1,0
4290,2011,6,RENT,1,Low,1,25000, 60 months,2,debt_consolidation,6,High,2,Good Loan,0,15.27,C,3,12.1,33297.11474,25000,0,598.3,409000004289,18-Sep-17,MASTER POSDOM ACQ SETTL16,,245850.76,-547281098.78,Chang,731,Spain,180712.52,0,1,0
4291,2011,10,MORTGAGE,3,Low,1,3500, 36 months,1,small_business,3,Low,1,Good Loan,0,6.03,A,1,5,3834.536818,3500,0,106.53,409000004290,18-Sep-17,MAESTRO POSDOM ACQ SETTL1,,93545.16,-547187553.62,Kent,650,Spain,180622.43,0,1,0
4292,2011,4,MORTGAGE,3,Medium,2,16000, 36 months,1,house,12,Low,1,Good Loan,0,6.03,A,1,4.73,16770.78,16000,0,486.97,409000004291,18-Sep-17,MAESTRO POSDOM ACQ SETTL1,,99524.05,-547088029.57,Buckley,779,France,86306.75,0,1,0
4293,2011,0.5,RENT,1,Medium,2,20000, 36 months,1,debt_consolidation,6,Low,1,Good Loan,0,8.9,A,1,15.88,22860.19208,20000,0,635.07,409000004292,18-Sep-17,RUPAY POS ACQ SETTL 17091,,1913376.02,-545174653.55,Micco,706,Spain,150156.82,0,1,0
4294,2011,7,MORTGAGE,3,Low,1,7500, 36 months,1,debt_consolidation,6,Low,1,Bad Loan,1,11.71,B,2,10.46,4240.28,2996.83,276.96,248.07,409000004293,18-Sep-17,RUPAY POS ACQ SETTL 18091,,1447760.42,-543726893.13,Avdeev,733,Spain,101617.43,0,1,0
4295,2011,5,RENT,1,Low,1,5000, 36 months,1,debt_consolidation,6,Low,1,Good Loan,0,12.42,B,2,7.35,6011.627516,5000,0,167.08,409000004294,19-Sep-17,TRF TO  Indiaforensic SERVICES I,"4,500,000.00",,-548226893.13,Bremer,579,Germany,85424.34,0,1,0
4296,2011,6,MORTGAGE,3,Low,1,35000, 36 months,1,debt_consolidation,6,Low,1,Good Loan,0,7.9,A,1,8.79,38694.15,35000,0,1095.16,409000004295,19-Sep-17,RUPAY POS ACQ SETTL 19091,,1771270.07,-546455623.06,Davidson,476,Germany,197221.81,0,1,0
4297,2011,9,OWN,2,Low,1,10000, 60 months,2,other,4,Low,1,Bad Loan,1,10.65,B,2,2.75,2861.23,1444.75,513.39,215.69,409000004296,19-Sep-17,VISA POSDOM ACQ SETTL 180,,1488260.37,-544967362.69,Gadsdon,775,France,70196.57,0,1,0
4298,2011,5,RENT,1,Low,1,10000, 36 months,1,debt_consolidation,6,High,2,Good Loan,0,18.64,E,5,21.15,12650.13,10000,0,364.75,409000004297,20-Sep-17,VISA POSDOM ACQ SETTL 190,,859728.86,-544107633.83,Connolly,538,Spain,110440.50,0,1,0
4299,2011,10,MORTGAGE,3,Low,1,3600, 36 months,1,other,4,Low,1,Good Loan,0,7.9,A,1,16.28,4054.106182,3600,0,112.65,409000004298,20-Sep-17,MASTER POSDOM ACQ SETTL19,,253011.11,-543854622.72,McDonald,602,France,124389.61,0,1,0
4300,2011,9,RENT,1,Low,1,5600, 36 months,1,debt_consolidation,6,High,2,Good Loan,0,15.96,C,3,20.4,7068.425644,5600,0,196.77,409000004299,20-Sep-17,MAESTRO POSDOM ACQ SETTL1,,96782.54,-543757840.18,Chiawuotu,615,France,3183.15,0,1,0
4301,2011,0.5,RENT,1,Low,1,14000, 60 months,2,debt_consolidation,6,High,2,Good Loan,0,15.27,C,3,21.91,14527.73,14000,0,335.05,409000004300,20-Sep-17,RUPAY POS ACQ SETTL 20091,,2064939.51,-541692900.67,Milne,700,Germany,146723.72,0,1,0
4302,2011,6,MORTGAGE,3,Low,1,7575, 36 months,1,debt_consolidation,6,Low,1,Good Loan,0,6.62,A,1,23.89,8371.447076,7575,0,232.59,409000004301,20-Sep-17,MAESTRO POSDOM ACQ   RVS1,"93,545.16",,-541786445.83,Fleming,615,France,2139.25,0,1,0
4303,2011,4,MORTGAGE,3,Low,1,23525, 36 months,1,debt_consolidation,6,Low,1,Good Loan,0,7.9,A,1,16.92,26493.10984,23525,0,736.11,409000004302,20-Sep-17,MAESTRO POSDOM ACQ SETTL1,,79878.26,-541706567.57,Hicks,544,Germany,69228.20,0,1,0
4304,2011,6,RENT,1,Low,1,10000, 36 months,1,debt_consolidation,6,Low,1,Good Loan,0,7.9,A,1,0.96,11263.33252,10000,0,312.91,409000004303,20-Sep-17,TRF TO  Indiaforensic SERVICES I,"4,500,000.00",,-546206567.57,Logan,573,Spain,115462.27,0,1,0
4305,2011,6,RENT,1,Low,1,35000, 60 months,2,debt_consolidation,6,High,2,Good Loan,0,17.27,D,4,14.22,49101.69402,35000,0,874.93,409000004304,20-Sep-17,Indiaforensic MASTER ACQ DOM2009,,415868.34,-545790699.23,Hammond,555,Spain,62375.10,0,1,0
4306,2011,0.5,MORTGAGE,3,Low,1,9300, 36 months,1,debt_consolidation,6,Low,1,Good Loan,0,8.9,A,1,3.65,9746.91,9300,0,295.31,409000004305,20-Sep-17,Indiaforensic MAESTRO ACQ DOM200,,95649.35,-545695049.88,Weber,692,France,91829.17,0,1,0
4307,2011,6.05,OWN,2,Low,1,7000, 36 months,1,other,4,Low,1,Good Loan,0,12.69,B,2,16.19,8487.867269,7000,0,234.82,409000004306,21-Sep-17,TRF TO  Indiaforensic SERVICES I,"2,500,000.00",,-548195049.88,Lettiere,476,France,182547.04,0,1,0
4308,2011,1,MORTGAGE,3,Low,1,8400, 36 months,1,debt_consolidation,6,High,2,Good Loan,0,16.77,D,4,21.39,8744.16,8400,0,298.53,409000004307,21-Sep-17,Indiaforensic MASTER POS INT 180,,12386.68,-548182663.20,Schnaars,770,Spain,14725.36,0,1,0
4309,2011,10,MORTGAGE,3,Low,1,17000, 36 months,1,debt_consolidation,6,Low,1,Good Loan,0,6.03,A,1,10.49,18625.88309,17000,0,517.41,409000004308,21-Sep-17,RUPAY POS ACQ SETTL 21091,,2183529.30,-545999133.90,Tao,641,France,126996.67,0,1,0
4310,2011,4,RENT,1,Low,1,5000, 36 months,1,debt_consolidation,6,Low,1,Good Loan,0,10.65,B,2,7.32,5823.176274,5000,0,162.87,409000004309,22-Sep-17,VISA POSDOM ACQ SETTL 200,,579193.13,-545419940.77,Algarin,705,France,133991.11,0,1,0
4311,2011,0.5,MORTGAGE,3,Low,1,20000, 60 months,2,debt_consolidation,6,High,2,Good Loan,0,19.42,E,5,23.82,29685.53894,20000,0,523.45,409000004310,22-Sep-17,VISA POSDOM ACQ SETTL 210,,838947.87,-544580992.90,Onyemere,784,France,169920.92,0,1,0
4312,2011,10,MORTGAGE,3,Low,1,3000, 36 months,1,major_purchase,8,High,2,Good Loan,0,16.77,D,4,16.63,3827.332114,3000,0,106.62,409000004311,22-Sep-17,MASTER POSDOM ACQ SETTL21,,283110.28,-544297882.62,Korovina,727,Spain,80259.67,0,1,0
4313,2011,4,OWN,2,Low,1,12000, 36 months,1,credit_card,1,Low,1,Good Loan,0,6.03,A,1,22.11,13097.28622,12000,0,365.23,409000004312,22-Sep-17,MAESTRO POSDOM ACQ SETTL2,,148507.35,-544149375.27,Chidubem,576,France,191035.18,0,1,0
4314,2011,0.5,RENT,1,Low,1,15000, 60 months,2,debt_consolidation,6,High,2,Good Loan,0,16.77,D,4,5.66,18495.7,11533.91,0,370.94,409000004313,22-Sep-17,MASTER POSDOM ACQ SETTL18,,391413.99,-543757961.28,King,646,Spain,40421.87,0,1,0
4315,2011,4,MORTGAGE,3,Low,1,5500, 36 months,1,debt_consolidation,6,Low,1,Good Loan,0,12.69,B,2,3.04,6570.877199,5500,0,184.5,409000004314,22-Sep-17,MAESTRO POSDOM ACQ SETTL1,,65933.19,-543692028.09,Greco,638,France,155643.04,0,1,0
4316,2011,2,RENT,1,Low,1,1450, 36 months,1,debt_consolidation,6,Low,1,Good Loan,0,7.51,A,1,10.9,1601.95,1450,0,45.12,409000004315,22-Sep-17,MASTER POS QR ACQ SETTL18,,1.00,-543692027.09,Beneventi,632,Germany,78670.52,0,1,0
4317,2011,10,RENT,1,Medium,2,30000, 60 months,2,debt_consolidation,6,Low,1,Good Loan,0,11.71,B,2,3.02,36694.21517,30000,0,662.95,409000004316,22-Sep-17,MASTER POS QR ACQ SETTL16,,1.11,-543692025.98,P'eng,850,Spain,104240.77,0,1,0
4318,2011,0.5,RENT,1,Low,1,8000, 36 months,1,small_business,3,Low,1,Good Loan,0,7.9,A,1,5.47,9011.458271,8000,0,250.33,409000004317,22-Sep-17,TRF TO  Indiaforensic SERVICES I,"4,582,000.00",,-548274025.98,Metcalf,492,France,95957.09,0,1,0
4319,2011,10,OWN,2,Low,1,7000, 36 months,1,medical,9,Low,1,Bad Loan,1,7.9,A,1,20.96,656.34,521.67,0,219.04,409000004318,22-Sep-17,Indiaforensic MASTER ACQ DOM2209,,283780.45,-547990245.53,Greco,673,Germany,59595.66,0,1,0
4320,2011,5,RENT,1,Low,1,10000, 36 months,1,wedding,5,High,2,Good Loan,0,14.27,C,3,22.28,12206.22386,10000,0,343.09,409000004319,22-Sep-17,Indiaforensic MAESTRO ACQ DOM220,,126192.17,-547864053.36,Lupton,609,Spain,46266.63,0,1,0
4321,2011,10,OWN,2,Medium,2,20000, 60 months,2,debt_consolidation,6,Low,1,Good Loan,0,12.69,B,2,23.87,26369.13002,20000,0,451.9,409000004320,22-Sep-17,Indiaforensic RUPAY POS ACQ22091,,1898678.99,-545965374.37,Ibeamaka,701,Germany,189085.07,0,1,0
4322,2011,5,MORTGAGE,3,Low,1,6600, 36 months,1,home_improvement,7,Low,1,Good Loan,0,7.9,A,1,26.89,7433.719605,6600,0,206.52,409000004321,22-Sep-17,Indiaforensic VISA ACQ DOM220917,,818040.93,-545147333.44,Hsiung,651,France,123954.15,0,1,0
4323,2011,3,RENT,1,Low,1,6000, 36 months,1,debt_consolidation,6,Low,1,Good Loan,0,11.71,B,2,17.36,7142.404117,6000,0,198.46,409000004322,22-Sep-17,MAESTRO POSDOM ACQ SETTL2,,5962.50,-545141370.94,Rueda,508,France,129803.08,0,1,0
4324,2011,2,MORTGAGE,3,Medium,2,7000, 36 months,1,wedding,5,High,2,Good Loan,0,16.77,D,4,16.94,7878.4,7000,0,248.77,409000004323,25-Sep-17,Indiaforensic MASTER ACQ DOM2309,,119047.29,-545022323.65,Li Fonti,616,Spain,18761.92,0,1,0
4325,2011,3,RENT,1,Low,1,4000, 36 months,1,debt_consolidation,6,Low,1,Good Loan,0,12.42,B,2,14.26,4808.414425,4000,0,133.67,409000004324,25-Sep-17,Indiaforensic MAESTRO ACQ DOM230,,83505.22,-544938818.43,Alexeeva,489,France,43540.59,0,1,0
4326,2011,1,RENT,1,Low,1,12350, 60 months,2,medical,9,High,2,Bad Loan,1,14.27,C,3,22.72,4046.14,2143.96,15.4,289.1,409000004325,25-Sep-17,Indiaforensic RUPAY POS ACQ23091,,1520278.50,-543418539.93,Madueke,567,Spain,62193.92,0,1,0
4327,2011,10,RENT,1,Low,1,10000, 36 months,1,debt_consolidation,6,Low,1,Good Loan,0,11.71,B,2,5.85,11904.62254,10000,0,330.76,409000004326,25-Sep-17,Indiaforensic VISA ACQ DOM230917,,508687.39,-542909852.54,Torres,714,Spain,129130.09,0,1,0
4328,2011,7,MORTGAGE,3,Low,1,12000, 36 months,1,debt_consolidation,6,High,2,Good Loan,0,16.77,D,4,0.52,15036.56,12000,0,426.47,409000004327,25-Sep-17,Indiaforensic VISA ACQ INT230917,,2036.35,-542907816.19,Chukwubuikem,678,Germany,16146.00,0,1,0
4329,2011,10,MORTGAGE,3,Low,1,18400, 60 months,2,house,12,High,2,Bad Loan,1,23.13,G,7,7.86,9707.88,3275.6,868.51,520.08,409000004328,25-Sep-17,Indiaforensic MAESTRO ACQ DOM240,,104029.82,-542803786.37,Holloway,581,France,22442.13,0,1,0
4330,2011,2,MORTGAGE,3,Low,1,24000, 60 months,2,debt_consolidation,6,High,2,Good Loan,0,17.58,D,4,13.92,35046.51398,24000,0,603.98,409000004329,25-Sep-17,Indiaforensic RUPAY POS ACQ24091,,2487243.62,-540316542.75,Evdokimov,748,Spain,78194.37,0,1,0
4331,2011,10,MORTGAGE,3,Low,1,10000, 36 months,1,house,12,Low,1,Good Loan,0,7.9,A,1,19.07,11263.18245,10000,0,312.91,409000004330,25-Sep-17,Indiaforensic VISA ACQ DOM240917,"1,990.00",,-540318532.75,Anayolisa,781,France,124297.32,0,1,0
4332,2011,9,RENT,1,Low,1,20000, 60 months,2,debt_consolidation,6,Low,1,Good Loan,0,9.91,B,2,23.27,21201.38,15945.01,0,424.06,409000004331,25-Sep-17,TRF TO  Indiaforensic SERVICES I,"7,900,000.00",,-548218532.75,Semmens,691,Spain,104648.58,0,1,0
4333,2011,3,RENT,1,Low,1,15000, 36 months,1,other,4,High,2,Good Loan,0,16.29,D,4,18.7,16829.59,15000,0,529.51,409000004332,25-Sep-17,Indiaforensic MASTER ACQ DOM2509,,272589.34,-547945943.41,Tu,507,Germany,166423.66,0,1,0
4334,2011,0.5,RENT,1,Low,1,3600, 36 months,1,other,4,High,2,Good Loan,0,14.27,C,3,12.59,4444.718632,3600,0,123.52,409000004333,25-Sep-17,Indiaforensic MAESTRO ACQ DOM250,,105527.97,-547840415.44,Anderson,724,Germany,157137.23,0,1,0
4335,2011,7,MORTGAGE,3,Low,1,11325, 36 months,1,house,12,Low,1,Good Loan,0,10.65,B,2,18.89,13187.78995,11325,0,368.9,409000004334,25-Sep-17,Indiaforensic RUPAY POS ACQ25091,,1651267.19,-546189148.25,Fang,705,Spain,34134.14,0,1,0
4336,2011,10,MORTGAGE,3,Low,1,25000, 60 months,2,debt_consolidation,6,Low,1,Good Loan,0,12.42,B,2,19.24,28045,19676.32,0,561.44,409000004335,25-Sep-17,Indiaforensic VISA ACQ DOM250917,,1557607.06,-544631541.19,Fanucci,708,Spain,112520.07,0,1,0
4337,2011,1,RENT,1,Low,1,3100, 36 months,1,moving,10,High,2,Good Loan,0,13.49,C,3,3.42,3785.082642,3100,0,105.19,409000004336,25-Sep-17,Indiaforensic MASTER ACQ DOM2409,,289637.00,-544341904.19,Boyle,580,Germany,128481.50,0,1,0
4338,2011,10,MORTGAGE,3,Medium,2,20000, 36 months,1,credit_card,1,Low,1,Good Loan,0,7.9,A,1,4.09,22526.67221,20000,0,625.81,409000004337,26-Sep-17,Indiaforensic MASTER ACQ DOM2609,,205697.83,-544136206.36,Milanesi,850,France,16491.64,0,1,0
4339,2011,3,MORTGAGE,3,Low,1,14400, 36 months,1,major_purchase,8,Low,1,Good Loan,0,6.03,A,1,27.02,15777.16771,14400,0,438.28,409000004338,26-Sep-17,Indiaforensic MAESTRO ACQ DOM260,,109102.84,-544027103.52,Davidson,714,Spain,132979.43,0,1,0
4340,2011,6,MORTGAGE,3,Low,1,5850, 36 months,1,debt_consolidation,6,High,2,Good Loan,0,13.49,C,3,24.19,7142.857826,5850,0,198.5,409000004339,26-Sep-17,Indiaforensic RUPAY POS ACQ26091,,2063139.69,-541963963.83,McKay,559,France,196645.87,0,1,0
4341,2011,2,MORTGAGE,3,Medium,2,5000, 36 months,1,car,2,Low,1,Good Loan,0,6.62,A,1,11.24,5181.88,5000,0,153.52,409000004340,26-Sep-17,Indiaforensic VISA ACQ DOM260917,,843603.44,-541120360.39,Bogdanova,577,Spain,127506.76,0,1,0
4342,2011,2,MORTGAGE,3,Low,1,3000, 36 months,1,home_improvement,7,Low,1,Good Loan,0,6.62,A,1,23.25,3295.941311,3000,0,92.12,409000004341,26-Sep-17,TRF TO  Indiaforensic SERVICES I,"3,900,000.00",,-545020360.39,Lavrentiev,647,Germany,147930.46,0,1,0
4343,2011,7,MORTGAGE,3,Low,1,35000, 60 months,2,small_business,3,Low,1,Bad Loan,1,11.71,B,2,6.56,5406.66,3108.98,0,773.44,409000004342,26-Sep-17,Indiaforensic MASTER INTG RVSL14,,24733.74,-544995626.65,Corser,554,Spain,179689.05,0,1,0
4344,2011,2,RENT,1,Low,1,12000, 36 months,1,debt_consolidation,6,Low,1,Good Loan,0,11.71,B,2,11.6,14284.38083,12000,0,396.92,409000004343,26-Sep-17,Indiaforensic MAEST INTG RVSL140,,2084.34,-544993542.31,Alexeeva,549,Germany,2619.64,0,1,0
4345,2011,5,RENT,1,Low,1,30000, 60 months,2,debt_consolidation,6,High,2,Good Loan,0,15.96,C,3,15.4,32320.76,30000,0,728.91,409000004344,26-Sep-17,Indiaforensic MASTER QR DOM15091,,3.00,-544993539.31,Madueke,528,France,166799.93,0,1,0
4346,2011,7,OWN,2,Low,1,20000, 36 months,1,credit_card,1,Low,1,Good Loan,0,12.69,B,2,13.63,22633.8,20000,0,670.9,409000004345,26-Sep-17,TRF TO  Indiaforensic SERVICES I,"3,200,000.00",,-548193539.31,Barber,720,Germany,133516.51,0,1,0
4347,2011,9,RENT,1,Low,1,7000, 36 months,1,vacation,11,Low,1,Bad Loan,1,7.9,A,1,3.15,5217.86,4076.44,403.16,219.04,409000004346,26-Sep-17,Indiaforensic MASTER ACQ INT 220,,1210.84,-548192328.47,McCardle,743,Spain,163736.09,0,1,0
4348,2011,2,RENT,1,Low,1,8000, 36 months,1,debt_consolidation,6,Low,1,Good Loan,0,6.62,A,1,5.91,8641.9,8000,0,245.63,409000004347,27-Sep-17,Indiaforensic MASTER ACQ DOM2709,,272229.39,-547920099.08,Radcliffe-Brown,615,Germany,179488.41,0,1,0
4349,2011,6.05,MORTGAGE,3,Low,1,8000, 36 months,1,home_improvement,7,Low,1,Good Loan,0,8.9,A,1,9.47,8570.86,8000,0,254.03,409000004348,27-Sep-17,Indiaforensic MAESTRO ACQ DOM270,,142247.52,-547777851.56,Ni,635,Germany,113291.75,0,1,0
4350,2011,6,MORTGAGE,3,Low,1,5000, 36 months,1,car,2,Low,1,Good Loan,0,9.91,B,2,18.65,5798.525738,5000,0,161.13,409000004349,27-Sep-17,Indiaforensic RUPAY POS ACQ27091,,2124060.14,-545653791.42,Chukwumaobim,686,Spain,64907.48,0,1,0
4351,2011,1,RENT,1,Low,1,17500, 36 months,1,debt_consolidation,6,High,2,Good Loan,0,13.49,C,3,8.19,21368.03011,17500,0,593.79,409000004350,27-Sep-17,TRF TO  Indiaforensic SERVICES I,"2,600,000.00",,-548253791.42,Dennis,840,Spain,141364.27,0,1,0
4352,2011,4,RENT,1,Low,1,9000, 36 months,1,debt_consolidation,6,Low,1,Good Loan,0,7.9,A,1,18.3,10090.90343,9000,0,281.62,409000004351,28-Sep-17,Indiaforensic MASTER ACQ DOM2809,,392842.24,-547860949.18,Hayward,695,France,101141.28,0,1,0
4353,2011,10,MORTGAGE,3,Low,1,6000, 36 months,1,debt_consolidation,6,High,2,Good Loan,0,13.49,C,3,6.24,7035.88,6000,0,203.59,409000004352,28-Sep-17,Indiaforensic MAESTRO ACQ DOM280,,139696.05,-547721253.13,Jones,564,France,183490.99,0,1,0
4354,2011,7,MORTGAGE,3,Low,1,8000, 36 months,1,other,4,High,2,Good Loan,0,17.58,D,4,4.81,10345.90983,8000,0,287.54,409000004353,28-Sep-17,Indiaforensic RUPAY POS ACQ28091,,2455358.29,-545265894.84,L?,805,France,4798.12,0,1,0
4355,2011,6,RENT,1,Low,1,7200, 36 months,1,debt_consolidation,6,Low,1,Bad Loan,1,12.69,B,2,19.52,240.88,164.94,0,241.53,409000004354,28-Sep-17,Indiaforensic VISA ACQ DOM280917,,1662302.60,-543603592.24,Nelson,558,Spain,131807.14,0,1,0
4356,2011,9,RENT,1,Medium,2,7500, 36 months,1,wedding,5,High,2,Good Loan,0,16.29,D,4,13.33,8907.99,7500,0,264.76,409000004355,28-Sep-17,TRANSFER TO  Indiaforensic SERVI,"4,600,000.00",,-548203592.24,Cardus,657,France,97192.76,0,1,0
4357,2011,2,RENT,1,Low,1,2500, 36 months,1,small_business,3,Low,1,Good Loan,0,10.65,B,2,20.6,2788.32,2500,0,81.44,409000004356,29-Sep-17,Indiaforensic MASTER ACQ DOM2909,,269628.26,-547933963.98,Whitehouse,641,France,164128.58,0,1,0
4358,2011,0.5,RENT,1,Low,1,6000, 36 months,1,debt_consolidation,6,Low,1,Good Loan,0,12.69,B,2,11.58,6938.4,6000,0,201.27,409000004357,29-Sep-17,Indiaforensic MAESTRO ACQ DOM290,,138725.99,-547795237.99,Johnstone,755,France,176809.87,0,1,0
4359,2011,1,RENT,1,Low,1,13200, 36 months,1,wedding,5,Low,1,Good Loan,0,6.62,A,1,12.75,14508.27931,13200,0,405.29,409000004358,29-Sep-17,Indiaforensic RUPAY POS ACQ29091,,1994932.31,-545800305.68,Tsui,483,France,110059.38,0,1,0
4360,2011,0.5,RENT,1,Low,1,16800, 60 months,2,major_purchase,8,Low,1,Good Loan,0,10.65,B,2,3.25,18053.78,13305.31,0,362.35,409000004359,29-Sep-17,Indiaforensic VISA ACQ DOM290917,,882829.71,-544917475.97,Chia,545,Germany,108398.63,0,1,0
4361,2011,5,RENT,1,Low,1,7500, 36 months,1,small_business,3,Low,1,Bad Loan,1,7.9,A,1,0.86,6802.75,5897.22,0,234.68,409000004360,29-Sep-17,TRF TO  Indiaforensic SERVICES I,"3,300,000.00",,-548217475.97,Su,678,France,47117.03,0,1,0
4362,2011,3,RENT,1,Low,1,6000, 36 months,1,credit_card,1,Low,1,Good Loan,0,8.9,A,1,14.53,6857.769952,6000,0,190.52,409000004361,3-Oct-17,Indiaforensic MASTER ACQ DOM3009,,310075.81,-547907400.16,Calabresi,781,Germany,124720.68,0,1,0
4363,2011,6.05,OWN,2,Low,1,17950, 60 months,2,debt_consolidation,6,Low,1,Good Loan,0,11.71,B,2,5.45,23373.23296,17950,0,396.67,409000004362,3-Oct-17,Indiaforensic MAESTRO ACQ DOM300,,93292.67,-547814107.49,Ts'ui,571,Spain,53328.70,0,1,0
4364,2011,8,RENT,1,Low,1,9525, 60 months,2,debt_consolidation,6,High,2,Good Loan,0,17.27,D,4,7.03,13672.72818,9525,0,238.11,409000004363,3-Oct-17,Indiaforensic RUPAY POS ACQ30091,,2079117.29,-545734990.20,McCulloch,634,Spain,82634.41,0,1,0
4365,2011,0.5,MORTGAGE,3,Low,1,12000, 36 months,1,debt_consolidation,6,Low,1,Good Loan,0,7.9,A,1,11.69,13516.9084,12000,0,375.49,409000004364,3-Oct-17,Indiaforensic VISA ACQ DOM300917,,812801.87,-544922188.33,Koo,523,Germany,147059.16,0,1,0
4366,2011,6.05,MORTGAGE,3,Low,1,5000, 36 months,1,other,4,Low,1,Good Loan,0,11.71,B,2,17.75,5951.606346,5000,0,165.38,409000004365,3-Oct-17,Indiaforensic RUPAY POS ACQ01101,,1948893.09,-542973295.24,Miller,501,France,141946.92,0,1,0
4367,2011,10,OWN,2,Low,1,14000, 36 months,1,small_business,3,Low,1,Good Loan,0,9.91,B,2,4.72,14228.74,14000,0,451.15,409000004366,3-Oct-17,Indiaforensic MASTER ACQ DOM0210,,540634.74,-542432660.50,Woolnough,662,France,123583.85,0,1,0
4368,2011,0.5,MORTGAGE,3,Low,1,13000, 36 months,1,medical,9,High,2,Good Loan,0,15.96,C,3,21.34,16439.87823,13000,0,456.79,409000004367,3-Oct-17,Indiaforensic MAESTRO ACQ DOM021,,302127.34,-542130533.16,Douglas,573,Spain,155915.24,0,1,0
4369,2011,10,RENT,1,Low,1,30000, 60 months,2,debt_consolidation,6,High,2,Good Loan,0,14.27,C,3,14.49,38681.01151,30000,0,702.26,409000004368,3-Oct-17,Indiaforensic RUPAY POS ACQ02101,,1668401.51,-540462131.65,Fang,648,Germany,29076.27,0,1,0
4370,2011,2,RENT,1,Low,1,9000, 36 months,1,major_purchase,8,Low,1,Bad Loan,1,6.62,A,1,25.91,7443.39,5793.8,818.43,276.34,409000004369,3-Oct-17,Indiaforensic VISA ACQ DOM021017,,1752106.62,-538710025.03,Munro,662,France,97382.80,0,1,0
4371,2011,10,RENT,1,Low,1,10000, 36 months,1,other,4,Low,1,Bad Loan,1,6.62,A,1,11.65,4366.18,3380.22,380.25,307.04,409000004370,3-Oct-17,Indiaforensic MASTER ACQ DOM0310,,299470.76,-538410554.27,Vinogradov,725,France,57643.55,0,1,0
4372,2011,10,RENT,1,Low,1,15850, 60 months,2,debt_consolidation,6,High,2,Good Loan,0,13.49,C,3,28.71,18188.57,12394.31,0,364.63,409000004371,3-Oct-17,Indiaforensic MAESTRO ACQ DOM031,,156866.67,-538253687.60,Lai,563,France,66006.75,0,1,0
4373,2011,10,MORTGAGE,3,Low,1,6000, 36 months,1,car,2,Low,1,Good Loan,0,6.03,A,1,24.07,6568.420646,6000,0,182.62,409000004372,3-Oct-17,Indiaforensic RUPAY POS ACQ03101,,1638783.06,-536614904.54,Udegbulam,628,France,72350.47,0,1,0
4374,2011,7,MORTGAGE,3,Low,1,15000, 60 months,2,debt_consolidation,6,Low,1,Good Loan,0,8.9,A,1,15.45,16497.21,15000,0,310.65,409000004373,3-Oct-17,Indiaforensic VISA ACQ DOM031017,,906594.31,-535708310.23,Mao,546,Spain,197789.83,0,1,0
4375,2011,4,MORTGAGE,3,Low,1,8975, 36 months,1,debt_consolidation,6,Low,1,Good Loan,0,6.62,A,1,29.61,9919.025609,8975,0,275.57,409000004374,3-Oct-17,TRF TO  Indiaforensic SERVICES I,"9,500,000.00",,-545208310.23,Onyekaozulu,688,Germany,65520.74,0,1,0
4376,2011,1,RENT,1,Low,1,8000, 36 months,1,credit_card,1,Low,1,Bad Loan,1,7.9,A,1,12.66,2501.8,2035.01,0,250.33,409000004375,3-Oct-17,Indiaforensic MASTER ACQ INT27-2,,59091.68,-545149218.55,Fu,850,Germany,31825.84,0,1,0
4377,2011,5,RENT,1,Low,1,11975, 36 months,1,debt_consolidation,6,Low,1,Good Loan,0,6.62,A,1,14.55,12971.91,11975,0,367.68,409000004376,3-Oct-17,Indiaforensic MASTER INT3009-021,,2479.93,-545146738.62,Cross,614,France,185561.89,0,1,0
4378,2011,10,MORTGAGE,3,Medium,2,21000, 60 months,2,debt_consolidation,6,High,2,Good Loan,0,16.77,D,4,20.17,24289.42,21000,0,519.32,409000004377,4-Oct-17,TRF TO  Indiaforensic SERVICES I,"3,100,000.00",,-548246738.62,Snider,719,France,25803.59,0,1,0
4379,2011,10,MORTGAGE,3,Medium,2,11000, 36 months,1,debt_consolidation,6,Low,1,Good Loan,0,8.9,A,1,13.76,12572.61707,11000,0,349.29,409000004378,4-Oct-17,Indiaforensic MASTER ACQ DOM0410,,257720.13,-547989018.49,Harrison,757,France,154337.47,0,1,0
4380,2011,2,MORTGAGE,3,Medium,2,15000, 36 months,1,major_purchase,8,Low,1,Good Loan,0,8.9,A,1,8.6,17145.76319,15000,0,476.3,409000004379,4-Oct-17,Indiaforensic MAESTRO ACQ DOM041,,131855.73,-547857162.76,Dale,669,France,138145.62,0,1,0
4381,2011,9,RENT,1,Low,1,8000, 36 months,1,other,4,Low,1,Bad Loan,1,11.71,B,2,15.84,6453.81,186.14,6189.77,264.61,409000004380,4-Oct-17,Indiaforensic RUPAY POS ACQ04101,,2521162.26,-545336000.50,Udinese,438,Germany,51565.98,0,1,0
4382,2011,10,RENT,1,Low,1,11200, 36 months,1,wedding,5,High,2,Good Loan,0,13.49,C,3,15.42,12325.22,11200,0,380.03,409000004381,4-Oct-17,Indiaforensic VISA ACQ DOM041017,,870169.72,-544465830.78,DeRose,492,France,71323.23,0,1,0
4383,2011,2,RENT,1,Low,1,3200, 36 months,1,debt_consolidation,6,Low,1,Good Loan,0,12.69,B,2,12.62,3837.940369,3200,0,107.35,409000004382,4-Oct-17,TRF TO  Indiaforensic SERVICES I,"3,800,000.00",,-548265830.78,Hay,622,France,38882.34,0,1,0
4384,2011,10,RENT,1,Low,1,8400, 36 months,1,debt_consolidation,6,Low,1,Good Loan,0,12.42,B,2,1.69,10092.17504,8400,0,280.69,409000004383,5-Oct-17,Indiaforensic MASTER ACQ DOM0510,,304380.27,-547961450.51,Bruce,645,France,676.06,0,1,0
4385,2011,10,MORTGAGE,3,Medium,2,2400, 36 months,1,home_improvement,7,High,2,Bad Loan,1,19.91,E,5,14.35,1859.14,956.72,347.5,89.09,409000004384,5-Oct-17,Indiaforensic MAESTRO ACQ DOM051,,124219.29,-547837231.22,Romani,728,France,72203.80,0,1,0
4386,2011,8,MORTGAGE,3,Low,1,7000, 36 months,1,home_improvement,7,High,2,Good Loan,0,16.29,D,4,12.22,7700.56,7000,0,247.11,409000004385,5-Oct-17,Indiaforensic VISA ACQ DOM051017,,691508.55,-547145722.67,Tseng,651,France,174094.24,0,1,0
4387,2011,5,RENT,1,Low,1,6000, 36 months,1,debt_consolidation,6,High,2,Good Loan,0,15.96,C,3,16.7,7588.749871,6000,0,210.83,409000004386,5-Oct-17,Indiaforensic MASTER ACQ  QR0510,,14.00,-547145708.67,Tang,783,Germany,2150.22,0,1,0
4388,2011,10,RENT,1,Low,1,9600, 60 months,2,other,4,High,2,Bad Loan,1,13.49,C,3,8.33,9921.21,6057.09,652.03,220.85,409000004387,6-Oct-17,FDRL/INTERNAL FUND TRANSFE,,1500000.00,-545645708.67,Isayeva,732,Spain,177783.04,0,1,0
4389,2011,0.5,MORTGAGE,3,Low,1,13000, 36 months,1,debt_consolidation,6,Low,1,Good Loan,0,12.42,B,2,13.34,15609.34279,13000,0,434.4,409000004388,6-Oct-17,Indiaforensic MASTER ACQ DOM0610,,322994.57,-545322714.10,Hill,553,Spain,44363.42,0,1,0
4390,2011,4,OWN,2,Low,1,5150, 60 months,2,car,2,Low,1,Good Loan,0,10.65,B,2,15.74,5838.68,5150,0,111.08,409000004389,6-Oct-17,Indiaforensic MAESTRO ACQ DOM061,,205092.91,-545117621.19,Barnes,660,France,96847.91,0,1,0
4391,2011,4,MORTGAGE,3,Medium,2,15000, 36 months,1,debt_consolidation,6,High,2,Good Loan,0,13.49,C,3,0.66,15168.62,15000,0,508.96,409000004390,6-Oct-17,Indiaforensic RUPAY POS ACQ06101,,1752778.05,-543364843.14,Moreno,670,France,148579.43,0,1,0
4392,2011,1,OWN,2,Low,1,7500, 36 months,1,credit_card,1,Low,1,Good Loan,0,7.51,A,1,13.37,8422.251917,7500,0,233.34,409000004391,6-Oct-17,Indiaforensic POS ACQ SETTL 0510,"1,510,936.72",,-544875779.86,McGregor,718,France,38308.34,0,1,0
4393,2011,6,MORTGAGE,3,Low,1,15850, 60 months,2,medical,9,High,2,Bad Loan,1,13.49,C,3,11.44,15314.46,9919.34,32.13,364.63,409000004392,7-Oct-17,Indiaforensic RUPAY POS ACQ07101,,2284498.42,-542591281.44,Genovese,787,France,142538.31,0,1,0
4394,2011,2,RENT,1,Low,1,6000, 36 months,1,wedding,5,Low,1,Good Loan,0,7.9,A,1,14.56,6757.906605,6000,0,187.75,409000004393,7-Oct-17,TRF TO  Indiaforensic SERVICES I,"1,000,000.00",,-543591281.44,Gill,775,Germany,153122.58,0,1,0
4395,2011,1,OWN,2,Low,1,10000, 36 months,1,debt_consolidation,6,Low,1,Good Loan,0,7.9,A,1,23.11,10961.78,10000,0,312.91,409000004394,7-Oct-17,TRF TO  Indiaforensic SERVICES I,"2,000,000.00",,-545591281.44,Ts'ai,479,Germany,169505.83,0,1,0
4396,2011,5,RENT,1,Low,1,15000, 60 months,2,debt_consolidation,6,High,2,Bad Loan,1,20.89,F,6,22.34,14604.03,6320.92,1279.71,404.88,409000004395,9-Oct-17,Indiaforensic MASTER ACQ DOM0710,,424623.29,-545166658.15,Green,660,France,57929.90,0,1,0
4397,2011,10,RENT,1,Low,1,1500, 36 months,1,other,4,High,2,Good Loan,0,16.77,D,4,12.98,1916.940061,1500,0,53.31,409000004396,9-Oct-17,Indiaforensic MAESTRO ACQ DOM071,,179142.43,-544987515.72,Martin,721,Germany,175399.14,0,1,0
4398,2011,5,MORTGAGE,3,Low,1,20000, 60 months,2,debt_consolidation,6,High,2,Bad Loan,1,22.06,F,6,11.14,16384.73,6090.71,2025.57,553.07,409000004397,9-Oct-17,Indiaforensic VISA ACQ DOM071017,,1687889.00,-543299626.72,Johnson,659,Germany,107964.36,0,1,0
4399,2011,10,MORTGAGE,3,Low,1,21000, 60 months,2,debt_consolidation,6,Low,1,Good Loan,0,11.71,B,2,18.33,26040.92149,21000,0,464.07,409000004398,9-Oct-17,Indiaforensic RUPAY POS ACQ08101,,2411058.03,-540888568.69,Onio,743,France,94263.44,0,1,0
4400,2011,10,OWN,2,Low,1,12000, 36 months,1,debt_consolidation,6,Low,1,Good Loan,0,11.71,B,2,16.37,14285.28906,12000,0,396.92,409000004399,9-Oct-17,Indiaforensic MASTER ACQ DOM0910,,450163.10,-540438405.59,Vaguine,670,France,155921.81,0,1,0
4401,2011,1,MORTGAGE,3,Low,1,30000, 60 months,2,debt_consolidation,6,High,2,Good Loan,0,14.27,C,3,18.65,38953.96331,30000,0,702.26,409000004400,9-Oct-17,Indiaforensic MAESTRO ACQ DOM091,,307869.38,-540130536.21,Manna,766,Germany,137995.66,0,1,0
4402,2011,10,MORTGAGE,3,Low,1,12000, 36 months,1,debt_consolidation,6,High,2,Good Loan,0,16.29,D,4,19.1,15001.75,12000,0,423.61,409000004401,9-Oct-17,Indiaforensic RUPAY POS ACQ09101,,1173779.51,-538956756.70,Toomey,845,Spain,179631.85,0,1,0
4403,2011,2,OWN,2,Low,1,5000, 36 months,1,debt_consolidation,6,Low,1,Good Loan,0,6.03,A,1,16.76,5478.212687,5000,0,152.18,409000004402,9-Oct-17,Indiaforensic VISA ACQ DOM091017,,1827334.81,-537129421.89,Bell,710,Germany,166586.99,0,1,0
4404,2011,10,RENT,1,Low,1,30000, 36 months,1,house,12,Low,1,Bad Loan,1,10.65,B,2,22.74,14800.55,10522.39,1118.61,977.2,409000004403,9-Oct-17,FND TRF TO  Indiaforensic SERVIC,"2,000,000.00",,-539129421.89,Bonwick,602,Germany,115116.35,0,1,0
4405,2011,2,RENT,1,Low,1,11250, 36 months,1,debt_consolidation,6,High,2,Good Loan,0,14.27,C,3,19.92,13592.04381,11250,0,385.98,409000004404,9-Oct-17,FND TRF TO  Indiaforensic SERVIC,"2,000,000.00",,-541129421.89,Folliero,604,Spain,23881.62,0,1,0
4406,2011,6.05,MORTGAGE,3,Low,1,12000, 36 months,1,other,4,Low,1,Good Loan,0,7.9,A,1,2.8,13266.44,12000,0,375.49,409000004405,9-Oct-17,FND TRF TO  Indiaforensic SERVIC,"1,000,000.00",,-542129421.89,Holt,564,Spain,105837.38,0,1,0
4407,2011,0.5,RENT,1,Low,1,7800, 36 months,1,debt_consolidation,6,Low,1,Good Loan,0,12.69,B,2,9.39,9177.84,7800,0,261.65,409000004406,9-Oct-17,FND TRF TO  Indiaforensic SERVIC,"1,000,000.00",,-543129421.89,Brown,637,Germany,101418.05,0,1,0
4408,2011,6,RENT,1,Low,1,30000, 60 months,2,debt_consolidation,6,Low,1,Good Loan,0,12.42,B,2,18.56,31220.04,30000,0,673.72,409000004407,9-Oct-17,FND TRF TO  Indiaforensic SERVIC,"1,000,000.00",,-544129421.89,Ch'ang,527,France,182266.01,0,1,0
4409,2011,5,MORTGAGE,3,Low,1,17000, 36 months,1,credit_card,1,Low,1,Good Loan,0,8.9,A,1,19.66,19489.79451,17000,0,539.81,409000004408,10-Oct-17,TRF TO  Indiaforensic SERVICES I,"4,100,000.00",,-548229421.89,Fiorentini,687,France,28698.17,0,1,0
4410,2011,10,MORTGAGE,3,Low,1,14000, 36 months,1,credit_card,1,Low,1,Good Loan,0,6.03,A,1,22.91,15336.90236,14000,0,426.1,409000004409,10-Oct-17,Indiaforensic MASTER ACQ DOM1010,,737893.21,-547491528.68,Middleton,756,Germany,50422.36,0,1,0
4411,2011,2,RENT,1,Low,1,2500, 36 months,1,debt_consolidation,6,Low,1,Good Loan,0,8.9,A,1,11.01,2856.624538,2500,0,79.39,409000004410,10-Oct-17,Indiaforensic MAESTRO ACQ DOM101,,206927.46,-547284601.22,Millar,503,Germany,151336.96,0,1,0
4412,2011,5,RENT,1,Low,1,15000, 60 months,2,debt_consolidation,6,High,2,Good Loan,0,17.27,D,4,15.84,22027.44522,15000,0,374.97,409000004411,10-Oct-17,Indiaforensic RUPAY POS ACQ10101,,2466420.78,-544818180.44,Osborne,657,Spain,112979.60,0,1,0
4413,2011,6,RENT,1,Low,1,24000, 60 months,2,debt_consolidation,6,Low,1,Good Loan,0,11.71,B,2,9.06,29063.95,24000,0,530.36,409000004412,10-Oct-17,Indiaforensic VISA ACQ DOM101017,,943414.85,-543874765.59,Feng,666,France,36371.27,0,1,0
4414,2011,1,MORTGAGE,3,Low,1,9000, 36 months,1,debt_consolidation,6,Low,1,Good Loan,0,7.51,A,1,16.14,10001.49,9000,0,280,409000004413,11-Oct-17,TRF TO  Indiaforensic SERVICES I,"4,300,000.00",,-548174765.59,Vale,615,Germany,52166.25,0,1,0
4415,2011,4,RENT,1,Low,1,17050, 60 months,2,debt_consolidation,6,Low,1,Bad Loan,1,10.65,B,2,25.44,8088.92,4669.97,737.78,367.74,409000004414,11-Oct-17,Indiaforensic MASTER ACQ DOM1110,,453943.20,-547720822.39,Arkwookerum,712,Germany,147261.58,0,1,0
4416,2011,6,MORTGAGE,3,Low,1,3000, 60 months,2,other,4,Low,1,Good Loan,0,10.65,B,2,11.53,3151.35,2312.18,0,64.71,409000004415,11-Oct-17,Indiaforensic MAESTRO ACQ DOM111,,175069.41,-547545752.98,Lujan,764,France,88724.49,0,1,0
4417,2011,3,OWN,2,Low,1,1925, 36 months,1,debt_consolidation,6,Low,1,Good Loan,0,6.03,A,1,13.32,2109.001734,1925,0,58.59,409000004416,11-Oct-17,Indiaforensic RUPAY POS ACQ11101,,2771178.25,-544774574.73,Alexeyeva,471,France,190531.77,0,1,0
4418,2011,10,MORTGAGE,3,Medium,2,35000, 60 months,2,debt_consolidation,6,High,2,Good Loan,0,19.91,E,5,20.21,46252.43,26525.11,0,925.54,409000004417,11-Oct-17,Indiaforensic VISA ACQ DOM111017,,940174.18,-543834400.55,Gannon,608,Spain,199953.33,0,1,0
4419,2011,6,MORTGAGE,3,Low,1,6625, 60 months,2,debt_consolidation,6,High,2,Good Loan,0,14.27,C,3,24.68,7752.53,5160.25,0,155.09,409000004418,12-Oct-17,Indiaforensic MASTER ACQ DOM1210,,299144.14,-543535256.41,Prokhorova,682,Spain,144290.97,0,1,0
4420,2011,3,RENT,1,Low,1,1000, 36 months,1,other,4,Low,1,Good Loan,0,7.9,A,1,17.01,1125.460385,1000,0,31.3,409000004419,12-Oct-17,Indiaforensic MAESTRO ACQ DOM121,,122354.74,-543412901.67,Romero,587,Germany,130514.78,0,1,0
4421,2011,1,MORTGAGE,3,Low,1,21600, 60 months,2,debt_consolidation,6,High,2,Good Loan,0,13.49,C,3,5.38,24799.55,16899.7,0,496.91,409000004420,12-Oct-17,Indiaforensic RUPAY POS ACQ12101,,2647169.56,-540765732.11,Toscani,714,Germany,53954.24,0,1,0
4422,2011,6,MORTGAGE,3,Medium,2,4200, 36 months,1,other,4,Low,1,Good Loan,0,11.71,B,2,10.03,4864.56,4200,0,138.92,409000004421,12-Oct-17,Indiaforensic VISA ACQ DOM121017,,938629.39,-539827102.72,Onwuamaegbu,630,Spain,169802.73,0,1,0
4423,2011,3,RENT,1,Low,1,12850, 60 months,2,other,4,High,2,Bad Loan,1,22.74,G,7,1.36,5334.19,1700.98,639.22,360.34,409000004422,12-Oct-17,Indiaforensic VISA ACQ INT121017,,595.84,-539826506.88,King,648,Germany,146851.73,0,1,0
4424,2011,2,MORTGAGE,3,Low,1,4800, 36 months,1,credit_card,1,Low,1,Good Loan,0,7.51,A,1,28.87,5374.917255,4800,0,149.34,409000004423,12-Oct-17,TRANSFER TO  Indiaforensic SERVI,"4,400,000.00",,-544226506.88,Trentino,785,France,96832.82,0,1,0
4425,2011,3,RENT,1,Low,1,4200, 36 months,1,car,2,Low,1,Good Loan,0,9.91,B,2,9.86,4870.954244,4200,0,135.35,409000004424,12-Oct-17,Indiaforensic MASTER ACQ INT06-1,,17450.80,-544209056.08,Peacock,601,Germany,57553.02,0,1,0
4426,2011,10,MORTGAGE,3,Medium,2,5000, 36 months,1,medical,9,Low,1,Good Loan,0,6.03,A,1,20.43,5478.212687,5000,0,152.18,409000004425,13-Oct-17,TRF TO  Indiaforensic SERVICES I,"4,000,000.00",,-548209056.08,Nnaife,717,France,74800.99,0,1,0
4427,2011,7,MORTGAGE,3,Low,1,16000, 36 months,1,credit_card,1,High,2,Good Loan,0,14.65,C,3,22.57,19865.31322,16000,0,551.91,409000004426,13-Oct-17,Indiaforensic MASTER ACQ DOM1310,,388295.05,-547820761.03,Chao,707,France,192542.17,0,1,0
4428,2011,0.5,MORTGAGE,3,Low,1,12800, 60 months,2,other,4,Low,1,Good Loan,0,12.42,B,2,19.46,14355.99,10072.48,0,287.46,409000004427,13-Oct-17,Indiaforensic MAESTRO ACQ DOM131,,145358.32,-547675402.71,Barese,771,France,72990.62,0,1,0
4429,2011,10,RENT,1,Low,1,19850, 36 months,1,debt_consolidation,6,Low,1,Good Loan,0,9.91,B,2,9.66,23024.55804,19850,0,639.67,409000004428,13-Oct-17,Indiaforensic RUPAY POS ACQ13101,,2486879.27,-545188523.44,Udegbulam,602,France,31050.02,0,1,0
4430,2011,3,MORTGAGE,3,Low,1,20000, 60 months,2,credit_card,1,High,2,Good Loan,0,15.27,C,3,20.03,28164.41411,20000,0,478.64,409000004429,13-Oct-17,Indiaforensic VISA ACQ DOM131017,,982805.45,-544205717.99,Fu,626,France,52795.56,0,1,0
4431,2011,6,MORTGAGE,3,Low,1,15000, 60 months,2,major_purchase,8,Low,1,Good Loan,0,11.71,B,2,20.8,18514.52139,15000,0,331.48,409000004430,13-Oct-17,TRF TO  Indiaforensic SERVICES I,"4,000,000.00",,-548205717.99,Onwuatuegwu,588,Spain,27435.41,0,1,0
4432,2011,7,RENT,1,Medium,2,8000, 36 months,1,other,4,Low,1,Good Loan,0,12.69,B,2,10.03,9657.806224,8000,0,268.36,409000004431,16-Oct-17,Indiaforensic MASTER ACQ DOM1410,,480923.67,-547724794.32,Degtyaryov,616,Germany,150266.81,0,1,0
4433,2011,7,MORTGAGE,3,Low,1,15000, 36 months,1,debt_consolidation,6,Low,1,Good Loan,0,7.9,A,1,7.68,16877.62568,15000,0,469.36,409000004432,16-Oct-17,Indiaforensic MAESTRO ACQ DOM141,,150105.40,-547574688.92,Nnaemeka,621,Spain,40299.23,0,1,0
4434,2011,1,RENT,1,Low,1,3000, 36 months,1,credit_card,1,High,2,Good Loan,0,13.49,C,3,14.73,3660.733624,3000,0,101.8,409000004433,16-Oct-17,Indiaforensic RUPAY POS ACQ14101,,2422684.79,-545152004.13,Udinese,674,France,149369.41,0,1,0
4435,2011,10,MORTGAGE,3,Low,1,21850, 60 months,2,debt_consolidation,6,High,2,Bad Loan,1,17.27,D,4,24.39,24579.45,14846.05,0,546.21,409000004434,16-Oct-17,Indiaforensic VISA ACQ DOM141017,,905082.54,-544246921.59,Mitchell,633,Spain,120250.58,0,1,0
4436,2011,2,RENT,1,Medium,2,4000, 36 months,1,major_purchase,8,Low,1,Good Loan,0,12.69,B,2,1.34,4161.78,4000,0,134.18,409000004435,16-Oct-17,Indiaforensic RUPAY POS ACQ15101,,2531210.53,-541715711.06,Ch'en,698,Germany,84760.32,0,1,0
4437,2011,4,OWN,2,Low,1,34000, 60 months,2,debt_consolidation,6,Low,1,Bad Loan,1,12.42,B,2,11.54,21748.13,10932.43,3150.03,763.55,409000004436,16-Oct-17,Indiaforensic VISA ACQ INT151017,,10186.70,-541705524.36,Golovanov,508,France,156424.40,0,1,0
4438,2011,10,RENT,1,Medium,2,20000, 60 months,2,credit_card,1,High,2,Good Loan,0,19.91,E,5,14.02,22552.31,20000,0,528.88,409000004437,16-Oct-17,Indiaforensic MASTER ACQ DOM1610,,526313.43,-541179210.93,Efimov,736,France,109355.73,0,1,0
4439,2011,10,MORTGAGE,3,High,3,28000, 36 months,1,home_improvement,7,Low,1,Good Loan,0,7.9,A,1,14.5,31380.29278,28000,0,876.13,409000004438,16-Oct-17,Indiaforensic MAESTRO ACQ DOM161,,264386.56,-540914824.37,Davidson,672,Germany,184936.77,0,1,0
4440,2011,10,RENT,1,Low,1,14000, 60 months,2,debt_consolidation,6,High,2,Good Loan,0,17.27,D,4,15.05,17453.34,10739.74,0,349.98,409000004439,16-Oct-17,Indiaforensic RUPAY POS ACQ16101,,2338684.06,-538576140.31,Wade,613,France,36560.51,0,1,0
4441,2011,6.05,MORTGAGE,3,Low,1,12000, 60 months,2,debt_consolidation,6,High,2,Good Loan,0,14.27,C,3,5.2,14068.06,12000,0,280.91,409000004440,16-Oct-17,Indiaforensic VISA ACQ DOM161017,,2669040.06,-535907100.25,Maynard,712,France,165693.06,0,1,0
4442,2011,10,MORTGAGE,3,Medium,2,8000, 36 months,1,debt_consolidation,6,High,2,Good Loan,0,18.64,E,5,11.36,10500.95266,8000,0,291.8,409000004441,16-Oct-17,Indiaforensic VISA ACQ INT161017,,9626.34,-535897473.91,Murphy,624,France,163666.85,0,1,0
4443,2011,4,RENT,1,Low,1,10000, 36 months,1,wedding,5,High,2,Good Loan,0,14.65,C,3,8.62,11187.34,10000,0,344.95,409000004442,16-Oct-17,Indiaforensic MASTER ACQ INT12-1,,62573.31,-535834900.60,Zotova,676,France,35644.79,0,1,0
4444,2011,10,RENT,1,Medium,2,12000, 60 months,2,medical,9,High,2,Good Loan,0,19.03,E,5,8.32,15509.66,9110.1,0,311.49,409000004443,17-Oct-17,TRF TO  Indiaforensic SERVICES I,"12,000,000.00",,-547834900.60,Hannah,683,Germany,188203.58,0,1,0
4445,2011,2,RENT,1,Low,1,16000, 60 months,2,credit_card,1,Low,1,Good Loan,0,11.71,B,2,14.3,19271.02,16000,0,353.58,409000004444,17-Oct-17,Indiaforensic MASTER ACQ DOM1710,,1083573.08,-546751327.52,Cartagena,489,France,6120.84,0,1,0
4446,2011,10,MORTGAGE,3,Medium,2,17000, 36 months,1,debt_consolidation,6,Low,1,Good Loan,0,6.03,A,1,9.47,17419.81,17000,0,517.41,409000004445,17-Oct-17,Indiaforensic MAESTRO ACQ DOM171,,201114.78,-546550212.74,Hall,739,France,164484.78,0,1,0
4447,2011,10,MORTGAGE,3,Low,1,5000, 36 months,1,home_improvement,7,High,2,Bad Loan,1,15.27,C,3,14.71,4523.74,3358.71,23.14,173.99,409000004446,17-Oct-17,Indiaforensic RUPAY POS ACQ17101,,2821466.58,-543728746.16,Hunt,701,France,164268.28,0,1,0
4448,2011,4,RENT,1,Low,1,2000, 36 months,1,debt_consolidation,6,High,2,Good Loan,0,15.27,C,3,0.87,2467.64,2000,0,69.6,409000004447,17-Oct-17,Indiaforensic VISA ACQ DOM171017,,1379749.27,-542348996.89,Greece,666,Germany,140136.10,0,1,0
4449,2011,4,OWN,2,Low,1,20000, 60 months,2,small_business,3,Low,1,Good Loan,0,10.65,B,2,2.16,21483.03,15833.99,0,431.37,409000004448,17-Oct-17,Indiaforensic VISA ACQ INT171017,,1980.00,-542347016.89,Thomson,565,Germany,121084.27,0,1,0
4450,2011,6.05,OWN,2,Low,1,10000, 36 months,1,debt_consolidation,6,Low,1,Good Loan,0,6.03,A,1,13.18,10956.36694,10000,0,304.36,409000004449,17-Oct-17,TRF TO  Indiaforensic SERVICES I,"5,900,000.00",,-548247016.89,Victor,666,France,35156.54,0,1,0
4451,2011,4,RENT,1,Low,1,4500, 36 months,1,debt_consolidation,6,Low,1,Good Loan,0,9.91,B,2,11.09,5206.323173,4500,0,145.02,409000004450,18-Oct-17,Indiaforensic RUPAY POS ACQ18101,,3577775.22,-544669241.67,Mitchell,633,France,103159.11,0,1,0
4452,2011,1,RENT,1,Low,1,4100, 36 months,1,vacation,11,High,2,Good Loan,0,17.58,D,4,12.86,4276.01,4100,0,147.37,409000004451,20-Oct-17,TRF TO  Indiaforensic SERVICES I,"1,000,000.00",,-545669241.67,Olisaemeka,578,France,74858.30,0,1,0
4453,2011,5,MORTGAGE,3,Low,1,4200, 36 months,1,other,4,High,2,Good Loan,0,13.49,C,3,15.5,5128.514935,4200,0,142.51,409000004452,20-Oct-17,TRF TO  Indiaforensic SERVICES I,"500,000.00",,-546169241.67,Krawczyk,812,Spain,91556.57,0,1,0
4454,2011,5,RENT,1,Low,1,12000, 36 months,1,debt_consolidation,6,Low,1,Good Loan,0,9.91,B,2,6.41,13584.83,12000,0,386.7,409000004453,20-Oct-17,TRF TO  Indiaforensic SERVICES I,"500,000.00",,-546669241.67,Alexandrova,809,Germany,199203.21,0,1,0
4455,2011,10,MORTGAGE,3,Low,1,18000, 60 months,2,credit_card,1,High,2,Good Loan,0,18.25,D,4,14.6,21072.85,18000,0,459.54,409000004454,20-Oct-17,TRF TO  Indiaforensic SERVICES I,"500,000.00",,-547169241.67,Paterson,615,France,27011.80,0,1,0
4456,2011,10,RENT,1,Medium,2,35000, 60 months,2,debt_consolidation,6,High,2,Bad Loan,1,22.06,F,6,16.82,40040.02,17593.09,3232.45,967.86,409000004455,20-Oct-17,TRF TO  Indiaforensic SERVICES I,"500,000.00",,-547669241.67,Chou,684,Spain,188637.05,0,1,0
4457,2011,10,MORTGAGE,3,Low,1,10000, 36 months,1,debt_consolidation,6,High,2,Good Loan,0,16.29,D,4,15.58,12706.08689,10000,0,353.01,409000004456,21-Oct-17,Indiaforensic VISA ACQ DOM181017,,1713458.31,-545955783.36,Abel,544,France,61581.20,0,1,0
4458,2011,2,RENT,1,Low,1,3000, 36 months,1,other,4,Low,1,Good Loan,0,6.03,A,1,15.72,3257.5,3000,0,91.31,409000004457,21-Oct-17,Indiaforensic MASTER ACQ DOM1810,,764476.27,-545191307.09,Chesnokova,713,Germany,197529.23,0,1,0
4459,2011,0.5,RENT,1,Low,1,4425, 36 months,1,debt_consolidation,6,Low,1,Good Loan,0,8.9,A,1,2.94,4897.65,4425,0,140.51,409000004458,21-Oct-17,Indiaforensic MAESTRO ACQ DOM181,,193179.09,-544998128.00,Niu,633,France,182258.17,0,1,0
4460,2011,8,MORTGAGE,3,Medium,2,28000, 36 months,1,home_improvement,7,Low,1,Good Loan,0,7.51,A,1,8.52,31354.16373,28000,0,871.11,409000004459,21-Oct-17,Indiaforensic RUPAY POS ACQ19101,,3424460.36,-541573667.64,Sullivan,672,Germany,80778.50,0,1,0
4461,2011,10,OWN,2,Low,1,35000, 60 months,2,home_improvement,7,High,2,Good Loan,0,13.49,C,3,0.64,43813.07,35000,0,805.17,409000004460,21-Oct-17,Indiaforensic VISA ACQ DOM191017,,1526127.02,-540047540.62,Ma,661,France,155394.52,0,1,0
4462,2011,10,MORTGAGE,3,Low,1,12000, 36 months,1,debt_consolidation,6,Low,1,Bad Loan,1,6.62,A,1,22.75,6263.38,5362.5,10.1,368.45,409000004461,21-Oct-17,Indiaforensic RUPAY POS ACQ20101,,2638438.22,-537409102.40,Cavill,749,Spain,3408.70,0,1,0
4463,2011,8,MORTGAGE,3,Low,1,4800, 36 months,1,debt_consolidation,6,High,2,Bad Loan,1,14.65,C,3,13.49,4082.72,2818.46,277.83,165.58,409000004462,21-Oct-17,Indiaforensic VISA ACQ DOM201017,,1706462.49,-535702639.91,Nicholls,635,Spain,19367.98,0,1,0
4464,2011,5,RENT,1,Low,1,2400, 36 months,1,other,4,Low,1,Good Loan,0,8.9,A,1,13.56,2630.4,2400,0,76.21,409000004463,21-Oct-17,Indiaforensic RUPAY POS ACQ21101,,2517620.43,-533185019.48,Nnonso,850,Germany,62282.99,0,1,0
4465,2011,5,MORTGAGE,3,Low,1,31300, 36 months,1,small_business,3,Low,1,Good Loan,0,11.71,B,2,18.58,36825.77,31300,0,1035.28,409000004464,21-Oct-17,Indiaforensic VISA ACQ DOM211017,,1226280.02,-531958739.46,Gibson,641,France,65396.79,0,1,0
4466,2011,3,MORTGAGE,3,Low,1,32250, 60 months,2,debt_consolidation,6,High,2,Good Loan,0,19.42,E,5,20.99,35299.89,32250,0,844.06,409000004465,21-Oct-17,TRF TO  Indiaforensic SERVICES I,"10,000,000.00",,-541958739.46,Garcia,633,Germany,139712.81,0,1,0
4467,2011,10,RENT,1,Low,1,3000, 36 months,1,credit_card,1,Low,1,Good Loan,0,8.9,A,1,16.05,3428.173998,3000,0,95.26,409000004466,21-Oct-17,TRF TO  Indiaforensic SERVICES I,"5,000,000.00",,-546958739.46,Renwick,413,Spain,60972.84,0,1,0
4468,2011,9,MORTGAGE,3,Low,1,4000, 36 months,1,debt_consolidation,6,Low,1,Bad Loan,1,7.9,A,1,9.91,1181.7,807.09,182.9,125.17,409000004467,23-Oct-17,Indiaforensic MASTER ACQ DOM1910,,645475.88,-546313263.58,Norris,538,France,1375.46,0,1,0
4469,2011,6.05,MORTGAGE,3,Low,1,15000, 36 months,1,debt_consolidation,6,Low,1,Bad Loan,1,12.69,B,2,5.94,4499.45,2118.33,739.87,503.18,409000004468,23-Oct-17,Indiaforensic MAESTRO ACQ DOM191,,160688.30,-546152575.28,Nkemakonam,437,France,22191.82,0,1,0
4470,2011,2,MORTGAGE,3,Low,1,4800, 36 months,1,debt_consolidation,6,Low,1,Good Loan,0,6.62,A,1,6.96,5251.8,4800,0,147.38,409000004469,23-Oct-17,Indiaforensic MASTER ACQ DOM2010,,640841.23,-545511734.05,Piccio,612,Spain,8973.67,0,1,0
4471,2011,10,MORTGAGE,3,Medium,2,14400, 36 months,1,home_improvement,7,Low,1,Good Loan,0,12.69,B,2,12.55,17380.37031,14400,0,483.05,409000004470,23-Oct-17,Indiaforensic MAESTRO ACQ DOM201,,153143.32,-545358590.73,Linton,516,Germany,118502.34,0,1,0
4472,2011,10,OWN,2,Medium,2,7000, 36 months,1,debt_consolidation,6,Low,1,Good Loan,0,8.9,A,1,20.75,7928.616581,7000,0,222.28,409000004471,23-Oct-17,Indiaforensic MASTER ACQ DOM2110,,528061.82,-544830528.91,Onyekaozulu,826,Spain,161802.82,0,1,0
4473,2011,2,RENT,1,Low,1,5000, 60 months,2,major_purchase,8,High,2,Bad Loan,1,14.27,C,3,14.07,4387.3,2385.4,372.01,117.05,409000004472,23-Oct-17,Indiaforensic MAESTRO ACQ DOM211,,132561.11,-544697967.80,Tobenna,660,Germany,90494.72,0,1,0
4474,2011,1,MORTGAGE,3,Low,1,20800, 60 months,2,debt_consolidation,6,Low,1,Good Loan,0,12.69,B,2,7.08,25561.77,20800,0,469.97,409000004473,23-Oct-17,Indiaforensic VISA ACQ INT211017,,4554.00,-544693413.80,Wang,646,Germany,15470.91,0,1,0
4475,2011,9,RENT,1,Low,1,4200, 36 months,1,debt_consolidation,6,Low,1,Good Loan,0,7.9,A,1,10.86,4730.294331,4200,0,131.42,409000004474,23-Oct-17,Indiaforensic MASTER ACQ DOM2310,,968792.77,-543724621.03,O'Donnell,767,France,65147.27,0,1,0
4476,2011,4,MORTGAGE,3,Low,1,7200, 36 months,1,debt_consolidation,6,Low,1,Good Loan,0,8.9,A,1,22.06,8034.4,7200,0,228.63,409000004475,23-Oct-17,Indiaforensic MAESTRO ACQ DOM231,,341334.06,-543383286.97,Langlands,640,France,157886.60,0,1,0
4477,2011,4,RENT,1,Low,1,4200, 36 months,1,debt_consolidation,6,Low,1,Good Loan,0,8.9,A,1,12.4,4725.983884,4200,0,133.37,409000004476,23-Oct-17,Indiaforensic RUPAY POS ACQ23101,,2505118.20,-540878168.77,Smith,778,France,85439.73,0,1,0
4478,2011,5,MORTGAGE,3,Low,1,18200, 36 months,1,credit_card,1,Low,1,Good Loan,0,7.9,A,1,17.37,18976.01,18200,0,569.49,409000004477,23-Oct-17,Indiaforensic RUPAY POS ACQ22101,,3266992.16,-537611176.61,Sykes,679,Germany,54038.62,0,1,0
4479,2011,6.05,RENT,1,Low,1,10000, 36 months,1,small_business,3,Low,1,Good Loan,0,6.03,A,1,14.14,10956.33773,10000,0,304.36,409000004478,23-Oct-17,Indiaforensic VISA ACQ DOM231017,,2144534.59,-535466642.02,Marshall,549,France,25684.85,0,1,0
4480,2011,4,MORTGAGE,3,Medium,2,22000, 36 months,1,debt_consolidation,6,Low,1,Good Loan,0,12.69,B,2,21.64,26558.25659,22000,0,737.99,409000004479,23-Oct-17,Indiaforensic VISA ACQ DOM221017,,180.00,-535466462.02,Gibson,598,France,186116.54,0,1,0
4481,2011,10,MORTGAGE,3,Low,1,20000, 36 months,1,debt_consolidation,6,High,2,Good Loan,0,15.27,C,3,9.01,20745.97,20000,0,695.96,409000004480,24-Oct-17,TRANSFER TO  Indiaforensic SERVI,"12,000,000.00",,-547466462.02,Stephenson,655,France,166830.71,0,1,0
4482,2011,0.5,RENT,1,Low,1,3000, 36 months,1,debt_consolidation,6,High,2,Good Loan,0,16.29,D,4,16.62,3736.67,3000,0,105.91,409000004481,24-Oct-17,Indiaforensic MASTER ACQ DOM2410,,436396.08,-547030065.94,Y?,494,France,27886.06,0,1,0
4483,2011,6,RENT,1,Low,1,2800, 36 months,1,other,4,Low,1,Bad Loan,1,12.69,B,2,13.85,2621.4,2076.47,0,93.93,409000004482,24-Oct-17,Indiaforensic MAESTRO ACQ DOM241,,164811.15,-546865254.79,Kang,653,France,5768.32,0,1,0
4484,2011,0.5,RENT,1,Low,1,4000, 36 months,1,moving,10,High,2,Good Loan,0,14.65,C,3,22.38,4966.419167,4000,0,137.98,409000004483,24-Oct-17,Indiaforensic RUPAY POS ACQ24101,,2461218.50,-544404036.29,Miller,539,Germany,80575.44,0,1,0
4485,2011,6,MORTGAGE,3,Low,1,3775, 36 months,1,debt_consolidation,6,Low,1,Good Loan,0,11.71,B,2,23.54,4459.977564,3775,0,124.87,409000004484,24-Oct-17,Indiaforensic VISA ACQ DOM241017,,1113277.52,-543290758.77,Kryukov,645,France,68987.55,0,1,0
4486,2011,6,RENT,1,Low,1,2500, 60 months,2,other,4,High,2,Good Loan,0,15.96,C,3,22.6,2752.49,2500,0,60.75,409000004485,24-Oct-17,Indiaforensic VISA ACQ INT231017,,1980.00,-543288778.77,Y?,751,Germany,27097.82,0,1,0
4487,2011,10,MORTGAGE,3,Medium,2,25000, 60 months,2,small_business,3,Low,1,Good Loan,0,10.65,B,2,3.55,31696.20679,25000,0,539.21,409000004486,24-Oct-17,TRANSFER TO  Indiaforensic SERVI,"4,900,000.00",,-548188778.77,Fanucci,528,France,199320.77,0,1,0
4488,2011,2,RENT,1,Low,1,6000, 36 months,1,other,4,Low,1,Good Loan,0,11.71,B,2,21.45,7075.654805,6000,0,198.46,409000004487,25-Oct-17,Indiaforensic MASTER ACQ DOM2510,,505726.37,-547683052.40,Lombardi,696,Germany,5566.60,0,1,0
4489,2011,10,RENT,1,Low,1,7500, 36 months,1,other,4,High,2,Bad Loan,1,14.27,C,3,23.81,2406.23,1400.65,350.23,257.32,409000004488,25-Oct-17,Indiaforensic MAESTRO ACQ DOM251,,112242.55,-547570809.85,Hs?,716,France,133871.83,0,1,0
4490,2011,5,MORTGAGE,3,Low,1,11625, 60 months,2,small_business,3,Low,1,Bad Loan,1,10.65,B,2,11.49,5014.83,2842.44,502.65,250.74,409000004489,25-Oct-17,Indiaforensic RUPAY POS ACQ25101,,3867983.91,-543702825.94,Anderson,602,France,152843.53,0,1,0
4491,2011,10,RENT,1,Low,1,20000, 36 months,1,other,4,Low,1,Good Loan,0,6.62,A,1,17.74,21356.56,20000,0,614.08,409000004490,25-Oct-17,Indiaforensic VISA ACQ DOM251017,,989927.57,-542712898.37,Trentino,647,Spain,41800.18,0,1,0
4492,2011,7,RENT,1,Low,1,16000, 36 months,1,credit_card,1,Low,1,Good Loan,0,8.9,A,1,8.58,18287.92421,16000,0,508.06,409000004491,25-Oct-17,TRANSFER TO  Indiaforensic SERVI,"5,000,000.00",,-547712898.37,Donnelly,850,Germany,92053.75,0,1,0
4493,2011,10,MORTGAGE,3,Low,1,6000, 36 months,1,car,2,Low,1,Good Loan,0,6.03,A,1,23.8,6492.7,6000,0,182.62,409000004492,26-Oct-17,Indiaforensic MASTER ACQ DOM2610,,490304.42,-547222593.95,Tsou,590,France,100717.54,0,1,0
4494,2011,0.5,RENT,1,Low,1,1000, 36 months,1,debt_consolidation,6,Low,1,Good Loan,0,10.65,B,2,21.3,1092.04,1000,0,32.58,409000004493,26-Oct-17,Indiaforensic MAESTRO ACQ DOM261,,202178.15,-547020415.80,Johnson,825,Spain,42935.15,0,1,0
4495,2011,4,RENT,1,Low,1,12000, 36 months,1,credit_card,1,Low,1,Good Loan,0,6.03,A,1,8.14,13129.5909,12000,0,365.23,409000004494,26-Oct-17,Indiaforensic RUPAY POS ACQ26101,,5506799.88,-541513615.92,Watson,850,Spain,149170.92,0,1,0
4496,2011,3,RENT,1,Low,1,14000, 60 months,2,debt_consolidation,6,High,2,Good Loan,0,16.77,D,4,13.47,19557.60208,14000,0,346.21,409000004495,26-Oct-17,Indiaforensic VISA ACQ DOM261017,,1167060.85,-540346555.07,Allan,789,France,107499.39,0,1,0
4497,2011,0.5,RENT,1,Low,1,2550, 36 months,1,car,2,High,2,Good Loan,0,14.27,C,3,23.32,3016.94,2550,0,87.49,409000004496,26-Oct-17,Indiaforensic VISA ACQ INT251017,,1285.70,-540345269.37,Butcher,701,France,153342.38,0,1,0
4498,2011,10,MORTGAGE,3,Low,1,6000, 36 months,1,other,4,Low,1,Good Loan,0,6.62,A,1,11.46,6631.002691,6000,0,184.23,409000004497,26-Oct-17,TRF TO  Indiaforensic SERVICES I,"7,900,000.00",,-548245269.37,Henderson,713,Spain,107825.08,0,1,0
4499,2011,1,RENT,1,Low,1,3000, 36 months,1,other,4,Low,1,Bad Loan,1,7.9,A,1,8.98,2643.82,2179.8,112.3,93.88,409000004498,27-Oct-17,Indiaforensic MASTER ACQ DOM2710,,372051.17,-547873218.20,Boucaut,570,France,47952.45,0,1,0
4500,2011,1,OWN,2,Low,1,8000, 36 months,1,debt_consolidation,6,Low,1,Good Loan,0,12.69,B,2,13.75,9658.207401,8000,0,268.36,409000004499,27-Oct-17,Indiaforensic MAESTRO ACQ DOM271,,116715.16,-547756503.04,Obiajulu,536,Germany,131007.18,0,1,0
4501,2011,3,RENT,1,Low,1,13250, 36 months,1,debt_consolidation,6,Low,1,Good Loan,0,11.71,B,2,24.54,14403.17,13250,0,438.26,409000004500,27-Oct-17,Indiaforensic RUPAY POS ACQ27101,,3729292.01,-544027211.03,Ifeatu,771,Germany,33143.04,0,1,0
4502,2011,5,MORTGAGE,3,Low,1,11400, 36 months,1,debt_consolidation,6,Low,1,Good Loan,0,6.62,A,1,8.17,12514.64,11400,0,350.03,409000004501,27-Oct-17,Indiaforensic VISA ACQ DOM271017,,853916.53,-543173294.50,Kelly,512,France,123304.62,0,1,0
4503,2011,6,RENT,1,Low,1,8000, 36 months,1,debt_consolidation,6,High,2,Good Loan,0,17.27,D,4,21.26,10304.17508,8000,0,286.3,409000004502,27-Oct-17,Indiaforensic VISA ACQ INT261017,,1382.92,-543171911.58,Pirozzi,698,Spain,141970.02,0,1,0
4504,2011,5,RENT,1,Low,1,17500, 60 months,2,debt_consolidation,6,High,2,Good Loan,0,13.49,C,3,17.42,20950.52,17500,0,402.59,409000004503,27-Oct-17,Indiaforensic MASTER ACQ DOM2710,,1.00,-543171910.58,Siciliano,656,France,37136.15,0,1,0
4505,2011,10,RENT,1,Low,1,5450, 36 months,1,debt_consolidation,6,High,2,Bad Loan,1,15.96,C,3,18.33,4013.94,2856.1,0,191.5,409000004504,27-Oct-17,Indiaforensic MASTER ACQ DOM2710,1,,-543171911.58,Silva,761,Spain,199293.01,0,1,0
4506,2011,10,RENT,1,Medium,2,35000, 60 months,2,debt_consolidation,6,Low,1,Good Loan,0,12.69,B,2,8.68,37332.61,35000,0,790.82,409000004505,27-Oct-17,TRF TO  Indiaforensic SERVICES I,"5,100,000.00",,-548271911.58,Iweobiegbunam,709,France,161388.22,0,1,0
4507,2011,10,MORTGAGE,3,Medium,2,22000, 36 months,1,debt_consolidation,6,High,2,Good Loan,0,19.42,E,5,13.84,29031.39178,22000,0,811.12,409000004506,30-Oct-17,Indiaforensic MASTER ACQ DOM2810,,331079.78,-547940831.80,Williamson,597,Spain,70532.53,0,1,0
4508,2011,10,MORTGAGE,3,Low,1,2400, 36 months,1,other,4,Low,1,Good Loan,0,12.69,B,2,17.07,2896.478668,2400,0,80.51,409000004507,30-Oct-17,Indiaforensic MAESTRO ACQ DOM281,,132646.28,-547808185.52,Madueke,592,France,144290.25,0,1,0
4509,2011,3,RENT,1,Medium,2,20000, 36 months,1,debt_consolidation,6,High,2,Good Loan,0,13.49,C,3,17.57,24313.10661,20000,0,678.61,409000004508,30-Oct-17,Indiaforensic RUPAY POS ACQ28101,,2906182.96,-544902002.56,Chiagoziem,599,France,96069.82,0,1,0
4510,2011,9,MORTGAGE,3,Low,1,19425, 60 months,2,debt_consolidation,6,High,2,Good Loan,0,13.49,C,3,8.71,25417.5,19425,0,446.87,409000004509,30-Oct-17,Indiaforensic VISA ACQ DOM281017,,698958.20,-544203044.36,Kwemto,572,Germany,185662.84,0,1,0
4511,2011,3,RENT,1,Low,1,10000, 36 months,1,debt_consolidation,6,Low,1,Good Loan,0,10.65,B,2,14.08,11730.05566,10000,0,325.74,409000004510,30-Oct-17,Indiaforensic VISA ACQ INT281017,,360.00,-544202684.36,Zito,611,Germany,17913.25,0,1,0
4512,2011,9,MORTGAGE,3,Low,1,7500, 36 months,1,major_purchase,8,Low,1,Good Loan,0,6.03,A,1,19.63,8217.348246,7500,0,228.27,409000004511,30-Oct-17,Indiaforensic RUPAY POS ACQ29101,,2941434.71,-541261249.65,Ukaegbunam,634,France,101039.53,0,1,0
4513,2011,0.5,MORTGAGE,3,Medium,2,12650, 60 months,2,debt_consolidation,6,High,2,Good Loan,0,21.28,F,6,21.9,19189.63677,12650,0,344.23,409000004512,30-Oct-17,Indiaforensic VISA ACQ INT291017,,3065.90,-541258183.75,Trevisani,666,France,156953.54,0,1,0
4514,2011,10,MORTGAGE,3,Low,1,10400, 60 months,2,major_purchase,8,Low,1,Good Loan,0,9.91,B,2,2.03,12137.11,10400,0,220.51,409000004513,30-Oct-17,Indiaforensic MASTER ACQ DOM3010,,765829.30,-540492354.45,Edmondstone,696,France,28276.83,0,1,0
4515,2011,10,MORTGAGE,3,Medium,2,10000, 36 months,1,debt_consolidation,6,Low,1,Good Loan,0,10.65,B,2,21.36,11724.68908,10000,0,325.74,409000004514,30-Oct-17,Indiaforensic MAESTRO ACQ DOM301,,387985.41,-540104369.04,Chien,669,France,84049.16,0,1,0
4516,2011,10,MORTGAGE,3,Low,1,35000, 36 months,1,other,4,High,2,Good Loan,0,17.27,D,4,10.92,45078.91448,35000,0,1252.56,409000004515,30-Oct-17,Indiaforensic RUPAY POS ACQ30101,,2050725.36,-538053643.68,Boni,726,Spain,147822.44,0,1,0
4517,2011,10,MORTGAGE,3,Medium,2,10000, 36 months,1,debt_consolidation,6,Low,1,Good Loan,0,11.71,B,2,14.19,11892.60661,10000,0,330.76,409000004516,30-Oct-17,Indiaforensic VISA ACQ DOM301017,,1690997.34,-536362646.34,Yashina,497,Germany,9497.99,0,1,0
4518,2011,10,OWN,2,Low,1,21725, 60 months,2,debt_consolidation,6,High,2,Bad Loan,1,20.89,F,6,15.12,7273.89,2247.49,1117.78,586.4,409000004517,30-Oct-17,TRF TO  Indiaforensic SERVICES I,"2,000,000.00",,-538362646.34,Georg,750,Spain,87067.73,0,1,0
4519,2011,8,MORTGAGE,3,Low,1,30000, 60 months,2,credit_card,1,High,2,Good Loan,0,19.42,E,5,8.45,41130,30000,0,785.17,409000004518,30-Oct-17,TRF TO  Indiaforensic SERVICES I,"2,000,000.00",,-540362646.34,Tung,850,Spain,23237.25,0,1,0
4520,2011,7,MORTGAGE,3,Low,1,10000, 36 months,1,debt_consolidation,6,Low,1,Good Loan,0,8.9,A,1,16.38,11163.27,10000,0,317.54,409000004519,30-Oct-17,Indiaforensic MASTER POS CB 2810,"4,760.03",,-540367406.37,Michelides,617,Spain,27239.28,0,1,0
4521,2011,10,RENT,1,Low,1,18000, 60 months,2,debt_consolidation,6,High,2,Bad Loan,1,19.03,E,5,21.62,5378.43,180.5,4914.5,467.23,409000004520,31-Oct-17,Indiaforensic VISA ACQ DOM311017,,897949.04,-539469457.33,Korovina,652,Germany,151481.86,0,1,0
4522,2011,9,RENT,1,Low,1,10000, 36 months,1,credit_card,1,Low,1,Good Loan,0,7.9,A,1,12.75,11263.67018,10000,0,312.91,409000004521,31-Oct-17,Indiaforensic RUPAY POS ACQ31101,,2944117.60,-536525339.73,Chuang,560,Spain,114669.79,0,1,0
4523,2011,9,MORTGAGE,3,Low,1,27000, 60 months,2,debt_consolidation,6,Low,1,Good Loan,0,10.65,B,2,18.92,29019.73,21386.54,0,582.35,409000004522,31-Oct-17,TRF TO  Indiaforensic SERVICES I,"10,000,000.00",,-546525339.73,Yuriev,629,Spain,116748.14,0,1,0
4524,2011,4,RENT,1,Low,1,4200, 36 months,1,other,4,Low,1,Bad Loan,1,9.91,B,2,20.83,2703.4,2176.46,0,135.35,409000004523,31-Oct-17,Indiaforensic MASTER ACQ INT1610,,6305.04,-546519034.69,Chidimma,660,Germany,90877.76,0,1,0
4525,2011,2,RENT,1,Low,1,10000, 36 months,1,debt_consolidation,6,Low,1,Good Loan,0,7.9,A,1,13.09,11261.66315,10000,0,312.91,409000004524,31-Oct-17,TRF TO  Indiaforensic SERVICES I,"1,700,000.00",,-548219034.69,Stevens,676,France,133692.88,0,1,0
4526,2011,6.05,RENT,1,Low,1,14000, 60 months,2,debt_consolidation,6,High,2,Bad Loan,1,19.91,E,5,20.05,4414.87,1481.84,718.78,370.22,409000004525,31-Oct-17,Indiaforensic MASTER ACQ DOM3010,,409688.29,-547809346.40,Kao,581,Spain,30662.91,0,1,0
4527,2011,2,RENT,1,Low,1,2500, 36 months,1,other,4,Low,1,Good Loan,0,8.9,A,1,22.49,2855.255967,2500,0,79.39,409000004526,31-Oct-17,Indiaforensic MAESTRO ACQ DOM301,,165973.81,-547643372.59,Edmund la Touche,798,France,191395.88,0,1,0
4528,2011,10,RENT,1,Low,1,3500, 36 months,1,small_business,3,Low,1,Bad Loan,1,10.65,B,2,9.03,3041.77,2202.94,311.53,114.01,409000004527,31-Oct-17,Indiaforensic VISA ACQ INT271017,,1782.00,-547641590.59,Belousov,705,France,106648.58,0,1,0
4529,2011,0.5,RENT,1,Low,1,13000, 36 months,1,debt_consolidation,6,Low,1,Good Loan,0,7.9,A,1,17.03,13554.22,13000,0,406.78,409000004528,1-Nov-17,Indiaforensic RUPAY POS ACQ01111,,2784880.77,-544856709.82,McCane,714,Spain,50899.91,0,1,0
4530,2011,4,RENT,1,Low,1,20000, 60 months,2,debt_consolidation,6,Low,1,Good Loan,0,12.69,B,2,29.26,25565.81372,20000,0,451.9,409000004529,1-Nov-17,Indiaforensic VISA ACQ DOM011117,,1003329.66,-543853380.16,Parry-Okeden,664,France,115452.51,0,1,0
4531,2011,3,MORTGAGE,3,Low,1,12000, 60 months,2,debt_consolidation,6,Low,1,Good Loan,0,11.71,B,2,13.55,15580.13334,12000,0,265.18,409000004530,1-Nov-17,Indiaforensic MASTER ACQ DOM0111,,527711.44,-543325668.72,Hudson,697,Germany,64139.10,0,1,0
4532,2011,7,MORTGAGE,3,Low,1,4000, 36 months,1,debt_consolidation,6,Low,1,Good Loan,0,7.9,A,1,6.6,4268.74,4000,0,125.17,409000004531,1-Nov-17,Indiaforensic MAESTRO ACQ DOM011,,182961.85,-543142706.87,Marsden,609,France,22030.72,0,1,0
4533,2011,3,RENT,1,Medium,2,7500, 36 months,1,car,2,Low,1,Good Loan,0,12.69,B,2,7.87,9053.006853,7500,0,251.59,409000004532,1-Nov-17,TRANSFER TO  Indiaforensic SERVI,"5,100,000.00",,-548242706.87,Manfrin,548,Spain,38434.73,0,1,0
4534,2011,10,MORTGAGE,3,Low,1,35000, 36 months,1,debt_consolidation,6,High,2,Good Loan,0,18.25,D,4,14.42,36544.01,35000,0,1269.73,409000004533,2-Nov-17,Indiaforensic RUPAY POS ACQ02111,,3558426.71,-544684280.16,Ch'ang,850,Spain,42774.84,0,1,0
4535,2011,10,RENT,1,Low,1,12000, 60 months,2,medical,9,High,2,Bad Loan,1,14.27,C,3,23.97,279.71,137.62,0,280.91,409000004534,2-Nov-17,Indiaforensic VISA ACQ DOM021117,,823242.09,-543861038.07,Clark,656,France,158973.77,0,1,0
4536,2011,6,RENT,1,Low,1,16500, 60 months,2,debt_consolidation,6,Low,1,Good Loan,0,11.71,B,2,5.81,19762.05,16500,0,364.62,409000004535,2-Nov-17,Indiaforensic MASTER ACQ DOM0211,,354992.38,-543506045.69,Aldrich,727,Germany,34551.35,0,1,0
4537,2011,6,OWN,2,Low,1,8000, 36 months,1,debt_consolidation,6,Low,1,Good Loan,0,12.69,B,2,7.67,8880.8,8000,0,268.36,409000004536,2-Nov-17,Indiaforensic MAESTRO ACQ DOM021,,197238.22,-543308807.47,Khan,642,France,101515.76,0,1,0
4538,2011,10,MORTGAGE,3,Low,1,25000, 60 months,2,debt_consolidation,6,High,2,Good Loan,0,21.67,F,6,16.92,40358.99,25000,0,685.8,409000004537,2-Nov-17,TRF TO  Indiaforensic SERVICES I,"4,900,000.00",,-548208807.47,Murray,710,Spain,9561.73,0,1,0
4539,2011,2,MORTGAGE,3,Low,1,15000, 36 months,1,home_improvement,7,Low,1,Good Loan,0,6.03,A,1,4.72,15617.02,15000,0,456.54,409000004538,3-Nov-17,Indiaforensic RUPAY POS ACQ03111,,2628094.97,-545580712.50,Anayolisa,710,Spain,168313.17,0,1,0
4540,2011,5,MORTGAGE,3,Low,1,10000, 36 months,1,major_purchase,8,Low,1,Good Loan,0,11.71,B,2,4.25,10656.87,10000,0,330.76,409000004539,3-Nov-17,Indiaforensic VISA ACQ DOM031117,,809481.07,-544771231.43,Shillito,718,France,55100.09,0,1,0
4541,2011,10,OWN,2,Low,1,35000, 60 months,2,debt_consolidation,6,High,2,Good Loan,0,20.89,F,6,9.56,47191.54,26380.82,0,944.71,409000004540,3-Nov-17,Indiaforensic MASTER ACQ DOM0311,,549490.13,-544221741.30,McMillan,586,Germany,31830.06,0,1,0
4542,2011,2,RENT,1,Low,1,2500, 36 months,1,moving,10,High,2,Good Loan,0,16.77,D,4,23.02,3132.81,2500,0,88.85,409000004541,3-Nov-17,Indiaforensic MAESTRO ACQ DOM031,,204166.75,-544017574.55,Howells,617,Spain,71519.40,0,1,0
4543,2011,10,MORTGAGE,3,Low,1,9750, 36 months,1,debt_consolidation,6,High,2,Good Loan,0,14.65,C,3,20.21,12105.56028,9750,0,336.32,409000004542,3-Nov-17,Indiaforensic MASTER ACQ DOM0311,,99.35,-544017475.20,Stewart,630,France,32599.35,0,1,0
4544,2011,2,RENT,1,Medium,2,9000, 36 months,1,moving,10,Low,1,Good Loan,0,7.51,A,1,0.16,10078.70945,9000,0,280,409000004543,3-Nov-17,Indiaforensic MASTER ACQ DOM0311,,99.50,-544017375.70,Ikechukwu,791,Germany,139946.68,0,1,0
4545,2011,6,RENT,1,Low,1,17500, 60 months,2,debt_consolidation,6,High,2,Good Loan,0,19.03,E,5,11.59,25880.28837,17500,0,454.25,409000004544,3-Nov-17,TRF TO  Indiaforensic SERVICES I,"4,200,000.00",,-548217375.70,Repina,673,Spain,110468.51,0,1,0
4546,2011,6.05,MORTGAGE,3,Low,1,5000, 36 months,1,credit_card,1,Low,1,Good Loan,0,7.9,A,1,11.11,5631.53137,5000,0,156.46,409000004545,6-Nov-17,Indiaforensic RUPAY POS ACQ04111,,2875739.03,-545341636.67,Cox,477,Germany,74042.00,0,1,0
4547,2011,3,MORTGAGE,3,Low,1,2700, 36 months,1,renewable_energy,13,Low,1,Bad Loan,1,7.9,A,1,26.82,1709.51,1338.99,90.71,84.49,409000004546,6-Nov-17,Indiaforensic VISA ACQ DOM041117,995,,-545342631.67,Lo,662,France,151871.84,0,1,0
4548,2011,10,MORTGAGE,3,Low,1,6000, 36 months,1,wedding,5,High,2,Good Loan,0,13.49,C,3,3.76,7158.53,6000,0,203.59,409000004547,6-Nov-17,Indiaforensic MASTER ACQ DOM0411,,384500.95,-544958130.72,Grant,850,Germany,199693.84,0,1,0
4549,2011,4,MORTGAGE,3,Low,1,9000, 36 months,1,home_improvement,7,Low,1,Good Loan,0,6.62,A,1,4.64,9789.22,9000,0,276.34,409000004548,6-Nov-17,Indiaforensic MAESTRO ACQ DOM041,,179231.65,-544778899.07,Stevenson,635,France,58907.08,0,1,0
4550,2011,10,RENT,1,Low,1,1000, 36 months,1,other,4,Low,1,Good Loan,0,7.9,A,1,14.94,1125.535385,1000,0,31.3,409000004549,6-Nov-17,Indiaforensic RUPAY POS ACQ05111,,3126876.79,-541652022.28,Kauffmann,537,France,103799.77,0,1,0
4551,2011,4,RENT,1,Low,1,12000, 36 months,1,debt_consolidation,6,Low,1,Good Loan,0,6.62,A,1,10.75,13263.25346,12000,0,368.45,409000004550,6-Nov-17,Indiaforensic VISA ACQ DOM051117,,1064019.55,-540588002.73,Samsonova,579,France,93835.64,0,1,0
4552,2011,6.05,MORTGAGE,3,Low,1,2200, 36 months,1,other,4,Low,1,Good Loan,0,7.9,A,1,11.53,2450.969879,2200,0,68.84,409000004551,6-Nov-17,Indiaforensic RUPAY POS ACQ06111,,2846635.24,-537741367.49,Niu,651,Spain,156425.57,0,1,0
4553,2011,9,MORTGAGE,3,Low,1,23100, 60 months,2,debt_consolidation,6,High,2,Good Loan,0,15.96,C,3,17.98,27960.87,17823.64,0,561.26,409000004552,6-Nov-17,Indiaforensic VISA ACQ DOM061117,,1930509.29,-535810858.20,Bock,610,France,123723.83,0,1,0
4554,2011,0.5,RENT,1,Low,1,1200, 36 months,1,debt_consolidation,6,Low,1,Good Loan,0,12.69,B,2,2.36,1248.97,1200,0,40.26,409000004553,6-Nov-17,Indiaforensic MASTER ACQ DOM0611,,816844.68,-534994013.52,Barlow,581,France,199464.08,0,1,0
4555,2011,2,MORTGAGE,3,Low,1,14000, 36 months,1,other,4,Low,1,Good Loan,0,10.65,B,2,19.01,14909.68,14000,0,456.03,409000004554,6-Nov-17,Indiaforensic MAESTRO ACQ DOM061,,405388.48,-534588625.04,Stevenson,592,France,83084.33,0,1,0
4556,2011,2,MORTGAGE,3,Low,1,20000, 60 months,2,debt_consolidation,6,Low,1,Good Loan,0,10.65,B,2,19.29,24688.94556,20000,0,431.37,409000004555,6-Nov-17,TRF TO  Indiaforensic SERVICES I,"5,000,000.00",,-539588625.04,Kung,688,Spain,25488.43,0,1,0
4557,2011,3,MORTGAGE,3,Medium,2,21000, 36 months,1,debt_consolidation,6,Low,1,Good Loan,0,11.71,B,2,11.53,23415.4,20999.99,0,694.6,409000004556,6-Nov-17,TRF TO  Indiaforensic SERVICES I,"5,000,000.00",,-544588625.04,Nwankwo,681,France,9596.40,0,1,0
4558,2011,10,MORTGAGE,3,Low,1,16000, 60 months,2,debt_consolidation,6,High,2,Good Loan,0,18.25,D,4,23.25,17416.16,16000,0,408.48,409000004557,6-Nov-17,TRF TO  Indiaforensic SERVICES I,"3,000,000.00",,-547588625.04,Brewer,658,Germany,70370.24,0,1,0
4559,2011,10,RENT,1,Low,1,8000, 36 months,1,debt_consolidation,6,Low,1,Good Loan,0,8.9,A,1,14.38,9142.239599,8000,0,254.03,409000004558,7-Nov-17,Indiaforensic RUPAY POS ACQ07111,,2531661.05,-545056963.99,Ch'iu,792,France,86330.32,0,1,0
4560,2011,7,RENT,1,Low,1,5150, 36 months,1,debt_consolidation,6,Low,1,Good Loan,0,7.9,A,1,0,5800.514546,5150,0,161.15,409000004559,7-Nov-17,Indiaforensic VISA ACQ DOM071117,,924406.54,-544132557.45,Quinn,528,Germany,168507.68,0,1,0
4561,2011,9,MORTGAGE,3,Low,1,14000, 60 months,2,debt_consolidation,6,High,2,Good Loan,0,17.27,D,4,20.35,14790.8,14000,0,349.98,409000004560,7-Nov-17,Indiaforensic MASTER ACQ DOM0711,,440276.37,-543692281.08,Kodilinyechukwu,624,Spain,111605.90,0,1,0
4562,2011,3,RENT,1,Low,1,3500, 36 months,1,other,4,Low,1,Good Loan,0,6.62,A,1,4.21,3736.95,3500,0,107.47,409000004561,7-Nov-17,Indiaforensic MAESTRO ACQ DOM071,,154143.91,-543538137.17,Ifeanyichukwu,562,Germany,143317.42,0,1,0
4563,2011,6.05,OWN,2,Low,1,12000, 60 months,2,other,4,Low,1,Good Loan,0,12.69,B,2,4.8,13242.53,9174.13,0,271.14,409000004562,7-Nov-17,Indiaforensic VISA ACQ INT061117,,415.38,-543537721.79,Yermakova,678,Germany,27619.06,0,1,0
4564,2011,1,MORTGAGE,3,Medium,2,3000, 36 months,1,home_improvement,7,High,2,Good Loan,0,14.27,C,3,16.86,3670.929618,3000,0,102.93,409000004563,7-Nov-17,Indiaforensic MASTER ACQ INT 041,,42987.12,-543494734.67,Sullivan,705,Germany,146573.66,0,1,0
4565,2011,4,MORTGAGE,3,Low,1,30000, 36 months,1,small_business,3,High,2,Bad Loan,1,17.27,D,4,9.22,16102.2,10646.39,20.25,1073.62,409000004564,7-Nov-17,TRF TO  Indiaforensic SERVICES I,"4,000,000.00",,-547494734.67,Grant,650,Germany,69055.45,0,1,0
4566,2011,6,RENT,1,Low,1,6000, 36 months,1,debt_consolidation,6,Low,1,Good Loan,0,10.65,B,2,17.46,6552.97,6000,0,195.44,409000004565,8-Nov-17,Indiaforensic RUPAY POS ACQ08111,,2088114.74,-545406619.93,Jacka,593,Spain,54453.72,0,1,0
4567,2011,7,MORTGAGE,3,Low,1,14000, 60 months,2,debt_consolidation,6,Low,1,Good Loan,0,7.9,A,1,27.74,14114.36,11236.27,0,283.2,409000004566,8-Nov-17,Indiaforensic VISA ACQ DOM081117,,866885.35,-544539734.58,Tsai,652,France,33524.60,0,1,0
4568,2011,2,MORTGAGE,3,Low,1,9000, 36 months,1,credit_card,1,Low,1,Good Loan,0,12.69,B,2,19.52,10697.56,9000,0,301.91,409000004567,8-Nov-17,Indiaforensic MAESTRO ACQ DOM081,,162344.10,-544377390.48,Emery,554,Spain,135083.73,0,1,0
4569,2011,10,MORTGAGE,3,Low,1,13700, 36 months,1,credit_card,1,Low,1,Good Loan,0,6.03,A,1,25.13,14998.00716,13700,0,416.97,409000004568,8-Nov-17,TRF TO  Indiaforensic SERVICES I,"3,800,000.00",,-548177390.48,Piccio,584,Germany,137439.34,0,1,0
4570,2011,3,RENT,1,Low,1,28000, 36 months,1,debt_consolidation,6,Low,1,Good Loan,0,7.9,A,1,3.8,31103.79,28000,0,876.13,409000004569,9-Nov-17,Indiaforensic RUPAY POS ACQ09111,,3932793.57,-544244596.91,Sanders,516,France,11205.50,0,1,0
4571,2011,2,MORTGAGE,3,Low,1,9950, 36 months,1,debt_consolidation,6,High,2,Bad Loan,1,15.27,C,3,23.54,7616.59,5524.09,15.15,346.24,409000004570,9-Nov-17,Indiaforensic VISA ACQ DOM091117,,1099840.07,-543144756.84,Sharp,789,Germany,60176.10,0,1,0
4572,2011,6,MORTGAGE,3,Low,1,35000, 60 months,2,debt_consolidation,6,Low,1,Good Loan,0,11.71,B,2,11.41,41223.12,35000,0,773.44,409000004571,9-Nov-17,Indiaforensic MASTER ACQ DOM0911,,790612.98,-542354143.86,Myers,598,Germany,29552.70,0,1,0
4573,2011,10,MORTGAGE,3,Low,1,12000, 60 months,2,debt_consolidation,6,Low,1,Bad Loan,1,12.69,B,2,17.65,269.61,143.43,0,271.14,409000004572,9-Nov-17,Indiaforensic MAESTRO ACQ DOM091,,177518.90,-542176624.96,Campbell,669,Germany,188795.85,0,1,0
4574,2011,0.5,OWN,2,Low,1,6000, 36 months,1,car,2,Low,1,Good Loan,0,6.03,A,1,0,6573.818445,6000,0,182.62,409000004573,9-Nov-17,TRF TO  Indiaforensic SERVICES I,"4,000,000.00",,-546176624.96,Abbott,645,France,11638.17,0,1,0
4575,2011,10,OWN,2,Low,1,15000, 60 months,2,credit_card,1,High,2,Bad Loan,1,19.91,E,5,20.99,3471.87,1251.52,302.99,396.66,409000004574,9-Nov-17,TRF TO  Indiaforensic SERVICES I,"2,000,000.00",,-548176624.96,Preston,659,France,93155.75,0,1,0
4576,2011,0.5,OWN,2,Low,1,21750, 60 months,2,debt_consolidation,6,Low,1,Bad Loan,1,12.42,B,2,21.88,11017.25,3340.47,5166.05,488.45,409000004575,9-Nov-17,ICA-17825 MAESTRO DOM 091,,30594.25,-548146030.71,Atherton,833,Germany,48986.18,0,1,0
4577,2011,2,RENT,1,High,3,24000, 36 months,1,debt_consolidation,6,High,2,Good Loan,0,14.27,C,3,15.23,29627.65849,24000,0,823.42,409000004576,9-Nov-17,ICA-17825 MAESTRO DOM 091,"30,594.25",,-548176624.96,Fanucci,697,Spain,116951.10,0,1,0
4578,2011,4,RENT,1,Low,1,11200, 36 months,1,debt_consolidation,6,High,2,Good Loan,0,14.27,C,3,9.76,13438.27,11200,0,384.26,409000004577,9-Nov-17,Indiaforensic MAESTRO ACQ DOM091,,25588.73,-548151036.23,Evans,580,Germany,137041.26,0,1,0
4579,2011,4,MORTGAGE,3,Low,1,6000, 60 months,2,car,2,High,2,Bad Loan,1,17.27,D,4,10.28,6471.57,3400.63,489.25,149.99,409000004578,10-Nov-17,Indiaforensic VISA ACQ DOM101117,,865142.69,-547285893.54,Cookson,691,France,44653.50,0,1,0
4580,2011,3,MORTGAGE,3,Low,1,6500, 36 months,1,home_improvement,7,Low,1,Good Loan,0,8.9,A,1,19.71,7428.975943,6500,0,206.4,409000004579,10-Nov-17,Indiaforensic MASTER ACQ DOM1011,,339096.57,-546946796.97,Nnachetam,534,France,104035.41,0,1,0
4581,2011,0.5,RENT,1,Low,1,28000, 60 months,2,credit_card,1,High,2,Good Loan,0,14.27,C,3,19.86,32715.68,21826.88,0,655.44,409000004580,10-Nov-17,Indiaforensic MAESTRO ACQ DOM101,,130838.79,-546815958.18,Johnstone,478,France,110593.62,0,1,0
4582,2011,6,MORTGAGE,3,Medium,2,35000, 36 months,1,home_improvement,7,Low,1,Good Loan,0,12.42,B,2,2.92,42099.93252,35000,0,1169.54,409000004581,10-Nov-17,Indiaforensic RUPAY POS ACQ10111,,2424668.42,-544391289.76,Hort,572,France,36099.70,0,1,0
4583,2011,6,MORTGAGE,3,Medium,2,14000, 36 months,1,home_improvement,7,Low,1,Good Loan,0,6.03,A,1,8.48,14819.4,14000,0,426.1,409000004582,10-Nov-17,TRF TO  Indiaforensic SERVICES I,"3,800,000.00",,-548191289.76,Johnson,501,France,12470.30,0,1,0
4584,2011,6,MORTGAGE,3,Medium,2,23000, 60 months,2,other,4,Low,1,Bad Loan,1,10.65,B,2,6.4,21022.5,13452.98,1802.13,496.08,409000004583,13-Nov-17,Indiaforensic MASTER ACQ DOM1111,,451076.06,-547740213.70,Zaytseva,624,Spain,95403.41,0,1,0
4585,2011,5,MORTGAGE,3,Low,1,7000, 36 months,1,home_improvement,7,Low,1,Good Loan,0,6.62,A,1,4.41,7736.092664,7000,0,214.93,409000004584,13-Nov-17,Indiaforensic MAESTRO ACQ DOM111,,179292.50,-547560921.20,Sorokina,595,France,151757.81,0,1,0
4586,2011,6.05,MORTGAGE,3,Low,1,5000, 36 months,1,home_improvement,7,Low,1,Good Loan,0,6.03,A,1,13.26,5437.24,5000,0,152.18,409000004585,13-Nov-17,Indiaforensic MASTER ACQ DOM1311,,789849.05,-546771072.15,Diehl,603,France,47536.46,0,1,0
4587,2011,10,MORTGAGE,3,Low,1,10800, 36 months,1,home_improvement,7,Low,1,Bad Loan,1,7.51,A,1,17.06,3020.4,2474.11,0,336,409000004586,13-Nov-17,Indiaforensic MAESTRO ACQ DOM131,,360256.07,-546410816.08,Onuchukwu,602,France,101274.17,0,1,0
4588,2011,0.5,OWN,2,Low,1,5375, 36 months,1,debt_consolidation,6,High,2,Good Loan,0,13.49,C,3,18.23,6562.731985,5375,0,182.38,409000004587,13-Nov-17,Indiaforensic VISA ACQ DOM131117,,2077096.25,-544333719.83,Osonduagwuike,500,France,140268.45,0,1,0
4589,2011,0.5,RENT,1,Low,1,15000, 60 months,2,small_business,3,High,2,Good Loan,0,16.77,D,4,20.5,18118.99,11213.94,0,370.94,409000004588,13-Nov-17,Indiaforensic RUPAY POS ACQ13111,,2281139.46,-542052580.37,Mead,422,France,11663.09,0,1,0
4590,2011,10,MORTGAGE,3,Medium,2,7500, 36 months,1,credit_card,1,Low,1,Good Loan,0,8.9,A,1,7.85,7906.26,7500,0,238.15,409000004589,13-Nov-17,Indiaforensic RUPAY POS ACQ12111,,2579831.25,-539472749.12,Stewart,615,France,150784.29,0,1,0
4591,2011,10,MORTGAGE,3,Low,1,15000, 60 months,2,small_business,3,High,2,Good Loan,0,19.03,E,5,10.72,19043.64,15000,0,389.36,409000004590,13-Nov-17,Indiaforensic VISA ACQ DOM111117,,940348.08,-538532401.04,Thomson,635,France,119400.08,0,1,0
4592,2011,9,MORTGAGE,3,Low,1,12800, 60 months,2,home_improvement,7,High,2,Good Loan,0,16.77,D,4,14.22,14394.3,12800,0,316.54,409000004591,13-Nov-17,Indiaforensic RUPAY POS ACQ11111,,2300034.66,-536232366.38,Goliwe,711,France,126188.42,0,1,0
4593,2011,6,RENT,1,Low,1,20000, 36 months,1,moving,10,Low,1,Good Loan,0,8.9,A,1,7.8,22609.59,20000,0,635.07,409000004592,14-Nov-17,TRFF TO  Indiaforensic SERVICES,"12,000,000.00",,-548232366.38,Lori,834,France,89983.02,0,1,0
4594,2011,10,RENT,1,Low,1,4000, 36 months,1,debt_consolidation,6,Low,1,Good Loan,0,8.9,A,1,15.84,4500.91,4000,0,127.02,409000004593,14-Nov-17,Indiaforensic VISA ACQ DOM141117,,962151.96,-547270214.42,Onwuamaeze,633,France,29761.29,0,1,0
4595,2011,1,RENT,1,Low,1,5150, 60 months,2,debt_consolidation,6,High,2,Good Loan,0,18.64,E,5,17.59,6613.61,3923.61,0,132.58,409000004594,14-Nov-17,Indiaforensic RUPAY POS ACQ14111,,1452797.52,-545817416.90,Butusov,650,France,27073.81,0,1,0
4596,2011,6,RENT,1,Low,1,5000, 36 months,1,major_purchase,8,Low,1,Good Loan,0,12.69,B,2,12.65,5782.41,5000,0,167.73,409000004595,14-Nov-17,Indiaforensic MASTER ACQ DOM1411,,508790.11,-545308626.79,Rogers,743,Germany,96399.67,0,1,0
4597,2011,6.05,RENT,1,Low,1,10000, 36 months,1,house,12,Low,1,Good Loan,0,6.62,A,1,2.4,10773.46,10000,0,307.04,409000004596,14-Nov-17,Indiaforensic MAESTRO ACQ DOM141,,185970.92,-545122655.87,Nicholson,567,France,45422.89,0,1,0
4598,2011,8,MORTGAGE,3,Medium,2,8000, 36 months,1,credit_card,1,Low,1,Good Loan,0,12.69,B,2,20.14,9157.6,8000,0,268.36,409000004597,14-Nov-17,TRF TO  Indiaforensic SERVICES I,"2,400,000.00",,-547522655.87,Rossi,706,Germany,108699.59,0,1,0
4599,2011,4,RENT,1,Low,1,8000, 36 months,1,car,2,Low,1,Good Loan,0,12.42,B,2,4.74,9618.583664,8000,0,267.33,409000004598,15-Nov-17,Indiaforensic MASTER ACQ DOM1511,,503882.25,-547018773.62,Hall,638,France,38967.29,0,1,0
4600,2011,7,RENT,1,Low,1,12000, 36 months,1,major_purchase,8,Low,1,Good Loan,0,9.91,B,2,18.32,13780.41,12000,0,386.7,409000004599,15-Nov-17,Indiaforensic MAESTRO ACQ DOM151,,141612.95,-546877160.67,Huddart,641,France,116466.19,0,1,0
4601,2011,10,MORTGAGE,3,Medium,2,4500, 36 months,1,renewable_energy,13,Low,1,Good Loan,0,6.62,A,1,4.16,4961.483091,4500,0,138.17,409000004600,15-Nov-17,Indiaforensic VISA ACQ DOM151117,,1141772.69,-545735387.98,Chinomso,574,France,17993.43,0,1,0
4602,2011,8,RENT,1,Low,1,8875, 36 months,1,major_purchase,8,Low,1,Good Loan,0,10.65,B,2,22.15,10405.75112,8875,0,289.09,409000004601,15-Nov-17,Indiaforensic RUPAY POS ACQ15111,,3790971.41,-541944416.57,Shaw,642,Germany,43250.54,0,1,0
4603,2011,2,RENT,1,Low,1,12800, 60 months,2,credit_card,1,High,2,Good Loan,0,17.27,D,4,15.12,16859.51,12800,0,319.98,409000004602,15-Nov-17,TRF TO  Indiaforensic SERVICES I,"4,000,000.00",,-545944416.57,Hargreaves,722,Spain,125240.80,0,1,0
4604,2011,7,MORTGAGE,3,Low,1,10600, 36 months,1,debt_consolidation,6,High,2,Good Loan,0,15.96,C,3,16.03,12853.17,10600,0,372.46,409000004603,15-Nov-17,TRF TO  Indiaforensic SERVICES I,"2,000,000.00",,-547944416.57,Swain,623,France,191415.94,0,1,0
4605,2011,4,RENT,1,Low,1,1500, 36 months,1,debt_consolidation,6,Low,1,Good Loan,0,6.03,A,1,28.34,1568.92,1500,0,45.66,409000004604,15-Nov-17,CDUTWL00100000943866-2017,10,,-547944426.57,Butcher,681,France,90860.97,0,1,0
4606,2011,6.05,RENT,1,Low,1,6250, 36 months,1,credit_card,1,Low,1,Good Loan,0,9.91,B,2,11.85,7240.105211,6250,0,201.41,409000004605,16-Nov-17,CDUTWL00100000943866-2017,10,,-547944436.57,Stone,530,France,141872.52,0,1,0
4607,2011,10,MORTGAGE,3,Low,1,7500, 36 months,1,credit_card,1,Low,1,Good Loan,0,12.69,B,2,13.59,9053.694574,7500,0,251.59,409000004606,16-Nov-17,COMMISSION FOR Indiaforensic 201,,0.08,-547944436.49,Allan,797,France,49418.87,0,1,0
4608,2011,6,MORTGAGE,3,Low,1,7800, 36 months,1,debt_consolidation,6,Low,1,Good Loan,0,7.9,A,1,7.42,8400.03,7800,0,244.07,409000004607,16-Nov-17,OIndiaforensic VISA ACQ DOM16111,,833770.12,-547110666.37,Wang,653,France,170426.65,0,1,0
4609,2011,4,MORTGAGE,3,Medium,2,20000, 36 months,1,debt_consolidation,6,Low,1,Good Loan,0,7.9,A,1,5.26,22527.15995,20000,0,625.81,409000004608,16-Nov-17,Indiaforensic RUPAY POS ACQ16111,,2754173.16,-544356493.21,Colombo,850,Germany,51016.02,0,1,0
4610,2011,10,RENT,1,Low,1,10000, 36 months,1,debt_consolidation,6,High,2,Good Loan,0,14.27,C,3,23.43,12347.07981,10000,0,343.09,409000004609,16-Nov-17,RNJTWL00100000887265-2017,10,,-544356503.21,McKay,581,Spain,81175.25,0,1,0
4611,2011,5,MORTGAGE,3,Low,1,2000, 36 months,1,other,4,Low,1,Good Loan,0,7.9,A,1,21.23,2251.886323,2000,0,62.59,409000004610,16-Nov-17,BLRTWL00100001022696-2017,10,,-544356513.21,Brient,589,Germany,99106.97,0,1,0
4612,2011,3,MORTGAGE,3,Low,1,5000, 36 months,1,home_improvement,7,Low,1,Good Loan,0,10.65,B,2,2.3,5878.838646,5000,0,162.87,409000004611,16-Nov-17,Indiaforensic MASTER ACQ DOM1611,,527480.51,-543829032.70,Yin,555,Germany,79134.78,0,1,0
4613,2011,4,RENT,1,Low,1,2400, 36 months,1,credit_card,1,Low,1,Good Loan,0,7.9,A,1,15.23,2702.74996,2400,0,75.1,409000004612,16-Nov-17,Indiaforensic MAESTRO ACQ DOM161,,205195.05,-543623837.65,Bellucci,748,France,163550.58,0,1,0
4614,2011,4,MORTGAGE,3,Low,1,10400, 36 months,1,debt_consolidation,6,Low,1,Good Loan,0,8.9,A,1,5.25,11251.52,10400,0,330.24,409000004613,16-Nov-17,TRF TO  Indiaforensic SERVICES I,"4,600,000.00",,-548223837.65,Duncan,745,France,67769.94,0,1,0
4615,2011,6,RENT,1,Low,1,25000, 36 months,1,debt_consolidation,6,Low,1,Good Loan,0,12.69,B,2,19.06,30183.85924,25000,0,838.63,409000004614,17-Nov-17,COMMISSION FOR Indiaforensic 201,,0.23,-548223837.42,Pirozzi,730,France,126592.01,0,1,0
4616,2011,6,RENT,1,Low,1,9200, 36 months,1,debt_consolidation,6,Low,1,Good Loan,0,6.62,A,1,20.84,10167.94209,9200,0,282.48,409000004615,17-Nov-17,Indiaforensic MASTER ACQ DOM1711,,401149.21,-547822688.21,Findlay,565,France,89602.81,0,1,0
4617,2011,6.05,RENT,1,Low,1,8450, 36 months,1,debt_consolidation,6,Low,1,Good Loan,0,11.71,B,2,16.69,10059.35752,8450,0,279.5,409000004616,17-Nov-17,Indiaforensic MAESTRO ACQ DOM171,,152943.44,-547669744.77,King,778,France,179421.84,0,1,0
4618,2011,10,MORTGAGE,3,Low,1,12400, 36 months,1,debt_consolidation,6,Low,1,Good Loan,0,7.51,A,1,25.98,13885.76363,12400,0,385.78,409000004617,17-Nov-17,Indiaforensic VISA ACQ DOM171117,,715158.68,-546954586.09,Iweobiegbunam,812,France,156906.15,0,1,0
4619,2011,3,RENT,1,Low,1,8000, 36 months,1,small_business,3,Low,1,Bad Loan,1,8.9,A,1,9.24,8000.81,6873.84,0,254.03,409000004618,17-Nov-17,Indiaforensic RUPAY POS ACQ17111,,2384903.31,-544569682.78,Tucker,526,France,168486.02,0,1,0
4620,2011,4,OWN,2,Low,1,3600, 36 months,1,home_improvement,7,High,2,Good Loan,0,13.49,C,3,16.46,4293.16,3600,0,122.15,409000004619,17-Nov-17,TRF TO  Indiaforensic SERVICES I,"3,000,000.00",,-547569682.78,Izmailova,708,France,132730.07,0,1,0
4621,2011,7,RENT,1,Low,1,2000, 36 months,1,debt_consolidation,6,Low,1,Good Loan,0,11.71,B,2,14.63,2397.167618,2000,0,66.16,409000004620,18-Nov-17,Indiaforensic VISA ACQ DOM181117,,852014.36,-546717668.42,Meng,680,France,39057.67,0,1,0
4622,2011,1,MORTGAGE,3,Low,1,16000, 60 months,2,debt_consolidation,6,High,2,Bad Loan,1,15.27,C,3,15.13,9188.49,4958.03,0,382.92,409000004621,18-Nov-17,Indiaforensic RUPAY POS ACQ18111,,2016278.85,-544701389.57,Liang,567,Spain,174606.35,0,1,0
4623,2011,1,RENT,1,Low,1,16000, 60 months,2,other,4,High,2,Good Loan,0,16.77,D,4,16.65,21882.37445,16000,0,395.67,409000004622,20-Nov-17,TRF TO  Indiaforensic SERVICES I,"3,500,000.00",,-548201389.57,Hutchinson,564,Spain,79259.77,0,1,0
4624,2011,3,RENT,1,Low,1,1200, 36 months,1,debt_consolidation,6,Low,1,Bad Loan,1,11.71,B,2,6.54,1059.15,804.03,56.53,39.7,409000004623,20-Nov-17,Indiaforensic MASTER ACQ DOM1811,,393355.67,-547808033.90,Shen,709,France,168515.61,0,1,0
4625,2011,6.05,MORTGAGE,3,Low,1,4000, 36 months,1,car,2,Low,1,Bad Loan,1,6.62,A,1,12.49,1470.48,1243.57,0,122.82,409000004624,20-Nov-17,Indiaforensic MAESTRO ACQ DOM181,,150324.00,-547657709.90,Okwuoma,629,France,161125.67,0,1,0
4626,2011,6.05,MORTGAGE,3,Low,1,3000, 36 months,1,debt_consolidation,6,Low,1,Good Loan,0,6.03,A,1,11.03,3286.821578,3000,0,91.31,409000004625,20-Nov-17,Indiaforensic MASTER ACQ DOM2011,,785159.52,-546872550.38,Chinwemma,510,France,77878.62,0,1,0
4627,2011,4,OWN,2,Low,1,16800, 36 months,1,debt_consolidation,6,Low,1,Good Loan,0,7.51,A,1,22.8,18670.66635,16800,0,522.67,409000004626,20-Nov-17,Indiaforensic MAESTRO ACQ DOM201,,270371.37,-546602179.01,Golubova,506,France,80823.02,0,1,0
4628,2011,2,MORTGAGE,3,Low,1,15000, 60 months,2,home_improvement,7,Low,1,Good Loan,0,11.71,B,2,5.28,19517.94129,15000,0,331.48,409000004627,20-Nov-17,Indiaforensic VISA ACQ DOM201117,,1865416.09,-544736762.92,Schiavone,605,France,119348.28,0,1,0
4629,2011,4,RENT,1,Low,1,8000, 60 months,2,other,4,Low,1,Bad Loan,1,12.42,B,2,2.08,4850.82,2992.41,11.34,179.66,409000004628,20-Nov-17,Indiaforensic RUPAY POS ACQ20111,,1760493.71,-542976269.21,Moore,650,Spain,178331.36,0,1,0
4630,2011,6.05,RENT,1,Low,1,12000, 36 months,1,debt_consolidation,6,High,2,Bad Loan,1,16.77,D,4,11.12,9758.01,6222.74,815.24,426.47,409000004629,20-Nov-17,Indiaforensic RUPAY POS ACQ19111,,1713072.91,-541263196.30,Graham,850,Germany,119174.88,0,1,0
4631,2011,10,MORTGAGE,3,Low,1,12000, 36 months,1,debt_consolidation,6,Low,1,Good Loan,0,6.62,A,1,7.88,13263.15784,12000,0,368.45,409000004630,20-Nov-17,Indiaforensic VISA ACQ INT181117,,108.79,-541263087.51,Amadi,489,Germany,82662.73,0,1,0
4632,2011,5,RENT,1,Low,1,12000, 36 months,1,debt_consolidation,6,Low,1,Good Loan,0,6.62,A,1,27.84,13250.43994,12000,0,368.45,409000004631,20-Nov-17,TRF TO  Indiaforensic SERVICES I,"3,000,000.00",,-544263087.51,McKay,659,Germany,40441.10,0,1,0
4633,2011,10,MORTGAGE,3,Low,1,32000, 36 months,1,debt_consolidation,6,High,2,Good Loan,0,19.03,E,5,4.55,38974.92,32000,0,1173.48,409000004632,20-Nov-17,ICA17825 Indiaforensic MASTER 18,,1968.00,-544261119.51,Fedorova,753,France,109881.71,0,1,0
4634,2011,10,MORTGAGE,3,High,3,34000, 60 months,2,other,4,High,2,Good Loan,0,19.91,E,5,15.59,44946.36,25774.64,0,899.1,409000004633,20-Nov-17,TRF TO  Indiaforensic SERVICES I,"4,000,000.00",,-548261119.51,Percy,477,Germany,157937.35,0,1,0
4635,2011,8,MORTGAGE,3,Low,1,14300, 36 months,1,debt_consolidation,6,Low,1,Bad Loan,1,9.91,B,2,25.11,9896.33,7205.81,634.09,460.82,409000004634,20-Nov-17,ICA17825 Indiaforensic MEST FEE1,434.93,,-548261554.44,Floyd,610,Spain,38276.84,0,1,0
4636,2011,4,RENT,1,Low,1,14000, 36 months,1,credit_card,1,Low,1,Good Loan,0,6.62,A,1,17.81,14918.93,14000,0,429.86,409000004635,21-Nov-17,Indiaforensic MASTER ACQ DOM2111,,278357.96,-547983196.48,Long,619,France,65222.48,0,1,0
4637,2011,10,RENT,1,Low,1,30000, 60 months,2,small_business,3,High,2,Good Loan,0,13.49,C,3,14.16,34483.2,23492.98,0,690.15,409000004636,21-Nov-17,Indiaforensic MAESTRO ACQ DOM211,,172616.87,-547810579.61,Castiglione,619,Germany,2181.94,0,1,0
4638,2011,10,MORTGAGE,3,Medium,2,35000, 60 months,2,debt_consolidation,6,High,2,Good Loan,0,19.03,E,5,18.06,47541.22089,35000,0,908.5,409000004637,21-Nov-17,Indiaforensic VISA ACQ DOM211117,,764567.01,-547046012.60,Melendez,758,France,156249.06,0,1,0
4639,2011,5,RENT,1,Low,1,9600, 36 months,1,debt_consolidation,6,High,2,Bad Loan,1,16.77,D,4,5.68,4495.8,2571.8,403.32,341.17,409000004638,21-Nov-17,Indiaforensic RUPAY POS ACQ21111,,1703279.51,-545342733.09,Mazzi,516,Germany,45591.23,0,1,0
4640,2011,0.5,RENT,1,Low,1,6800, 36 months,1,small_business,3,Low,1,Good Loan,0,7.51,A,1,21.74,7614.788843,6800,0,211.56,409000004639,21-Nov-17,TRF TO  Indiaforensic SERVICES I,"2,900,000.00",,-548242733.09,Kovaleva,789,France,79458.12,0,1,0
4641,2011,6,RENT,1,Low,1,5000, 36 months,1,major_purchase,8,Low,1,Good Loan,0,7.9,A,1,10.02,5630.968632,5000,0,156.46,409000004640,21-Nov-17,MASTERO ACQ INT 07-201117,,1582.43,-548241150.66,Gill,687,France,103042.20,0,1,0
4642,2011,1,RENT,1,Low,1,12000, 36 months,1,car,2,Low,1,Good Loan,0,11.71,B,2,17.81,14320.11497,12000,0,396.92,409000004641,22-Nov-17,1200505-20171122180515,10,,-548241160.66,Arcuri,485,Germany,70209.83,0,1,0
4643,2011,2,MORTGAGE,3,Low,1,15000, 36 months,1,debt_consolidation,6,Low,1,Good Loan,0,9.91,B,2,24.41,17399.36626,15000,0,483.38,409000004642,22-Nov-17,Indiaforensic VISA ACQ DOM221117,,913031.04,-547328129.62,Chukwuma,446,Germany,176743.51,0,1,0
4644,2011,3,MORTGAGE,3,Low,1,10000, 36 months,1,home_improvement,7,High,2,Bad Loan,1,13.49,C,3,4.76,9533.24,7854.38,133.12,339.31,409000004643,22-Nov-17,Indiaforensic RUPAY POS ACQ22111,,1781166.73,-545546962.89,Stevenson,597,France,10703.53,0,1,0
4645,2011,2,MORTGAGE,3,Low,1,35000, 36 months,1,small_business,3,High,2,Bad Loan,1,17.27,D,4,17.49,14101.95,7518.58,1594.79,1252.56,409000004644,22-Nov-17,Indiaforensic MASTER ACQ DOM2211,,384188.40,-545162774.49,Ponomarev,712,Spain,151425.82,0,1,0
4646,2011,2,RENT,1,Low,1,9000, 36 months,1,debt_consolidation,6,Low,1,Good Loan,0,12.42,B,2,3.05,10728.53324,9000,0,300.74,409000004645,22-Nov-17,Indiaforensic MAESTRO ACQ DOM221,,141779.02,-545020995.47,Gilroy,522,France,3894.34,0,1,0
4647,2011,0.5,MORTGAGE,3,Low,1,13750, 36 months,1,credit_card,1,Low,1,Good Loan,0,6.03,A,1,6.99,15065.08704,13750,0,418.49,409000004646,22-Nov-17,Indiaforensic VISA ACQ INT 22111,,14499.42,-545006496.05,Sidorov,805,Germany,28861.69,0,1,0
4648,2011,3,MORTGAGE,3,Low,1,12025, 36 months,1,credit_card,1,Low,1,Good Loan,0,10.65,B,2,16.13,14098.69442,12025,0,391.7,409000004647,22-Nov-17,TRF TO  Indiaforensic SERVICES I,"3,000,000.00",,-548006496.05,Bates,781,France,177703.15,0,1,0
4649,2011,0.5,RENT,1,Low,1,12000, 36 months,1,debt_consolidation,6,High,2,Good Loan,0,13.49,C,3,9.48,14412.52,12000,0,407.17,409000004648,23-Nov-17,Indiaforensic VISA ACQ DOM231117,,680833.92,-547325662.13,Fanucci,689,Spain,136649.80,0,1,0
4650,2011,2,MORTGAGE,3,Low,1,24000, 36 months,1,debt_consolidation,6,Low,1,Good Loan,0,7.51,A,1,11.55,26524.03,24000,0,746.66,409000004649,23-Nov-17,Indiaforensic RUPAY POS ACQ23111,,1681930.41,-545643731.72,Toscano,670,Germany,175894.24,0,1,0
4651,2011,7,MORTGAGE,3,Low,1,4800, 36 months,1,debt_consolidation,6,Low,1,Good Loan,0,6.03,A,1,3.1,5219.83,4800,0,146.1,409000004650,23-Nov-17,Indiaforensic VISA ACQ INT 22111,,11763.60,-545631968.12,Hearn,670,France,76257.46,0,1,0
4652,2011,10,RENT,1,Low,1,35000, 36 months,1,house,12,Low,1,Good Loan,0,8.9,A,1,9.53,40007.62815,35000,0,1111.37,409000004651,23-Nov-17,COMMISSION FOR Indiaforensic 201,,0.08,-545631968.04,Iroawuchi,524,Germany,193668.49,0,1,0
4653,2011,5,RENT,1,Low,1,23400, 60 months,2,debt_consolidation,6,High,2,Good Loan,0,21.67,F,6,10.65,30693.8,23400,0,641.9,409000004652,23-Nov-17,Indiaforensic MASTER ACQ CB 2311,"1,534.21",,-545633502.25,Martin,734,Spain,125671.29,0,1,0
4654,2011,0.5,OWN,2,Low,1,7000, 60 months,2,debt_consolidation,6,High,2,Good Loan,0,18.64,E,5,9.75,7966.55,7000,0,180.21,409000004653,23-Nov-17,TRF TO  Indiaforensic SERVICES I,"2,600,000.00",,-548233502.25,Sinclair,489,France,174098.28,0,1,0
4655,2011,10,MORTGAGE,3,Low,1,15000, 36 months,1,debt_consolidation,6,Low,1,Good Loan,0,6.03,A,1,14.63,16260.1,15000,0,456.54,409000004654,23-Nov-17,Indiaforensic MASTER ACQ DOM2311,,387749.05,-547845753.20,Swanson,578,Germany,187866.21,0,1,0
4656,2011,4,MORTGAGE,3,Low,1,12000, 60 months,2,home_improvement,7,Low,1,Good Loan,0,11.71,B,2,7.06,15403.68334,12000,0,265.18,409000004655,23-Nov-17,Indiaforensic MAESTRO ACQ DOM231,,181349.66,-547664403.54,Chinomso,622,Spain,100862.36,0,1,0
4657,2011,10,MORTGAGE,3,Low,1,14500, 60 months,2,debt_consolidation,6,High,2,Good Loan,0,14.27,C,3,29.43,18024.6,14500,0,339.43,409000004656,23-Nov-17,1093140-20171123202539,10,,-547664413.54,Fomin,843,France,10804.04,0,1,0
4658,2011,6.05,MORTGAGE,3,Medium,2,14975, 36 months,1,moving,10,Low,1,Good Loan,0,6.03,A,1,20.24,16407.30153,14975,0,455.78,409000004657,24-Nov-17,COMMISSION FOR Indiaforensic 201,,0.08,-547664413.46,McKay,687,France,170893.85,0,1,0
4659,2011,5,RENT,1,Low,1,14000, 60 months,2,small_business,3,High,2,Good Loan,0,21.67,F,6,2.66,17076.29,14000,0,384.05,409000004658,24-Nov-17,Indiaforensic RUPAY POS ACQ24111,,1842650.07,-545821763.39,Bergamaschi,700,Spain,22698.56,0,1,0
4660,2011,3,MORTGAGE,3,Low,1,14000, 36 months,1,debt_consolidation,6,High,2,Good Loan,0,16.29,D,4,19.93,17788.6468,14000,0,494.21,409000004659,24-Nov-17,Indiaforensic MASTER ACQ DOM2411,,341311.24,-545480452.15,Matveyeva,410,Germany,89822.48,0,1,0
4661,2011,0.5,OWN,2,Low,1,1500, 36 months,1,debt_consolidation,6,High,2,Bad Loan,1,16.29,D,4,8.97,647.26,368.12,64.84,52.96,409000004660,24-Nov-17,Indiaforensic MAESTRO ACQ DOM241,,163254.42,-545317197.73,Madukaego,537,France,175262.49,0,1,0
4662,2011,5,MORTGAGE,3,Low,1,16800, 60 months,2,other,4,High,2,Good Loan,0,18.25,D,4,13.41,23717.29458,16800,0,428.9,409000004661,24-Nov-17,Indiaforensic MASTER ACQ CB 2311,298.05,,-545317495.78,Ferri,780,France,15705.27,0,1,0
4663,2011,8,RENT,1,Medium,2,13000, 60 months,2,debt_consolidation,6,High,2,Good Loan,0,14.65,C,3,10.89,16994.27482,13000,0,306.89,409000004662,24-Nov-17,TRF TO  Indiaforensic SERVICES I,"2,900,000.00",,-548217495.78,Achebe,652,Spain,170025.43,0,1,0
4664,2011,10,OWN,2,Low,1,20000, 36 months,1,other,4,Low,1,Good Loan,0,7.9,A,1,16.66,21780.29,20000,0,625.81,409000004663,27-Nov-17,Indiaforensic MASTER ACQ DOM2711,,856205.30,-547361290.48,Mai,620,Germany,17242.79,0,1,0
4665,2011,0.5,RENT,1,Low,1,25000, 60 months,2,debt_consolidation,6,High,2,Good Loan,0,14.65,C,3,21.98,29507.15,19475.58,0,590.17,409000004664,27-Nov-17,Indiaforensic MAESTRO ACQ DOM271,,403069.17,-546958221.31,Davis,697,France,79734.23,0,1,0
4666,2011,10,RENT,1,Low,1,10000, 36 months,1,small_business,3,Low,1,Good Loan,0,8.9,A,1,6.49,11429.86151,10000,0,317.54,409000004665,27-Nov-17,Indiaforensic VISA ACQ DOM271117,,1785557.97,-545172663.34,Davey,786,France,92712.97,0,1,0
4667,2011,5,MORTGAGE,3,Medium,2,14000, 36 months,1,home_improvement,7,Low,1,Good Loan,0,6.03,A,1,5.17,15224.14,14000,0,426.1,409000004666,27-Nov-17,Indiaforensic RUPAY POS ACQ27111,,1485164.28,-543687499.06,Tsou,850,Germany,99689.48,0,1,0
4668,2011,0.5,MORTGAGE,3,Low,1,20000, 60 months,2,debt_consolidation,6,High,2,Good Loan,0,23.91,G,7,13.91,28658.04,14822.16,0,574.32,409000004667,27-Nov-17,Indiaforensic MASTER ACQ DOM2511,,376832.32,-543310666.74,Marino,749,Germany,93336.30,0,1,0
4669,2011,9,MORTGAGE,3,Low,1,14500, 60 months,2,debt_consolidation,6,High,2,Bad Loan,1,14.65,C,3,19.3,1026.66,501.8,0,342.3,409000004668,27-Nov-17,Indiaforensic MAESTRO ACQ DOM251,,188853.81,-543121812.93,Kerr,445,France,175893.53,0,1,0
4670,2011,1,RENT,1,Low,1,5850, 60 months,2,major_purchase,8,High,2,Bad Loan,1,17.58,D,4,13.12,1494.02,512.53,306.59,147.22,409000004669,27-Nov-17,Indiaforensic VISA ACQ DOM251117,,1589005.69,-541532807.24,Hsiao,443,Germany,42840.18,0,1,0
4671,2011,7,MORTGAGE,3,Low,1,4000, 36 months,1,other,4,High,2,Bad Loan,1,20.89,F,6,14.97,3440.65,2027.55,282.25,150.48,409000004670,27-Nov-17,Indiaforensic RUPAY POS ACQ25111,,1760014.41,-539772792.83,Graham,637,Germany,140298.24,0,1,0
4672,2011,0.5,RENT,1,Low,1,2400, 36 months,1,medical,9,Low,1,Good Loan,0,6.03,A,1,14.59,2616.391335,2400,0,73.05,409000004671,27-Nov-17,Indiaforensic RUPAY POS ACQ26111,,1887526.69,-537885266.14,Ejikemeifeuwa,616,Germany,144000.59,0,1,0
4673,2011,0.5,MORTGAGE,3,Low,1,19700, 36 months,1,debt_consolidation,6,Low,1,Good Loan,0,7.9,A,1,13.57,22124.96604,19700,0,616.42,409000004672,27-Nov-17,Indiaforensic VISA ACQ INT 26111,,7856.00,-537877410.14,Volkova,756,France,113408.11,0,1,0
4674,2011,6.05,RENT,1,Low,1,5800, 36 months,1,wedding,5,Low,1,Bad Loan,1,6.62,A,1,20.81,1825.27,439.86,1292.02,178.09,409000004673,28-Nov-17,TRF TO  Indiaforensic SERVICES I,"10,300,000.00",,-548177410.14,Wang,644,France,96420.58,0,1,0
4675,2011,5,OWN,2,Low,1,11100, 60 months,2,debt_consolidation,6,High,2,Good Loan,0,17.58,D,4,23.68,14452.68,11100,0,279.34,409000004674,28-Nov-17,Indiaforensic MASTER ACQ DOM2811,,407794.64,-547769615.50,Benjamin,850,Germany,125806.30,0,1,0
4676,2011,6,MORTGAGE,3,High,3,15000, 36 months,1,small_business,3,Low,1,Good Loan,0,8.9,A,1,2.05,17047.80312,15000,0,476.3,409000004675,28-Nov-17,Indiaforensic MAESTRO ACQ DOM281,,153847.32,-547615768.18,Ryrie,703,Germany,65720.92,0,1,0
4677,2011,8,MORTGAGE,3,Medium,2,12000, 60 months,2,debt_consolidation,6,High,2,Good Loan,0,18.25,D,4,12.51,12514.73,12000,0,306.36,409000004676,28-Nov-17,Indiaforensic VISA ACQ DOM281117,,965379.65,-546650388.53,Andreev,684,Spain,31002.03,0,1,0
4678,2011,2,MORTGAGE,3,Low,1,3000, 36 months,1,debt_consolidation,6,Low,1,Bad Loan,1,8.9,A,1,14.26,1802.72,1477.88,0,95.26,409000004677,28-Nov-17,Indiaforensic RUPAY POS ACQ28111,,6025.11,-546644363.42,Ts'ao,706,Germany,158248.71,0,1,0
4679,2011,1,RENT,1,Low,1,6000, 36 months,1,debt_consolidation,6,Low,1,Good Loan,0,6.03,A,1,10.65,6534.26,6000,0,182.62,409000004678,29-Nov-17,Indiaforensic MASTER ACQ DOM2911,,354944.21,-546289419.21,Frolov,580,Spain,94677.83,0,1,0
4680,2011,6.05,OWN,2,Low,1,2500, 36 months,1,debt_consolidation,6,Low,1,Good Loan,0,9.91,B,2,10.72,2898.589398,2500,0,80.57,409000004679,29-Nov-17,Indiaforensic MAESTRO ACQ DOM291,,114456.02,-546174963.19,Montemayor,777,Spain,17257.72,0,1,0
4681,2011,6.05,OWN,2,Low,1,6000, 36 months,1,debt_consolidation,6,Low,1,Good Loan,0,8.9,A,1,20.27,6857.602663,6000,0,190.52,409000004680,29-Nov-17,Indiaforensic VISA ACQ DOM291117,,930152.41,-545244810.78,Fu,676,Germany,101397.86,0,1,0
4682,2011,10,MORTGAGE,3,Low,1,12000, 36 months,1,debt_consolidation,6,Low,1,Good Loan,0,6.03,A,1,15.37,13147.61197,12000,0,365.23,409000004681,29-Nov-17,Indiaforensic RUPAY POS ACQ29111,,3552019.62,-541692791.16,Whitehead,708,France,84870.23,0,1,0
4683,2011,10,MORTGAGE,3,Low,1,12800, 60 months,2,debt_consolidation,6,High,2,Good Loan,0,18.64,E,5,12,16448.23,9756.56,0,329.51,409000004682,29-Nov-17,Indiaforensic VISA ACQ INT281117,,333.88,-541692457.28,Izuchukwu,809,France,183515.13,0,1,0
4684,2011,6,RENT,1,Low,1,9400, 36 months,1,debt_consolidation,6,Low,1,Bad Loan,1,8.9,A,1,8.91,4472.55,3611.74,0,298.49,409000004683,29-Nov-17,TRF TO  Indiaforensic SERVICES I,"6,500,000.00",,-548192457.28,Lai,588,France,75969.19,0,1,0
4685,2011,2,MORTGAGE,3,Low,1,27000, 60 months,2,other,4,High,2,Good Loan,0,19.42,E,5,14.51,34696.21,19936.31,0,706.65,409000004684,30-Nov-17,Indiaforensic MASTER ACQ DOM3011,,364592.88,-547827864.40,Herring,623,France,146379.30,0,1,0
4686,2011,7,RENT,1,Low,1,27500, 60 months,2,small_business,3,High,2,Good Loan,0,19.42,E,5,8.01,35960,20891.44,0,719.74,409000004685,30-Nov-17,Indiaforensic MAESTRO ACQ DOM301,,98741.56,-547729122.84,Duffy,537,Spain,127154.80,0,1,0
4687,2011,8,MORTGAGE,3,Low,1,20000, 36 months,1,debt_consolidation,6,Low,1,Good Loan,0,11.71,B,2,20.89,23746.78624,20000,0,661.52,409000004686,30-Nov-17,Indiaforensic VISA ACQ DOM301117,,663984.30,-547065138.54,Chiefo,536,Spain,2019.78,0,1,0
4688,2011,3,RENT,1,Low,1,15000, 36 months,1,credit_card,1,Low,1,Bad Loan,1,7.9,A,1,9.08,8457.87,6641.95,480.45,469.36,409000004687,30-Nov-17,TRF TO  Indiaforensic SERVICES I,"1,200,000.00",,-548265138.54,Fyodorov,769,France,197885.72,0,1,0
4689,2011,1,RENT,1,Low,1,7000, 36 months,1,debt_consolidation,6,Low,1,Good Loan,0,12.69,B,2,16.51,8347.336305,7000,0,234.82,409000004688,30-Nov-17,Indiaforensic RUPAY POS ACQ30111,,1629373.55,-546635764.99,Chu,690,France,138017.68,0,1,0
4690,2011,6,OWN,2,Low,1,12000, 60 months,2,debt_consolidation,6,High,2,Good Loan,0,15.27,C,3,16.33,14317.38,9296.49,0,287.19,409000004689,1-Dec-17,TRF TO  Indiaforensic SERVICES I,"1,600,000.00",,-548235764.99,Robertson,771,Spain,170984.97,0,1,0
4691,2011,10,MORTGAGE,3,Low,1,3000, 36 months,1,medical,9,Low,1,Good Loan,0,8.9,A,1,13.6,3426.786428,3000,0,95.26,409000004690,2-Dec-17,Indiaforensic VISA ACQ DOM011217,,691562.23,-547544202.76,Palmerston,497,Germany,55859.27,0,1,0
4692,2011,4,MORTGAGE,3,Low,1,10000, 36 months,1,home_improvement,7,Low,1,Good Loan,0,10.65,B,2,14.69,11724.24691,10000,0,325.74,409000004691,2-Dec-17,Indiaforensic RUPAY POS ACQ01121,,1284121.34,-546260081.42,Madukwe,622,Spain,4459.50,0,1,0
4693,2011,2,RENT,1,Medium,2,35000, 60 months,2,debt_consolidation,6,Low,1,Good Loan,0,12.69,B,2,13.32,44628.68998,35000,0,790.82,409000004692,2-Dec-17,Indiaforensic VISA ACQ DOM021217,,760475.50,-545499605.92,Chinedum,602,Spain,102135.92,0,1,0
4694,2011,10,MORTGAGE,3,Low,1,6000, 36 months,1,other,4,Low,1,Good Loan,0,6.03,A,1,10.42,6564.767742,6000,0,182.62,409000004693,2-Dec-17,Indiaforensic RUPAY POS ACQ02121,,1282956.61,-544216649.31,French,543,France,112771.95,0,1,0
4695,2011,5,MORTGAGE,3,Low,1,10000, 36 months,1,debt_consolidation,6,Low,1,Good Loan,0,6.62,A,1,9,10879.83,10000,0,307.04,409000004694,4-Dec-17,TRF TO  Indiaforensic SERVICES I,"4,000,000.00",,-548216649.31,Polyakov,520,Spain,32903.93,0,1,0
4696,2011,2,RENT,1,Low,1,16000, 60 months,2,debt_consolidation,6,High,2,Good Loan,0,20.89,F,6,8.04,23476.73098,16000,0,431.87,409000004695,4-Dec-17,Indiaforensic MASTER ACQ DOM0412,,913490.98,-547303158.33,Clements,669,France,162260.93,0,1,0
4697,2011,6,RENT,1,Low,1,4000, 36 months,1,debt_consolidation,6,High,2,Good Loan,0,13.49,C,3,21.21,4642.66,4000,0,135.73,409000004696,4-Dec-17,Indiaforensic MAESTRO ACQ DOM041,,415121.46,-546888036.87,Connor,631,Spain,87959.83,0,1,0
4698,2011,7,MORTGAGE,3,Medium,2,13000, 36 months,1,debt_consolidation,6,Low,1,Good Loan,0,12.69,B,2,10.64,15569.05646,13000,0,436.09,409000004697,4-Dec-17,Indiaforensic VISA ACQ DOM041217,,1797207.91,-545090828.96,Balashov,537,Germany,166476.95,0,1,0
4699,2011,6.05,MORTGAGE,3,Medium,2,20000, 36 months,1,small_business,3,Low,1,Good Loan,0,7.51,A,1,13.5,22396.83111,20000,0,622.22,409000004698,4-Dec-17,Indiaforensic RUPAY POS ACQ04121,,1268369.49,-543822459.47,Avdeeva,732,France,25438.87,0,1,0
4700,2011,5,MORTGAGE,3,Low,1,27000, 36 months,1,small_business,3,Low,1,Good Loan,0,7.9,A,1,7.78,30412.46197,27000,0,844.84,409000004699,4-Dec-17,Indiaforensic MASTER ACQ DOM0112,,353350.82,-543469108.65,Chester,844,Spain,157230.06,0,1,0
4701,2011,9,RENT,1,Medium,2,9000, 36 months,1,car,2,Low,1,Good Loan,0,8.9,A,1,14.11,10266.2313,9000,0,285.78,409000004700,4-Dec-17,Indiaforensic MAESTRO ACQ DOM011,,120371.56,-543348737.09,Hung,838,Spain,197305.91,0,1,0
4702,2011,7,RENT,1,Low,1,6000, 36 months,1,other,4,Low,1,Good Loan,0,11.71,B,2,7.56,6892.47,6000,0,198.46,409000004701,4-Dec-17,Indiaforensic MASTER ACQ DOM0212,,342311.21,-543006425.88,Tu,652,France,44435.76,0,1,0
4703,2011,7,MORTGAGE,3,Low,1,3100, 36 months,1,other,4,Low,1,Good Loan,0,7.9,A,1,10.14,3280.99,3100,0,97,409000004702,4-Dec-17,Indiaforensic MAESTRO ACQ DOM021,,209738.31,-542796687.57,Thompson,660,France,181051.99,0,1,0
4704,2011,2,MORTGAGE,3,Low,1,5000, 36 months,1,credit_card,1,Low,1,Good Loan,0,7.51,A,1,13.45,5513.21,5000,0,155.56,409000004703,4-Dec-17,Indiaforensic RUPAY POS ACQ03121,,1500418.09,-541296269.48,Jones,692,Spain,159069.37,0,1,0
4705,2011,10,MORTGAGE,3,Low,1,16000, 60 months,2,debt_consolidation,6,High,2,Bad Loan,1,19.91,E,5,18.38,11096.26,3479.07,3016.61,423.11,409000004704,4-Dec-17,Indiaforensic MASTER  CB DOM0112,"1,990.00",,-541298259.48,Li,588,France,155485.24,0,1,0
4706,2011,8,RENT,1,Medium,2,16800, 36 months,1,car,2,Low,1,Good Loan,0,12.42,B,2,17.34,19987.65597,16800,0,561.38,409000004705,5-Dec-17,TRF TO  Indiaforensic SERVICES I,"6,900,000.00",,-548198259.48,Denisova,533,Germany,43852.05,0,1,0
4707,2011,5,MORTGAGE,3,Low,1,5000, 36 months,1,debt_consolidation,6,Low,1,Good Loan,0,9.91,B,2,1.5,5699.63,5000,0,161.13,409000004706,5-Dec-17,Indiaforensic MASTER ACQ DOM0512,,482032.94,-547716226.54,Clogstoun,850,France,140071.57,0,1,0
4708,2011,10,MORTGAGE,3,Medium,2,12350, 36 months,1,credit_card,1,Low,1,Good Loan,0,6.62,A,1,3.23,13648.70336,12350,0,379.2,409000004707,5-Dec-17,Indiaforensic MAESTRO ACQ DOM051,,219581.09,-547496645.45,Tan,511,France,49089.36,0,1,0
4709,2011,10,RENT,1,Low,1,13000, 60 months,2,other,4,Low,1,Good Loan,0,8.9,A,1,16.9,13412.9,10380.08,0,269.23,409000004708,5-Dec-17,Indiaforensic VISA ACQ DOM051217,,884279.86,-546612365.59,Power,530,Spain,55893.37,0,1,0
4710,2011,1,RENT,1,Low,1,6000, 60 months,2,credit_card,1,High,2,Good Loan,0,17.27,D,4,20.45,8619.666071,6000,0,149.99,409000004709,5-Dec-17,Indiaforensic RUPAY POS ACQ05121,,2474803.35,-544137562.24,Harriman,554,France,192660.55,0,1,0
4711,2011,8,MORTGAGE,3,Low,1,3900, 36 months,1,debt_consolidation,6,Low,1,Good Loan,0,11.71,B,2,8,4533.77,3900,0,129,409000004710,5-Dec-17,TRF TO  Indiaforensic SERVICES I,"4,000,000.00",,-548137562.24,Benson,585,Germany,137028.51,0,1,0
4712,2011,3,MORTGAGE,3,Low,1,6400, 36 months,1,debt_consolidation,6,Low,1,Good Loan,0,7.51,A,1,12.03,7031.335693,6400,0,199.11,409000004711,6-Dec-17,Indiaforensic MASTER ACQ DOM0612,,309999.27,-547827562.97,Thornton,754,France,34430.16,0,1,0
4713,2011,9,MORTGAGE,3,Low,1,12000, 36 months,1,credit_card,1,Low,1,Good Loan,0,6.03,A,1,16.06,12876.38,12000,0,365.23,409000004712,6-Dec-17,Indiaforensic MAESTRO ACQ DOM061,,155221.71,-547672341.26,White,474,France,108409.17,0,1,0
4714,2011,3,MORTGAGE,3,Medium,2,8900, 36 months,1,other,4,Low,1,Good Loan,0,11.71,B,2,1.18,10594.7896,8900,0,294.38,409000004713,6-Dec-17,Indiaforensic VISA ACQ DOM061217,,746958.50,-546925382.76,Mackenzie,837,Germany,145325.32,0,1,0
4715,2011,4,MORTGAGE,3,Low,1,18000, 36 months,1,debt_consolidation,6,Low,1,Good Loan,0,8.9,A,1,9.79,18134.14,18000,0,571.56,409000004714,6-Dec-17,Indiaforensic RUPAY POS ACQ06121,,1457762.20,-545467620.56,Kalinina,567,France,81425.61,0,1,0
4716,2011,6,RENT,1,Low,1,16800, 36 months,1,debt_consolidation,6,High,2,Bad Loan,1,16.77,D,4,7.34,7092.85,4266.82,729.53,597.05,409000004715,6-Dec-17,TRF TO  Indiaforensic SERVICES I,"2,800,000.00",,-548267620.56,Bennet,800,Spain,51553.43,0,1,0
4717,2011,10,MORTGAGE,3,Low,1,15000, 36 months,1,other,4,Low,1,Good Loan,0,7.9,A,1,23.71,16895.28375,15000,0,469.36,409000004716,7-Dec-17,Indiaforensic MASTER ACQ DOM0612,,516976.57,-547750643.99,Hallahan,646,France,52795.15,0,1,0
4718,2011,6,MORTGAGE,3,Low,1,35000, 60 months,2,debt_consolidation,6,High,2,Bad Loan,1,19.91,E,5,13.65,28758.26,3715.34,19508.26,925.54,409000004717,7-Dec-17,Indiaforensic RUPAY POS ACQ07121,,1544044.93,-546206599.06,Martin,627,Germany,84270.09,0,1,0
4719,2011,10,MORTGAGE,3,Low,1,20000, 60 months,2,debt_consolidation,6,High,2,Bad Loan,1,15.96,C,3,20.29,23287.32,14622.92,0,485.94,409000004718,7-Dec-17,TRF TO  Indiaforensic SERVICES I,"2,000,000.00",,-548206599.06,Rivera,505,France,145011.62,0,1,0
4720,2011,10,MORTGAGE,3,Low,1,12000, 60 months,2,car,2,Low,1,Bad Loan,1,8.9,A,1,4.53,2601.33,1299.14,629.33,248.52,409000004719,7-Dec-17,Indiaforensic VISA ACQ INT 06121,,2527.42,-548204071.64,Chiawuotu,566,Germany,66245.44,0,1,0
4721,2011,10,MORTGAGE,3,Low,1,8575, 60 months,2,credit_card,1,Low,1,Good Loan,0,10.65,B,2,20.78,9195.39,6778.32,0,184.95,409000004720,8-Dec-17,Indiaforensic MASTER ACQ DOM0812,,619700.15,-547584371.49,Sergeyev,619,Germany,36446.74,0,1,0
4722,2011,5,RENT,1,Low,1,6000, 36 months,1,other,4,Low,1,Bad Loan,1,7.9,A,1,20.22,750.32,598.34,0,187.75,409000004721,8-Dec-17,Indiaforensic VISA ACQ DOM081217,,1635370.37,-545949001.12,Christie,757,France,137136.29,0,1,0
4723,2011,3,OWN,2,Low,1,7600, 36 months,1,wedding,5,Low,1,Good Loan,0,6.62,A,1,18.94,8399.108398,7600,0,233.35,409000004722,8-Dec-17,Indiaforensic RUPAY POS ACQ08121,,1619524.72,-544329476.40,Louis,648,France,117323.31,0,1,0
4724,2011,10,MORTGAGE,3,Low,1,35000, 60 months,2,debt_consolidation,6,High,2,Good Loan,0,18.64,E,5,22.72,52930.69432,35000,0,901.01,409000004723,8-Dec-17,Indiaforensic VISA ACQ INT 07121,,1920.84,-544327555.56,Iqbal,621,Spain,74157.71,0,1,0
4725,2011,2,RENT,1,Medium,2,10000, 36 months,1,debt_consolidation,6,Low,1,Good Loan,0,11.71,B,2,7.77,11905.21024,10000,0,330.76,409000004724,8-Dec-17,TRF TO  Indiaforensic SERVICES I,"3,900,000.00",,-548227555.56,Marino,543,Germany,104253.56,0,1,0
4726,2011,5,RENT,1,Medium,2,30000, 60 months,2,other,4,Low,1,Good Loan,0,10.65,B,2,15.17,37516.81629,30000,0,647.05,409000004725,11-Dec-17,Indiaforensic VISA ACQ DOM111217,,2117752.79,-546109802.77,Robertson,658,France,2748.72,0,1,0
4727,2011,10,RENT,1,Low,1,3000, 36 months,1,medical,9,Low,1,Good Loan,0,11.71,B,2,23.11,3555.857249,3000,0,99.23,409000004726,11-Dec-17,Indiaforensic RUPAY POS ACQ11121,,1215316.86,-544894485.91,Pai,633,Germany,195937.16,0,1,0
4728,2011,4,MORTGAGE,3,Medium,2,35000, 60 months,2,home_improvement,7,Low,1,Good Loan,0,12.69,B,2,7.55,39524.26,27501.98,0,790.82,409000004727,11-Dec-17,Indiaforensic MASTER ACQ DOM0912,,554052.53,-544340433.38,Barese,648,France,22101.86,0,1,0
4729,2011,1,RENT,1,Low,1,8000, 36 months,1,debt_consolidation,6,Low,1,Bad Loan,1,12.42,B,2,19.54,7769.9,5947.25,298.16,267.33,409000004728,11-Dec-17,Indiaforensic VISA ACQ DOM091217,,903167.14,-543437266.24,Chigolum,501,Germany,126535.92,0,1,0
4730,2011,0.5,MORTGAGE,3,Medium,2,35000, 60 months,2,debt_consolidation,6,High,2,Bad Loan,1,20.3,E,5,13.54,23230.22,8026.73,3816.53,933.14,409000004729,11-Dec-17,Indiaforensic RUPAY POS ACQ09121,,1707159.88,-541730106.36,Trouette,683,France,44692.63,0,1,0
4731,2011,6.05,MORTGAGE,3,Low,1,6100, 36 months,1,home_improvement,7,High,2,Bad Loan,1,14.27,C,3,23.95,1755.22,989.91,293.41,209.29,409000004730,11-Dec-17,Indiaforensic VISA ACQ INT 08121,,49.50,-541730056.86,Ugochukwu,619,Spain,112442.63,0,1,0
4732,2011,10,MORTGAGE,3,Medium,2,2000, 36 months,1,major_purchase,8,Low,1,Good Loan,0,12.69,B,2,18.48,2412.875502,2000,0,67.09,409000004731,11-Dec-17,Indiaforensic MASTER ACQ DOM1112,,810169.50,-540919887.36,Cribb,705,France,66331.01,0,1,0
4733,2011,4,MORTGAGE,3,Low,1,7500, 36 months,1,credit_card,1,High,2,Good Loan,0,15.27,C,3,11.18,9370.84082,7500,0,260.99,409000004732,11-Dec-17,Indiaforensic RUPAY POS ACQ10121,,2933708.18,-537986179.18,McIntyre,638,Germany,16657.68,0,1,0
4734,2011,3,RENT,1,Low,1,8800, 36 months,1,other,4,Low,1,Good Loan,0,12.42,B,2,0.43,9747.92,8800,0,294.06,409000004733,11-Dec-17,Indiaforensic VISA ACQ INT 10121,,4419.00,-537981760.18,Pickering,710,France,20081.30,0,1,0
4735,2011,0.5,RENT,1,Low,1,14725, 36 months,1,debt_consolidation,6,Low,1,Good Loan,0,10.65,B,2,19.03,16876.7,14725,0,479.65,409000004734,11-Dec-17,TRF TO  Indiaforensic SERVICES I,"3,000,000.00",,-540981760.18,Fletcher,590,France,93820.49,0,1,0
4736,2011,2,RENT,1,Low,1,3000, 60 months,2,debt_consolidation,6,High,2,Good Loan,0,19.42,E,5,3.04,4300.01078,3000,0,78.52,409000004735,11-Dec-17,TRF TO  Indiaforensic SERVICES I,"5,000,000.00",,-545981760.18,Uchenna,725,France,130795.52,0,1,0
4737,2011,5,RENT,1,Low,1,1000, 36 months,1,debt_consolidation,6,Low,1,Good Loan,0,8.9,A,1,0.75,1041.65,1000,0,31.76,409000004736,11-Dec-17,TRF TO  Indiaforensic SERVICES I,"1,000,000.00",,-546981760.18,Pisano,638,France,160129.99,0,1,0
4738,2011,8,RENT,1,Low,1,1200, 36 months,1,other,4,High,2,Good Loan,0,16.29,D,4,7.16,1524.171666,1200,0,42.37,409000004737,11-Dec-17,TRF TO  Indiaforensic SERVICES I,"1,000,000.00",,-547981760.18,Corson,791,France,189969.91,0,1,0
4739,2011,0.5,RENT,1,Low,1,25000, 60 months,2,wedding,5,Low,1,Good Loan,0,12.69,B,2,4.15,28822.42,25000,0,564.87,409000004738,12-Dec-17,Indiaforensic MASTER ACQ DOM1212,,657222.24,-547324537.94,Hooper,702,France,9712.52,0,1,0
4740,2011,0.5,RENT,1,Low,1,8000, 36 months,1,debt_consolidation,6,Low,1,Good Loan,0,7.51,A,1,20.36,8358.01,8000,0,248.89,409000004739,12-Dec-17,Indiaforensic VISA ACQ DOM121217,,992534.98,-546332002.96,He,607,France,196062.01,0,1,0
4741,2011,9,MORTGAGE,3,Low,1,21600, 60 months,2,debt_consolidation,6,High,2,Good Loan,0,17.27,D,4,19.82,31432.73263,21600,0,539.96,409000004740,12-Dec-17,Indiaforensic RUPAY POS ACQ12121,,2874697.44,-543457305.52,Chidubem,535,France,125710.53,0,1,0
4742,2011,10,RENT,1,Low,1,17500, 60 months,2,debt_consolidation,6,High,2,Bad Loan,1,20.89,F,6,18.65,4722.54,1810.82,9.34,472.36,409000004741,12-Dec-17,TRF TO  Indiaforensic SERVICES I,"4,000,000.00",,-547457305.52,Schofield,651,France,23054.51,0,1,0
4743,2011,4,MORTGAGE,3,Low,1,35000, 60 months,2,debt_consolidation,6,High,2,Good Loan,0,20.89,F,6,24.54,50254.51798,35000,0,944.71,409000004742,12-Dec-17,Indiaforensic VISA ACQ INT 12121,,1284.14,-547456021.38,Liang,506,Germany,170679.74,0,1,0
4744,2011,5,RENT,1,Low,1,2000, 36 months,1,vacation,11,Low,1,Good Loan,0,6.62,A,1,27.21,2209.824303,2000,0,61.41,409000004743,12-Dec-17,Indiaforensic MASTER ACQ DOM1212,,504226.45,-546951794.93,Somadina,511,Spain,181258.76,0,1,0
4745,2011,2,MORTGAGE,3,Medium,2,30000, 60 months,2,debt_consolidation,6,High,2,Good Loan,0,22.35,F,6,18.46,35339.7,30000,0,834.55,409000004744,13-Dec-17,Indiaforensic RUPAY POS ACQ13121,,1358554.01,-545593240.92,McIntosh,757,France,22835.13,0,1,0
4746,2011,10,RENT,1,Low,1,21250, 60 months,2,debt_consolidation,6,Low,1,Good Loan,0,12.69,B,2,14.74,26809.86809,21250,0,480.14,409000004745,13-Dec-17,Indiaforensic VISA ACQ INT 13121,,1284.14,-545591956.78,Hinton,768,Germany,102397.22,0,1,0
4747,2011,6.05,MORTGAGE,3,Low,1,3000, 36 months,1,home_improvement,7,Low,1,Good Loan,0,8.9,A,1,4.08,3427.881242,3000,0,95.26,409000004746,13-Dec-17,Indiaforensic MASTER ACQ DOM1312,,136600.26,-545455356.52,Sal,757,France,115950.96,0,1,0
4748,2011,10,MORTGAGE,3,Low,1,28100, 60 months,2,debt_consolidation,6,High,2,Good Loan,0,19.03,E,5,21.23,35694.88,28100,0,729.4,409000004747,13-Dec-17,TRF TO  Indiaforensic SERVICES I,"2,600,000.00",,-548055356.52,De Luca,663,Spain,15876.52,0,1,0
4749,2011,6,MORTGAGE,3,Low,1,14000, 60 months,2,debt_consolidation,6,High,2,Bad Loan,1,14.65,C,3,3.88,4699.91,2232.89,404.71,330.5,409000004748,14-Dec-17,Indiaforensic MASTER ACQ DOM1412,,1042731.29,-547012625.23,Bromby,537,Germany,117690.58,0,1,0
4750,2011,10,MORTGAGE,3,Low,1,35000, 60 months,2,major_purchase,8,Low,1,Good Loan,0,12.69,B,2,20.2,43951.22339,34999.99,0,790.82,409000004749,14-Dec-17,Indiaforensic VISA ACQ DOM141217,,1772152.69,-545240472.54,Chang,570,Germany,173792.77,0,1,0
4751,2011,3,MORTGAGE,3,Low,1,18225, 60 months,2,debt_consolidation,6,High,2,Good Loan,0,13.49,C,3,10.21,24342.27244,18225,0,419.27,409000004750,14-Dec-17,Indiaforensic RUPAY POS ACQ14121,,3055053.01,-542185419.53,Hunter,850,France,80992.80,0,1,0
4752,2011,4,RENT,1,Low,1,20000, 60 months,2,wedding,5,Low,1,Good Loan,0,12.42,B,2,14.83,23274.91,20000,0,449.15,409000004751,14-Dec-17,Indiaforensic MASTER ACQ  CB DOM,994.98,,-542186414.51,Sheppard,661,Germany,189398.18,0,1,0
4753,2011,10,MORTGAGE,3,Low,1,16000, 36 months,1,debt_consolidation,6,Low,1,Good Loan,0,11.71,B,2,10.74,19047.50749,16000,0,529.22,409000004752,14-Dec-17,TRF TO  Indiaforensic SERVICES I,"1,000,000.00",,-543186414.51,Fan,659,France,56787.80,0,1,0
4754,2011,7,MORTGAGE,3,Medium,2,21000, 60 months,2,debt_consolidation,6,High,2,Good Loan,0,15.27,C,3,13.07,29033.47419,21000,0,502.57,409000004753,14-Dec-17,TRF TO  Indiaforensic SERVICES I,"5,000,000.00",,-548186414.51,Muir,454,Spain,148309.98,0,1,0
4755,2011,6.05,RENT,1,Low,1,6250, 36 months,1,debt_consolidation,6,High,2,Good Loan,0,15.27,C,3,7.89,7426.07,6250,0,217.49,409000004754,15-Dec-17,Indiaforensic MASTER ACQ DOM1512,,640769.47,-547545645.04,Lai,708,France,179673.11,0,1,0
4756,2011,5,MORTGAGE,3,Low,1,28200, 60 months,2,debt_consolidation,6,High,2,Good Loan,0,14.27,C,3,25.09,35526.19,28200,0,660.12,409000004755,15-Dec-17,Indiaforensic VISA ACQ DOM151217,,902731.79,-546642913.25,Padovesi,720,France,138470.21,0,1,0
4757,2011,10,MORTGAGE,3,Low,1,16000, 60 months,2,debt_consolidation,6,Low,1,Good Loan,0,12.42,B,2,4.74,17415.4,16000,0,359.32,409000004756,15-Dec-17,Indiaforensic RUPAY POS ACQ15121,,1961189.46,-544681723.79,Kemp,785,France,163798.41,0,1,0
4758,2011,6,MORTGAGE,3,Low,1,10000, 60 months,2,debt_consolidation,6,High,2,Good Loan,0,14.65,C,3,12.54,14020.02,10000,0,236.07,409000004757,15-Dec-17,TRF TO  Indiaforensic SERVICES I,"3,500,000.00",,-548181723.79,Greece,743,Spain,33693.78,0,1,0
4759,2011,2,MORTGAGE,3,Low,1,12000, 60 months,2,small_business,3,High,2,Good Loan,0,18.25,D,4,12.14,15679.21,12000,0,306.36,409000004758,16-Dec-17,Indiaforensic VISA ACQ DOM161217,,752795.17,-547428928.62,Young,493,Spain,48545.10,0,1,0
4760,2011,0.5,MORTGAGE,3,Medium,2,13600, 36 months,1,home_improvement,7,Low,1,Good Loan,0,6.62,A,1,11.71,15031.67792,13600,0,417.57,409000004759,16-Dec-17,Indiaforensic RUPAY POS ACQ16121,,2109225.67,-545319702.95,Chukwueloka,557,Spain,123427.98,0,1,0
4761,2011,10,OWN,2,Medium,2,6000, 36 months,1,credit_card,1,High,2,Good Loan,0,15.27,C,3,15.99,6363.81,6000,0,208.79,409000004760,16-Dec-17,TRF  Indiaforensic SERVICES INDI,"2,000,000.00",,-547319702.95,Woods,850,France,174183.44,0,1,0
4762,2011,3,RENT,1,Medium,2,15000, 36 months,1,other,4,Low,1,Good Loan,0,10.65,B,2,14.36,17497.28948,15000,0,488.6,409000004761,16-Dec-17,TRF TO  Indiaforensic SERVICES I,"500,000.00",,-547819702.95,Forbes,799,France,17938.00,0,1,0
4763,2011,10,MORTGAGE,3,Low,1,5000, 36 months,1,car,2,Low,1,Good Loan,0,7.51,A,1,10.19,5061.3,5000,0,155.56,409000004762,18-Dec-17,Indiaforensic MASTER ACQ DOM1712,,498234.98,-547321467.97,Kang,756,France,90059.04,0,1,0
4764,2011,4,MORTGAGE,3,Low,1,12000, 36 months,1,home_improvement,7,Low,1,Good Loan,0,10.65,B,2,6.78,14069.16543,12000,0,390.88,409000004763,18-Dec-17,Indiaforensic RUPAY POS ACQ17121,,1804799.57,-545516668.40,Nweke,752,France,137694.23,0,1,0
4765,2011,10,MORTGAGE,3,Medium,2,28000, 36 months,1,debt_consolidation,6,Low,1,Good Loan,0,7.51,A,1,24.73,31356.51493,28000,0,871.11,409000004764,18-Dec-17,Indiaforensic MASTER ACQ DOM1812,,534400.12,-544982268.28,Ts'ui,696,Spain,65039.90,0,1,0
4766,2011,0.5,RENT,1,Low,1,15000, 36 months,1,other,4,High,2,Good Loan,0,13.49,C,3,13.9,15930.29,15000,0,508.96,409000004765,18-Dec-17,Indiaforensic VISA ACQ DOM181217,,1456032.23,-543526236.05,Milano,630,Spain,162858.29,0,1,0
4767,2011,3,RENT,1,Medium,2,12000, 36 months,1,credit_card,1,Low,1,Good Loan,0,7.9,A,1,4.41,13516.72081,12000,0,375.49,409000004766,18-Dec-17,Indiaforensic RUPAY POS ACQ18121,,1434120.54,-542092115.51,Chao,659,Spain,35701.06,0,1,0
4768,2011,3,RENT,1,Low,1,26400, 60 months,2,house,12,Low,1,Good Loan,0,11.71,B,2,9.66,30717.5,26400,0,583.4,409000004767,18-Dec-17,Indiaforensic MASTER ACQ DOM1612,,496532.15,-541595583.36,Wan,685,Spain,18826.06,0,1,0
4769,2011,9,OWN,2,Low,1,12000, 60 months,2,home_improvement,7,High,2,Good Loan,0,14.65,C,3,13.68,15113.97,12000,0,283.28,409000004768,18-Dec-17,TRF TO  Indiaforensic SERVICES I,"6,600,000.00",,-548195583.36,Napolitani,599,Spain,130086.47,0,1,0
4770,2011,8,MORTGAGE,3,Medium,2,9600, 60 months,2,debt_consolidation,6,Low,1,Good Loan,0,10.65,B,2,11.26,10882.71,9600,0,207.06,409000004769,19-Dec-17,Indiaforensic MASTER ACQ DOM1912,,517612.69,-547677970.67,Kovaleva,559,Spain,143360.56,0,1,0
4771,2011,4,MORTGAGE,3,Low,1,5000, 36 months,1,debt_consolidation,6,High,2,Good Loan,0,14.27,C,3,11.93,5530.93,5000,0,171.55,409000004770,19-Dec-17,Indiaforensic VISA ACQ DOM191217,,763865.79,-546914104.88,Russell,615,Spain,159920.92,0,1,0
4772,2011,2,RENT,1,Low,1,9200, 36 months,1,small_business,3,Low,1,Good Loan,0,6.03,A,1,21.86,9738.47,9200,0,280.01,409000004771,19-Dec-17,Indiaforensic RUPAY POS ACQ19121,,1579331.05,-545334773.83,Chiebuka,580,Germany,12099.67,0,1,0
4773,2011,2,MORTGAGE,3,Low,1,4400, 36 months,1,other,4,Low,1,Good Loan,0,8.9,A,1,15.62,5028.549752,4400,0,139.72,409000004772,19-Dec-17,TRF TO  Indiaforensic SERVICES I,"2,900,000.00",,-548234773.83,Ellis,487,Spain,53087.98,0,1,0
4774,2011,3,MORTGAGE,3,Low,1,12000, 36 months,1,debt_consolidation,6,Low,1,Good Loan,0,7.51,A,1,1.81,13438.50826,12000,0,373.33,409000004773,20-Dec-17,Indiaforensic MASTER ACQ DOM2012,,616080.64,-547618693.19,Gordon,646,Germany,142839.82,0,1,0
4775,2011,5,RENT,1,Low,1,9800, 60 months,2,debt_consolidation,6,High,2,Good Loan,0,18.64,E,5,14.23,14818.72259,9800,0,252.29,409000004774,20-Dec-17,Indiaforensic VISA ACQ DOM201217,,713384.98,-546905308.21,Conway,811,France,178.19,0,1,0
4776,2011,8,MORTGAGE,3,Medium,2,6000, 36 months,1,medical,9,Low,1,Good Loan,0,6.62,A,1,18.08,6630.747727,6000,0,184.23,409000004775,20-Dec-17,Indiaforensic RUPAY POS ACQ20121,,1607066.46,-545298241.75,Buccho,526,Spain,105618.14,0,1,0
4777,2011,1,RENT,1,Low,1,5500, 36 months,1,credit_card,1,Low,1,Good Loan,0,11.71,B,2,8.93,6547.371048,5500,0,181.92,409000004776,20-Dec-17,TRF TO  Indiaforensic SERVICES I,"2,900,000.00",,-548198241.75,Aksyonova,767,Spain,24734.25,0,1,0
4778,2011,0.5,MORTGAGE,3,Low,1,5000, 36 months,1,small_business,3,Low,1,Good Loan,0,6.03,A,1,1.2,5400.12,5000,0,152.18,409000004777,21-Dec-17,Indiaforensic RUPAY POS ACQ21121,,1763811.94,-546434429.81,Batty,548,France,82245.67,0,1,0
4779,2011,0.5,RENT,1,Low,1,5600, 36 months,1,debt_consolidation,6,High,2,Bad Loan,1,15.27,C,3,24.8,2935.12,1874.82,213.7,194.87,409000004778,21-Dec-17,Indiaforensic VISA ACQ DOM211217,,860629.25,-545573800.56,Rowe,737,Spain,177695.67,0,1,0
4780,2011,10,MORTGAGE,3,Medium,2,11200, 36 months,1,debt_consolidation,6,High,2,Good Loan,0,14.27,C,3,21.08,13379.39,11200,0,384.26,409000004779,21-Dec-17,Indiaforensic MASTER ACQ DOM2112,,507690.03,-545066110.53,Pisani,613,Germany,107961.11,0,1,0
4781,2011,10,MORTGAGE,3,Low,1,30000, 60 months,2,debt_consolidation,6,High,2,Good Loan,0,19.42,E,5,6.58,41119.5,30000,0,785.17,409000004780,21-Dec-17,TRF TO  Indiaforensic SERVICES I,"3,000,000.00",,-548066110.53,Onochie,711,Spain,55207.41,0,1,0
4782,2011,0.5,RENT,1,Low,1,15000, 36 months,1,credit_card,1,Low,1,Good Loan,0,7.9,A,1,8.25,16895.5839,15000,0,469.36,409000004781,22-Dec-17,Indiaforensic MASTER ACQ DOM2212,,437929.97,-547628180.56,Farmer,850,Spain,182633.63,0,1,0
4783,2011,5,RENT,1,Low,1,10000, 36 months,1,home_improvement,7,High,2,Good Loan,0,14.27,C,3,21.54,12348.28449,10000,0,343.09,409000004782,22-Dec-17,Indiaforensic VISA ACQ DOM221217,,799320.34,-546828860.22,Cameron,752,France,51587.04,0,1,0
4784,2011,0.5,OWN,2,Low,1,8400, 60 months,2,car,2,High,2,Bad Loan,1,18.25,D,4,19.34,7952.54,3804.86,697.96,214.45,409000004783,22-Dec-17,Indiaforensic RUPAY POS ACQ22121,,1808280.22,-545020580.00,Jennings,710,France,115403.31,0,1,0
4785,2011,5,MORTGAGE,3,Low,1,3000, 36 months,1,debt_consolidation,6,Low,1,Good Loan,0,9.91,B,2,3.82,3477.070109,3000,0,96.68,409000004784,22-Dec-17,TRF TO  Indiaforensic SERVICES I,"3,000,000.00",,-548020580.00,Eluemuno,664,Spain,186392.99,0,1,0
4786,2011,10,MORTGAGE,3,Low,1,5875, 36 months,1,debt_consolidation,6,Low,1,Bad Loan,1,6.62,A,1,19.42,3871.2,2623.97,811.37,180.39,409000004785,26-Dec-17,Indiaforensic RUPAY POS ACQ23121,,1556040.27,-546464539.73,Swift,510,France,44374.44,0,1,0
4787,2011,1,MORTGAGE,3,Medium,2,20000, 60 months,2,debt_consolidation,6,Low,1,Good Loan,0,11.71,B,2,19.42,22812.61,20000,0,441.97,409000004786,26-Dec-17,Indiaforensic RUPAY POS ACQ24121,,1483136.85,-544981402.88,Pisani,577,France,84033.35,0,1,0
4788,2011,3,RENT,1,Low,1,14000, 60 months,2,debt_consolidation,6,High,2,Bad Loan,1,18.64,E,5,13.8,2907.47,888.72,752.15,360.41,409000004787,26-Dec-17,Indiaforensic VISA ACQ INT 23121,,706.16,-544980696.72,Nnonso,529,France,82276.62,0,1,0
4789,2011,2,RENT,1,Low,1,7200, 36 months,1,debt_consolidation,6,Low,1,Good Loan,0,7.9,A,1,20.46,8095.081845,7200,0,225.29,409000004788,26-Dec-17,Indiaforensic VISA ACQ DOM251217,,1519669.44,-543461027.28,Cameron,757,Spain,177528.92,0,1,0
4790,2011,10,MORTGAGE,3,Low,1,15000, 36 months,1,debt_consolidation,6,Low,1,Good Loan,0,11.71,B,2,13.26,17857.17424,15000,0,496.14,409000004789,26-Dec-17,Indiaforensic RUPAY POS ACQ25121,,1317526.11,-542143501.17,Stevens,691,France,56850.92,0,1,0
4791,2011,8,RENT,1,Low,1,5000, 36 months,1,major_purchase,8,Low,1,Good Loan,0,6.03,A,1,2.92,5365.15,5000,0,152.18,409000004790,26-Dec-17,Indiaforensic MASTER ACQ DOM2612,,505902.93,-541637598.24,Zito,621,Spain,47972.65,0,1,0
4792,2011,6.05,MORTGAGE,3,Low,1,13200, 36 months,1,wedding,5,High,2,Bad Loan,1,16.29,D,4,23.23,12743.73,9524.91,0,465.97,409000004791,26-Dec-17,Indiaforensic VISA ACQ DOM261217,,818323.27,-540819274.97,Taylor,709,Spain,104982.39,0,1,0
4793,2011,1,RENT,1,Low,1,13200, 60 months,2,wedding,5,Low,1,Good Loan,0,10.65,B,2,17.26,15846.21638,13200,0,284.71,409000004792,26-Dec-17,Indiaforensic RUPAY POS ACQ26121,,1265916.10,-539553358.87,Ferrari,756,Spain,133535.29,0,1,0
4794,2011,10,RENT,1,Low,1,5000, 36 months,1,wedding,5,Low,1,Good Loan,0,11.71,B,2,4.04,5952.553616,5000,0,165.38,409000004793,26-Dec-17,Indiaforensic MASTER ACQ DOM2512,,927983.18,-538625375.69,Yeh,788,France,25571.37,0,1,0
4795,2011,2,RENT,1,Medium,2,14000, 36 months,1,credit_card,1,High,2,Good Loan,0,13.49,C,3,5.98,16495.42,14000,0,475.03,409000004794,26-Dec-17,Indiaforensic MASTER ACQ DOM2312,,472663.54,-538152712.15,Gould,705,France,96075.55,0,1,0
4796,2011,4,RENT,1,Low,1,14000, 36 months,1,wedding,5,Low,1,Good Loan,0,6.62,A,1,4.38,14848.8,14000,0,429.86,409000004795,26-Dec-17,Indiaforensic VISA ACQ DOM231217,,845547.95,-537307164.20,Agafonova,483,France,81634.45,0,1,0
4797,2011,5,RENT,1,Low,1,20000, 60 months,2,debt_consolidation,6,Low,1,Good Loan,0,10.65,B,2,22.38,21518.55,15856.86,0,431.37,409000004796,26-Dec-17,Indiaforensic MASTER ACQ DOM REV,"3,343.43",,-537310507.63,Fowler,719,Spain,165008.97,0,1,0
4798,2011,10,MORTGAGE,3,Low,1,20000, 60 months,2,debt_consolidation,6,Low,1,Good Loan,0,11.71,B,2,22.26,22077.71,15795.8,0,441.97,409000004797,26-Dec-17,TRF TO  Indiaforensic SERVICES I,"5,000,000.00",,-542310507.63,Chidumaga,793,Germany,138191.81,0,1,0
4799,2011,10,MORTGAGE,3,Low,1,35000, 60 months,2,debt_consolidation,6,High,2,Bad Loan,1,19.03,E,5,6.05,18827.19,7753,1565.95,908.5,409000004798,26-Dec-17,TRF TO  Indiaforensic SERVICES I,"3,000,000.00",,-545310507.63,Sabbatini,593,France,99136.49,0,1,0
4800,2011,1,MORTGAGE,3,Low,1,13200, 60 months,2,debt_consolidation,6,Low,1,Good Loan,0,12.69,B,2,18.05,15533.95,13200,0,298.25,409000004799,26-Dec-17,TRF TO  Indiaforensic SERVICES I,"2,000,000.00",,-547310507.63,Johnson,551,France,63584.55,0,1,0
4801,2011,1,MORTGAGE,3,Low,1,12000, 60 months,2,debt_consolidation,6,High,2,Good Loan,0,15.96,C,3,11.82,15052.29,12000,0,291.57,409000004800,26-Dec-17,TRF TO  Indiaforensic SERVICES I,"500,000.00",,-547810507.63,Chapman,690,France,160532.88,0,1,0
4802,2011,3,RENT,1,Low,1,18825, 60 months,2,major_purchase,8,Low,1,Bad Loan,1,12.42,B,2,11.39,1266.51,689.9,0,422.76,409000004801,27-Dec-17,Indiaforensic MASTER ACQ DOM2712,,595223.09,-547215284.54,Birk,823,France,162683.06,0,1,0
4803,2011,7,MORTGAGE,3,Low,1,8000, 36 months,1,credit_card,1,High,2,Good Loan,0,16.29,D,4,11.9,10165.01963,8000,0,282.41,409000004802,27-Dec-17,Indiaforensic VISA ACQ DOM271217,,702937.42,-546512347.12,Capon,512,Spain,134878.19,0,1,0
4804,2011,8,MORTGAGE,3,Low,1,13250, 36 months,1,debt_consolidation,6,Low,1,Good Loan,0,6.62,A,1,28.64,14147.72,13250,0,406.83,409000004803,27-Dec-17,Indiaforensic RUPAY POS ACQ27121,,1688758.39,-544823588.73,Chidubem,802,Spain,134626.30,0,1,0
4805,2011,0.5,MORTGAGE,3,Low,1,12000, 60 months,2,debt_consolidation,6,High,2,Bad Loan,1,16.77,D,4,8.93,9893.23,4175.76,1880.98,296.75,409000004804,27-Dec-17,Indiaforensic VISA ACQ INT 26121,,4125.76,-544819462.97,Childs,450,Spain,175480.93,0,1,0
4806,2011,10,MORTGAGE,3,High,3,12000, 36 months,1,car,2,Low,1,Good Loan,0,6.03,A,1,16.31,13147.87492,12000,0,365.23,409000004805,27-Dec-17,TRF TO  Indiaforensic SERVICES I,"3,400,000.00",,-548219462.97,Sun,651,Germany,174337.68,0,1,0
4807,2011,10,OWN,2,Low,1,10000, 36 months,1,debt_consolidation,6,Low,1,Good Loan,0,9.91,B,2,6.39,11599.27404,10000,0,322.25,409000004806,28-Dec-17,Indiaforensic RUPAY POS ACQ28121,,1629973.34,-546589489.63,Lung,697,France,172524.51,0,1,0
4808,2011,10,RENT,1,Low,1,3000, 36 months,1,other,4,Low,1,Good Loan,0,12.42,B,2,23.45,3604.963882,3000,0,100.25,409000004807,28-Dec-17,Indiaforensic VISA ACQ DOM281217,,800230.25,-545789259.38,Tao,611,France,25395.83,0,1,0
4809,2011,0.5,OWN,2,Low,1,10000, 36 months,1,debt_consolidation,6,High,2,Good Loan,0,17.58,D,4,6.56,13005.55763,10000,0,359.43,409000004808,28-Dec-17,Indiaforensic MASTER ACQ DOM2812,,633105.15,-545156154.23,Napolitano,643,France,184856.89,0,1,0
4810,2011,9,MORTGAGE,3,Low,1,5300, 36 months,1,debt_consolidation,6,High,2,Good Loan,0,19.91,E,5,14.7,6910.8,5300,0,196.73,409000004809,28-Dec-17,TRF TO  Indiaforensic SERVICES I,"3,000,000.00",,-548156154.23,Davis,822,France,182624.93,0,1,0
4811,2011,8,MORTGAGE,3,Low,1,22000, 60 months,2,debt_consolidation,6,High,2,Bad Loan,1,20.3,E,5,15.79,24454.4,8990.67,5715.04,586.55,409000004810,29-Dec-17,Indiaforensic MASTER ACQ DOM2912,,512631.83,-547643522.40,Sagese,632,France,192505.62,0,1,0
4812,2011,1,MORTGAGE,3,Low,1,10000, 36 months,1,debt_consolidation,6,Low,1,Good Loan,0,7.9,A,1,5.8,10851.88,10000,0,312.91,409000004811,29-Dec-17,Indiaforensic VISA ACQ INT 28121,,2256.92,-547641265.48,Hutchinson,575,Spain,112507.63,0,1,0
4813,2011,10,OWN,2,Low,1,9250, 36 months,1,debt_consolidation,6,Low,1,Good Loan,0,12.69,B,2,17.39,11166.8156,9250,0,310.29,409000004812,29-Dec-17,Indiaforensic RUPAY POS ACQ29121,,1089006.21,-546552259.27,Nelson,672,France,177295.92,0,1,0
4814,2011,0.5,RENT,1,Low,1,9000, 36 months,1,debt_consolidation,6,High,2,Good Loan,0,16.77,D,4,16.69,11320.06,9000,0,319.85,409000004813,29-Dec-17,TRF TO  Indiaforensic SERVICES I,"500,000.00",,-547052259.27,Schiavone,517,Spain,12465.51,0,1,0
4815,2011,7,RENT,1,Low,1,14000, 60 months,2,small_business,3,High,2,Bad Loan,1,21.67,F,6,11.57,5303.68,1734.97,703.71,384.05,409000004814,30-Dec-17,Indiaforensic RUPAY POS ACQ30121,,2419884.58,-544632374.69,Chienezie,621,Spain,36122.96,0,1,0
4816,2011,6,RENT,1,Low,1,5000, 36 months,1,debt_consolidation,6,Low,1,Good Loan,0,7.9,A,1,8.43,5362.46,5000,0,156.46,409000004815,30-Dec-17,Indiaforensic VISA ACQ DOM301217,,1629944.99,-543002429.70,Obioma,775,Germany,37836.64,0,1,0
4817,2011,1,OWN,2,Low,1,15000, 36 months,1,debt_consolidation,6,Low,1,Good Loan,0,12.42,B,2,21.08,17526.4,15000,0,501.23,409000004816,30-Dec-17,Indiaforensic VISA ACQ DOM291217,,1570.00,-543000859.70,Butusov,600,France,34747.43,0,1,0
4818,2011,4,MORTGAGE,3,Low,1,17800, 60 months,2,debt_consolidation,6,High,2,Good Loan,0,18.25,D,4,14.12,23210.09,17800,0,454.43,409000004817,30-Dec-17,TRF TO  Indiaforensic SERVICES I,"5,000,000.00",,-548000859.70,Pisano,640,France,131097.90,0,1,0
4819,2011,1,MORTGAGE,3,Low,1,15000, 60 months,2,debt_consolidation,6,High,2,Bad Loan,1,20.3,E,5,10.67,2491.81,753.73,498.21,399.92,409000004818,1-Jan-18,Indiaforensic VISA ACQ DOM311217,,416.00,-548000443.70,Stetson,752,France,105280.55,0,1,0
4820,2011,2,RENT,1,Low,1,8000, 36 months,1,debt_consolidation,6,Low,1,Good Loan,0,11.71,B,2,17.6,9523.940737,8000,0,264.61,409000004819,1-Jan-18,Indiaforensic RUPAY POS ACQ31121,,888110.76,-547112332.94,Waring,613,France,149653.81,0,1,0
4821,2011,1,RENT,1,Low,1,1500, 36 months,1,wedding,5,High,2,Bad Loan,1,16.29,D,4,18.53,86.05,0,86.05,52.96,409000004820,1-Jan-18,Indiaforensic VISA ACQ INT 31121,,989.00,-547111343.94,Fanucci,484,France,139390.99,0,1,0
4822,2011,3,MORTGAGE,3,Medium,2,35000, 60 months,2,home_improvement,7,High,2,Good Loan,0,17.27,D,4,11.38,43697.63,26880.09,0,874.93,409000004821,1-Jan-18,Indiaforensic RUPAY POS ACQ01011,,1636631.26,-545474712.68,Thao,511,France,132436.71,0,1,0
4823,2011,1,MORTGAGE,3,Low,1,15000, 60 months,2,debt_consolidation,6,Low,1,Good Loan,0,9.91,B,2,3.02,15369.54,15000,0,318.05,409000004822,1-Jan-18,Indiaforensic VISA ACQ DOM010118,,1721285.90,-543753426.78,Murphy,745,France,179705.13,0,1,0
4824,2011,6,MORTGAGE,3,Low,1,24000, 60 months,2,debt_consolidation,6,High,2,Good Loan,0,20.89,F,6,6.76,32331.14,18075.3,0,647.8,409000004823,1-Jan-18,TRF TO  Indiaforensic SERVICES I,"500,000.00",,-544253426.78,McConnell,786,Spain,15796.66,0,1,0
4825,2011,10,MORTGAGE,3,Low,1,15000, 60 months,2,major_purchase,8,High,2,Good Loan,0,13.49,C,3,13.39,19457.6293,15000,0,345.08,409000004824,1-Jan-18,TRF TO  Indiaforensic SERVICES I,"4,000,000.00",,-548253426.78,Armfield,727,France,142754.71,0,1,0
4826,2011,5,MORTGAGE,3,Low,1,19000, 60 months,2,credit_card,1,Low,1,Good Loan,0,11.71,B,2,13.79,24430.41537,19000,0,419.87,409000004825,1-Jan-18,Indiaforensic VISA ACQ INT 30121,,3827.85,-548249598.93,Fanucci,622,France,2578.43,0,1,0
4827,2011,5,OWN,2,Low,1,21000, 36 months,1,credit_card,1,Low,1,Good Loan,0,12.42,B,2,16.98,21429.84,21000,0,701.73,409000004826,2-Jan-18,Indiaforensic MASTER ACQ DOM0201,,403189.87,-547846409.06,Panina,794,France,88992.05,0,1,0
4828,2011,2,RENT,1,Low,1,12000, 36 months,1,debt_consolidation,6,Low,1,Good Loan,0,8.9,A,1,14.43,13425.66,12000,0,381.04,409000004827,2-Jan-18,Indiaforensic MASTER ACQ DOM0101,,1198136.95,-546648272.11,Nixon,636,Spain,32936.44,0,1,0
4829,2011,10,MORTGAGE,3,Medium,2,35000, 60 months,2,debt_consolidation,6,Low,1,Good Loan,0,12.42,B,2,19,39284.03,27559.65,0,786.01,409000004828,2-Jan-18,Indiaforensic MASTER ACQ DOM3012,,576699.94,-546071572.17,Walker,741,Spain,39122.58,0,1,0
4830,2011,6,MORTGAGE,3,Low,1,3125, 36 months,1,credit_card,1,Low,1,Good Loan,0,8.9,A,1,8.09,3571.770116,3125,0,99.23,409000004829,2-Jan-18,Indiaforensic VISA ACQ DOM020118,"19,630.00",,-546091202.17,Chiemela,687,France,191092.62,0,1,0
4831,2011,0.5,RENT,1,Low,1,16000, 36 months,1,credit_card,1,Low,1,Good Loan,0,8.9,A,1,12.24,18288.8861,16000,0,508.06,409000004830,2-Jan-18,Indiaforensic RUPAY POS ACQ02011,,1716570.64,-544374631.53,Martel,660,Spain,129149.06,0,1,0
4832,2011,9,MORTGAGE,3,Low,1,5000, 36 months,1,vacation,11,High,2,Good Loan,0,13.49,C,3,5.55,6104.932146,5000,0,169.66,409000004831,2-Jan-18,Indiaforensic MASTER ACQ DOM REV,666.5,,-544375298.03,Briggs,660,France,13218.60,0,1,0
4833,2011,10,MORTGAGE,3,Low,1,20000, 36 months,1,debt_consolidation,6,Low,1,Good Loan,0,8.9,A,1,28.13,22246.02,20000,0,635.07,409000004832,2-Jan-18,Indiaforensic MASTER ACQ DOM REV,0.99,,-544375299.02,Iheatu,617,France,160589.18,0,1,0
4834,2011,2,OWN,2,Low,1,24000, 60 months,2,debt_consolidation,6,High,2,Good Loan,0,20.3,E,5,5.49,37089.24881,24000,0,639.87,409000004833,3-Jan-18,TRF TO  Indiaforensic SERVICES I,"3,000,000.00",,-547375299.02,Jennings,762,France,179657.83,0,1,0
4835,2011,10,RENT,1,Medium,2,32000, 60 months,2,debt_consolidation,6,High,2,Good Loan,0,21.67,F,6,6.04,43288.41,31999.99,0,877.82,409000004834,3-Jan-18,TRF TO  Indiaforensic SERVICES I,"500,000.00",,-547875299.02,Ch'en,752,Spain,44335.54,0,1,0
4836,2011,9,RENT,1,Low,1,7000, 36 months,1,debt_consolidation,6,High,2,Good Loan,0,13.49,C,3,8.36,8351.28,7000,0,237.52,409000004835,3-Jan-18,Indiaforensic MASTER ACQ DOM0301,,543996.35,-547331302.67,Kovalyov,561,Spain,29217.37,0,1,0
4837,2011,2,RENT,1,Low,1,5500, 60 months,2,debt_consolidation,6,High,2,Bad Loan,1,21.28,F,6,18.87,930.7,269.97,182.7,149.67,409000004836,3-Jan-18,Indiaforensic VISA ACQ DOM030118,,645063.95,-546686238.72,Yeh,609,France,43651.49,0,1,0
4838,2011,10,MORTGAGE,3,Low,1,5000, 36 months,1,debt_consolidation,6,Low,1,Good Loan,0,7.9,A,1,2.52,5631.944044,5000,0,156.46,409000004837,3-Jan-18,Indiaforensic RUPAY POS ACQ03011,,1549720.45,-545136518.27,Chien,803,France,159654.00,0,1,0
4839,2011,4,MORTGAGE,3,Low,1,8400, 36 months,1,other,4,Low,1,Good Loan,0,6.62,A,1,7.76,9283.15619,8400,0,257.92,409000004838,3-Jan-18,TRF TO  Indiaforensic SERVICES I,"3,100,000.00",,-548236518.27,Brown,556,France,17992.94,0,1,0
4840,2011,6,MORTGAGE,3,Low,1,30000, 60 months,2,debt_consolidation,6,High,2,Good Loan,0,21.28,F,6,14.84,48155.6499,30000,0,816.34,409000004839,3-Jan-18,Indiaforensic MASTER INT SET 020,,1009.17,-548235509.10,Buddicom,531,France,141501.45,0,1,0
4841,2011,4,MORTGAGE,3,Low,1,6625, 36 months,1,other,4,Low,1,Good Loan,0,11.71,B,2,15.86,7887.538743,6625,0,219.13,409000004840,4-Jan-18,Indiaforensic MASTER ACQ DOM0401,,574006.46,-547661502.64,McGregor,411,France,93825.78,0,1,0
4842,2011,10,MORTGAGE,3,Low,1,8000, 36 months,1,debt_consolidation,6,High,2,Good Loan,0,16.77,D,4,12.06,9004.6,8000,0,284.31,409000004841,4-Jan-18,Indiaforensic VISA ACQ DOM040118,,1449612.86,-546211889.78,Thompson,587,Germany,41852.24,0,1,0
4843,2011,6,RENT,1,Low,1,4000, 36 months,1,other,4,High,2,Bad Loan,1,13.49,C,3,22.59,801.41,463.52,123.66,135.73,409000004842,4-Jan-18,Indiaforensic RUPAY POS ACQ04011,,1660030.44,-544551859.34,Ross,683,Spain,97629.31,0,1,0
4844,2011,6.05,RENT,1,Low,1,4200, 36 months,1,credit_card,1,Low,1,Bad Loan,1,9.91,B,2,12.61,3576.74,2780.09,195.99,135.35,409000004843,4-Jan-18,TRF TO  Indiaforensic SERVICES I,"3,700,000.00",,-548251859.34,Ch'ang,654,France,37065.66,0,1,0
4845,2011,1,RENT,1,Medium,2,20000, 36 months,1,debt_consolidation,6,Low,1,Good Loan,0,6.62,A,1,5.58,21058.03,20000,0,614.08,409000004844,5-Jan-18,Indiaforensic MASTER ACQ DOM0501,,758140.65,-547493718.69,Warren,670,Germany,38614.69,0,1,0
4846,2011,0.5,MORTGAGE,3,Medium,2,6000, 36 months,1,car,2,Low,1,Good Loan,0,6.62,A,1,11.16,6630.747727,6000,0,184.23,409000004845,5-Jan-18,Indiaforensic VISA ACQ DOM050118,,789964.68,-546703754.01,Uspenskaya,655,France,87816.86,0,1,0
4847,2011,6,MORTGAGE,3,Low,1,5175, 36 months,1,debt_consolidation,6,Low,1,Good Loan,0,6.03,A,1,17.57,5667.558398,5175,0,157.51,409000004846,5-Jan-18,Indiaforensic RUPAY POS ACQ05011,,1640559.78,-545063194.23,King,752,France,184866.86,0,1,0
4848,2011,0.5,RENT,1,Low,1,2500, 36 months,1,debt_consolidation,6,High,2,Good Loan,0,18.64,E,5,20.37,3156.57,2500,0,91.19,409000004847,5-Jan-18,Indiaforensic VISA ACQ INT 04011,,5940.00,-545057254.23,Trentini,534,France,160176.47,0,1,0
4849,2011,10,MORTGAGE,3,Medium,2,30000, 60 months,2,home_improvement,7,High,2,Good Loan,0,20.89,F,6,9.94,40445.65,22608.35,0,809.75,409000004848,5-Jan-18,Indiaforensic MASTER ACQ DOM CB,993.5,,-545058247.73,Konovalova,635,France,164357.10,0,1,0
4850,2011,10,MORTGAGE,3,Low,1,16000, 36 months,1,debt_consolidation,6,Low,1,Good Loan,0,7.9,A,1,17.21,17954.10097,16000,0,500.65,409000004849,5-Jan-18,TRF TO  Indiaforensic SERVICES I,"3,200,000.00",,-548258247.73,Dellucci,491,Germany,17818.33,0,1,0
4851,2011,4,RENT,1,Low,1,3700, 36 months,1,moving,10,Low,1,Bad Loan,1,9.91,B,2,16.49,3924.74,3230.13,112.57,119.24,409000004850,6-Jan-18,Indiaforensic VISA ACQ DOM060118,,328961.67,-547929286.06,Goddard,516,France,142680.64,0,1,0
4852,2011,4,MORTGAGE,3,Low,1,10000, 36 months,1,vacation,11,Low,1,Good Loan,0,12.69,B,2,8.08,12073.60459,10000,0,335.45,409000004851,6-Jan-18,Indiaforensic RUPAY POS ACQ06011,,1383356.63,-546545929.43,Neumann,530,France,85081.09,0,1,0
4853,2011,6,MORTGAGE,3,Low,1,12000, 36 months,1,debt_consolidation,6,Low,1,Good Loan,0,6.03,A,1,15.78,12532.42,12000,0,365.23,409000004852,6-Jan-18,Indiaforensic VISA ACQ INT 05011,,1978.00,-546543951.43,Ch'in,687,Spain,176450.19,0,1,0
4854,2011,10,MORTGAGE,3,Medium,2,35000, 36 months,1,home_improvement,7,Low,1,Good Loan,0,7.9,A,1,8.73,39038,35000,0,1095.16,409000004853,8-Jan-18,Indiaforensic MASTER ACQ DOM0601,,548886.42,-545995065.01,Walters,684,France,121967.88,0,1,0
4855,2011,10,RENT,1,Low,1,12000, 36 months,1,debt_consolidation,6,Low,1,Good Loan,0,10.65,B,2,10.39,12107.02,12000,0,390.88,409000004854,8-Jan-18,Indiaforensic RUPAY POS ACQ07011,,877932.60,-545117132.41,Muravyova,706,Germany,127187.04,0,1,0
4856,2011,9,MORTGAGE,3,Low,1,21000, 60 months,2,credit_card,1,Low,1,Good Loan,0,12.42,B,2,21.43,24637.68,21000,0,471.61,409000004855,8-Jan-18,Indiaforensic VISA ACQ INT 06011,,422.26,-545116710.15,Barry,490,Germany,108313.34,0,1,0
4857,2011,3,MORTGAGE,3,Low,1,6000, 36 months,1,debt_consolidation,6,Low,1,Good Loan,0,6.03,A,1,1.31,6568.184246,6000,0,182.62,409000004856,8-Jan-18,Indiaforensic VISA ACQ DOM070118,,454844.76,-544661865.39,Woolnough,796,France,57205.55,0,1,0
4858,2011,1,MORTGAGE,3,Low,1,12375, 36 months,1,credit_card,1,Low,1,Good Loan,0,7.9,A,1,23.85,13816.2768,12375,0,387.22,409000004857,8-Jan-18,Indiaforensic MASTER ACQ DOM0801,,1188636.87,-543473228.52,Keen,849,France,157891.86,0,1,0
4859,2011,5,MORTGAGE,3,Medium,2,12000, 36 months,1,home_improvement,7,Low,1,Good Loan,0,6.62,A,1,2.31,12770.94,12000,0,368.45,409000004858,8-Jan-18,Indiaforensic VISA ACQ DOM080118,,1695756.63,-541777471.89,Liebe,779,France,86927.53,0,1,0
4860,2011,10,OWN,2,Low,1,8400, 36 months,1,wedding,5,Low,1,Good Loan,0,7.9,A,1,25.32,9461.451595,8400,0,262.84,409000004859,8-Jan-18,Indiaforensic RUPAY POS ACQ08011,,1348672.80,-540428799.09,White,794,Spain,107753.07,0,1,0
4861,2011,5,MORTGAGE,3,Low,1,8000, 36 months,1,debt_consolidation,6,Low,1,Bad Loan,1,11.71,B,2,19.78,2990.47,1947.16,347.57,264.61,409000004860,8-Jan-18,TRF TO  Indiaforensic SERVICES I,"3,000,000.00",,-543428799.09,Hunter,748,Spain,82158.14,0,1,0
4862,2011,2,RENT,1,Low,1,25000, 60 months,2,debt_consolidation,6,Low,1,Good Loan,0,10.65,B,2,10.38,30019.82777,25000,0,539.21,409000004861,8-Jan-18,TRF TO  Indiaforensic SERVICES I,"1,000,000.00",,-544428799.09,Myers,663,Spain,29135.89,0,1,0
4863,2011,2,MORTGAGE,3,Low,1,12000, 60 months,2,debt_consolidation,6,High,2,Good Loan,0,20.3,E,5,10.31,16870.26033,12000,0,319.94,409000004862,8-Jan-18,TRF TO  Indiaforensic SERVICES I,"500,000.00",,-544928799.09,Rogova,645,Spain,17095.49,0,1,0
4864,2011,3,MORTGAGE,3,Low,1,13800, 60 months,2,small_business,3,High,2,Bad Loan,1,18.64,E,5,4.61,4945.91,1835.94,699.11,355.26,409000004863,8-Jan-18,TRF TO  Indiaforensic SERVICES I,"3,000,000.00",,-547928799.09,Raff,464,France,100447.53,0,1,0
4865,2011,1,MORTGAGE,3,Low,1,7500, 36 months,1,debt_consolidation,6,Low,1,Good Loan,0,8.9,A,1,11.05,8572.02424,7500,0,238.15,409000004864,8-Jan-18,Indiaforensic MASTER ACQ DOM REV,3.44,,-547928802.53,Cocci,737,France,83470.40,0,1,0
4866,2011,10,MORTGAGE,3,Low,1,15000, 36 months,1,other,4,Low,1,Good Loan,0,7.9,A,1,3.15,16895.80901,15000,0,469.36,409000004865,9-Jan-18,Indiaforensic MASTER ACQ DOM0901,,590125.16,-547338677.37,Kanayochukwu,590,France,121846.81,0,1,0
4867,2011,3,MORTGAGE,3,Medium,2,8000, 36 months,1,debt_consolidation,6,High,2,Good Loan,0,13.49,C,3,8.83,9808.689488,8000,0,271.45,409000004866,9-Jan-18,Indiaforensic VISA ACQ DOM090118,,836878.76,-546501798.61,Obialo,522,Germany,129107.59,0,1,0
4868,2011,10,MORTGAGE,3,Low,1,15000, 60 months,2,debt_consolidation,6,High,2,Good Loan,0,14.27,C,3,16.5,17511.41,11682.09,0,351.13,409000004867,9-Jan-18,Indiaforensic RUPAY POS ACQ09011,,1884835.79,-544616962.82,Liu,648,France,54726.43,0,1,0
4869,2011,10,MORTGAGE,3,Low,1,15025, 36 months,1,small_business,3,Low,1,Good Loan,0,6.03,A,1,29.92,16462.1791,15025,0,457.3,409000004868,9-Jan-18,Indiaforensic VISA ACQ INT 08011,,3960.00,-544613002.82,Gilbert,754,France,116141.72,0,1,0
4870,2011,10,MORTGAGE,3,Medium,2,30000, 60 months,2,debt_consolidation,6,High,2,Good Loan,0,19.03,E,5,15.18,38884.7,22827.07,0,778.72,409000004869,10-Jan-18,TRF TO  Indiaforensic SERVICES I,"3,000,000.00",,-547613002.82,Coles,669,France,124872.42,0,1,0
4871,2011,1,RENT,1,Low,1,20000, 60 months,2,debt_consolidation,6,High,2,Good Loan,0,14.27,C,3,21.75,23373.94,15591.43,0,468.17,409000004870,10-Jan-18,TRF TO  Indiaforensic SERVICES I,"500,000.00",,-548113002.82,Ponomaryov,648,Germany,186438.86,0,1,0
4872,2011,7,MORTGAGE,3,Low,1,12000, 60 months,2,credit_card,1,Low,1,Good Loan,0,12.69,B,2,7.14,12967.58,12000,0,271.14,409000004871,10-Jan-18,Indiaforensic MASTER ACQ DOM1001,,653265.09,-547459737.73,Bergamaschi,763,France,134281.11,0,1,0
4873,2011,5,MORTGAGE,3,Low,1,31825, 36 months,1,debt_consolidation,6,Low,1,Good Loan,0,12.69,B,2,16.17,38421.72382,31825,0,1067.57,409000004872,10-Jan-18,Indiaforensic VISA ACQ DOM100118,,1032858.93,-546426878.80,Guerin,790,Spain,91044.47,0,1,0
4874,2011,2,RENT,1,Low,1,12000, 36 months,1,small_business,3,Low,1,Good Loan,0,7.9,A,1,9.16,13516.68329,12000,0,375.49,409000004873,10-Jan-18,Indiaforensic RUPAY POS ACQ10011,,1970703.66,-544456175.14,Sinclair,581,France,74320.75,0,1,0
4875,2011,5,OWN,2,Low,1,8000, 36 months,1,debt_consolidation,6,Low,1,Good Loan,0,9.91,B,2,9.85,9279.585102,8000,0,257.8,409000004874,10-Jan-18,TRF TO  Indiaforensic SERVICES I,"3,800,000.00",,-548256175.14,Dominguez,703,France,9704.66,0,1,0
4876,2011,2,MORTGAGE,3,Low,1,14000, 36 months,1,credit_card,1,High,2,Good Loan,0,14.27,C,3,12.57,17288.92075,14000,0,480.33,409000004875,11-Jan-18,Indiaforensic VISA ACQ INT 10011,,2967.00,-548253208.14,Costa,571,France,128600.49,0,1,0
4877,2011,10,MORTGAGE,3,Low,1,9000, 36 months,1,credit_card,1,Low,1,Good Loan,0,6.62,A,1,23.23,9945.885082,9000,0,276.34,409000004876,11-Jan-18,Indiaforensic VISA ACQ DOM110118,,1172276.49,-547080931.65,Wei,657,Spain,6468.24,0,1,0
4878,2011,10,MORTGAGE,3,Medium,2,10000, 36 months,1,debt_consolidation,6,Low,1,Good Loan,0,10.65,B,2,15.37,11724.73821,10000,0,325.74,409000004877,11-Jan-18,Indiaforensic RUPAY POS ACQ11011,,2078228.02,-545002703.63,Mills,737,France,57898.58,0,1,0
4879,2011,5,MORTGAGE,3,Low,1,13000, 36 months,1,debt_consolidation,6,Low,1,Good Loan,0,8.9,A,1,19.62,14859.33198,13000,0,412.8,409000004878,11-Jan-18,Indiaforensic MASTER ACQ DOM1101,,717518.91,-544285184.72,Pugh,793,Spain,192120.66,0,1,0
4880,2011,3,MORTGAGE,3,Medium,2,15000, 36 months,1,home_improvement,7,Low,1,Good Loan,0,6.03,A,1,0.26,16434.78414,15000,0,456.54,409000004879,11-Jan-18,Indiaforensic MASTER ACQ DOM1101,,4770.86,-544280413.86,Price,783,Spain,164213.53,0,1,0
4881,2011,1,MORTGAGE,3,Low,1,10000, 36 months,1,debt_consolidation,6,High,2,Good Loan,0,14.65,C,3,14.94,12330.66611,10000,0,344.95,409000004880,11-Jan-18,TRF TO  Indiaforensic SERVICES I,"3,200,000.00",,-547480413.86,Wood,751,Spain,117547.76,0,1,0
4882,2011,6.05,MORTGAGE,3,Low,1,4000, 36 months,1,small_business,3,Low,1,Good Loan,0,6.62,A,1,1.53,4420.509108,4000,0,122.82,409000004881,12-Jan-18,Indiaforensic MASTER ACQ DOM1101,,660091.71,-546820322.15,Robertson,579,France,26149.25,0,1,0
4883,2011,10,RENT,1,Low,1,18000, 60 months,2,debt_consolidation,6,High,2,Good Loan,0,13.49,C,3,19.1,23553.91574,18000,0,414.09,409000004882,12-Jan-18,Indiaforensic VISA ACQ DOM110118,,831870.37,-545988451.78,Sawtell,655,Germany,9181.66,0,1,0
4884,2011,10,MORTGAGE,3,Low,1,4000, 36 months,1,other,4,Low,1,Good Loan,0,7.9,A,1,17.04,4397.98,4000,0,125.17,409000004883,12-Jan-18,Indiaforensic RUPAY POS ACQ11011,,1716441.97,-544272009.81,Yuryeva,614,Germany,166588.76,0,1,0
4885,2011,9,MORTGAGE,3,Low,1,6000, 36 months,1,small_business,3,Low,1,Good Loan,0,6.03,A,1,14.73,6573.818445,6000,0,182.62,409000004884,12-Jan-18,TRF TO  Indiaforensic SERVICES I,"4,000,000.00",,-548272009.81,Pisano,678,Germany,195053.58,0,1,0
4886,2011,6,MORTGAGE,3,Medium,2,14000, 60 months,2,small_business,3,High,2,Good Loan,0,16.77,D,4,12.89,20078.35861,14000,0,346.21,409000004885,15-Jan-18,Indiaforensic RUPAY POS ACQ13011,,1766723.94,-546505285.87,Kharitonova,562,Spain,85787.31,0,1,0
4887,2011,1,RENT,1,Medium,2,6000, 36 months,1,wedding,5,Low,1,Good Loan,0,12.69,B,2,16.32,6798.48,6000,0,201.27,409000004886,15-Jan-18,Indiaforensic VISA ACQ DOM130118,,848346.61,-545656939.26,Simmons,711,Germany,102428.51,0,1,0
4888,2011,0.5,MORTGAGE,3,Low,1,3000, 36 months,1,home_improvement,7,Low,1,Good Loan,0,7.9,A,1,2.25,3378.89345,3000,0,93.88,409000004887,15-Jan-18,Indiaforensic MASTER ACQ DOM1301,,689671.40,-544967267.86,Muramats,620,France,71175.94,0,1,0
4889,2011,4,MORTGAGE,3,Low,1,14000, 36 months,1,credit_card,1,Low,1,Good Loan,0,7.9,A,1,10.16,15303.9,14000,0,438.07,409000004888,15-Jan-18,Indiaforensic RUPAY POS ACQ14011,,1549544.51,-543417723.35,Tang,437,France,166440.32,0,1,0
4890,2011,6,MORTGAGE,3,Low,1,4000, 36 months,1,major_purchase,8,Low,1,Good Loan,0,12.69,B,2,4.96,4829.017734,4000,0,134.18,409000004889,15-Jan-18,Indiaforensic VISA ACQ DOM150118,,2344127.05,-541073596.30,Peng,691,Germany,148848.76,0,1,0
4891,2011,6,MORTGAGE,3,Low,1,12800, 60 months,2,debt_consolidation,6,High,2,Good Loan,0,23.52,G,7,20.89,20330.95198,12800,0,364.68,409000004890,15-Jan-18,Indiaforensic RUPAY POS ACQ15011,,1353022.03,-539720574.27,Bevan,552,Spain,140286.69,0,1,0
4892,2011,2,MORTGAGE,3,Low,1,6250, 60 months,2,debt_consolidation,6,High,2,Good Loan,0,15.96,C,3,16.72,8470.338472,6250,0,151.86,409000004891,15-Jan-18,Indiaforensic MASTER ACQ DOM1401,,721264.39,-538999309.88,Zito,765,Germany,104220.50,0,1,0
4893,2011,4,MORTGAGE,3,Low,1,25000, 60 months,2,debt_consolidation,6,High,2,Good Loan,0,21.28,F,6,20.68,26749.03,25000,0,680.28,409000004892,15-Jan-18,Indiaforensic MASTER ACQ DOM1501,,716553.42,-538282756.46,Sokolov,707,Germany,70778.63,0,1,0
4894,2011,6.05,MORTGAGE,3,Low,1,35000, 60 months,2,debt_consolidation,6,High,2,Bad Loan,1,17.27,D,4,17.94,33248.73,16720.09,2661.55,874.93,409000004893,15-Jan-18,Indiaforensic VISA ACQ INT 14011,,343.10,-538282413.36,Teng,764,Spain,65868.28,0,1,0
4895,2011,10,MORTGAGE,3,Medium,2,30000, 60 months,2,debt_consolidation,6,Low,1,Good Loan,0,12.42,B,2,18.1,33673.31,23623.25,0,673.72,409000004894,15-Jan-18,TRF TO  Indiaforensic SERVICES I,"9,900,000.00",,-548182413.36,Amadi,585,France,171482.56,0,1,0
4896,2011,10,RENT,1,Low,1,14000, 60 months,2,debt_consolidation,6,High,2,Good Loan,0,19.42,E,5,15.14,20643.08732,14000,0,366.42,409000004895,16-Jan-18,Indiaforensic MASTER ACQ DOM1701,,556106.97,-547626306.39,Davide,784,France,143204.41,0,1,0
4897,2011,5,RENT,1,Low,1,18000, 60 months,2,credit_card,1,High,2,Bad Loan,1,17.58,D,4,10.33,4564.78,1582.62,943.23,452.98,409000004896,16-Jan-18,Indiaforensic VISA ACQ DOM170118,,937527.53,-546688778.86,Parkes,605,France,28427.84,0,1,0
4898,2011,6.05,OWN,2,Low,1,15000, 60 months,2,credit_card,1,Low,1,Bad Loan,1,11.71,B,2,21.04,1651.4,940.35,0,331.48,409000004897,16-Jan-18,Indiaforensic RUPAY POS ACQ17011,,1547728.28,-545141050.58,Mazzanti,699,Spain,78387.32,0,1,0
4899,2011,5,RENT,1,Low,1,10000, 36 months,1,small_business,3,High,2,Good Loan,0,13.49,C,3,11.39,12211.6552,10000,0,339.31,409000004898,16-Jan-18,TRF TO  Indiaforensic SERVICES I,"3,100,000.00",,-548241050.58,Findlay,544,France,161076.92,0,1,0
4900,2011,4,MORTGAGE,3,Low,1,35000, 60 months,2,debt_consolidation,6,High,2,Good Loan,0,13.49,C,3,5.89,41011.9,35000,0,805.17,409000004899,17-Jan-18,Indiaforensic MASTER ACQ DOM1701,,690219.65,-547550830.93,Hsu,803,France,54277.45,0,1,0
4901,2011,0.5,RENT,1,Low,1,2000, 36 months,1,credit_card,1,Low,1,Good Loan,0,7.9,A,1,23.06,2164.23,2000,0,62.59,409000004900,17-Jan-18,Indiaforensic VISA ACQ DOM170118,,914099.32,-546636731.61,Chukwukadibia,735,France,137180.95,0,1,0
4902,2011,2,MORTGAGE,3,Low,1,25000, 60 months,2,debt_consolidation,6,High,2,Good Loan,0,17.58,D,4,9.59,31349,19132.51,0,629.14,409000004901,17-Jan-18,Indiaforensic RUPAY POS ACQ17011,,1510243.85,-545126487.76,Baxter,673,France,21063.71,0,1,0
4903,2011,10,MORTGAGE,3,Low,1,13000, 36 months,1,debt_consolidation,6,Low,1,Good Loan,0,8.9,A,1,18.53,14752.38955,13000,0,412.8,409000004902,17-Jan-18,TRF TO  Indiaforensic SERVICES I,"3,000,000.00",,-548126487.76,Kung,652,France,152210.81,0,1,0
4904,2011,1,MORTGAGE,3,Medium,2,21000, 36 months,1,debt_consolidation,6,Low,1,Good Loan,0,7.9,A,1,14.73,23377.48,21000,0,657.1,409000004903,17-Jan-18,Indiaforensic MASTER INT SET 01-,,1047.42,-548125440.34,Booth,694,France,88890.75,0,1,0
4905,2011,6.05,MORTGAGE,3,Low,1,15000, 36 months,1,other,4,Low,1,Good Loan,0,6.03,A,1,13.41,16435.01786,15000,0,456.54,409000004904,18-Jan-18,Indiaforensic MASTER ACQ DOM1801,,616016.25,-547509424.09,Evans,741,France,190534.76,0,1,0
4906,2011,5,MORTGAGE,3,Medium,2,30000, 60 months,2,debt_consolidation,6,Low,1,Good Loan,0,12.42,B,2,12.07,34979.17,29999.99,0,673.72,409000004905,18-Jan-18,Indiaforensic VISA ACQ DOM180118,,718938.13,-546790485.96,Kung,590,Spain,83090.35,0,1,0
4907,2011,4,MORTGAGE,3,Medium,2,26375, 36 months,1,credit_card,1,Low,1,Good Loan,0,9.91,B,2,17.33,28475.2,26375,0,849.94,409000004906,18-Jan-18,Indiaforensic RUPAY POS ACQ18011,,1625683.75,-545164802.21,Tung,809,Spain,141426.78,0,1,0
4908,2011,6,RENT,1,Low,1,1000, 36 months,1,vacation,11,Low,1,Good Loan,0,7.51,A,1,12.21,1079.4,1000,0,31.12,409000004907,18-Jan-18,TRF TO  Indiaforensic SERVICES I,"3,000,000.00",,-548164802.21,Yuan,523,France,51358.66,0,1,0
4909,2011,7,MORTGAGE,3,Low,1,14000, 60 months,2,debt_consolidation,6,Low,1,Good Loan,0,9.91,B,2,8.84,14840.92,11161.42,0,296.84,409000004908,19-Jan-18,Indiaforensic MASTER ACQ DOM1901,,563214.64,-547601587.57,Jackson,540,France,88703.04,0,1,0
4910,2011,6,OWN,2,Low,1,6200, 36 months,1,debt_consolidation,6,Low,1,Good Loan,0,10.65,B,2,4.01,6731.3,6200,0,201.96,409000004909,19-Jan-18,Indiaforensic VISA ACQ DOM190118,,946977.06,-546654610.51,Ross,596,Spain,116696.77,0,1,0
4911,2011,10,RENT,1,Low,1,1500, 36 months,1,other,4,Low,1,Bad Loan,1,9.91,B,2,8.21,529.87,410.77,0,48.34,409000004910,19-Jan-18,Indiaforensic RUPAY POS ACQ19011,,1201744.86,-545452865.65,Yang,597,France,7156.09,0,1,0
4912,2011,10,MORTGAGE,3,Low,1,1000, 36 months,1,medical,9,High,2,Good Loan,0,15.27,C,3,10.77,1252.69,999.99,0,34.8,409000004911,19-Jan-18,Indiaforensic MASTER INT SET 180,,412.91,-545452452.74,Yu,407,Spain,49161.12,0,1,0
4913,2011,6,RENT,1,Low,1,9500, 60 months,2,small_business,3,High,2,Bad Loan,1,18.25,D,4,10.62,3394.58,1507.98,19.6,242.54,409000004912,19-Jan-18,TRF TO  Indiaforensic SERVICES I,"2,800,000.00",,-548252452.74,Onwumelu,748,France,126743.33,0,1,0
4914,2011,10,MORTGAGE,3,Low,1,20000, 60 months,2,credit_card,1,High,2,Good Loan,0,17.27,D,4,16.34,28193.51148,20000,0,499.96,409000004913,20-Jan-18,Indiaforensic VISA ACQ INT 19011,,1372.42,-548251080.32,Gay,562,France,65390.46,0,1,0
4915,2011,7,RENT,1,Medium,2,6000, 36 months,1,debt_consolidation,6,Low,1,Good Loan,0,7.9,A,1,10.72,6187.59,6000,0,187.75,409000004914,20-Jan-18,Indiaforensic VISA ACQ DOM200118,,771276.92,-547479803.40,Morrison,734,Germany,138835.91,0,1,0
4916,2011,4,RENT,1,Low,1,8800, 36 months,1,debt_consolidation,6,High,2,Good Loan,0,14.27,C,3,9.57,10864.61179,8800,0,301.92,409000004915,20-Jan-18,Indiaforensic RUPAY POS ACQ20011,,1259418.39,-546220385.01,Belov,710,France,36154.66,0,1,0
4917,2011,1,RENT,1,Medium,2,28000, 36 months,1,debt_consolidation,6,Low,1,Good Loan,0,9.91,B,2,2.14,30381.36,28000,0,902.3,409000004916,20-Jan-18,TRF TO  Indiaforensic SERVICES I,"2,000,000.00",,-548220385.01,Mao,539,Spain,59755.14,0,1,0
4918,2011,8,MORTGAGE,3,Medium,2,15000, 36 months,1,debt_consolidation,6,Low,1,Good Loan,0,6.62,A,1,2.97,15241.96,15000,0,460.56,409000004917,22-Jan-18,Indiaforensic MASTER ACQ DOM2101,,554098.56,-547666286.45,Walsh,542,France,125302.64,0,1,0
4919,2011,4,RENT,1,Low,1,8000, 36 months,1,credit_card,1,Low,1,Good Loan,0,6.62,A,1,8.06,8181.96,8000,0,245.63,409000004918,22-Jan-18,Indiaforensic VISA ACQ INT 20011,,494.50,-547665791.95,Bruno,717,France,94274.72,0,1,0
4920,2011,1,RENT,1,Low,1,14400, 36 months,1,credit_card,1,Low,1,Good Loan,0,11.71,B,2,14.76,16941.66,14400,0,476.3,409000004919,22-Jan-18,Indiaforensic VISA ACQ INT 21011,,16318.50,-547649473.45,Gray,682,Spain,102260.16,0,1,0
4921,2011,10,MORTGAGE,3,Low,1,14000, 36 months,1,debt_consolidation,6,Low,1,Good Loan,0,6.03,A,1,11.43,15339.3829,14000,0,426.1,409000004920,22-Jan-18,Indiaforensic RUPAY POS ACQ21011,,1225988.70,-546423484.75,Maurer,515,France,136028.97,0,1,0
4922,2011,2,RENT,1,Low,1,12000, 36 months,1,wedding,5,High,2,Good Loan,0,14.27,C,3,7.2,14818.69773,12000,0,411.71,409000004921,22-Jan-18,Indiaforensic VISA ACQ DOM220118,,1628007.45,-544795477.30,Chiang,526,Spain,110114.38,0,1,0
4923,2011,1,MORTGAGE,3,Low,1,13800, 60 months,2,debt_consolidation,6,High,2,Good Loan,0,17.27,D,4,14.52,18550.14402,13800,0,344.98,409000004922,22-Jan-18,Indiaforensic MASTER ACQ DOM2201,,592161.06,-544203316.24,Cattaneo,702,France,100442.22,0,1,0
4924,2011,10,MORTGAGE,3,Low,1,27575, 60 months,2,home_improvement,7,High,2,Bad Loan,1,17.58,D,4,10.76,3695.23,1179.57,933.59,693.94,409000004923,22-Jan-18,Indiaforensic RUPAY POS ACQ22011,,732959.29,-543470356.95,Grieve,651,Germany,193597.94,0,1,0
4925,2011,5,MORTGAGE,3,Low,1,16000, 36 months,1,debt_consolidation,6,Low,1,Good Loan,0,8.9,A,1,21.66,18156.9172,16000,0,508.06,409000004924,22-Jan-18,Indiaforensic MASTER ACQ DOM2001,,668644.13,-542801712.82,Lowell,792,Germany,1871.25,0,1,0
4926,2011,10,OWN,2,Low,1,25000, 60 months,2,debt_consolidation,6,High,2,Good Loan,0,19.03,E,5,18.65,32397.36,19019.23,0,648.93,409000004925,22-Jan-18,TRF TO  Indiaforensic SERVICES I,"5,400,000.00",,-548201712.82,Trentino,817,Germany,42831.11,0,1,0
4927,2011,10,MORTGAGE,3,Low,1,3800, 36 months,1,debt_consolidation,6,Low,1,Good Loan,0,6.03,A,1,17.47,3890.71,3800,0,115.66,409000004926,23-Jan-18,Indiaforensic VISA ACQ DOM230118,,947487.29,-547254225.53,Sung,674,Germany,182156.86,0,1,0
4928,2011,10,RENT,1,High,3,12000, 36 months,1,debt_consolidation,6,High,2,Bad Loan,1,17.27,D,4,16.42,14371.84,10601.12,199.57,429.45,409000004927,23-Jan-18,Indiaforensic RUPAY POS ACQ23011,,1535844.67,-545718380.86,Yen,641,France,151648.66,0,1,0
4929,2011,10,MORTGAGE,3,Low,1,20000, 36 months,1,home_improvement,7,High,2,Bad Loan,1,17.58,D,4,11.82,15095.35,10369.97,18.4,718.85,409000004928,23-Jan-18,Indiaforensic MASTER ACQ DOM2301,,630402.37,-545087978.49,Philipp,513,Spain,146738.83,0,1,0
4930,2011,3,RENT,1,Low,1,3500, 36 months,1,small_business,3,Low,1,Good Loan,0,12.69,B,2,9.9,4182.26567,3500,0,117.41,409000004929,23-Jan-18,Indiaforensic VISA ACQ INT 22011,,5201.95,-545082776.54,Dynon,561,France,12148.20,0,1,0
4931,2011,10,MORTGAGE,3,Medium,2,35000, 60 months,2,debt_consolidation,6,High,2,Bad Loan,1,22.74,G,7,17.8,25280.77,6308.4,8607.17,981.45,409000004930,23-Jan-18,TRF TO  Indiaforensic SERVICES I,"3,000,000.00",,-548082776.54,Alexeyeva,627,Germany,118029.09,0,1,0
4932,2011,5,RENT,1,Low,1,11975, 36 months,1,debt_consolidation,6,High,2,Good Loan,0,16.29,D,4,6.38,13414.33,11975,0,422.73,409000004931,23-Jan-18,Indiaforensic MASTER INT SET 20-,,19634.99,-548063141.55,Hs?eh,682,Germany,50783.88,0,1,0
4933,2011,3,RENT,1,Low,1,15000, 60 months,2,medical,9,High,2,Bad Loan,1,17.58,D,4,9.5,14956.13,7527.25,1055.06,377.49,409000004932,24-Jan-18,Indiaforensic MASTER ACQ DOM2401,,511540.86,-547551600.69,Ferri,683,France,129891.66,0,1,0
4934,2011,8,OWN,2,Low,1,20000, 60 months,2,debt_consolidation,6,Low,1,Good Loan,0,12.42,B,2,10.23,21397.51,20000,0,449.15,409000004933,24-Jan-18,Indiaforensic VISA ACQ DOM240118,,779976.47,-546771624.22,Hsu,420,Germany,9904.63,0,1,0
4935,2011,10,MORTGAGE,3,Low,1,25000, 60 months,2,debt_consolidation,6,High,2,Bad Loan,1,17.58,D,4,14.61,21630.52,10157.12,2255.43,629.14,409000004934,24-Jan-18,Indiaforensic RUPAY POS ACQ24011,,1190785.44,-545580838.78,Bishop,670,France,63213.31,0,1,0
4936,2011,2,RENT,1,Medium,2,29550, 36 months,1,debt_consolidation,6,Low,1,Good Loan,0,8.9,A,1,22.86,33634.33725,29550,0,938.31,409000004935,24-Jan-18,Indiaforensic VISA ACQ INT 23011,,13846.00,-545566992.78,Toscani,505,Germany,137565.87,0,1,0
4937,2011,3,RENT,1,Low,1,35000, 36 months,1,debt_consolidation,6,High,2,Good Loan,0,18.25,D,4,14.27,42517.85,35000,0,1269.73,409000004936,24-Jan-18,TRF TO  Indiaforensic SERVICES I,"2,700,000.00",,-548266992.78,T'ao,580,Germany,17185.95,0,1,0
4938,2011,2,MORTGAGE,3,Low,1,25000, 60 months,2,debt_consolidation,6,Low,1,Good Loan,0,10.65,B,2,15.38,26898.92,19822.28,0,539.21,409000004937,25-Jan-18,Indiaforensic MASTER ACQ DOM2501,,590574.36,-547676418.42,Philip,577,France,143783.46,0,1,0
4939,2011,2,RENT,1,Low,1,8400, 36 months,1,debt_consolidation,6,High,2,Good Loan,0,18.25,D,4,20.48,10966.725,8400,0,304.74,409000004938,25-Jan-18,Indiaforensic VISA ACQ DOM250118,,753365.83,-546923052.59,Li Fonti,773,Germany,36823.28,0,1,0
4940,2011,10,MORTGAGE,3,Medium,2,25000, 60 months,2,small_business,3,High,2,Good Loan,0,17.27,D,4,24.17,31213.48,19200.52,0,624.95,409000004939,25-Jan-18,Indiaforensic RUPAY POS ACQ25011,,1303777.92,-545619274.67,Rene,616,France,154957.66,0,1,0
4941,2011,9,MORTGAGE,3,Low,1,6500, 36 months,1,debt_consolidation,6,Low,1,Good Loan,0,11.71,B,2,12.65,6625.33,6500,0,215,409000004940,25-Jan-18,Indiaforensic VISA ACQ INT 24011,,1256.96,-545618017.71,Daigle,763,France,31892.82,0,1,0
4942,2011,10,RENT,1,Low,1,15000, 60 months,2,debt_consolidation,6,High,2,Bad Loan,1,18.25,D,4,15.46,4221.8,1473.11,794.24,382.95,409000004941,25-Jan-18,Indiaforensic MASTER INT SET 230,,31322.77,-545586694.94,Joshua,640,Spain,191084.40,0,1,0
4943,2011,10,MORTGAGE,3,Medium,2,35000, 36 months,1,debt_consolidation,6,High,2,Good Loan,0,14.27,C,3,14.59,43221.23529,35000,0,1200.82,409000004942,25-Jan-18,TRF TO  Indiaforensic SERVICES I,"2,600,000.00",,-548186694.94,Simmons,592,France,179718.17,0,1,0
4944,2011,10,RENT,1,Low,1,10000, 36 months,1,credit_card,1,Low,1,Good Loan,0,10.65,B,2,12.99,11724.93473,10000,0,325.74,409000004943,29-Jan-18,Indiaforensic MASTER ACQ DOM2601,,713683.39,-547473011.55,Jamieson,528,Spain,159823.16,0,1,0
4945,2011,1,RENT,1,Low,1,7000, 36 months,1,vacation,11,Low,1,Good Loan,0,6.03,A,1,15.68,7409.53,7000,0,213.05,409000004944,29-Jan-18,Indiaforensic VISA ACQ DOM260118,,626069.70,-546846941.85,Hou,630,France,114110.97,0,1,0
4946,2011,5,MORTGAGE,3,Low,1,30000, 60 months,2,debt_consolidation,6,Low,1,Good Loan,0,12.42,B,2,24.23,35673.77,30000.01,0,673.72,409000004945,29-Jan-18,Indiaforensic RUPAY POS ACQ26011,,1302405.91,-545544535.94,Cochran,529,France,60993.23,0,1,0
4947,2011,10,MORTGAGE,3,Low,1,18000, 60 months,2,home_improvement,7,High,2,Bad Loan,1,15.27,C,3,9.9,9906.81,5318.91,0,430.78,409000004946,29-Jan-18,Indiaforensic MASTER ACQ DOM2701,,681274.47,-544863261.47,Bibb,546,France,66408.01,0,1,0
4948,2011,1,RENT,1,Low,1,15000, 36 months,1,credit_card,1,Low,1,Good Loan,0,6.03,A,1,14.71,16412.31076,15000,0,456.54,409000004947,29-Jan-18,Indiaforensic VISA ACQ DOM270118,,841738.95,-544021522.52,Jen,753,France,136398.90,0,1,0
4949,2011,10,MORTGAGE,3,Low,1,6000, 36 months,1,vacation,11,Low,1,Good Loan,0,6.62,A,1,12.09,6631.385136,6000,0,184.23,409000004948,29-Jan-18,Indiaforensic RUPAY POS ACQ27011,,1243129.56,-542778392.96,Corran,772,Spain,140709.25,0,1,0
4950,2011,10,MORTGAGE,3,Medium,2,12000, 36 months,1,debt_consolidation,6,Low,1,Good Loan,0,6.62,A,1,9.06,13263.15784,12000,0,368.45,409000004949,29-Jan-18,Indiaforensic RUPAY POS ACQ28011,,1434625.98,-541343766.98,He,567,France,8555.73,0,1,0
4951,2011,4,RENT,1,Medium,2,2800, 36 months,1,small_business,3,High,2,Good Loan,0,13.49,C,3,15.7,3417.49282,2800,0,95.01,409000004950,29-Jan-18,Indiaforensic VISA ACQ INT 28011,,341.20,-541343425.78,Loggia,628,Germany,115022.94,0,1,0
4952,2011,8,MORTGAGE,3,Low,1,15075, 36 months,1,debt_consolidation,6,Low,1,Good Loan,0,6.03,A,1,12.99,16094.24,15075,0,458.82,409000004951,29-Jan-18,Indiaforensic VISA ACQ DOM290118,,1626848.53,-539716577.25,Lovely,658,France,187638.34,0,1,0
4953,2011,0.5,RENT,1,Low,1,13500, 60 months,2,debt_consolidation,6,High,2,Good Loan,0,17.27,D,4,23.65,19139.40241,13500,0,337.48,409000004952,29-Jan-18,Indiaforensic RUPAY POS ACQ29011,,1188258.26,-538528318.99,Becker,679,Spain,3829.13,0,1,0
4954,2011,4,MORTGAGE,3,Low,1,5750, 60 months,2,debt_consolidation,6,High,2,Good Loan,0,14.27,C,3,18.11,6717.31,4480.79,0,134.6,409000004953,29-Jan-18,Indiaforensic MASTER ACQ DOM2901,,1210579.27,-537317739.72,Plascencia,629,Spain,119357.93,0,1,0
4955,2011,3,MORTGAGE,3,Low,1,16000, 60 months,2,small_business,3,High,2,Good Loan,0,17.27,D,4,1.94,19972.85,12286.49,0,399.97,409000004954,29-Jan-18,TRF TO  Indiaforensic SERVICES I,"10,900,000.00",,-548217739.72,Somadina,731,Spain,192175.52,0,1,0
4956,2011,0.5,OWN,2,Low,1,5000, 36 months,1,credit_card,1,High,2,Good Loan,0,16.29,D,4,9.79,5912.91,5000,0,176.51,409000004955,30-Jan-18,Indiaforensic MASTER ACQ DOM3001,,8941636.79,-539276102.93,Walker,775,Germany,128841.31,0,1,0
4957,2011,10,MORTGAGE,3,Medium,2,15000, 60 months,2,home_improvement,7,Low,1,Good Loan,0,10.65,B,2,17.04,16105.49,11870.6,0,323.53,409000004956,30-Jan-18,Indiaforensic VISA ACQ DOM300118,,746613.80,-538529489.13,Alekseeva,660,Spain,150422.35,0,1,0
4958,2011,5,RENT,1,Low,1,23850, 36 months,1,debt_consolidation,6,High,2,Good Loan,0,16.29,D,4,24.29,30138.95148,23850,0,841.92,409000004957,30-Jan-18,Indiaforensic RUPAY POS ACQ30011,,1411532.84,-537117956.29,Watson,752,France,188187.05,0,1,0
4959,2011,1,RENT,1,High,3,35000, 60 months,2,debt_consolidation,6,High,2,Good Loan,0,19.42,E,5,8.78,37773.52,35000,0,916.03,409000004958,30-Jan-18,Indiaforensic MASTER ACQ DOM3001,"8,941,636.79",,-546059593.08,Zotov,655,France,1775.52,0,1,0
4960,2011,3,MORTGAGE,3,Low,1,12000, 60 months,2,small_business,3,High,2,Bad Loan,1,19.03,E,5,15.45,13082.58,7133.83,45.9,311.49,409000004959,30-Jan-18,Indiaforensic MASTER ACQ DOM3001,,726562.21,-545333030.87,Williamson,543,Spain,85086.78,0,1,0
4961,2011,7,RENT,1,Low,1,7200, 36 months,1,debt_consolidation,6,High,2,Good Loan,0,14.27,C,3,15.28,7306.07,7200,0,247.03,409000004960,30-Jan-18,Indiaforensic MASTER INT SET 290,,1001.93,-545332028.94,Carpenter,811,France,3797.79,0,1,0
4962,2011,0.5,MORTGAGE,3,Low,1,6000, 36 months,1,major_purchase,8,Low,1,Good Loan,0,7.51,A,1,14.34,6678.227821,6000,0,186.67,409000004961,30-Jan-18,TRF TO  Indiaforensic SERVICES I,"2,900,000.00",,-548232028.94,Cattaneo,689,Germany,150856.38,0,1,0
4963,2011,6.05,MORTGAGE,3,Low,1,11100, 60 months,2,major_purchase,8,High,2,Good Loan,0,13.49,C,3,20.27,15100.32003,11100,0,255.36,409000004962,31-Jan-18,Indiaforensic MASTER ACQ DOM3101,,649780.58,-547582248.36,Gordon,531,France,90537.47,0,1,0
4964,2011,5,RENT,1,Low,1,4200, 36 months,1,other,4,Low,1,Bad Loan,1,9.91,B,2,16.06,1081.6,828.07,0,135.35,409000004963,31-Jan-18,Indiaforensic RUPAY POS ACQ31011,,1282120.87,-546300127.49,Boni,515,France,166370.81,0,1,0
4965,2011,6,MORTGAGE,3,Low,1,17500, 36 months,1,debt_consolidation,6,Low,1,Good Loan,0,8.9,A,1,16.82,19147.01,17500,0,555.69,409000004964,31-Jan-18,Indiaforensic VISA ACQ DOM310118,,912070.21,-545388057.28,Lynch,466,France,178994.13,0,1,0
4966,2011,1,OWN,2,Low,1,8400, 36 months,1,major_purchase,8,Low,1,Good Loan,0,6.03,A,1,6.57,8523.5,8400,0,255.66,409000004965,31-Jan-18,Indiaforensic MASTER INT SET 300,,431.93,-545387625.35,McCarthy,782,France,195681.43,0,1,0
4967,2011,10,OWN,2,Low,1,34475, 60 months,2,small_business,3,Low,1,Good Loan,0,12.42,B,2,11.67,45476.20818,34475.01,0,774.22,409000004966,1-Feb-18,TRF TO  Indiaforensic SERVICES I,"500,000.00",,-545887625.35,Davies,611,France,53277.15,0,1,0
4968,2011,2,RENT,1,Low,1,8000, 36 months,1,debt_consolidation,6,High,2,Bad Loan,1,13.49,C,3,14.92,1338.07,737.31,253.87,271.45,409000004967,1-Feb-18,TRF TO  Indiaforensic SERVICES I,"2,000,000.00",,-547887625.35,Hargreaves,621,Germany,172490.78,0,1,0
4969,2011,6,RENT,1,Low,1,7200, 60 months,2,home_improvement,7,High,2,Good Loan,0,18.64,E,5,13.56,9252.38,5488.22,0,185.35,409000004968,1-Feb-18,Indiaforensic MASTER INT SET 310,,9260.87,-547878364.48,Blackburn,604,Spain,11819.84,0,1,0
4970,2011,6,RENT,1,Low,1,6800, 36 months,1,debt_consolidation,6,Low,1,Good Loan,0,8.9,A,1,13.04,7453.95,6800,0,215.93,409000004969,1-Feb-18,Indiaforensic MASTER ACQ DOM0102,,653648.49,-547224715.99,K?,655,Spain,82900.25,0,1,0
4971,2011,4,RENT,1,Low,1,15625, 36 months,1,credit_card,1,Low,1,Good Loan,0,9.91,B,2,26.69,17648.57,15625,0,503.52,409000004970,1-Feb-18,Indiaforensic VISA ACQ DOM010218,,835914.60,-546388801.39,Meng,689,Spain,82709.80,0,1,0
4972,2011,0.5,RENT,1,Low,1,7000, 36 months,1,moving,10,Low,1,Good Loan,0,8.9,A,1,16.9,8006.35918,7000,0,222.28,409000004971,1-Feb-18,Indiaforensic RUPAY POS ACQ01021,,1481779.33,-544907022.06,Cattaneo,681,Spain,180593.45,0,1,0
4973,2011,10,RENT,1,Medium,2,8000, 36 months,1,debt_consolidation,6,Low,1,Good Loan,0,11.71,B,2,20.83,9152.29,8000,0,264.61,409000004972,1-Feb-18,TRF TO  Indiaforensic SERVICES I,"3,300,000.00",,-548207022.06,Hunt,643,Germany,172363.41,0,1,0
4974,2011,10,OWN,2,Low,1,35000, 36 months,1,other,4,High,2,Bad Loan,1,16.77,D,4,18.19,18758.31,11560.1,1345.75,1243.85,409000004973,2-Feb-18,Indiaforensic MASTER ACQ DOM0202,,621251.50,-547585770.56,Owens,617,France,91195.12,0,1,0
4975,2011,10,RENT,1,Low,1,4800, 36 months,1,moving,10,Low,1,Good Loan,0,12.69,B,2,14,5668.097022,4800,0,161.02,409000004974,2-Feb-18,Indiaforensic VISA ACQ DOM020218,,803259.90,-546782510.66,Steele,638,Spain,108987.25,0,1,0
4976,2011,2,OWN,2,Low,1,20000, 36 months,1,house,12,Low,1,Good Loan,0,12.42,B,2,23.32,24055.86436,20000,0,668.31,409000004975,2-Feb-18,Indiaforensic RUPAY POS ACQ02021,,1452688.23,-545329822.43,Kennedy,743,France,44265.28,0,1,0
4977,2011,9,RENT,1,Low,1,8400, 36 months,1,other,4,Low,1,Good Loan,0,6.03,A,1,2.32,9105.7,8400,0,255.66,409000004976,3-Feb-18,Indiaforensic VISA ACQ DOM030218,,798365.55,-544531456.88,Pan,828,Germany,116613.26,0,1,0
4978,2011,2,RENT,1,Low,1,12000, 36 months,1,debt_consolidation,6,Low,1,Good Loan,0,12.42,B,2,12.92,14074.83,12000,0,400.99,409000004977,3-Feb-18,Indiaforensic RUPAY POS ACQ03021,,1308747.51,-543222709.37,Alexander,776,Spain,148527.56,0,1,0
4979,2011,7,MORTGAGE,3,Low,1,10000, 36 months,1,debt_consolidation,6,Low,1,Good Loan,0,10.65,B,2,19.07,10586.08,10000,0,325.74,409000004978,3-Feb-18,TRF TO  Indiaforensic SERVICES I,"2,000,000.00",,-545222709.37,Bray,540,Germany,84239.46,0,1,0
4980,2011,10,MORTGAGE,3,Low,1,35000, 60 months,2,debt_consolidation,6,High,2,Good Loan,0,16.77,D,4,2.95,43220.11,26945.41,0,865.52,409000004979,3-Feb-18,TRF TO  Indiaforensic SERVICES I,"500,000.00",,-545722709.37,Nnabuife,616,Germany,62002.04,0,1,0
4981,2011,6,RENT,1,Low,1,9000, 36 months,1,debt_consolidation,6,Low,1,Good Loan,0,7.9,A,1,17.62,10137.29494,9000,0,281.62,409000004980,3-Feb-18,TRF TO  Indiaforensic SERVICES I,"2,000,000.00",,-547722709.37,Padovesi,628,Germany,46044.48,0,1,0
4982,2011,10,MORTGAGE,3,Low,1,12000, 60 months,2,other,4,Low,1,Good Loan,0,7.9,A,1,9.69,13244.19,12000,0,242.75,409000004981,3-Feb-18,TRF TO  Indiaforensic SERVICES I,"500,000.00",,-548222709.37,Bray,667,Spain,169669.33,0,1,0
4983,2011,6,MORTGAGE,3,Medium,2,23000, 36 months,1,debt_consolidation,6,High,2,Good Loan,0,18.25,D,4,14.96,27179.39,23000,0,834.4,409000004982,5-Feb-18,Indiaforensic MASTER ACQ DOM0302,,690907.86,-547531801.51,Lucas,615,France,156346.84,0,1,0
4984,2011,3,RENT,1,Low,1,6250, 36 months,1,debt_consolidation,6,Low,1,Good Loan,0,8.9,A,1,8.97,7143.540233,6250,0,198.46,409000004983,5-Feb-18,Indiaforensic MASTER ACQ DOM0502,,1586494.06,-545945307.45,Tinline,543,France,157711.18,0,1,0
4985,2011,1,RENT,1,Low,1,7200, 36 months,1,debt_consolidation,6,High,2,Good Loan,0,13.49,C,3,14.6,8517.37,7200,0,244.3,409000004984,5-Feb-18,Indiaforensic VISA ACQ DOM050218,,1556744.94,-544388562.51,Esomchi,553,France,89087.40,0,1,0
4986,2011,8,MORTGAGE,3,Low,1,12500, 36 months,1,credit_card,1,Low,1,Bad Loan,1,6.03,A,1,8.9,13517.99,5621.13,7051.87,380.45,409000004985,5-Feb-18,Indiaforensic RUPAY POS ACQ04021,,1544881.94,-542843680.57,Liao,554,Germany,8742.36,0,1,0
4987,2011,5,MORTGAGE,3,Low,1,5000, 60 months,2,major_purchase,8,Low,1,Good Loan,0,11.71,B,2,15.7,6526.97145,5000,0,110.5,409000004986,5-Feb-18,Indiaforensic RUPAY POS ACQ05021,,955577.98,-541888102.59,Iroawuchi,684,Spain,117038.96,0,1,0
4988,2011,7,MORTGAGE,3,Low,1,6000, 36 months,1,car,2,Low,1,Good Loan,0,8.9,A,1,18.28,6808.177045,6000,0,190.52,409000004987,5-Feb-18,TRF TO  Indiaforensic SERVICES I,"6,000,000.00",,-547888102.59,Retana,452,France,164241.67,0,1,0
4989,2011,4,MORTGAGE,3,Low,1,12000, 60 months,2,debt_consolidation,6,High,2,Good Loan,0,15.27,C,3,16.51,12883.2,12000,0,287.19,409000004988,6-Feb-18,Indiaforensic MASTER ACQ DOM0602,,777289.47,-547110813.12,Fang,606,France,137720.56,0,1,0
4990,2011,10,RENT,1,Low,1,17000, 60 months,2,debt_consolidation,6,Low,1,Bad Loan,1,12.42,B,2,25.18,15223.42,9212.65,1112.68,381.78,409000004989,6-Feb-18,Indiaforensic VISA ACQ DOM060218,,778192.85,-546332620.27,Ozioma,629,France,106.67,0,1,0
4991,2011,10,OWN,2,Low,1,25000, 60 months,2,debt_consolidation,6,High,2,Bad Loan,1,18.25,D,4,13.44,7749.86,780.49,5848.43,638.25,409000004990,6-Feb-18,Indiaforensic RUPAY POS ACQ06021,,2102529.40,-544230090.87,Robson,659,Spain,1539.21,0,1,0
4992,2011,7,RENT,1,Low,1,16500, 60 months,2,debt_consolidation,6,High,2,Good Loan,0,14.27,C,3,19.71,22933.32996,16500,0,386.24,409000004991,6-Feb-18,Indiaforensic VISA ACQ INT 01021,,54441.89,-544175648.98,Bruno,493,France,59659.53,0,1,0
4993,2011,8,MORTGAGE,3,Low,1,5000, 36 months,1,credit_card,1,Low,1,Good Loan,0,6.03,A,1,14.27,5478.514665,5000,0,152.18,409000004992,6-Feb-18,TRF TO  Indiaforensic SERVICES I,"4,000,000.00",,-548175648.98,Price,794,France,173586.63,0,1,0
4994,2011,0.5,MORTGAGE,3,Low,1,35000, 60 months,2,home_improvement,7,Low,1,Good Loan,0,12.69,B,2,9.67,40235.75,35000,0,790.82,409000004993,7-Feb-18,Indiaforensic MASTER ACQ DOM0702,,856224.02,-547319424.96,Swanson,554,France,126033.90,0,1,0
4995,2011,1,MORTGAGE,3,Low,1,11500, 36 months,1,debt_consolidation,6,Low,1,Bad Loan,1,6.03,A,1,24.3,7698.9,6778.58,0,350.01,409000004994,7-Feb-18,Indiaforensic VISA ACQ DOM070218,,990089.12,-546329335.84,Chang,796,Germany,62808.93,0,1,0
4996,2011,4,MORTGAGE,3,Low,1,6600, 36 months,1,debt_consolidation,6,High,2,Good Loan,0,14.27,C,3,4.07,7841.22,6600,0,226.44,409000004995,7-Feb-18,Indiaforensic RUPAY POS ACQ07021,,1623600.65,-544705735.19,Morgan,807,France,147007.33,0,1,0
4997,2011,6.05,MORTGAGE,3,Low,1,7200, 36 months,1,other,4,Low,1,Good Loan,0,7.9,A,1,18.5,8110.230042,7200,0,225.29,409000004996,7-Feb-18,TRF TO  Indiaforensic SERVICES I,"3,000,000.00",,-547705735.19,Nwebube,500,Germany,196261.64,0,1,0
4998,2011,10,MORTGAGE,3,Low,1,8000, 36 months,1,other,4,Low,1,Good Loan,0,6.03,A,1,9.49,8753.973604,8000,0,243.49,409000004997,8-Feb-18,Indiaforensic VISA ACQ INT 04021,,148.35,-547705586.84,Trevisan,722,Spain,44560.17,0,1,0
4999,2011,0.5,MORTGAGE,3,Low,1,24000, 36 months,1,credit_card,1,High,2,Good Loan,0,19.03,E,5,13.13,30605.81754,24000,0,880.11,409000004998,8-Feb-18,Indiaforensic VISA ACQ INT 03021,,98.90,-547705487.94,Ositadimma,559,Spain,18917.95,0,1,0
5000,2011,10,RENT,1,Low,1,2000, 36 months,1,other,4,Low,1,Good Loan,0,12.69,B,2,21.06,2413.792479,2000,0,67.09,409000004999,8-Feb-18,Indiaforensic RUPAY POS ACQ08021,,931299.07,-546774188.87,Cunningham,584,Spain,4525.40,0,1,0
5001,2011,10,MORTGAGE,3,Low,1,7000, 36 months,1,credit_card,1,Low,1,Good Loan,0,6.62,A,1,16,7736.092664,7000,0,214.93,409000005000,8-Feb-18,Indiaforensic VISA ACQ DOM080218,,923454.02,-545850734.85,Fields,834,Germany,93112.20,0,1,0
5002,2011,2,RENT,1,Low,1,7200, 36 months,1,debt_consolidation,6,Low,1,Good Loan,0,12.42,B,2,6.14,8680.719006,7200,0,240.59,409000005001,8-Feb-18,Indiaforensic MASTER ACQ DOM0802,,749543.11,-545101191.74,Johnston,754,Spain,9658.41,0,1,0
5003,2011,0.5,RENT,1,Medium,2,22000, 36 months,1,debt_consolidation,6,High,2,Good Loan,0,14.65,C,3,1.82,23407.62,22000,0,758.88,409000005002,8-Feb-18,Indiaforensic POS ACQ SETTL 0802,"931,299.07",,-546032490.81,Vasilyev,590,France,182627.25,0,1,0
5004,2011,3,MORTGAGE,3,Low,1,18750, 36 months,1,debt_consolidation,6,Low,1,Good Loan,0,7.9,A,1,13.94,21120.13645,18750,0,586.7,409000005003,8-Feb-18,Indiaforensic POS ACQ SETTL 0802,,930249.22,-545102241.59,Hooper,740,France,13177.40,0,1,0
5005,2011,3,MORTGAGE,3,Low,1,12500, 36 months,1,credit_card,1,Low,1,Good Loan,0,7.9,A,1,24.15,14080.04334,12500,0,391.13,409000005004,8-Feb-18,TRF TO  Indiaforensic SERVICES I,"3,000,000.00",,-548102241.59,Colombo,502,Germany,43568.31,0,1,0
5006,2011,5,RENT,1,Low,1,11000, 36 months,1,debt_consolidation,6,Low,1,Good Loan,0,7.51,A,1,19.88,12318.62307,11000,0,342.22,409000005005,9-Feb-18,Indiaforensic MASTER ACQ DOM0902,,669583.55,-547432658.04,Tsao,733,France,117830.57,0,1,0
5007,2011,1,RENT,1,Low,1,7000, 36 months,1,credit_card,1,Low,1,Good Loan,0,7.9,A,1,3.7,7884.319358,7000,0,219.04,409000005006,9-Feb-18,Indiaforensic VISA ACQ INT 06021,,3121.17,-547429536.87,Chikere,755,Germany,117396.25,0,1,0
5008,2011,10,MORTGAGE,3,Medium,2,31500, 60 months,2,other,4,High,2,Good Loan,0,15.96,C,3,6.01,34329.57,31500,0,765.35,409000005007,9-Feb-18,Indiaforensic POS ACQ SETTL 0102,"54,441.89",,-547483978.76,Ballard,554,Spain,96929.24,0,1,0
5009,2011,10,MORTGAGE,3,Low,1,13600, 60 months,2,other,4,High,2,Good Loan,0,17.58,D,4,8.1,17060.35,10411.76,0,342.26,409000005008,9-Feb-18,Indiaforensic RUPAY POS ACQ09021,,2152874.52,-545331104.24,Akhtar,534,France,36275.94,0,1,0
5010,2011,10,RENT,1,Low,1,14400, 60 months,2,small_business,3,High,2,Good Loan,0,17.58,D,4,7.48,18097.71,11023.69,0,362.39,409000005009,9-Feb-18,Indiaforensic VISA ACQ DOM090218,,1096899.94,-544234204.30,O'Loughlin,656,Spain,116706.00,0,1,0
5011,2011,10,OWN,2,Low,1,6000, 36 months,1,debt_consolidation,6,Low,1,Bad Loan,1,7.9,A,1,9.16,6109.15,5257.81,105.47,187.75,409000005010,9-Feb-18,TRF TO  Indiaforensic SERVICES I,"4,000,000.00",,-548234204.30,Davis,575,Germany,168080.53,0,1,0
5012,2011,3,MORTGAGE,3,Low,1,1400, 36 months,1,debt_consolidation,6,High,2,Good Loan,0,16.77,D,4,21.38,1419.6,1400,0,49.76,409000005011,9-Feb-18,Indiaforensic MASTER ACQ DOM REV,969.11,,-548235173.41,Barry,480,Spain,25887.89,0,1,0
5013,2011,5,MORTGAGE,3,Low,1,3000, 36 months,1,other,4,Low,1,Good Loan,0,10.65,B,2,5.2,3452.19,3000,0,97.72,409000005012,12-Feb-18,Indiaforensic MASTER ACQDOM10-12,,2317875.26,-545917298.15,K'ung,575,France,122488.59,0,1,0
5014,2011,6,MORTGAGE,3,Low,1,9100, 36 months,1,other,4,Low,1,Good Loan,0,12.42,B,2,18.51,10946.3068,9100,0,304.08,409000005013,12-Feb-18,Indiaforensic VISA ACQDOM100218,,1005260.15,-544912038.00,Gorman,672,France,113171.61,0,1,0
5015,2011,5,RENT,1,Low,1,12000, 36 months,1,credit_card,1,Low,1,Good Loan,0,12.42,B,2,13.9,14393.74241,12000,0,400.99,409000005014,12-Feb-18,Indiaforensic VISA ACQDOM 120218,,2047654.08,-542864383.92,John,758,Spain,100365.51,0,1,0
5016,2011,8,MORTGAGE,3,Low,1,3000, 36 months,1,renewable_energy,13,Low,1,Good Loan,0,12.42,B,2,15.73,3607.074353,3000,0,100.25,409000005015,12-Feb-18,Indiaforensic RUPAY POSACQ100218,,1481303.90,-541383080.02,Tsou,682,France,124151.37,0,1,0
5017,2011,5,MORTGAGE,3,Low,1,21000, 60 months,2,home_improvement,7,High,2,Good Loan,0,14.65,C,3,22.98,24784.57,16358.56,0,495.74,409000005016,12-Feb-18,Indiaforensic RUPAY POSACQ110218,,1863047.25,-539520032.77,Okonkwo,501,France,112664.24,0,1,0
5018,2011,4,RENT,1,Low,1,10000, 36 months,1,credit_card,1,Low,1,Bad Loan,1,9.91,B,2,10.6,3542.29,2743.91,0,322.25,409000005017,12-Feb-18,Indiaforensic RUPAY POSACQ120218,,1361159.59,-538158873.18,Esposito,746,Germany,183494.87,0,1,0
5019,2011,2,MORTGAGE,3,Low,1,6000, 36 months,1,major_purchase,8,Low,1,Good Loan,0,12.69,B,2,15.54,6543.57,6000,0,201.27,409000005018,12-Feb-18,Indiaforensic MASTER INT SET 090,,611.73,-538158261.45,Boni,556,France,198810.65,0,1,0
5020,2011,5,MORTGAGE,3,Medium,2,25000, 60 months,2,debt_consolidation,6,High,2,Good Loan,0,17.58,D,4,19.12,37085.94,25000,0,629.14,409000005019,12-Feb-18,Indiaforensic MASTER ACQDOM12021,,867.99,-538157393.46,Pratt,823,Germany,131259.60,0,1,0
5021,2011,10,RENT,1,Low,1,7200, 36 months,1,major_purchase,8,Low,1,Good Loan,0,11.71,B,2,2.42,8508.518856,7200,0,238.15,409000005020,13-Feb-18,TRF TO  Indiaforensic SERVICES I,"10,000,000.00",,-548157393.46,Page,491,Germany,116471.14,0,1,0
5022,2011,1,MORTGAGE,3,Low,1,25000, 60 months,2,small_business,3,Low,1,Good Loan,0,9.91,B,2,10.71,30273.54466,25000,0,530.07,409000005021,14-Feb-18,Indiaforensic MASTER ACQ DOM1402,,822534.03,-547334859.43,Wilkinson,638,France,15336.40,0,1,0
5023,2011,10,MORTGAGE,3,Medium,2,20000, 60 months,2,other,4,High,2,Bad Loan,1,16.77,D,4,19.31,23782.01,14618.91,0,494.59,409000005022,14-Feb-18,Indiaforensic VISA ACQ DOM140218,,961170.33,-546373689.10,Tseng,734,France,99593.28,0,1,0
5024,2011,10,MORTGAGE,3,Low,1,4800, 36 months,1,credit_card,1,Low,1,Good Loan,0,10.65,B,2,10.9,5506.28,4800,0,156.36,409000005023,14-Feb-18,Indiaforensic RUPAY POS ACQ14021,,2684779.78,-543688909.32,Clark,555,France,170514.21,0,1,0
5025,2011,7,MORTGAGE,3,Low,1,10000, 36 months,1,debt_consolidation,6,Low,1,Good Loan,0,9.91,B,2,15.42,11073.75,10000.01,0,322.25,409000005024,14-Feb-18,Indiaforensic MASTER ACQ DOM1302,,907663.38,-542781245.94,Finch,745,Germany,34265.08,0,1,0
5026,2011,3,MORTGAGE,3,Low,1,10000, 36 months,1,debt_consolidation,6,Low,1,Good Loan,0,6.03,A,1,6.53,10755.04,10000,0,304.36,409000005025,14-Feb-18,Indiaforensic VISA ACQ DOM130218,,1104589.67,-541676656.27,Shen,728,France,106977.53,0,1,0
5027,2011,6.05,OWN,2,Low,1,10000, 36 months,1,other,4,Low,1,Good Loan,0,6.03,A,1,4.78,10874.4,10000,0,304.36,409000005026,14-Feb-18,Indiaforensic RUPAY POS ACQ13021,,1333538.59,-540343117.68,Hou,626,France,164287.86,0,1,0
5028,2011,6,MORTGAGE,3,Low,1,10000, 36 months,1,home_improvement,7,Low,1,Good Loan,0,8.9,A,1,13.54,11429.86151,10000,0,317.54,409000005027,14-Feb-18,TRF TO  Indiaforensic SERVICES I,"7,900,000.00",,-548243117.68,Wall,681,Germany,25292.53,0,1,0
5029,2011,4,MORTGAGE,3,Medium,2,30000, 60 months,2,home_improvement,7,Low,1,Good Loan,0,11.71,B,2,8.02,31495.49,30000,0,662.95,409000005028,15-Feb-18,Indiaforensic MASTER ACQ DOM1502,,778009.71,-547465107.97,Manna,478,France,51820.87,0,1,0
5030,2011,10,MORTGAGE,3,Medium,2,18000, 60 months,2,debt_consolidation,6,High,2,Good Loan,0,15.96,C,3,14.29,21791.54,13888.98,0,437.35,409000005029,15-Feb-18,Indiaforensic VISA ACQ DOM150218,,982687.44,-546482420.53,Reyes,709,France,81452.29,0,1,0
5031,2011,0.5,RENT,1,Low,1,6650, 36 months,1,credit_card,1,Low,1,Good Loan,0,8.9,A,1,13.48,7595.848669,6650,0,211.16,409000005030,15-Feb-18,Indiaforensic RUPAY POS ACQ15021,,1917042.56,-544565377.97,Jideofor,562,Germany,1354.25,0,1,0
5032,2011,1,MORTGAGE,3,Medium,2,5000, 36 months,1,other,4,Low,1,Good Loan,0,8.9,A,1,14.31,5714.721651,5000,0,158.77,409000005031,15-Feb-18,TRF TO  Indiaforensic SERVICES I,"3,700,000.00",,-548265377.97,Sal,769,Germany,71379.92,0,1,0
5033,2011,4,MORTGAGE,3,Low,1,10000, 36 months,1,medical,9,Low,1,Good Loan,0,6.62,A,1,3.75,10642.65,10000,0,307.04,409000005032,15-Feb-18,Indiaforensic VISA ACQ INT 10021,,874.28,-548264503.69,Iweobiegbunam,684,Germany,154137.33,0,1,0
5034,2011,5,MORTGAGE,3,Low,1,9600, 36 months,1,home_improvement,7,High,2,Good Loan,0,14.27,C,3,24.76,11518.1,9600,0,329.37,409000005033,16-Feb-18,Indiaforensic MASTER ACQ DOM1602,,771473.92,-547493029.77,Shao,536,France,64308.49,0,1,0
5035,2011,10,MORTGAGE,3,Medium,2,20000, 60 months,2,debt_consolidation,6,High,2,Good Loan,0,17.58,D,4,18.28,25106.87,15320.45,0,503.32,409000005034,16-Feb-18,Indiaforensic VISA ACQ DOM160218,,1054089.52,-546438940.25,Heath,631,Germany,31613.35,0,1,0
5036,2011,10,RENT,1,Low,1,6000, 36 months,1,debt_consolidation,6,Low,1,Good Loan,0,10.65,B,2,19.18,6755.47,6000,0,195.44,409000005035,16-Feb-18,Indiaforensic RUPAY POS ACQ16021,,1944335.76,-544494604.49,Chidimma,657,Spain,27738.01,0,1,0
5037,2011,1,RENT,1,Low,1,23000, 60 months,2,debt_consolidation,6,High,2,Good Loan,0,17.58,D,4,17.76,28895.41,17629.57,0,578.81,409000005036,16-Feb-18,Indiaforensic VISA ACQ INT 14021,,1510.32,-544493094.17,Murray,699,Germany,163570.25,0,1,0
5038,2011,10,MORTGAGE,3,Low,1,6600, 36 months,1,debt_consolidation,6,Low,1,Good Loan,0,10.65,B,2,20.95,7397.45,6600,0,214.99,409000005037,16-Feb-18,TRF TO  Indiaforensic SERVICES I,"3,700,000.00",,-548193094.17,Sullivan,606,Spain,193878.51,0,1,0
5039,2011,1,RENT,1,Low,1,25000, 36 months,1,debt_consolidation,6,Low,1,Good Loan,0,7.9,A,1,15.29,28019.18615,25000,0,782.26,409000005038,17-Feb-18,Indiaforensic VISA ACQ DOM170218,,949204.41,-547243889.76,Wu,612,France,147545.65,0,1,0
5040,2011,4,MORTGAGE,3,Low,1,12000, 60 months,2,credit_card,1,Low,1,Good Loan,0,8.9,A,1,8.98,12366.6,9571.32,0,248.52,409000005039,17-Feb-18,Indiaforensic RUPAY POS ACQ17021,,1613660.27,-545630229.49,Downie,660,France,195906.59,0,1,0
5041,2011,8,MORTGAGE,3,Low,1,16500, 36 months,1,credit_card,1,High,2,Good Loan,0,16.77,D,4,11.5,21104.34184,16500,0,586.39,409000005040,17-Feb-18,TRF TO  Indiaforensic SERVICES I,"2,000,000.00",,-547630229.49,Chukwufumnanya,829,Spain,178458.86,0,1,0
5042,2011,2,RENT,1,Low,1,9600, 36 months,1,debt_consolidation,6,High,2,Good Loan,0,13.49,C,3,11.25,11565.53,9600,0,325.74,409000005041,20-Feb-18,Indiaforensic MASTER ACQ DOM1702,,730495.00,-546899734.49,Allan,567,Spain,156125.72,0,1,0
5043,2011,2,MORTGAGE,3,Low,1,6000, 36 months,1,debt_consolidation,6,High,2,Good Loan,0,14.27,C,3,7.64,7407.498949,6000,0,205.86,409000005042,20-Feb-18,Indiaforensic RUPAY POS ACQ18021,,1438384.15,-545461350.34,Findlay,850,France,11159.19,0,1,0
5044,2011,2,RENT,1,Low,1,20000, 60 months,2,debt_consolidation,6,High,2,Good Loan,0,17.58,D,4,21.34,27207.57353,20000,0,503.32,409000005043,20-Feb-18,Indiaforensic VISA ACQ DOM190218,,1817754.32,-543643596.02,Ch'eng,712,Spain,45738.94,0,1,0
5045,2011,5,MORTGAGE,3,Medium,2,4800, 36 months,1,home_improvement,7,Low,1,Good Loan,0,11.71,B,2,5.2,5615.62,4800,0,158.77,409000005044,20-Feb-18,Indiaforensic RUPAY POS ACQ19021,,1650790.89,-541992805.13,Miller,562,France,140650.19,0,1,0
5046,2011,9,MORTGAGE,3,Low,1,15000, 60 months,2,home_improvement,7,Low,1,Good Loan,0,10.65,B,2,7.3,16900.95,15000,0,323.53,409000005045,20-Feb-18,Indiaforensic MASTER ACQ DOM2002,,2287738.38,-539705066.75,Tsai,755,France,4733.94,0,1,0
5047,2011,10,RENT,1,Low,1,15000, 36 months,1,debt_consolidation,6,High,2,Bad Loan,1,18.25,D,4,5.63,6623.1,3747.91,645.81,544.17,409000005046,20-Feb-18,Indiaforensic VISA ACQ DOM200218,,1035925.38,-538669141.37,Graham,793,Spain,10579.72,0,1,0
5048,2011,4,MORTGAGE,3,Low,1,12000, 36 months,1,debt_consolidation,6,High,2,Good Loan,0,13.49,C,3,11.73,14654.53406,12000,0,407.17,409000005047,20-Feb-18,Indiaforensic RUPAY POS ACQ20021,,1906559.53,-536762581.84,Norton,471,Spain,179655.87,0,1,0
5049,2011,3,RENT,1,Low,1,10375, 36 months,1,other,4,High,2,Bad Loan,1,14.27,C,3,23.78,9722.92,7026.88,482.26,355.96,409000005048,20-Feb-18,Indiaforensic MASTER INT SET 160,,10.30,-536762571.54,Yegorov,707,France,77502.56,0,1,0
5050,2011,7,MORTGAGE,3,Medium,2,25000, 60 months,2,other,4,High,2,Good Loan,0,18.25,D,4,17.43,31876.59,19103.43,0,638.25,409000005049,20-Feb-18,TRF TO  Indiaforensic SERVICES I,"11,500,000.00",,-548262571.54,Holt,784,Spain,145759.93,0,1,0
5051,2011,5,MORTGAGE,3,Low,1,2000, 36 months,1,vacation,11,Low,1,Good Loan,0,10.65,B,2,5.57,2260.78,2000,0,65.15,409000005050,21-Feb-18,Indiaforensic MASTER ACQ DOM2102,,859735.58,-547402835.96,Kao,703,France,56246.72,0,1,0
5052,2011,10,MORTGAGE,3,Low,1,9600, 36 months,1,debt_consolidation,6,High,2,Good Loan,0,15.96,C,3,5.35,10842.84,9600,0,337.32,409000005051,21-Feb-18,Indiaforensic VISA ACQ DOM210218,,988978.38,-546413857.58,Ross,704,Spain,151335.24,0,1,0
5053,2011,10,RENT,1,Medium,2,10000, 36 months,1,major_purchase,8,High,2,Good Loan,0,16.29,D,4,8.87,12706.44138,10000,0,353.01,409000005052,21-Feb-18,Indiaforensic RUPAY POS ACQ21021,,2002935.97,-544410921.61,Hsiao,662,France,179833.45,0,1,0
5054,2011,6,RENT,1,Low,1,30000, 60 months,2,debt_consolidation,6,High,2,Good Loan,0,14.27,C,3,17.43,35085.73,23400.43,0,702.26,409000005053,21-Feb-18,Indiaforensic MASTER INT SET 190,,39163.83,-544371757.78,Allan,636,Germany,191627.85,0,1,0
5055,2011,7,MORTGAGE,3,Low,1,2000, 36 months,1,small_business,3,Low,1,Good Loan,0,7.9,A,1,15.12,2252.293166,2000,0,62.59,409000005054,21-Feb-18,TRF TO  Indiaforensic SERVICES I,"3,800,000.00",,-548171757.78,Liang,640,Spain,173016.46,0,1,0
5056,2011,0.5,RENT,1,Medium,2,2200, 36 months,1,vacation,11,Low,1,Good Loan,0,7.51,A,1,14,2444.88,2200,0,68.45,409000005055,22-Feb-18,Indiaforensic RUPAY POS ACQ22021,,1574990.14,-546596767.64,Briggs,739,Spain,58469.75,0,1,0
5057,2011,3,OWN,2,Low,1,25000, 60 months,2,debt_consolidation,6,High,2,Good Loan,0,13.49,C,3,19.97,28706.06,19560.99,0,575.12,409000005056,22-Feb-18,Indiaforensic VISA ACQ DOM220218,,987619.73,-545609147.91,Cantrell,767,Germany,28038.28,0,1,0
5058,2011,8,RENT,1,Low,1,5000, 36 months,1,other,4,Low,1,Good Loan,0,6.03,A,1,15.54,5478.212687,5000,0,152.18,409000005057,22-Feb-18,Indiaforensic MASTER ACQ DOM2202,,817892.23,-544791255.68,Wang,753,Germany,159576.75,0,1,0
5059,2011,7,MORTGAGE,3,Low,1,21000, 60 months,2,other,4,Low,1,Bad Loan,1,12.42,B,2,13.06,4709.2,2660.45,0,471.61,409000005058,22-Feb-18,TRF TO  Indiaforensic SERVICES I,"3,400,000.00",,-548191255.68,Aksenov,714,France,151280.96,0,1,0
5060,2011,8,RENT,1,Low,1,18250, 36 months,1,debt_consolidation,6,High,2,Good Loan,0,14.27,C,3,21.2,22539.23466,18250,0,626.14,409000005059,22-Feb-18,Indiaforensic VISA ACQ INT 20021,,11144.58,-548180111.10,Glennon,707,France,139953.94,0,1,0
5061,2011,0.5,RENT,1,Low,1,7200, 36 months,1,debt_consolidation,6,High,2,Good Loan,0,15.96,C,3,20.7,7741.94,7200,0,252.99,409000005060,23-Feb-18,Indiaforensic MASTER ACQ DOM2302,,653177.19,-547526933.91,Yancy,577,France,105407.79,0,1,0
5062,2011,10,MORTGAGE,3,Medium,2,12000, 36 months,1,debt_consolidation,6,Low,1,Good Loan,0,7.9,A,1,5.36,13516.87088,12000,0,375.49,409000005061,23-Feb-18,Indiaforensic VISA ACQ DOM230218,,1019763.68,-546507170.23,Mazzi,633,France,56865.62,0,1,0
5063,2011,2,OWN,2,Low,1,5000, 36 months,1,debt_consolidation,6,Low,1,Good Loan,0,12.69,B,2,22.81,5753.11,5000,0,167.73,409000005062,23-Feb-18,Indiaforensic RUPAY POS ACQ23021,,1761626.95,-544745543.28,Liu,849,Germany,198072.16,0,1,0
5064,2011,1,RENT,1,Low,1,15500, 60 months,2,credit_card,1,High,2,Good Loan,0,21.67,F,6,20.4,24818.37048,15500,0,425.19,409000005063,23-Feb-18,TRF TO  Indiaforensic SERVICES I,"3,500,000.00",,-548245543.28,Nucci,614,Spain,137791.18,0,1,0
5065,2011,10,MORTGAGE,3,Low,1,8000, 60 months,2,debt_consolidation,6,High,2,Good Loan,0,19.91,E,5,2.43,11771.79893,8000,0,211.56,409000005064,26-Feb-18,Indiaforensic MASTER ACQ DOM2402,,552833.60,-547692709.68,Y?,558,France,103787.28,0,1,0
5066,2011,10,OWN,2,Low,1,20000, 60 months,2,small_business,3,High,2,Bad Loan,1,20.89,F,6,15.63,4960.89,1626.61,651.53,539.84,409000005065,26-Feb-18,Indiaforensic VISA ACQ DOM240218,,1022944.79,-546669764.89,Nucci,832,France,30912.89,0,1,0
5067,2011,3,MORTGAGE,3,Low,1,6400, 36 months,1,debt_consolidation,6,Low,1,Good Loan,0,9.91,B,2,13.77,7054.53,6400,0,206.24,409000005066,26-Feb-18,Indiaforensic RUPAY POS ACQ24021,,1747852.35,-544921912.54,Tang,567,France,78651.55,0,1,0
5068,2011,10,RENT,1,Low,1,11000, 60 months,2,debt_consolidation,6,High,2,Bad Loan,1,17.58,D,4,14.46,11018.24,5504.37,833.4,276.83,409000005067,26-Feb-18,Indiaforensic RUPAY POS ACQ25021,,1785401.42,-543136511.12,Kao,587,Germany,123309.57,0,1,0
5069,2011,6,RENT,1,Low,1,6000, 36 months,1,wedding,5,Low,1,Good Loan,0,7.9,A,1,14.91,6732.787594,6000,0,187.75,409000005068,26-Feb-18,Indiaforensic MASTER ACQ DOM2602,,1440201.53,-541696309.59,Chen,712,Spain,174118.93,0,1,0
5070,2011,4,OWN,2,Low,1,5000, 36 months,1,debt_consolidation,6,Low,1,Bad Loan,1,7.9,A,1,3.47,1925.69,1403.08,206.5,156.46,409000005069,26-Feb-18,Indiaforensic VISA ACQ DOM260218,,2059185.68,-539637123.91,Yao,655,Spain,85736.26,0,1,0
5071,2011,4,RENT,1,Medium,2,16000, 36 months,1,debt_consolidation,6,High,2,Good Loan,0,13.49,C,3,5.35,19015.86,16000,0,542.89,409000005070,26-Feb-18,Indiaforensic RUPAY POS ACQ26021,,1630083.47,-538007040.44,Tsou,641,France,121138.77,0,1,0
5072,2011,10,MORTGAGE,3,Medium,2,12000, 36 months,1,home_improvement,7,Low,1,Good Loan,0,11.71,B,2,5.33,13529.37,12000,0,396.92,409000005071,26-Feb-18,TRF TO  Indiaforensic SERVICES I,"10,200,000.00",,-548207040.44,Barnes,676,France,84199.78,0,1,0
5073,2011,6.05,RENT,1,Low,1,8000, 36 months,1,debt_consolidation,6,High,2,Good Loan,0,15.27,C,3,9.75,9137.24,8000,0,278.39,409000005072,27-Feb-18,Indiaforensic MASTER ACQ DOM2702,,961965.27,-547245075.17,H?,472,France,181224.56,0,1,0
5074,2011,7,MORTGAGE,3,Low,1,14400, 60 months,2,debt_consolidation,6,Low,1,Good Loan,0,12.69,B,2,22.42,18730.97352,14400,0,325.37,409000005073,27-Feb-18,Indiaforensic RUPAY POS ACQ27021,,1798130.59,-545446944.58,Cruz,644,Germany,141230.07,0,1,0
5075,2011,5,MORTGAGE,3,Low,1,12500, 60 months,2,debt_consolidation,6,High,2,Good Loan,0,16.77,D,4,19.31,15398.58,9605.17,0,309.12,409000005074,27-Feb-18,TRF TO  Indiaforensic SERVICES I,"2,800,000.00",,-548246944.58,Smith,598,France,158111.71,0,1,0
5076,2011,6,MORTGAGE,3,Low,1,5300, 36 months,1,debt_consolidation,6,Low,1,Good Loan,0,7.51,A,1,11.34,5593.63,5300,0,164.89,409000005075,28-Feb-18,Indiaforensic MASTER ACQ DOM2802,,747889.53,-547499055.05,Onuchukwu,792,Spain,130639.01,0,1,0
5077,2011,10,MORTGAGE,3,Low,1,15000, 36 months,1,home_improvement,7,Low,1,Good Loan,0,6.03,A,1,1.21,16434.87179,15000,0,456.54,409000005076,28-Feb-18,Indiaforensic VISA ACQ DOM280218,,2307661.97,-545191393.08,Bukowski,700,France,17040.82,0,1,0
5078,2011,6.05,RENT,1,Low,1,12000, 36 months,1,credit_card,1,Low,1,Bad Loan,1,7.51,A,1,19.56,8895.99,6997.36,688.26,373.33,409000005077,28-Feb-18,Indiaforensic RUPAY POS ACQ28021,,1816466.20,-543374926.88,Simmons,616,France,25662.27,0,1,0
5079,2011,9,MORTGAGE,3,Low,1,20000, 60 months,2,debt_consolidation,6,High,2,Good Loan,0,20.89,F,6,12.33,26934.79,15060.14,0,539.84,409000005078,28-Feb-18,TRF TO  Indiaforensic SERVICES I,"4,800,000.00",,-548174926.88,Stewart,743,Spain,193360.69,0,1,0
5080,2011,10,MORTGAGE,3,Medium,2,35000, 36 months,1,debt_consolidation,6,Low,1,Good Loan,0,12.69,B,2,22.46,39369.85,35000,0,1174.07,409000005079,1-Mar-18,Indiaforensic VISA ACQ INT 24021,,692.31,-548174234.57,Gow,427,France,121485.10,0,1,0
5081,2011,0.5,RENT,1,Low,1,5600, 36 months,1,debt_consolidation,6,High,2,Bad Loan,1,15.96,C,3,10.29,2668.44,1019.47,1102.92,196.77,409000005080,1-Mar-18,Indiaforensic VISA ACQ INT 25021,,13817.40,-548160417.17,Williams,731,France,162452.65,0,1,0
5082,2011,5,MORTGAGE,3,Medium,2,35000, 36 months,1,debt_consolidation,6,Low,1,Good Loan,0,7.9,A,1,13.8,39425.48994,35000,0,1095.16,409000005081,1-Mar-18,Indiaforensic VISA ACQ DOM010318,,1332188.28,-546828228.89,Francis,610,France,141137.53,0,1,0
5083,2011,3,RENT,1,Low,1,4000, 36 months,1,debt_consolidation,6,High,2,Bad Loan,1,14.27,C,3,13.17,4492.66,2554.11,1059.31,137.24,409000005082,1-Mar-18,Indiaforensic RUPAY POS ACQ01031,,2182420.65,-544645808.24,Calabresi,724,Spain,185541.20,0,1,0
5084,2011,8,RENT,1,Medium,2,35000, 36 months,1,credit_card,1,High,2,Good Loan,0,18.25,D,4,17.93,36863.57,35000,0,1269.73,409000005083,1-Mar-18,TRF TO  Indiaforensic SERVICES I,"3,600,000.00",,-548245808.24,Chimaobim,653,Spain,118383.18,0,1,0
5085,2011,0.5,MORTGAGE,3,Low,1,7000, 36 months,1,major_purchase,8,Low,1,Good Loan,0,7.9,A,1,13.14,7757.4,7000,0,219.04,409000005084,3-Mar-18,Indiaforensic VISA ACQ DOM020318,,1734486.17,-546511322.07,Chikwendu,774,France,8214.41,0,1,0
5086,2011,3,MORTGAGE,3,Medium,2,2600, 36 months,1,debt_consolidation,6,Low,1,Good Loan,0,8.9,A,1,8.05,2971.584954,2600,0,82.56,409000005085,3-Mar-18,Indiaforensic RUPAY POS ACQ02031,,2972986.91,-543538335.16,Padovesi,547,Germany,46521.45,0,1,0
5087,2011,7,MORTGAGE,3,Low,1,12000, 36 months,1,debt_consolidation,6,Low,1,Good Loan,0,6.03,A,1,12,12539.27,12000,0,365.23,409000005086,3-Mar-18,Indiaforensic VISA ACQ INT 27021,,1870.70,-543536464.46,Henderson,719,Spain,10772.13,0,1,0
5088,2011,10,MORTGAGE,3,Low,1,14000, 36 months,1,debt_consolidation,6,Low,1,Good Loan,0,6.03,A,1,7.79,14270.89,14000,0,426.1,409000005087,3-Mar-18,Indiaforensic VISA ACQ DOM030318,,636872.77,-542899591.69,Kharlamova,740,Spain,199290.68,0,1,0
5089,2011,10,RENT,1,Low,1,19850, 60 months,2,debt_consolidation,6,High,2,Good Loan,0,18.25,D,4,17.94,25875.48,19850,0,506.77,409000005088,3-Mar-18,Indiaforensic RUPAY POS ACQ03031,,975687.34,-541923904.35,Onio,543,France,85983.54,0,1,0
5090,2011,4,RENT,1,Low,1,9000, 36 months,1,debt_consolidation,6,Low,1,Good Loan,0,10.65,B,2,24.27,10291.77,9000,0,293.16,409000005089,3-Mar-18,TRF TO  Indiaforensic SERVICES I,"4,000,000.00",,-545923904.35,Yeh,688,Germany,129870.93,0,1,0
5091,2011,6,OWN,2,Low,1,4500, 36 months,1,other,4,Low,1,Good Loan,0,12.69,B,2,17.66,5429.014086,4500,0,150.96,409000005090,3-Mar-18,TRF TO  Indiaforensic SERVICES I,"500,000.00",,-546423904.35,Feng,474,France,63158.22,0,1,0
5092,2011,10,MORTGAGE,3,Low,1,12700, 60 months,2,home_improvement,7,Low,1,Good Loan,0,7.9,A,1,19.47,13422.69,12700,0,256.91,409000005091,3-Mar-18,TRF TO  Indiaforensic SERVICES I,"1,000,000.00",,-547423904.35,Norman,505,Germany,171070.52,0,1,0
5093,2011,3,RENT,1,Low,1,2000, 36 months,1,other,4,High,2,Good Loan,0,14.65,C,3,7.19,2482.399124,2000,0,68.99,409000005092,3-Mar-18,TRF TO  Indiaforensic SERVICES I,"500,000.00",,-547923904.35,White,688,France,53222.15,0,1,0
5094,2011,10,MORTGAGE,3,Low,1,7200, 36 months,1,credit_card,1,High,2,Good Loan,0,17.58,D,4,11.34,8595.79,7200,0,258.79,409000005093,5-Mar-18,IndforGN MSTR ACQ DOM01-0503,,4759255.58,-543164648.77,Manfrin,650,Germany,179834.45,0,1,0
5095,2011,7,MORTGAGE,3,Low,1,15000, 36 months,1,debt_consolidation,6,Low,1,Good Loan,0,12.69,B,2,16.8,17965.3179,15000,0,503.18,409000005094,5-Mar-18,Indiaforensic RUPAY POS ACQ04031,,1976388.26,-541188260.51,Ritchie,610,France,114514.64,0,1,0
5096,2011,5,MORTGAGE,3,Low,1,15000, 36 months,1,home_improvement,7,High,2,Good Loan,0,13.49,C,3,6.39,17827.31,15000,0,508.96,409000005095,5-Mar-18,Indiaforensic RUPAY POS ACQ05031,,1806993.81,-539381266.70,Udegbulam,705,Spain,139162.15,0,1,0
5097,2011,5,MORTGAGE,3,Low,1,12800, 36 months,1,debt_consolidation,6,Low,1,Good Loan,0,10.65,B,2,9.62,15007.91342,12800,0,416.94,409000005096,5-Mar-18,Indiaforensic VISA ACQ DOM050318,,2804904.72,-536576361.98,Kao,669,France,50249.16,0,1,0
5098,2011,2,RENT,1,Low,1,3000, 36 months,1,medical,9,Low,1,Good Loan,0,6.62,A,1,16.83,3314.271903,3000,0,92.12,409000005097,5-Mar-18,Indiaforensic MASTER INT SET 010,,35485.39,-536540876.59,Diaz,650,Spain,113469.65,0,1,0
5099,2011,8,RENT,1,Low,1,1200, 36 months,1,debt_consolidation,6,Low,1,Good Loan,0,11.71,B,2,12.76,1372.34,1200,0,39.7,409000005098,5-Mar-18,TRF TO  Indiaforensic SERVICES I,"11,600,000.00",,-548140876.59,Olisaemeka,550,Germany,147484.13,0,1,0
5100,2011,3,MORTGAGE,3,Low,1,3825, 36 months,1,debt_consolidation,6,Low,1,Good Loan,0,11.71,B,2,11.26,4551.990063,3825,0,126.52,409000005099,6-Mar-18,Indiaforensic VISA ACQ INT 28021,,3956.00,-548136920.59,Ross-Watt,595,Germany,191448.96,0,1,0
5101,2011,1,RENT,1,Low,1,7000, 36 months,1,debt_consolidation,6,High,2,Good Loan,0,14.65,C,3,16.16,8691.663195,7000,0,241.46,409000005100,6-Mar-18,Indiaforensic RUPAY POS ACQ06031,,1425336.67,-546711583.92,Miller,572,Spain,119381.41,0,1,0
5102,2011,10,MORTGAGE,3,Low,1,19500, 36 months,1,debt_consolidation,6,Low,1,Good Loan,0,7.9,A,1,13.78,21440.4,19500,0,610.16,409000005101,6-Mar-18,Indiaforensic VISA ACQ DOM060318,,1737721.26,-544973862.66,Shubin,622,Spain,33277.31,0,1,0
5103,2011,4,MORTGAGE,3,Low,1,1500, 60 months,2,other,4,High,2,Bad Loan,1,13.49,C,3,20.18,1250.64,697.98,115.86,34.51,409000005102,6-Mar-18,Indiaforensic MASTER ACQ DOM 060,,1336123.81,-543637738.85,Nwankwo,662,Spain,73107.53,0,1,0
5104,2011,10,MORTGAGE,3,Medium,2,7200, 36 months,1,car,2,Low,1,Good Loan,0,6.03,A,1,16.58,7888.61307,7200,0,219.14,409000005103,6-Mar-18,TRF TO  Indiaforensic SERVICES I,"4,600,000.00",,-548237738.85,Cartwright,783,Germany,96590.39,0,1,0
5105,2011,7,OWN,2,Medium,2,5600, 60 months,2,car,2,High,2,Good Loan,0,15.27,C,3,18.7,6313.95,5600,0,134.02,409000005104,7-Mar-18,Indiaforensic VISA ACQ DOM070318,,1336084.19,-546901654.66,Ngozichukwuka,714,Spain,6923.11,0,1,0
5106,2011,3,RENT,1,Low,1,25000, 36 months,1,debt_consolidation,6,High,2,Good Loan,0,13.49,C,3,16.94,30532.80357,25000,0,848.27,409000005105,7-Mar-18,Indiaforensic VISA ACQ INT 01031,,494.50,-546901160.16,Sadler,671,Germany,176403.33,0,1,0
5107,2011,5,MORTGAGE,3,Medium,2,35000, 60 months,2,small_business,3,High,2,Good Loan,0,20.89,F,6,12.23,50638.6925,35000,0,944.71,409000005106,7-Mar-18,Indiaforensic MASTER ACQ DOM 070,,1206213.73,-545694946.43,Azuka,600,France,64349.60,0,1,0
5108,2011,4,MORTGAGE,3,Low,1,14000, 60 months,2,debt_consolidation,6,High,2,Bad Loan,1,16.77,D,4,20.42,4173.32,1593.29,734.12,346.21,409000005107,7-Mar-18,Indiaforensic RUPAY POS ACQ07031,,2067731.26,-543627215.17,Shen,847,Spain,116097.26,0,1,0
5109,2011,0.5,MORTGAGE,3,Low,1,11000, 36 months,1,debt_consolidation,6,High,2,Good Loan,0,14.27,C,3,17.99,11383.25,11000,0,377.4,409000005108,7-Mar-18,TRF TO  Indiaforensic SERVICES I,"4,600,000.00",,-548227215.17,Whittaker,650,Spain,29861.13,0,1,0
5110,2011,10,MORTGAGE,3,Medium,2,27400, 60 months,2,debt_consolidation,6,High,2,Bad Loan,1,17.27,D,4,17.63,13794.54,2763.94,7646.37,684.95,409000005109,8-Mar-18,Indiaforensic RUPAY POS ACQ08031,,2541680.42,-545685534.75,Abazu,710,Spain,48426.98,0,1,0
5111,2011,1,RENT,1,Low,1,8875, 36 months,1,debt_consolidation,6,High,2,Good Loan,0,16.29,D,4,23.22,11148.03476,8875,0,313.3,409000005110,8-Mar-18,Indiaforensic VISA ACQ DOM080318,,1202924.05,-544482610.70,Murphy,682,France,32770.56,0,1,0
5112,2011,0.5,RENT,1,Low,1,7000, 60 months,2,debt_consolidation,6,High,2,Bad Loan,1,18.25,D,4,11.82,3705.63,1567.84,331.8,178.71,409000005111,8-Mar-18,Indiaforensic MASTER ACQ DOM 080,,928321.98,-543554288.72,Ford,642,France,117060.20,0,1,0
5113,2011,10,OWN,2,Low,1,5000, 36 months,1,debt_consolidation,6,Low,1,Good Loan,0,7.9,A,1,24.58,5631.831496,5000,0,156.46,409000005112,8-Mar-18,TRF TO  Indiaforensic SERVICES I,"4,700,000.00",,-548254288.72,Gratwick,536,Spain,136197.65,0,1,0
5114,2011,5,MORTGAGE,3,Low,1,15000, 36 months,1,credit_card,1,Low,1,Good Loan,0,6.03,A,1,5.01,16421.28407,15000,0,456.54,409000005113,9-Mar-18,Indiaforensic RUPAY POS ACQ09031,,2157676.60,-546096612.12,Pai,754,France,27438.83,0,1,0
5115,2011,4,MORTGAGE,3,Low,1,21725, 60 months,2,debt_consolidation,6,High,2,Good Loan,0,13.49,C,3,25.04,24946.7,16998.95,0,499.78,409000005114,9-Mar-18,Indiaforensic VISA ACQ DOM090318,,1380687.62,-544715924.50,Lorenzo,678,France,192156.54,0,1,0
5116,2011,10,MORTGAGE,3,Low,1,23675, 60 months,2,debt_consolidation,6,High,2,Good Loan,0,20.3,E,5,19.27,25630.63,23675,0,631.21,409000005115,9-Mar-18,Indiaforensic MASTER ACQ DOM 090,,899770.26,-543816154.24,Brady,533,Germany,69409.37,0,1,0
5117,2011,6,MORTGAGE,3,Low,1,13600, 60 months,2,debt_consolidation,6,Low,1,Good Loan,0,12.42,B,2,13.98,15269.81,10719.82,0,305.42,409000005116,9-Mar-18,TRF TO  Indiaforensic SERVICES I,"4,400,000.00",,-548216154.24,Wong,741,Germany,58440.43,0,1,0
5118,2011,6,RENT,1,Low,1,8500, 36 months,1,small_business,3,High,2,Good Loan,0,13.49,C,3,23.68,10293.75904,8500,0,288.41,409000005117,12-Mar-18,IndforGN MSTR ACQ DOM10-1203,,2951753.66,-545264400.58,Douglas,757,France,192519.39,0,1,0
5119,2011,10,MORTGAGE,3,Low,1,20000, 60 months,2,debt_consolidation,6,High,2,Bad Loan,1,13.49,C,3,21.98,13376.21,6725.12,1874.04,460.1,409000005118,12-Mar-18,Indiaforensic VISA ACQ DOM120318,,3116765.95,-542147634.63,Kennedy,721,France,144874.67,0,1,0
5120,2011,4,RENT,1,Low,1,15000, 60 months,2,small_business,3,High,2,Good Loan,0,18.64,E,5,3.31,17908.72,15000,0,386.15,409000005119,12-Mar-18,Indiaforensic RUPAY POS ACQ12031,,2075795.76,-540071838.87,Chang,700,France,175373.46,0,1,0
5121,2011,2,MORTGAGE,3,Medium,2,9400, 60 months,2,home_improvement,7,High,2,Good Loan,0,19.42,E,5,8.68,13961.64605,9400,0,246.02,409000005120,12-Mar-18,Indiaforensic RUPAY POS ACQ11031,,2057325.00,-538014513.87,Brown,663,France,440.20,0,1,0
5122,2011,5,RENT,1,Low,1,2300, 36 months,1,credit_card,1,High,2,Good Loan,0,17.58,D,4,5.93,2430.02,2300,0,82.67,409000005121,12-Mar-18,Indiaforensic VISA ACQ DOM100318,,1293288.62,-536721225.25,Hsiung,677,Spain,76637.38,0,1,0
5123,2011,10,MORTGAGE,3,Low,1,3600, 36 months,1,debt_consolidation,6,High,2,Bad Loan,1,17.27,D,4,9.5,2318.77,1561.86,11.53,128.84,409000005122,12-Mar-18,Indiaforensic RUPAY POS ACQ10031,,2024483.53,-534696741.72,MacDonald,655,France,49480.66,0,1,0
5124,2011,8,RENT,1,Low,1,15000, 60 months,2,other,4,Low,1,Good Loan,0,8.9,A,1,8.2,15506.04,11997.97,0,310.65,409000005123,12-Mar-18,TRF TO  Indiaforensic SERVICES I,"8,200,000.00",,-542896741.72,Davidson,832,Spain,10417.87,0,1,0
5125,2011,5,MORTGAGE,3,Low,1,20000, 60 months,2,home_improvement,7,High,2,Good Loan,0,14.65,C,3,4.06,23941.61,20000,0,472.14,409000005124,13-Mar-18,TRF TO  Indiaforensic SERVICES I,"5,000,000.00",,-547896741.72,Milano,721,Spain,67976.57,0,1,0
5126,2011,1,MORTGAGE,3,Medium,2,5000, 36 months,1,moving,10,Low,1,Good Loan,0,9.91,B,2,11.44,5606.48,5000,0,161.13,409000005125,13-Mar-18,Indiaforensic MASTER ACQ DOM1303,,1134856.66,-546761885.06,Bovee,542,Spain,140929.98,0,1,0
5127,2011,9,MORTGAGE,3,Low,1,17000, 60 months,2,home_improvement,7,Low,1,Good Loan,0,10.65,B,2,10.94,20590.50884,17000,0,366.67,409000005126,13-Mar-18,Indiaforensic VISA ACQ DOM130318,,1384132.47,-545377752.59,Lewis,654,Spain,47139.06,0,1,0
5128,2011,4,MORTGAGE,3,Low,1,14300, 60 months,2,other,4,Low,1,Good Loan,0,7.9,A,1,20.09,17237.27999,14300,0,289.27,409000005127,13-Mar-18,Indiaforensic RUPAY POS ACQ13031,,2316511.83,-543061240.76,Dyer,821,Spain,126241.40,0,1,0
5129,2011,2,MORTGAGE,3,Low,1,15000, 60 months,2,other,4,Low,1,Good Loan,0,12.69,B,2,23.68,16892.68,11769.31,0,338.93,409000005128,13-Mar-18,Indiaforensic MASTER INT SET 120,,557.86,-543060682.90,Hsia,508,France,22614.19,0,1,0
5130,2011,1,MORTGAGE,3,Low,1,20000, 60 months,2,debt_consolidation,6,Low,1,Good Loan,0,10.65,B,2,12.26,25659.95,20000,0,431.37,409000005129,13-Mar-18,TRF TO  Indiaforensic SERVICES I,"5,200,000.00",,-548260682.90,Hicks,588,Germany,48498.19,0,1,0
5131,2011,6,RENT,1,Medium,2,21000, 36 months,1,debt_consolidation,6,Low,1,Good Loan,0,10.65,B,2,20.02,23948.34,21000.01,0,684.04,409000005130,14-Mar-18,Indiaforensic MASTER ACQ DOM1403,,1050890.33,-547209792.57,Millar,691,Germany,103511.26,0,1,0
5132,2011,2,OWN,2,Low,1,4800, 60 months,2,debt_consolidation,6,High,2,Good Loan,0,19.91,E,5,24.61,6341.6,3637.46,0,126.94,409000005131,14-Mar-18,Indiaforensic VISA ACQ DOM140318,,1439336.22,-545770456.35,Fan,664,France,122073.48,0,1,0
5133,2011,6,RENT,1,Low,1,14400, 36 months,1,debt_consolidation,6,High,2,Good Loan,0,14.27,C,3,20.52,17779.95634,14400,0,494.05,409000005132,14-Mar-18,Indiaforensic RUPAY POS ACQ14031,,2504225.18,-543266231.17,Young,439,France,65535.56,0,1,0
5134,2011,5,MORTGAGE,3,Low,1,7200, 36 months,1,debt_consolidation,6,Low,1,Good Loan,0,12.42,B,2,9.76,7805.98,7200,0,240.59,409000005133,14-Mar-18,TRF TO  Indiaforensic SERVICES I,"5,000,000.00",,-548266231.17,Kerr,479,Spain,160060.90,0,1,0
5135,2011,3,MORTGAGE,3,Low,1,15000, 60 months,2,debt_consolidation,6,Low,1,Good Loan,0,12.69,B,2,11.24,16892.78,11769.35,0,338.93,409000005134,15-Mar-18,Indiaforensic VISA ACQ DOM150318,,1256817.11,-547009414.06,Frolova,850,France,155879.57,0,1,0
5136,2011,5,RENT,1,Low,1,4800, 36 months,1,other,4,Low,1,Good Loan,0,7.9,A,1,9.19,5406.100185,4800,0,150.2,409000005135,15-Mar-18,Indiaforensic RUPAY POS ACQ15031,,2105951.56,-544903462.50,Vasilyev,518,France,194416.58,0,1,0
5137,2011,10,MORTGAGE,3,Low,1,15350, 60 months,2,debt_consolidation,6,High,2,Bad Loan,1,13.49,C,3,28.63,703.36,361.68,0,353.13,409000005136,15-Mar-18,Indiaforensic MASTER ACQ DOM1503,,927443.40,-543976019.10,Sabbatini,717,Germany,21630.21,0,1,0
5138,2011,2,RENT,1,Low,1,6500, 36 months,1,car,2,Low,1,Good Loan,0,12.69,B,2,3.96,7831.142729,6500,0,218.05,409000005137,15-Mar-18,TRF TO  Indiaforensic SERVICES I,"4,200,000.00",,-548176019.10,Ifeanacho,698,France,157143.61,0,1,0
5139,2011,10,OWN,2,Low,1,6000, 36 months,1,debt_consolidation,6,Low,1,Good Loan,0,7.9,A,1,6.32,6678.88,6000,0,187.75,409000005138,16-Mar-18,Indiaforensic MASTER ACQ DOM1603,,930235.32,-547245783.78,Capon,850,France,52796.31,0,1,0
5140,2011,10,RENT,1,Low,1,2800, 36 months,1,major_purchase,8,Low,1,Good Loan,0,10.65,B,2,20.92,3281.826595,2800,0,91.21,409000005139,16-Mar-18,Indiaforensic VISA ACQ DOM160318,,1294330.99,-545951452.79,Chieloka,700,Spain,121798.52,0,1,0
5141,2011,1,RENT,1,Medium,2,12000, 36 months,1,debt_consolidation,6,Low,1,Good Loan,0,7.51,A,1,5.42,13404.0393,12000,0,373.33,409000005140,16-Mar-18,Indiaforensic RUPAY POS ACQ16031,,2007447.58,-543944005.21,Hanson,626,France,41104.82,0,1,0
5142,2011,2,MORTGAGE,3,Low,1,12000, 36 months,1,other,4,Low,1,Good Loan,0,6.62,A,1,16.03,12618.48,12000,0,368.45,409000005141,16-Mar-18,Indiaforensic VISA ACQ INT 14031,,4202.51,-543939802.70,Ts'ao,774,Spain,10604.48,0,1,0
5143,2011,2,MORTGAGE,3,Low,1,19425, 60 months,2,debt_consolidation,6,Low,1,Bad Loan,1,12.42,B,2,18.45,3449.75,1694.69,0,436.24,409000005142,16-Mar-18,Indiaforensic MASTER INT SET 150,,2222.34,-543937580.36,Bradshaw,719,Spain,78563.66,0,1,0
5144,2011,9,MORTGAGE,3,Medium,2,21000, 36 months,1,debt_consolidation,6,Low,1,Good Loan,0,12.69,B,2,7.92,24017.33,21000,0,704.45,409000005143,16-Mar-18,TRF TO  Indiaforensic SERVICES I,"4,300,000.00",,-548237580.36,Nkemakolam,646,Spain,170821.43,0,1,0
5145,2011,2,MORTGAGE,3,Medium,2,6900, 36 months,1,debt_consolidation,6,Low,1,Good Loan,0,10.65,B,2,13.42,8088.112322,6900,0,224.76,409000005144,17-Mar-18,Indiaforensic VISA ACQ DOM170318,,1119457.32,-547118123.04,Clunie,485,France,113266.09,0,1,0
5146,2011,4,RENT,1,Low,1,15000, 36 months,1,other,4,Low,1,Good Loan,0,12.42,B,2,24.04,16385.8,15000,0,501.23,409000005145,17-Mar-18,Indiaforensic RUPAY POS ACQ17031,,1410316.41,-545707806.63,Cover,784,Germany,171768.76,0,1,0
5147,2011,6,RENT,1,Low,1,4500, 36 months,1,credit_card,1,Low,1,Good Loan,0,12.69,B,2,13.5,5428.641609,4500,0,150.96,409000005146,17-Mar-18,Indiaforensic VISA ACQ INT 15031,,22764.73,-545685041.90,Esposito,850,Germany,54416.18,0,1,0
5148,2011,9,RENT,1,Medium,2,32000, 60 months,2,debt_consolidation,6,High,2,Good Loan,0,19.91,E,5,13.25,42297.81,24256.23,0,846.21,409000005147,17-Mar-18,ICA17825 Indiaforensic MASTER IN,,49922.26,-545635119.64,Hodgson,669,France,130755.34,0,1,0
5149,2011,7,RENT,1,Low,1,9000, 36 months,1,debt_consolidation,6,Low,1,Good Loan,0,12.69,B,2,23.38,10864.23507,9000,0,301.91,409000005148,17-Mar-18,TRF TO  Indiaforensic SERVICES I,"2,000,000.00",,-547635119.64,Harvey,731,Spain,141180.66,0,1,0
5150,2011,10,OWN,2,Low,1,9825, 36 months,1,small_business,3,Low,1,Good Loan,0,7.9,A,1,19.87,11066.33527,9825,0,307.43,409000005149,17-Mar-18,TRF TO  Indiaforensic SERVICES I,"500,000.00",,-548135119.64,Dobie,721,France,183421.76,0,1,0
5151,2011,10,MORTGAGE,3,Low,1,10625, 36 months,1,debt_consolidation,6,Low,1,Good Loan,0,12.42,B,2,15.06,12778.78797,10625,0,355.04,409000005150,19-Mar-18,IndforGN MSTR ACQ DOM17-1903,,2690541.17,-545444578.47,Okwudilichukwu,515,France,132770.11,0,1,0
5152,2011,10,RENT,1,Low,1,12000, 60 months,2,debt_consolidation,6,High,2,Good Loan,0,15.27,C,3,11.47,13569.99,12000,0,287.19,409000005151,19-Mar-18,Indiaforensic VISA ACQ DOM190318,,2535150.33,-542909428.14,Dyer,774,France,24400.37,0,1,0
5153,2011,10,RENT,1,Low,1,35000, 36 months,1,debt_consolidation,6,Low,1,Good Loan,0,8.9,A,1,16.64,40007.20993,35000,0,1111.37,409000005152,19-Mar-18,Indiaforensic RUPAY POS ACQ18031,,2500463.93,-540408964.21,Chase,585,Spain,180318.60,0,1,0
5154,2011,3,RENT,1,Low,1,35000, 60 months,2,other,4,High,2,Good Loan,0,17.58,D,4,16.49,43978.14,26811.61,0,880.8,409000005153,19-Mar-18,Indiaforensic RUPAY POS ACQ19031,,1688011.16,-538720953.05,Baresi,695,France,111565.45,0,1,0
5155,2011,2,MORTGAGE,3,Low,1,7000, 36 months,1,debt_consolidation,6,Low,1,Bad Loan,1,6.62,A,1,21.69,5373.25,4702.49,11.25,214.93,409000005154,19-Mar-18,TRF TO  Indiaforensic SERVICES I,"9,500,000.00",,-548220953.05,Lo,729,Germany,2002.50,0,1,0
5156,2011,5,RENT,1,Low,1,8000, 36 months,1,debt_consolidation,6,Low,1,Good Loan,0,12.69,B,2,23.71,9656.946558,8000,0,268.36,409000005155,20-Mar-18,Indiaforensic MASTER ACQ DOM2003,,925201.91,-547295751.14,Tyler,713,France,82565.01,0,1,0
5157,2011,4,RENT,1,Low,1,16200, 60 months,2,other,4,High,2,Good Loan,0,14.65,C,3,20.75,17794.81,16200,0,382.43,409000005156,20-Mar-18,Indiaforensic VISA ACQ DOM200318,,1143454.67,-546152296.47,Ts'ui,555,Spain,121789.30,0,1,0
5158,2011,1,MORTGAGE,3,Low,1,16000, 60 months,2,other,4,Low,1,Good Loan,0,12.69,B,2,10.88,20266.21253,16000,0,361.52,409000005157,20-Mar-18,Indiaforensic RUPAY POS ACQ20031,,2149426.23,-544002870.24,Aparicio,699,Spain,193785.87,0,1,0
5159,2011,2,MORTGAGE,3,Low,1,3000, 36 months,1,small_business,3,Low,1,Good Loan,0,6.62,A,1,22.06,3306.532696,3000,0,92.12,409000005158,20-Mar-18,Indiaforensic MASTER INT SET 170,,98.97,-544002771.27,Macleod,587,France,64593.07,0,1,0
5160,2011,0.5,RENT,1,Low,1,4000, 36 months,1,major_purchase,8,Low,1,Good Loan,0,12.69,B,2,2.5,4521,4000,0,134.18,409000005159,20-Mar-18,TRF TO  Indiaforensic SERVICES I,"4,200,000.00",,-548202771.27,Sal,762,Spain,196993.69,0,1,0
5161,2011,8,MORTGAGE,3,Low,1,14400, 60 months,2,credit_card,1,High,2,Good Loan,0,19.42,E,5,9.23,18795.06,10923.44,0,376.88,409000005160,21-Mar-18,Indiaforensic RUPAY POS ACQ 2103,,2065366.99,-546137404.28,Yeh,510,France,175518.31,0,1,0
5162,2011,0.5,RENT,1,Low,1,12000, 36 months,1,debt_consolidation,6,Low,1,Good Loan,0,7.9,A,1,2.92,13516.9473,12000,0,375.49,409000005161,21-Mar-18,Indiaforensic VISA ACQ DOM 21031,,1131376.41,-545006027.87,Udegbunam,842,Spain,17268.02,0,1,0
5163,2011,3,RENT,1,Low,1,12000, 60 months,2,major_purchase,8,High,2,Good Loan,0,19.03,E,5,20.97,15530.16,9119.87,0,311.49,409000005162,21-Mar-18,Indiaforensic MASTER ACQ DOM 210,,762926.84,-544243101.03,Alexandrov,608,France,60901.72,0,1,0
5164,2011,1,MORTGAGE,3,Low,1,30000, 60 months,2,small_business,3,High,2,Good Loan,0,20.89,F,6,15.33,40500.99,22603.55,0,809.75,409000005163,21-Mar-18,Indiaforensic VISA ACQ INT 17031,,29574.00,-544213527.03,Ozioma,850,France,100750.03,0,1,0
5165,2011,1,RENT,1,Low,1,14000, 60 months,2,debt_consolidation,6,Low,1,Good Loan,0,12.42,B,2,6.71,14705.83,14000,0,314.41,409000005164,21-Mar-18,Indiaforensic VISA ACQ INT 18031,,395.60,-544213131.43,Atkins,642,France,195224.91,0,1,0
5166,2011,2,RENT,1,Low,1,18000, 60 months,2,small_business,3,High,2,Good Loan,0,20.3,E,5,22.62,23954.82,13601.18,0,479.9,409000005165,21-Mar-18,TRF TO  Indiaforensic SERVICES I,"2,000,000.00",,-546213131.43,Campos,850,France,3510.18,0,1,0
5167,2011,7,RENT,1,Low,1,5000, 36 months,1,debt_consolidation,6,Low,1,Bad Loan,1,7.9,A,1,1.11,948.83,624.81,152.79,156.46,409000005166,21-Mar-18,TRF TO  Indiaforensic SERVICES I,"2,000,000.00",,-548213131.43,Wood,455,Spain,81250.79,0,1,0
5168,2011,1,MORTGAGE,3,Low,1,15000, 36 months,1,other,4,Low,1,Good Loan,0,6.03,A,1,2.63,16014.13,15000,0,456.54,409000005167,21-Mar-18,Indiaforensic MASTER ACQ DOM2103,"46,810.59",,-548259942.02,Kerr,726,France,91844.14,0,1,0
5169,2011,1,MORTGAGE,3,Low,1,3000, 36 months,1,vacation,11,Low,1,Good Loan,0,9.91,B,2,15.63,3479.527886,3000,0,96.68,409000005168,22-Mar-18,Indiaforensic RUPAY POS ACQ 2203,,1779439.20,-546480502.82,Chienezie,544,Spain,80676.83,0,1,0
5170,2011,6,MORTGAGE,3,Low,1,14000, 60 months,2,house,12,High,2,Good Loan,0,15.96,C,3,6.89,16949.25,10804.02,0,340.16,409000005169,22-Mar-18,Indiaforensic VISA ACQ DOM 22031,,1270455.53,-545210047.29,Tsou,651,Germany,129912.74,0,1,0
5171,2011,2,RENT,1,Low,1,3000, 36 months,1,other,4,High,2,Good Loan,0,13.49,C,3,16.59,3662.304377,3000,0,101.8,409000005170,22-Mar-18,Indiaforensic MASTER ACQ DOM 220,,309803.84,-544900243.45,McKinnon,814,France,142029.17,0,1,0
5172,2011,10,MORTGAGE,3,Low,1,35000, 60 months,2,debt_consolidation,6,Low,1,Good Loan,0,11.71,B,2,19.87,38636.89,27643.13,0,773.44,409000005171,22-Mar-18,TRF TO  Indiaforensic SERVICES I,"3,300,000.00",,-548200243.45,Nwachukwu,537,France,137651.60,0,1,0
5173,2011,10,MORTGAGE,3,Low,1,30000, 60 months,2,debt_consolidation,6,High,2,Good Loan,0,14.65,C,3,19.9,37008.97,30000,0,708.2,409000005172,22-Mar-18,Indiaforensic MASTER ACQ DOM 220,,498795.71,-547701447.74,Nwebube,553,France,33877.29,0,1,0
5174,2011,10,MORTGAGE,3,Low,1,10000, 36 months,1,other,4,High,2,Good Loan,0,13.49,C,3,3.55,12210.68847,10000,0,339.31,409000005173,22-Mar-18,Indiaforensic VISA ACQ INT 20031,,9890.00,-547691557.74,Burt,800,Spain,78744.39,0,1,0
5175,2011,2,RENT,1,Low,1,10000, 36 months,1,debt_consolidation,6,Low,1,Good Loan,0,10.65,B,2,9.11,10814.74,10000,0,325.74,409000005174,23-Mar-18,Indiaforensic RUPAY POS ACQ 2303,,1665186.95,-546026370.79,Ross,791,France,96734.46,0,1,0
5176,2011,10,MORTGAGE,3,Low,1,11100, 60 months,2,debt_consolidation,6,Low,1,Good Loan,0,8.9,A,1,21.23,11472.13,8876.82,0,229.88,409000005175,23-Mar-18,Indiaforensic VISA ACQ DOM 23031,,1106682.12,-544919688.67,Lees,699,Spain,164756.81,0,1,0
5177,2011,4,MORTGAGE,3,Low,1,2600, 36 months,1,debt_consolidation,6,Low,1,Good Loan,0,11.71,B,2,15.46,2625.62,2600,0,86,409000005176,23-Mar-18,Indiaforensic MASTER ACQ DOM 230,,683459.51,-544236229.16,Feetham,756,France,164394.65,0,1,0
5178,2011,5,RENT,1,High,3,21000, 36 months,1,debt_consolidation,6,Low,1,Good Loan,0,11.71,B,2,3.81,24706.57,21000,0,694.6,409000005177,23-Mar-18,TRF TO  Indiaforensic SERVICES I,"4,000,000.00",,-548236229.16,Chuang,591,Spain,162501.83,0,1,0
5179,2011,0.5,RENT,1,Low,1,2200, 60 months,2,major_purchase,8,Low,1,Good Loan,0,12.69,B,2,23.77,2418.66,2200,0,49.71,409000005178,23-Mar-18,Indiaforensic MASTER INT SET 220,,4887.86,-548231341.30,Aitken,850,Germany,10541.38,0,1,0
5180,2011,10,RENT,1,Medium,2,15000, 36 months,1,debt_consolidation,6,High,2,Good Loan,0,19.03,E,5,12.16,19719.12207,15000,0,550.07,409000005179,26-Mar-18,Indiaforensic RUPAY POS ACQ 2403,,1938136.46,-546293204.84,Chambers,760,Germany,59325.21,0,1,0
5181,2011,3,MORTGAGE,3,Low,1,3800, 36 months,1,credit_card,1,High,2,Good Loan,0,18.64,E,5,19,4981.527608,3800,0,138.61,409000005180,26-Mar-18,Indiaforensic RUPAY POS ACQ 2503,,1622928.39,-544670276.45,Coburn,569,Spain,178187.28,0,1,0
5182,2011,4,RENT,1,Low,1,3000, 36 months,1,moving,10,Low,1,Good Loan,0,7.51,A,1,12.54,3359.187975,3000,0,93.34,409000005181,26-Mar-18,Indiaforensic RUPAY POS ACQ 2603,,1406490.45,-543263786.00,Ahmed,661,Spain,142626.49,0,1,0
5183,2011,10,RENT,1,Low,1,30000, 36 months,1,debt_consolidation,6,Low,1,Good Loan,0,10.65,B,2,20.58,32370.14,29999.98,0,977.2,409000005182,26-Mar-18,Indiaforensic VISA ACQ DOM 24031,,1252562.93,-542011223.07,Ogochukwu,670,France,181893.31,0,1,0
5184,2011,1,MORTGAGE,3,High,3,35000, 36 months,1,debt_consolidation,6,Low,1,Good Loan,0,7.9,A,1,21.9,39424.10667,35000,0,1095.16,409000005183,26-Mar-18,Indiaforensic VISA ACQ DOM 26031,,2172737.45,-539838485.62,Soto,694,France,156858.20,0,1,0
5185,2011,5,RENT,1,Low,1,10400, 60 months,2,car,2,High,2,Bad Loan,1,19.03,E,5,10.74,4543.43,1749.27,495.5,269.96,409000005184,26-Mar-18,Indiaforensic MSTR ACQ DOM24-260,,2424876.17,-537413609.45,Obiajulu,728,France,33074.51,0,1,0
5186,2011,10,MORTGAGE,3,High,3,30000, 60 months,2,debt_consolidation,6,High,2,Good Loan,0,22.11,G,7,5.4,42826.6,30000,0,830.45,409000005185,26-Mar-18,Indiaforensic VISA ACQ INT 22031,,1865.80,-537411743.65,Yegorova,764,Germany,50072.94,0,1,0
5187,2011,10,MORTGAGE,3,Low,1,16000, 36 months,1,credit_card,1,High,2,Good Loan,0,13.49,C,3,19.12,17876.03,16000,0,542.89,409000005186,26-Mar-18,TRF TO  Indiaforensic SERVICES I,"10,800,000.00",,-548211743.65,Lucchese,639,France,111340.36,0,1,0
5188,2011,6,MORTGAGE,3,Low,1,7500, 36 months,1,small_business,3,Low,1,Good Loan,0,7.51,A,1,9.33,8397.490512,7500,0,233.34,409000005187,27-Mar-18,Indiaforensic VISA ACQ DOM 27031,,852335.94,-547359407.71,Talbot,683,France,100496.84,0,1,0
5189,2011,10,MORTGAGE,3,Medium,2,10200, 36 months,1,home_improvement,7,Low,1,Good Loan,0,12.42,B,2,11.75,12267.64132,10200,0,340.84,409000005188,27-Mar-18,Indiaforensic RUPAY POS ACQ 2703,,1564237.48,-545795170.23,Lu,663,Spain,101371.05,0,1,0
5190,2011,10,MORTGAGE,3,Low,1,4000, 36 months,1,home_improvement,7,Low,1,Good Loan,0,12.69,B,2,13.57,4602.66,4000,0,134.18,409000005189,27-Mar-18,Indiaforensic MSTR ACQ DOM   270,,666654.42,-545128515.81,Arnold,826,Spain,180934.67,0,1,0
5191,2011,10,OWN,2,Low,1,17000, 36 months,1,debt_consolidation,6,Low,1,Good Loan,0,6.62,A,1,24.73,17683.02,17000,0,521.97,409000005190,27-Mar-18,Indiaforensic VISA ACQ INT 23031,,898.94,-545127616.87,Nicholson,735,Spain,105152.17,0,1,0
5192,2011,10,MORTGAGE,3,Low,1,30000, 60 months,2,other,4,High,2,Good Loan,0,18.64,E,5,2.12,38672.96,30000,0,772.29,409000005191,27-Mar-18,TRF TO  Indiaforensic SERVICES I,"3,100,000.00",,-548227616.87,Chukwualuka,682,France,706.50,0,1,0
5193,2011,1,MORTGAGE,3,Low,1,11000, 36 months,1,home_improvement,7,Low,1,Bad Loan,1,11.71,B,2,21.02,4785.28,2498.04,488.47,363.84,409000005192,28-Mar-18,ICA17825 Indiaforensic MASTER AD,,37548.24,-548190068.63,Wallace,663,France,101168.90,0,1,0
5194,2011,4,MORTGAGE,3,Low,1,10000, 36 months,1,home_improvement,7,Low,1,Good Loan,0,6.03,A,1,7.68,10956.30851,10000,0,304.36,409000005193,28-Mar-18,Indiaforensic MSTR ACQ DOM   280,,781717.64,-547408350.99,Pisano,562,Spain,6795.61,0,1,0
5195,2011,6.05,MORTGAGE,3,Low,1,12000, 60 months,2,small_business,3,High,2,Bad Loan,1,17.27,D,4,1.64,1621.94,517.22,400.11,299.98,409000005194,28-Mar-18,Indiaforensic VISA ACQ DOM 28031,,942536.56,-546465814.43,Kelly,696,France,196111.35,0,1,0
5196,2011,10,MORTGAGE,3,Low,1,12000, 36 months,1,major_purchase,8,Low,1,Good Loan,0,6.03,A,1,2.55,13148.25988,12000,0,365.23,409000005195,28-Mar-18,TRF TO  Indiaforensic SERVICES I,"1,800,000.00",,-548265814.43,Brady,850,Spain,171960.76,0,1,0
5197,2011,0.5,RENT,1,Low,1,4000, 36 months,1,credit_card,1,Low,1,Good Loan,0,6.62,A,1,26.34,4407.882611,4000,0,122.82,409000005196,28-Mar-18,Indiaforensic VISA ACQ INT 24031,,4470.41,-548261344.02,Palmer,719,France,177497.40,0,1,0
5198,2011,8,RENT,1,Medium,2,35000, 60 months,2,debt_consolidation,6,High,2,Good Loan,0,22.74,G,7,16.27,49062.51,26131.67,0,981.45,409000005197,28-Mar-18,Indiaforensic VISA ACQ INT 25031,,15230.60,-548246113.42,Tan,804,France,147995.96,0,1,0
5199,2011,5,OWN,2,Low,1,5200, 36 months,1,credit_card,1,Low,1,Good Loan,0,12.42,B,2,15.44,6254.433518,5200,0,173.76,409000005198,28-Mar-18,Indiaforensic RUPAY POS ACQ 2803,,1010053.52,-547236059.90,L?,604,France,36209.10,0,1,0
5200,2011,10,MORTGAGE,3,Low,1,11650, 36 months,1,debt_consolidation,6,Low,1,Good Loan,0,6.62,A,1,9.04,12875.2614,11650,0,357.7,409000005199,30-Mar-18,FUND TRF TO  Indiaforensic SERVI,"1,000,000.00",,-548236059.90,Mordvinova,782,Spain,143614.01,0,1,0
5201,2011,1,MORTGAGE,3,Low,1,9250, 36 months,1,debt_consolidation,6,Low,1,Good Loan,0,7.9,A,1,29.48,10418.55197,9250,0,289.44,409000005200,31-Mar-18,Indiaforensic RUPAY POS ACQ 2903,,1817436.47,-546418623.43,Corones,512,Germany,14828.54,0,1,0
5202,2011,2,MORTGAGE,3,Low,1,12000, 60 months,2,car,2,High,2,Good Loan,0,17.27,D,4,16.83,14956.07,9202.87,0,299.98,409000005201,31-Mar-18,Indiaforensic RUPAY POS ACQ 2803,,994335.68,-545424287.75,Clements,569,France,154775.70,0,1,0
5203,2011,0.5,MORTGAGE,3,High,3,12000, 60 months,2,debt_consolidation,6,High,2,Good Loan,0,20.3,E,5,8.78,12601.46,12000,0,319.94,409000005202,31-Mar-18,TRF TO  Indiaforensic SERVICES I,"2,800,000.00",,-548224287.75,Morrice,597,Germany,70529.00,0,1,0
5204,2011,10,MORTGAGE,3,Medium,2,24000, 60 months,2,debt_consolidation,6,High,2,Bad Loan,1,20.89,F,6,4.01,4030.71,1188.5,797.81,647.8,409000005203,31-Mar-18,Indiaforensic VISA ACQ DOM 29031,,1081320.98,-547142966.77,Hsiung,753,Germany,57896.27,0,1,0
5205,2011,10,RENT,1,Low,1,3600, 36 months,1,major_purchase,8,High,2,Good Loan,0,15.27,C,3,1,4417.29,3600,0,125.28,409000005204,31-Mar-18,Indiaforensic VISA ACQ DOM 30031,,842955.95,-546300010.82,Barrett,430,France,69759.91,0,1,0
5206,2011,6.05,MORTGAGE,3,Low,1,16000, 60 months,2,small_business,3,High,2,Good Loan,0,17.58,D,4,8.34,20070.94,12248.68,0,402.65,409000005205,31-Mar-18,Indiaforensic VISA ACQ DOM 31031,,1123706.74,-545176304.08,Kanayochukwu,756,France,89938.08,0,1,0
5207,2011,6.05,MORTGAGE,3,Low,1,10375, 36 months,1,debt_consolidation,6,Low,1,Good Loan,0,8.9,A,1,26.76,11858.28257,10375,0,329.44,409000005206,31-Mar-18,Indiaforensic RUPAY POS ACQ 2803,"1,010,053.52",,-546186357.60,Tardent,493,France,89578.32,0,1,0
5208,2011,6.05,OWN,2,Low,1,2000, 36 months,1,debt_consolidation,6,Low,1,Good Loan,0,12.42,B,2,14,2404.705282,2000,0,66.84,409000005207,31-Mar-18,Indiaforensic RUPAY POS ACQ 3003,,1509646.77,-544676710.83,Bowhay,777,Germany,73464.88,0,1,0
5209,2011,3,MORTGAGE,3,Low,1,18875, 60 months,2,debt_consolidation,6,High,2,Good Loan,0,19.42,E,5,23.93,24899.56,18875,0,494.01,409000005208,31-Mar-18,Indiaforensic RUPAY POS ACQ 3103,,1469574.91,-543207135.92,Lei,779,Spain,138542.87,0,1,0
5210,2011,1,MORTGAGE,3,Low,1,6400, 36 months,1,debt_consolidation,6,Low,1,Good Loan,0,6.03,A,1,19.27,6481.92,6400,0,194.79,409000005209,31-Mar-18,TRF TO  Indiaforensic SERVICES I,"2,000,000.00",,-545207135.92,Baker,702,Spain,161888.63,0,1,0
5211,2011,10,RENT,1,Low,1,16000, 36 months,1,credit_card,1,High,2,Good Loan,0,17.27,D,4,12.1,19048.12,16000,0,572.6,409000005210,31-Mar-18,TRF TO  Indiaforensic SERVICES I,"2,000,000.00",,-547207135.92,Pisano,551,France,86937.20,0,1,0
5212,2011,3,RENT,1,Low,1,11600, 60 months,2,wedding,5,High,2,Good Loan,0,16.77,D,4,18.16,16084.65382,11600,0,286.86,409000005211,31-Mar-18,TRF TO  Indiaforensic SERVICES I,"1,000,000.00",,-548207135.92,Castillo,749,Germany,42241.54,0,1,0
5213,2011,3,MORTGAGE,3,Low,1,7500, 36 months,1,debt_consolidation,6,Low,1,Good Loan,0,6.62,A,1,16.65,8288.258904,7500,0,230.28,409000005212,3-Apr-18,Indiaforensic VISA ACQ DOM 01041,,38525273.35,-509681862.57,Gibson,742,Germany,121207.66,0,1,0
5214,2011,10,MORTGAGE,3,Low,1,11000, 36 months,1,debt_consolidation,6,Low,1,Good Loan,0,10.65,B,2,13.8,12896.51344,11000,0,358.31,409000005213,3-Apr-18,Indiaforensic VISA ACQ DOM 02041,,1870017.44,-507811845.13,Lindsay,752,Germany,102930.46,0,1,0
5215,2011,7,RENT,1,Low,1,7200, 36 months,1,debt_consolidation,6,Low,1,Good Loan,0,12.69,B,2,5.25,7731.63,7200,0,241.53,409000005214,3-Apr-18,Indiaforensic VISA ACQ DOM 03041,,948629.45,-506863215.68,Macnamara,740,Germany,65121.63,0,1,0
5216,2011,9,OWN,2,Low,1,6000, 36 months,1,debt_consolidation,6,High,2,Good Loan,0,15.96,C,3,20.18,7101.19,6000,0,210.83,409000005215,3-Apr-18,Indiaforensic RUPAY POS ACQ 0104,,1301151.52,-505562064.16,Romano,576,France,78498.04,0,1,0
5217,2011,1,RENT,1,Low,1,11000, 36 months,1,debt_consolidation,6,Low,1,Good Loan,0,6.62,A,1,19.49,11340.62,11000,0,337.75,409000005216,3-Apr-18,Indiaforensic RUPAY POS ACQ 0204,,1219784.75,-504342279.41,Aksakova,637,Spain,104769.96,0,1,0
5218,2011,2,MORTGAGE,3,Low,1,29175, 60 months,2,moving,10,High,2,Good Loan,0,18.25,D,4,16.7,37180.48,22283.66,0,744.83,409000005217,3-Apr-18,Indiaforensic RUPAY POS ACQ 0304,,1530167.80,-502812111.61,Farnsworth,724,France,96498.14,0,1,0
5219,2011,0.5,RENT,1,Low,1,10000, 36 months,1,debt_consolidation,6,High,2,Good Loan,0,18.25,D,4,4.6,13055.37773,10000,0,362.78,409000005218,3-Apr-18,TRF TO  Indiaforensic SERVICES I,"15,000,000.00",,-517812111.61,Giordano,685,France,38691.34,0,1,0
5220,2011,10,MORTGAGE,3,Low,1,12000, 60 months,2,other,4,Low,1,Bad Loan,1,9.91,B,2,8.02,1526.4,951.35,0,254.44,409000005219,3-Apr-18,TRF TO  Indiaforensic SERVICES I,"15,000,000.00",,-532812111.61,Arnold,625,France,164804.02,0,1,0
5221,2011,6.05,MORTGAGE,3,Low,1,17000, 60 months,2,major_purchase,8,Low,1,Good Loan,0,7.9,A,1,9.14,18768.16,17000,0,343.89,409000005220,3-Apr-18,TRF TO  Indiaforensic SERVICES I,"15,000,000.00",,-547812111.61,Thompson,571,Germany,104152.65,0,1,0
5222,2011,10,MORTGAGE,3,Low,1,3950, 36 months,1,debt_consolidation,6,Low,1,Good Loan,0,10.65,B,2,10.74,4630.504404,3950,0,128.67,409000005221,3-Apr-18,TRF TO  Indiaforensic SERVICES I,"400,000.00",,-548212111.61,Koch,584,Spain,88866.92,0,1,0
5223,2011,2,MORTGAGE,3,Medium,2,35000, 60 months,2,debt_consolidation,6,High,2,Bad Loan,1,20.89,F,6,16.81,41731.38,17250.48,3870.73,944.71,409000005222,3-Apr-18,Indiaforensic MASTER ACQ DOM2902,,3252775.52,-544959336.09,Jones,550,France,129890.94,0,1,0
5224,2011,1,OWN,2,Low,1,8000, 36 months,1,debt_consolidation,6,Low,1,Good Loan,0,7.51,A,1,18.05,8958.037637,8000,0,248.89,409000005223,3-Apr-18,Indiaforensic MASTER ACQ DOM 030,,1258653.01,-543700683.08,Otitodilinna,662,Spain,179258.67,0,1,0
5225,2011,10,RENT,1,Low,1,4500, 36 months,1,other,4,Low,1,Good Loan,0,9.91,B,2,16.89,5219.478583,4500,0,145.02,409000005224,3-Apr-18,Indiaforensic MASTER INT SET 280,,503.90,-543700179.18,Fleetwood-Smith,803,Spain,72051.44,0,1,0
5226,2011,4,MORTGAGE,3,Low,1,30000, 60 months,2,debt_consolidation,6,High,2,Bad Loan,1,19.03,E,5,20.98,38074.39,22156.9,0,778.72,409000005225,4-Apr-18,TRF TO  Indiaforensic SERVICES I,"4,500,000.00",,-548200179.18,Chinonyelum,615,France,74580.80,0,1,0
5227,2011,10,RENT,1,Low,1,14000, 60 months,2,debt_consolidation,6,High,2,Bad Loan,1,15.96,C,3,12.9,8916.69,3879.83,1434.73,340.16,409000005226,4-Apr-18,TRF FROM Indiaforensic SERVICES,,15000000.00,-533200179.18,Montague,481,Spain,123995.15,0,1,0
5228,2011,10,MORTGAGE,3,Low,1,18000, 60 months,2,debt_consolidation,6,Low,1,Good Loan,0,11.71,B,2,12.54,19852.05,14204.76,0,397.77,409000005227,4-Apr-18,TRF FROM Indiaforensic SERVICES,,15000000.00,-518200179.18,Milani,701,France,38960.59,0,1,0
5229,2011,3,MORTGAGE,3,Low,1,6950, 60 months,2,home_improvement,7,High,2,Good Loan,0,13.49,C,3,3.15,9469.749998,6950,0,159.89,409000005228,4-Apr-18,Indiaforensic VISA ACQ DOM 04041,,1014286.68,-517185892.50,Palermo,751,France,94951.27,0,1,0
5230,2011,6,OWN,2,Low,1,18000, 36 months,1,debt_consolidation,6,Low,1,Good Loan,0,9.91,B,2,21.53,20104.14,18000,0,580.05,409000005229,4-Apr-18,Indiaforensic VISA ACQ INT 27031,,306.19,-517185586.31,Anderson,675,France,56642.97,0,1,0
5231,2011,1,RENT,1,Low,1,12000, 60 months,2,house,12,High,2,Bad Loan,1,15.96,C,3,13.31,12844.08,7738.85,47.79,291.57,409000005230,4-Apr-18,Indiaforensic VISA ACQ INT 30031,,989.00,-517184597.31,Crawford,733,Germany,50783.10,0,1,0
5232,2011,0.5,MORTGAGE,3,Medium,2,15000, 60 months,2,debt_consolidation,6,High,2,Good Loan,0,18.25,D,4,10.28,20341.68799,15000,0,382.95,409000005231,4-Apr-18,Indiaforensic VISA ACQ INT 02041,,504.61,-517184092.70,Lin,822,France,9149.96,0,1,0
5233,2011,3,RENT,1,Low,1,2000, 36 months,1,credit_card,1,Low,1,Good Loan,0,11.71,B,2,21.9,2379.817518,2000,0,66.16,409000005232,4-Apr-18,Indiaforensic RUPAY POS ACQ 0404,,1720558.35,-515463534.35,Yewen,559,France,21006.10,0,1,0
5234,2011,6.05,OWN,2,Low,1,4000, 36 months,1,debt_consolidation,6,Low,1,Good Loan,0,7.51,A,1,17.48,4478.891443,4000,0,124.45,409000005233,4-Apr-18,Indiaforensic MSTR ACQ DOM   040,,848347.46,-514615186.89,Simmons,731,Germany,33759.41,0,1,0
5235,2011,5,RENT,1,Medium,2,2000, 36 months,1,home_improvement,7,High,2,Good Loan,0,16.29,D,4,20.34,2222.32,2000,0,70.61,409000005234,4-Apr-18,REVIndiaforensic VISA ACQ DOM010,"33,659,553.72",,-548274740.61,Mbadiwe,678,France,196622.28,0,1,0
5236,2011,3,MORTGAGE,3,Low,1,10500, 36 months,1,medical,9,Low,1,Good Loan,0,6.62,A,1,16.26,11603.65331,10500,0,322.39,409000005235,4-Apr-18,TRF FROM  Indiaforensic SERVICES,,7500000.00,-540774740.61,Munro,645,France,176353.87,0,1,0
5237,2011,9,MORTGAGE,3,Low,1,2050, 36 months,1,debt_consolidation,6,High,2,Good Loan,0,15.96,C,3,23.34,2579.113482,2050,0,72.04,409000005236,4-Apr-18,REVIndiaforensic VISA ACQ DOM010,"4,865,719.63",,-545640460.24,Graham,701,France,176943.59,0,1,0
5238,2011,10,OWN,2,Low,1,7500, 36 months,1,debt_consolidation,6,High,2,Good Loan,0,17.58,D,4,11.87,9564.221954,7500,0,269.57,409000005237,4-Apr-18,Indiaforensic MASTER INT SET 030,,1955.34,-545638504.90,Lombardo,554,Spain,177966.24,0,1,0
5239,2011,8,MORTGAGE,3,Low,1,8400, 36 months,1,debt_consolidation,6,Low,1,Good Loan,0,7.51,A,1,12.96,9395.371829,8400,0,261.34,409000005238,5-Apr-18,TRF TO  Indiaforensic SERVICES I,"2,600,000.00",,-548238504.90,Kalinin,723,France,162198.32,0,1,0
5240,2011,4,MORTGAGE,3,Low,1,7200, 36 months,1,credit_card,1,Low,1,Good Loan,0,10.65,B,2,11.16,8440.906491,7200,0,234.53,409000005239,5-Apr-18,Indiaforensic VISA ACQ DOM 05041,,1340963.89,-546897541.01,Woodward,766,Germany,197643.24,0,1,0
5241,2011,3,RENT,1,Medium,2,6800, 36 months,1,debt_consolidation,6,Low,1,Good Loan,0,6.03,A,1,4.23,6886.33,6800,0,206.97,409000005240,5-Apr-18,Indiaforensic RUPAY POS ACQ 0504,,1880236.64,-545017304.37,Pirozzi,597,France,60420.07,0,1,0
5242,2011,3,MORTGAGE,3,Low,1,12500, 36 months,1,medical,9,Low,1,Good Loan,0,6.03,A,1,12.09,13695.5028,12500,0,380.45,409000005241,5-Apr-18,Indiaforensic MSTR ACQ DOM   050,,986116.12,-544031188.25,Iweobiegbulam,574,France,70550.00,0,1,0
5243,2011,4,RENT,1,Low,1,5000, 36 months,1,credit_card,1,High,2,Good Loan,0,14.27,C,3,3.88,5166.26,5000,0,171.55,409000005242,5-Apr-18,TRF TO  Indiaforensic SERVICES I,"4,200,000.00",,-548231188.25,Piazza,655,Germany,198798.44,0,1,0
5244,2011,3,MORTGAGE,3,Low,1,2600, 36 months,1,other,4,Low,1,Bad Loan,1,7.9,A,1,17.44,1386.22,1074.71,87.36,81.36,409000005243,6-Apr-18,Indiaforensic VISA ACQ DOM 06041,,1140945.03,-547090243.22,Baranova,780,Germany,126310.39,0,1,0
5245,2011,7,MORTGAGE,3,Low,1,5000, 60 months,2,other,4,High,2,Good Loan,0,20.89,F,6,17.95,6734.35,3764.17,0,134.96,409000005244,6-Apr-18,Indiaforensic VISA ACQ INT 04041,,3461.50,-547086781.72,Fan,672,Spain,64515.50,0,1,0
5246,2011,4,MORTGAGE,3,Low,1,15000, 36 months,1,major_purchase,8,Low,1,Good Loan,0,6.03,A,1,0.7,15695.18,15000,0,456.54,409000005245,6-Apr-18,Indiaforensic RUPAY POS ACQ 0604,,1708256.83,-545378524.89,Sun,717,France,158580.05,0,1,0
5247,2011,10,RENT,1,Low,1,6000, 60 months,2,debt_consolidation,6,High,2,Bad Loan,1,15.96,C,3,8.93,7267.09,4615.27,0,145.79,409000005246,6-Apr-18,Indiaforensic MSTR ACQ DOM   060,,885795.49,-544492729.40,Marino,521,France,129353.21,0,1,0
5248,2011,2,RENT,1,Low,1,19950, 60 months,2,debt_consolidation,6,Low,1,Good Loan,0,10.65,B,2,3.51,21406.5,15778.62,0,430.29,409000005247,6-Apr-18,TRF TO  Indiaforensic SERVICES I,"3,700,000.00",,-548192729.40,Donaldson,633,France,137273.97,0,1,0
5249,2011,2,MORTGAGE,3,High,3,30000, 60 months,2,debt_consolidation,6,High,2,Good Loan,0,20.89,F,6,15.86,39912.49,30000,0,809.75,409000005248,7-Apr-18,Indiaforensic VISA ACQ DOM 07041,,1128092.50,-547064636.90,Burton,669,France,171575.54,0,1,0
5250,2011,0.5,RENT,1,Low,1,2000, 36 months,1,other,4,High,2,Good Loan,0,14.65,C,3,11.2,2482.788145,2000,0,68.99,409000005249,7-Apr-18,TRF TO  Indiaforensic SERVICES I,"500,000.00",,-547564636.90,Quinn,740,France,96528.00,0,1,0
5251,2011,1,MORTGAGE,3,Low,1,12750, 60 months,2,debt_consolidation,6,High,2,Good Loan,0,17.27,D,4,20.59,18896.23997,12750,0,318.73,409000005250,7-Apr-18,TRF TO  Indiaforensic SERVICES I,"500,000.00",,-548064636.90,Sabbatini,462,Germany,64421.02,0,1,0
5252,2011,2,RENT,1,Low,1,6400, 36 months,1,moving,10,Low,1,Good Loan,0,6.62,A,1,7.92,6442,6400,0,196.51,409000005251,9-Apr-18,Indiaforensic RUPAY POS ACQ 0704,,1927653.95,-546136982.95,Brooks,619,France,158444.61,0,1,0
5253,2011,10,MORTGAGE,3,Low,1,5000, 36 months,1,credit_card,1,Low,1,Bad Loan,1,6.03,A,1,23.13,1655.2,254.63,1350.98,152.18,409000005252,9-Apr-18,Indiaforensic RUPAY POS ACQ 0804,,1757314.59,-544379668.36,Black,665,France,66548.58,0,1,0
5254,2011,4,RENT,1,Low,1,18000, 36 months,1,debt_consolidation,6,Low,1,Good Loan,0,8.9,A,1,10.98,19955.47,18000,0,571.56,409000005253,9-Apr-18,Indiaforensic RUPAY POS ACQ 0904,,1616696.33,-542762972.03,Schwartz,655,Spain,108008.05,0,1,0
5255,2011,2,MORTGAGE,3,Low,1,20000, 36 months,1,debt_consolidation,6,High,2,Good Loan,0,14.27,C,3,11.74,24693.72361,20000,0,686.18,409000005254,9-Apr-18,Indiaforensic MSTR ACQ DOM07-090,,2716816.47,-540046155.56,Ts'ui,463,Spain,128268.39,0,1,0
5256,2011,10,RENT,1,Low,1,14000, 60 months,2,credit_card,1,High,2,Bad Loan,1,20.3,E,5,19.83,14835.98,6909.55,1085.57,373.26,409000005255,9-Apr-18,Indiaforensic VISA ACQ DOM 09041,,2511102.15,-537535053.41,Sargent,799,France,37464.00,0,1,0
5257,2011,10,MORTGAGE,3,Medium,2,35000, 60 months,2,debt_consolidation,6,Low,1,Good Loan,0,11.71,B,2,11.4,38652.02,27652.59,0,773.44,409000005256,9-Apr-18,TRF TO  Indiaforensic SERVICES I,"10,000,000.00",,-547535053.41,Udinesi,713,Spain,157381.14,0,1,0
5258,2011,10,MORTGAGE,3,Low,1,7500, 36 months,1,home_improvement,7,Low,1,Good Loan,0,11.71,B,2,12.12,8928.00893,7500,0,248.07,409000005257,9-Apr-18,TRF TO  Indiaforensic SERVICES I,"500,000.00",,-548035053.41,Lee,807,Germany,194257.11,0,1,0
5259,2011,7,MORTGAGE,3,Low,1,13800, 36 months,1,home_improvement,7,Low,1,Good Loan,0,8.9,A,1,4.17,15772.96256,13800,0,438.2,409000005258,10-Apr-18,Indiaforensic MSTR ACQ DOM   100,,973232.63,-547061820.78,Taylor,728,France,139059.05,0,1,0
5260,2011,7,RENT,1,Low,1,10700, 36 months,1,debt_consolidation,6,High,2,Bad Loan,1,13.49,C,3,24.18,5826.25,4217.67,11.39,363.06,409000005259,10-Apr-18,Indiaforensic VISA ACQ DOM 10041,,1444371.67,-545617449.11,Kepley,582,France,40893.61,0,1,0
5261,2011,3,RENT,1,Low,1,10000, 36 months,1,debt_consolidation,6,Low,1,Good Loan,0,7.9,A,1,16.09,11117.27,10000,0,312.91,409000005260,10-Apr-18,Indiaforensic RUPAY POS ACQ 1004,,2261359.12,-543356089.99,Ozuluonye,704,Germany,40261.49,0,1,0
5262,2011,10,OWN,2,Low,1,20000, 60 months,2,debt_consolidation,6,High,2,Good Loan,0,13.49,C,3,24.74,22701.15,20000,0,460.1,409000005261,10-Apr-18,TRF TO  Indiaforensic SERVICES I,"4,900,000.00",,-548256089.99,Lassetter,714,France,46203.31,0,1,0
5263,2011,0.5,RENT,1,Low,1,11500, 36 months,1,credit_card,1,Low,1,Good Loan,0,6.62,A,1,10.28,12457.79,11500,0,353.1,409000005262,10-Apr-18,Indiaforensic VISA ACQ INT 06041,,2341.80,-548253748.19,Mishina,628,France,13126.90,0,1,0
5264,2011,0.5,RENT,1,Low,1,10000, 36 months,1,debt_consolidation,6,Low,1,Good Loan,0,12.42,B,2,13.58,11341.97,10000,0,334.16,409000005263,10-Apr-18,17825-IRTT00701810687-BIL,"9,702.93",,-548263451.12,Trevisano,809,Germany,165675.01,0,1,0
5265,2011,3,RENT,1,Low,1,5000, 36 months,1,debt_consolidation,6,Low,1,Bad Loan,1,11.71,B,2,19.15,1725.01,1087.82,224.57,165.38,409000005264,11-Apr-18,Indiaforensic RUPAY POS ACQ 1104,,2057150.79,-546206300.33,Iloerika,547,Spain,5459.07,0,1,0
5266,2011,2,RENT,1,Low,1,18800, 60 months,2,home_improvement,7,Low,1,Good Loan,0,12.42,B,2,8.35,22764.16,16802.77,0,422.2,409000005265,11-Apr-18,Indiaforensic MSTR ACQ DOM   110,,987424.07,-545218876.26,Tan,560,France,131919.48,0,1,0
5267,2011,8,MORTGAGE,3,Low,1,12000, 60 months,2,home_improvement,7,Low,1,Good Loan,0,12.69,B,2,5.22,13538.52,9428.75,0,271.14,409000005266,11-Apr-18,Indiaforensic VISA ACQ DOM 11041,,1521589.48,-543697286.78,Chikelu,811,France,182372.35,0,1,0
5268,2011,10,RENT,1,Low,1,4000, 36 months,1,debt_consolidation,6,High,2,Bad Loan,1,15.27,C,3,9.48,3312.01,2225.57,249.61,139.2,409000005267,11-Apr-18,TRF TO  Indiaforensic SERVICES I,"4,500,000.00",,-548197286.78,Lin,584,France,147600.54,0,1,0
5269,2011,4,OWN,2,Low,1,20000, 60 months,2,small_business,3,High,2,Bad Loan,1,17.27,D,4,19.76,2022.5,862.86,0,499.96,409000005268,12-Apr-18,Indiaforensic MSTR ACQ DOM   120,,1150952.56,-547046334.22,Nicholson,691,France,92865.41,0,1,0
5270,2011,0.5,MORTGAGE,3,Low,1,15000, 36 months,1,small_business,3,Low,1,Good Loan,0,7.51,A,1,3.4,16798.93509,15000,0,466.67,409000005269,12-Apr-18,Indiaforensic VISA ACQ DOM 12041,,1611989.33,-545434344.89,Ugoji,680,Germany,67142.97,0,1,0
5271,2011,10,MORTGAGE,3,Medium,2,28000, 60 months,2,debt_consolidation,6,High,2,Good Loan,0,14.65,C,3,12.03,33047.54,21812.36,0,660.99,409000005270,12-Apr-18,Indiaforensic RUPAY POS ACQ 1204,,2372880.13,-543061464.76,Michel,588,Germany,65611.01,0,1,0
5272,2011,0.5,MORTGAGE,3,Low,1,10000, 36 months,1,home_improvement,7,Low,1,Good Loan,0,6.62,A,1,18.52,10401.64,10000,0,307.04,409000005271,12-Apr-18,Indiaforensic MASTER INT SET 110,,1969.80,-543059494.96,Bruce,721,Germany,138564.48,0,1,0
5273,2011,3,MORTGAGE,3,Low,1,5000, 36 months,1,debt_consolidation,6,Low,1,Good Loan,0,7.9,A,1,9.18,5631.559139,5000,0,156.46,409000005272,13-Apr-18,TRF TO  Indiaforensic SERVICES I,"4,000,000.00",,-547059494.96,Feng,850,France,187391.02,0,1,0
5274,2011,10,MORTGAGE,3,Low,1,5000, 36 months,1,debt_consolidation,6,Low,1,Good Loan,0,7.51,A,1,5.65,5598.418154,5000,0,155.56,409000005273,13-Apr-18,TRF TO  Indiaforensic SERVICES I,"1,000,000.00",,-548059494.96,McDonald,529,France,33656.35,0,1,0
5275,2011,3,MORTGAGE,3,Medium,2,12000, 36 months,1,debt_consolidation,6,High,2,Good Loan,0,14.27,C,3,14.4,14684.71795,12000,0,411.71,409000005274,13-Apr-18,Indiaforensic MSTR ACQ DOM   130,,1211092.69,-546848402.27,Watt,622,France,100618.17,0,1,0
5276,2011,10,MORTGAGE,3,Low,1,12600, 60 months,2,debt_consolidation,6,High,2,Good Loan,0,14.27,C,3,15.71,14717.54,9815.64,0,294.95,409000005275,13-Apr-18,Indiaforensic RUPAY POS ACQ 1304,,2490856.88,-544357545.39,Goodwin,683,France,198134.90,0,1,0
5277,2011,2,MORTGAGE,3,Low,1,35000, 60 months,2,debt_consolidation,6,Low,1,Good Loan,0,11.71,B,2,14.12,45824.93997,35000,0,773.44,409000005276,13-Apr-18,Indiaforensic VISA ACQ DOM 13041,,1554850.15,-542802695.24,Arcuri,575,France,50368.87,0,1,0
5278,2011,3,RENT,1,Low,1,7000, 36 months,1,debt_consolidation,6,Low,1,Good Loan,0,6.62,A,1,15.62,7735.598066,7000,0,214.93,409000005277,13-Apr-18,TRF TO  Indiaforensic SERVICES I,"5,400,000.00",,-548202695.24,Rapuluolisa,577,Spain,108787.00,0,1,0
5279,2011,1,RENT,1,Low,1,7000, 36 months,1,medical,9,Low,1,Good Loan,0,12.69,B,2,4.97,8012.53,7000,0,234.82,409000005278,16-Apr-18,Indiaforensic MSTR ACQ DOM14-160,,3548694.58,-544654000.66,Kao,510,Germany,33099.41,0,1,0
5280,2011,10,MORTGAGE,3,Low,1,8000, 36 months,1,car,2,Low,1,Good Loan,0,7.51,A,1,8.58,8934.511493,8000,0,248.89,409000005279,16-Apr-18,Indiaforensic VISA ACQ DOM 14041,,1565288.16,-543088712.50,Tsui,652,Spain,124550.88,0,1,0
5281,2011,5,RENT,1,Low,1,1400, 36 months,1,moving,10,High,2,Good Loan,0,22.06,F,6,6.49,1924.756354,1400,0,53.52,409000005280,16-Apr-18,Indiaforensic VISA ACQ DOM 16041,,3364746.42,-539723966.08,Summers,569,Germany,5159.21,0,1,0
5282,2011,2,MORTGAGE,3,Low,1,18000, 60 months,2,wedding,5,High,2,Good Loan,0,21.28,F,6,23.56,28364.23343,18000,0,489.8,409000005281,16-Apr-18,Indiaforensic RUPAY POS ACQ 1404,,2250972.16,-537472993.92,Cross,687,Spain,48228.10,0,1,0
5283,2011,4,RENT,1,Low,1,5000, 36 months,1,other,4,Low,1,Bad Loan,1,12.69,B,2,9.38,3835.66,2677.58,322.99,167.73,409000005282,16-Apr-18,Indiaforensic RUPAY POS ACQ 1504,,2505366.37,-534967627.55,Osorio,822,France,108798.36,0,1,0
5284,2011,6.05,MORTGAGE,3,Low,1,24375, 60 months,2,debt_consolidation,6,High,2,Good Loan,0,17.58,D,4,15.82,30620.38,18681.93,0,613.41,409000005283,16-Apr-18,Indiaforensic RUPAY POS ACQ 1604,,2348826.37,-532618801.18,Bobrov,656,Germany,21085.12,0,1,0
5285,2011,4,RENT,1,Low,1,4000, 36 months,1,debt_consolidation,6,Low,1,Good Loan,0,12.69,B,2,14.36,4515.42,4000,0,134.18,409000005284,16-Apr-18,TRF TO  Indiaforensic SERVICES I,"5,000,000.00",,-537618801.18,Barnett,745,Germany,28922.25,0,1,0
5286,2011,0.5,MORTGAGE,3,Medium,2,20000, 60 months,2,debt_consolidation,6,High,2,Good Loan,0,23.91,G,7,9.47,23069.83,20000,0,574.32,409000005285,16-Apr-18,TRF TO  Indiaforensic SERVICES I,"2,000,000.00",,-539618801.18,Pike,386,Spain,62514.65,0,1,0
5287,2011,4,RENT,1,Medium,2,35000, 36 months,1,major_purchase,8,Low,1,Good Loan,0,8.9,A,1,14.08,38934.1,35000,0,1111.37,409000005286,16-Apr-18,TRF TO  Indiaforensic SERVICES I,"3,000,000.00",,-542618801.18,Gearheart,684,Spain,177506.66,0,1,0
5288,2011,0.5,RENT,1,Low,1,12600, 60 months,2,other,4,High,2,Good Loan,0,16.77,D,4,7.98,15447.25,12600,0,311.59,409000005287,16-Apr-18,TRF TO  Indiaforensic SERVICES I,"5,600,000.00",,-548218801.18,Bruno,635,Spain,90605.05,0,1,0
5289,2011,10,MORTGAGE,3,Medium,2,10000, 60 months,2,debt_consolidation,6,Low,1,Bad Loan,1,9.91,B,2,12.87,4664.22,3108.62,0,212.03,409000005288,17-Apr-18,Indiaforensic MASTER ACQ DOM 170,,1376994.90,-546841806.28,Egobudike,582,France,132029.95,0,1,0
5290,2011,6,RENT,1,Low,1,17000, 60 months,2,debt_consolidation,6,Low,1,Good Loan,0,11.71,B,2,14.77,18769.22,13428.25,0,375.67,409000005289,17-Apr-18,Indiaforensic RUPAY POS ACQ 1704,,2798974.02,-544042832.26,Okechukwu,613,Spain,176903.35,0,1,0
5291,2011,10,MORTGAGE,3,Low,1,30000, 60 months,2,debt_consolidation,6,Low,1,Good Loan,0,12.42,B,2,18.66,36571.66,30000,0,673.72,409000005290,17-Apr-18,Indiaforensic VISA ACQ INT 12041,,1437.65,-544041394.61,Zikoranachidimma,795,Germany,29239.29,0,1,0
5292,2011,2,RENT,1,Low,1,8000, 36 months,1,debt_consolidation,6,Low,1,Good Loan,0,9.91,B,2,20.45,9278.893979,8000,0,257.8,409000005291,17-Apr-18,17825-IRTT00701811345-BIL,"13,029.46",,-544054424.07,Milanesi,659,France,153662.88,0,1,0
5293,2011,5,OWN,2,Low,1,12000, 36 months,1,major_purchase,8,Low,1,Good Loan,0,6.03,A,1,13.45,13147.75446,12000,0,365.23,409000005292,17-Apr-18,Indiaforensic VISA ACQ DOM 17041,,2107621.92,-541946802.15,Ahern,745,France,154389.18,0,1,0
5294,2011,6,RENT,1,Low,1,2875, 36 months,1,credit_card,1,Low,1,Good Loan,0,11.71,B,2,20.47,3420.072672,2875,0,95.1,409000005293,17-Apr-18,TRF TO  Indiaforensic SERVICES I,"4,200,000.00",,-546146802.15,Dickson,604,Spain,166224.39,0,1,0
5295,2011,2,RENT,1,Low,1,14000, 36 months,1,debt_consolidation,6,Low,1,Good Loan,0,6.03,A,1,5.34,14783.84,14000,0,426.1,409000005294,17-Apr-18,ICA17825 Indiaforensic MC ADJ 11,,9087.19,-546137714.96,Anayochukwu,509,Germany,21646.20,0,1,0
5296,2011,2,MORTGAGE,3,Medium,2,4000, 36 months,1,home_improvement,7,Low,1,Good Loan,0,8.9,A,1,3.19,4571.338808,4000,0,127.02,409000005295,18-Apr-18,TRF TO  Indiaforensic SERVICES I,"2,100,000.00",,-548237714.96,McDonald,706,Germany,171037.63,0,1,0
5297,2011,9,RENT,1,Low,1,10800, 36 months,1,other,4,High,2,Bad Loan,1,16.29,D,4,5.08,7205.32,4744.77,347.5,381.25,409000005296,18-Apr-18,Indiaforensic RUPAY POS ACQ 1804,,2949820.91,-545287894.05,Fiorentini,619,Spain,112649.22,0,1,0
5298,2011,2,RENT,1,Low,1,2000, 36 months,1,car,2,High,2,Good Loan,0,13.49,C,3,12.41,2440.89394,2000,0,67.87,409000005297,18-Apr-18,Indiaforensic MASTER ACQ DOM 180,,1606609.27,-543681284.78,Russo,572,Germany,193014.26,0,1,0
5299,2011,10,RENT,1,Low,1,6000, 36 months,1,debt_consolidation,6,Low,1,Good Loan,0,6.03,A,1,16.27,6573.793099,6000,0,182.62,409000005298,18-Apr-18,Indiaforensic VISA ACQ DOM 18041,,1867981.14,-541813303.64,Young,695,France,118120.88,0,1,0
5300,2011,5,MORTGAGE,3,Low,1,24000, 60 months,2,debt_consolidation,6,Low,1,Bad Loan,1,10.65,B,2,8.94,15119.89,6246.42,5285.01,517.64,409000005299,18-Apr-18,TRF TO  Indiaforensic SERVICES I,"6,400,000.00",,-548213303.64,Bianchi,543,France,25650.04,0,1,0
5301,2011,6,MORTGAGE,3,Low,1,14400, 60 months,2,debt_consolidation,6,High,2,Good Loan,0,15.27,C,3,4.43,19068.13906,14400,0,344.62,409000005300,18-Apr-18,Indiaforensic VISA ACQ INT 14041,,2036.35,-548211267.29,Fallaci,640,France,113048.79,0,1,0
5302,2011,10,MORTGAGE,3,Low,1,35000, 60 months,2,debt_consolidation,6,High,2,Bad Loan,1,19.91,E,5,23.18,15724.83,6704.72,0,925.54,409000005301,19-Apr-18,Indiaforensic RUPAY POS ACQ 1904,,3379206.77,-544832060.52,Crawford,672,France,87372.49,0,1,0
5303,2011,10,MORTGAGE,3,Low,1,25875, 60 months,2,credit_card,1,High,2,Good Loan,0,23.13,G,7,21.64,36495.42,19250.68,0,731.37,409000005302,19-Apr-18,Indiaforensic MASTER ACQ DOM 190,,1451542.54,-543380517.98,Marsh,701,France,146651.99,0,1,0
5304,2011,3,MORTGAGE,3,Medium,2,2000, 36 months,1,home_improvement,7,Low,1,Good Loan,0,7.51,A,1,24.33,2101.08,2000,0,62.23,409000005303,19-Apr-18,Indiaforensic VISA ACQ DOM 19041,,1993420.23,-541387097.75,Kosisochukwu,634,Spain,8227.91,0,1,0
5305,2011,1,OWN,2,Low,1,3000, 36 months,1,credit_card,1,Low,1,Good Loan,0,6.03,A,1,3.81,3097.96,3000,0,91.31,409000005304,19-Apr-18,TRF TO  Indiaforensic SERVICES I,"500,000.00",,-541887097.75,Piccio,531,Spain,57034.35,0,1,0
5306,2011,10,MORTGAGE,3,Low,1,25000, 60 months,2,debt_consolidation,6,Low,1,Good Loan,0,11.71,B,2,14.98,27584.64,19736.6,0,552.46,409000005305,19-Apr-18,TRF TO  Indiaforensic SERVICES I,"1,000,000.00",,-542887097.75,Nevels,699,France,93003.21,0,1,0
5307,2011,0.5,MORTGAGE,3,Low,1,1700, 36 months,1,other,4,Low,1,Good Loan,0,7.9,A,1,22.65,1863.35,1700,0,53.2,409000005306,19-Apr-18,TRF TO  Indiaforensic SERVICES I,"5,000,000.00",,-547887097.75,Kaodilinakachukwu,605,France,165574.54,0,1,0
5308,2011,9,RENT,1,Low,1,25450, 60 months,2,debt_consolidation,6,High,2,Bad Loan,1,21.67,F,6,18,13186,5402.31,0,698.14,409000005307,20-Apr-18,Indiaforensic RUPAY POS ACQ 2004,,2729885.42,-545157212.33,Amaechi,534,France,13566.48,0,1,0
5309,2011,8,MORTGAGE,3,Medium,2,10000, 36 months,1,home_improvement,7,Low,1,Good Loan,0,6.03,A,1,9.23,10956.31255,10000,0,304.36,409000005308,20-Apr-18,Indiaforensic MASTER ACQ DOM 200,,1343076.87,-543814135.46,P'an,449,Spain,82796.29,0,1,0
5310,2011,6,MORTGAGE,3,Medium,2,12000, 60 months,2,debt_consolidation,6,High,2,Good Loan,0,18.25,D,4,9.13,17652.72157,12000,0,306.36,409000005309,20-Apr-18,Indiaforensic VISA ACQ INT 18041,,315.78,-543813819.68,Ikemefuna,684,Spain,119830.08,0,1,0
5311,2011,10,MORTGAGE,3,Low,1,27000, 60 months,2,credit_card,1,High,2,Good Loan,0,14.65,C,3,21.67,31866.48,21032.76,0,637.38,409000005310,20-Apr-18,Indiaforensic VISA ACQ DOM 20041,,1954967.01,-541858852.67,Tai,622,Germany,72155.85,0,1,0
5312,2011,3,RENT,1,Low,1,6000, 36 months,1,major_purchase,8,Low,1,Bad Loan,1,12.42,B,2,10.63,2786.88,998.56,1384.57,200.5,409000005311,21-Apr-18,TRF TO  Indiaforensic SERVICES I,"4,000,000.00",,-545858852.67,Winn,714,France,62762.12,0,1,0
5313,2011,10,MORTGAGE,3,Low,1,23000, 60 months,2,debt_consolidation,6,Low,1,Good Loan,0,9.91,B,2,8.15,28562.17007,23000,0,487.67,409000005312,21-Apr-18,TRF TO  Indiaforensic SERVICES I,"2,000,000.00",,-547858852.67,Hardy,712,Spain,183235.33,0,1,0
5314,2011,3,MORTGAGE,3,Low,1,6000, 36 months,1,home_improvement,7,Low,1,Good Loan,0,12.69,B,2,8.42,7243.661835,6000,0,201.27,409000005313,21-Apr-18,Indiaforensic RUPAY POS ACQ 2104,,2527381.40,-545331471.27,Chiu,783,France,105206.48,0,1,0
5315,2011,1,MORTGAGE,3,Low,1,15000, 60 months,2,debt_consolidation,6,Low,1,Good Loan,0,12.69,B,2,15.8,18228.91,15000,0,338.93,409000005314,21-Apr-18,Indiaforensic VISA ACQ DOM 21041,,1655224.25,-543676247.02,Lopez,743,Germany,22512.44,0,1,0
5316,2011,4,OWN,2,Low,1,12000, 36 months,1,credit_card,1,Low,1,Good Loan,0,12.42,B,2,13.64,14432.8159,12000,0,400.99,409000005315,21-Apr-18,TRF TO  Indiaforensic SERVICES I,"500,000.00",,-544176247.02,Steen,683,France,122305.91,0,1,0
5317,2011,6.05,OWN,2,Low,1,8000, 36 months,1,credit_card,1,High,2,Good Loan,0,16.77,D,4,23.25,10192.39104,8000,0,284.31,409000005316,21-Apr-18,TRF TO  Indiaforensic SERVICES I,"4,000,000.00",,-548176247.02,Ferri,654,Spain,173617.09,0,1,0
5318,2011,10,RENT,1,Low,1,13225, 36 months,1,debt_consolidation,6,High,2,Good Loan,0,16.77,D,4,22.47,16913.80783,13225,0,470,409000005317,23-Apr-18,Indiaforensic MSTR ACQ DOM21-230,,3526486.00,-544649761.02,Yegorova,700,France,160670.37,0,1,0
5319,2011,5,MORTGAGE,3,Low,1,32875, 60 months,2,small_business,3,High,2,Good Loan,0,15.96,C,3,22.5,39884.24,25412.85,0,798.76,409000005318,23-Apr-18,Indiaforensic RUPAY POS ACQ 2204,,2427227.06,-542222533.96,Knowles,744,Spain,158958.90,0,1,0
5320,2011,4,MORTGAGE,3,Low,1,7500, 36 months,1,credit_card,1,High,2,Good Loan,0,16.29,D,4,18.31,9529.588165,7500,0,264.76,409000005319,23-Apr-18,Indiaforensic RUPAY POS ACQ 2304,,2110934.51,-540111599.45,May,645,Germany,93073.04,0,1,0
5321,2011,0.5,RENT,1,Low,1,5000, 36 months,1,small_business,3,Low,1,Bad Loan,1,6.62,A,1,4.32,1161.89,764.22,243.05,153.52,409000005320,23-Apr-18,Indiaforensic VISA ACQ INT 19041,,14850.00,-540096749.45,Bianchi,525,Spain,67238.01,0,1,0
5322,2011,3,MORTGAGE,3,Low,1,14000, 36 months,1,debt_consolidation,6,Low,1,Good Loan,0,10.65,B,2,22.48,15617.88,14000,0,456.03,409000005321,23-Apr-18,Indiaforensic VISA ACQ DOM 23041,,3602285.91,-536494463.54,Pipes,732,France,172576.56,0,1,0
5323,2011,10,MORTGAGE,3,High,3,30000, 36 months,1,credit_card,1,Low,1,Good Loan,0,10.65,B,2,1.15,31027.47,30000,0,977.2,409000005322,23-Apr-18,TRF TO  Indiaforensic SERVICES I,"10,000,000.00",,-546494463.54,Doherty,721,France,122580.48,0,1,0
5324,2011,2,RENT,1,Low,1,5000, 36 months,1,other,4,Low,1,Bad Loan,1,9.91,B,2,7.34,2131.76,1502.12,200.81,161.13,409000005323,23-Apr-18,TRF TO  Indiaforensic SERVICES I,"1,000,000.00",,-547494463.54,Yobanna,622,France,149043.78,0,1,0
5325,2011,2,MORTGAGE,3,Low,1,10000, 36 months,1,debt_consolidation,6,High,2,Good Loan,0,13.49,C,3,13.44,11929.46,10000,0,339.31,409000005324,24-Apr-18,Indiaforensic MASTER ACQ DOM 240,,1523557.64,-545970905.90,Hsu,654,Germany,105218.45,0,1,0
5326,2011,10,MORTGAGE,3,Medium,2,35000, 36 months,1,credit_card,1,Low,1,Good Loan,0,7.9,A,1,13.98,37981.6,35000,0,1095.16,409000005325,24-Apr-18,Indiaforensic VISA ACQ DOM 21041,,1999939.23,-543970966.67,Russell,529,France,78463.99,0,1,0
5327,2011,6,MORTGAGE,3,Low,1,19400, 60 months,2,debt_consolidation,6,High,2,Bad Loan,1,20.89,F,6,18.19,18913.93,8176.57,1664.14,523.64,409000005326,24-Apr-18,Indiaforensic RUPAY POS ACQ 2404,,2710298.95,-541260667.72,Payne,720,Spain,160849.43,0,1,0
5328,2011,6.05,OWN,2,Low,1,3600, 60 months,2,debt_consolidation,6,High,2,Bad Loan,1,17.27,D,4,14.34,2421.63,1245.02,0,90,409000005327,24-Apr-18,17825-IRTT00701812061-BIL,"12,200.94",,-541272868.66,Windsor,850,Germany,87834.24,0,1,0
5329,2011,10,RENT,1,Low,1,30000, 60 months,2,debt_consolidation,6,High,2,Good Loan,0,21.67,F,6,14.73,41774.27,30000,0,822.95,409000005328,24-Apr-18,TRF TO  Indiaforensic SERVICES I,"4,000,000.00",,-545272868.66,Bray,667,Germany,166317.71,0,1,0
5330,2011,0.5,RENT,1,Low,1,7500, 36 months,1,other,4,Low,1,Good Loan,0,6.03,A,1,22.12,7679.15,7500,0,228.27,409000005329,24-Apr-18,TRF TO  Indiaforensic SERVICES I,"3,000,000.00",,-548272868.66,Seleznyov,620,France,137309.06,0,1,0
5331,2011,0.5,MORTGAGE,3,Low,1,18000, 60 months,2,debt_consolidation,6,Low,1,Bad Loan,1,12.42,B,2,14.89,7679.62,4540.94,14.64,404.24,409000005330,25-Apr-18,Indiaforensic RUPAY POS ACQ 2504,,2599911.74,-545672956.92,Wark,616,France,166984.44,0,1,0
5332,2011,10,MORTGAGE,3,Low,1,18975, 60 months,2,debt_consolidation,6,Low,1,Good Loan,0,10.65,B,2,10.54,22373.82,18975,0,409.26,409000005331,25-Apr-18,Indiaforensic VISA ACQ DOM 25041,,1836830.56,-543836126.36,Y?,637,Germany,166996.46,0,1,0
5333,2011,6,RENT,1,Low,1,12000, 60 months,2,other,4,High,2,Good Loan,0,17.58,D,4,13.39,13661.44,12000.01,0,301.99,409000005332,25-Apr-18,Indiaforensic MASTER ACQ DOM 250,,1396642.26,-542439484.10,Brown,710,Spain,188022.44,0,1,0
5334,2011,0.5,MORTGAGE,3,High,3,10000, 36 months,1,other,4,High,2,Good Loan,0,17.27,D,4,6.8,12236.37,10000,0,357.88,409000005333,25-Apr-18,TRF TO  Indiaforensic SERVICES I,"5,800,000.00",,-548239484.10,Huang,717,Spain,194467.23,0,1,0
5335,2011,0.5,MORTGAGE,3,Low,1,12500, 60 months,2,small_business,3,Low,1,Good Loan,0,9.91,B,2,17.09,13251.46,9966.11,0,265.04,409000005334,26-Apr-18,Indiaforensic VISA ACQ DOM 26041,,1808043.71,-546431440.39,Zito,786,Germany,125449.47,0,1,0
5336,2011,10,MORTGAGE,3,Low,1,16275, 60 months,2,debt_consolidation,6,Low,1,Good Loan,0,12.69,B,2,27.79,18356.69,12785.25,0,367.73,409000005335,26-Apr-18,Indiaforensic RUPAY POS ACQ 2604,,2769536.21,-543661904.18,Bailey,651,France,137452.57,0,1,0
5337,2011,3,RENT,1,Low,1,7000, 36 months,1,debt_consolidation,6,Low,1,Good Loan,0,12.69,B,2,10.95,8449.299057,7000,0,234.82,409000005336,26-Apr-18,Indiaforensic MASTER ACQ DOM 260,,1369018.98,-542292885.20,Allnutt,530,France,123475.88,0,1,0
5338,2011,10,MORTGAGE,3,Low,1,9200, 36 months,1,other,4,Low,1,Good Loan,0,6.03,A,1,5.47,10029.98091,9200,0,280.01,409000005337,26-Apr-18,TRF TO  Indiaforensic SERVICES I,"5,900,000.00",,-548192885.20,Christie,815,Spain,38941.44,0,1,0
5339,2011,6,MORTGAGE,3,Medium,2,30000, 36 months,1,debt_consolidation,6,High,2,Good Loan,0,17.58,D,4,5.99,36597.36,29999.99,0,1078.27,409000005338,27-Apr-18,Indiaforensic VISA ACQ DOM  2741,,1990817.21,-546202067.99,Pope,715,Germany,177852.57,0,1,0
5340,2011,10,MORTGAGE,3,Low,1,3000, 60 months,2,home_improvement,7,Low,1,Bad Loan,1,10.65,B,2,24.28,2264.85,1543.84,17.08,64.71,409000005339,27-Apr-18,Indiaforensic RUPAY POS ACQ 2704,,2381810.96,-543820257.03,Johnstone,496,Germany,31532.96,0,1,0
5341,2011,1,MORTGAGE,3,Low,1,10300, 36 months,1,debt_consolidation,6,High,2,Bad Loan,1,16.29,D,4,12.86,1917.19,223.56,1553.94,363.6,409000005340,27-Apr-18,Indiaforensic MASTER ACQ DOM 270,,1571281.06,-542248975.97,Bird,680,Spain,136377.21,0,1,0
5342,2011,10,RENT,1,Low,1,15600, 36 months,1,other,4,Low,1,Good Loan,0,12.69,B,2,3.61,16672.11,15600,0,523.3,409000005341,27-Apr-18,TRF TO  Indiaforensic SERVICES I,"6,000,000.00",,-548248975.97,Jones,646,France,130541.10,0,1,0
5343,2011,10,OWN,2,Medium,2,8000, 36 months,1,debt_consolidation,6,Low,1,Good Loan,0,12.42,B,2,15.39,9283.79,8000,0,267.33,409000005342,27-Apr-18,Indiaforensic VISA ACQ INT 25041,,0.99,-548248974.98,Pedder,807,Germany,65636.92,0,1,0
5344,2011,10,RENT,1,Low,1,7200, 36 months,1,credit_card,1,Low,1,Good Loan,0,9.91,B,2,21.71,7845.46,7200,0,232.02,409000005343,2-May-18,Indiaforensic RUPAY POS ACQ 2804,,2266050.67,-545982924.31,Calabrese,727,France,193305.35,0,1,0
5345,2011,2,RENT,1,Low,1,3000, 36 months,1,credit_card,1,Low,1,Good Loan,0,7.51,A,1,21.12,3282.88,3000,0,93.34,409000005344,2-May-18,Indiaforensic RUPAY POS ACQ 2904,,2247496.04,-543735428.27,Chialuka,787,France,47307.90,0,1,0
5346,2011,10,MORTGAGE,3,Low,1,17450, 36 months,1,debt_consolidation,6,Low,1,Good Loan,0,6.62,A,1,23.4,18630.89,17450,0,535.78,409000005345,2-May-18,Indiaforensic RUPAY POS ACQ 3004,,1885492.58,-541849935.69,McKenzie,806,France,100809.99,0,1,0
5347,2011,10,MORTGAGE,3,Low,1,12000, 36 months,1,debt_consolidation,6,Low,1,Good Loan,0,6.62,A,1,4.73,13081.97,12000,0,368.45,409000005346,2-May-18,Indiaforensic RUPAY POS ACQ 0105,,2449654.68,-539400281.01,Holloway,603,France,109145.20,0,1,0
5348,2011,7,MORTGAGE,3,Low,1,16000, 36 months,1,debt_consolidation,6,Low,1,Good Loan,0,7.9,A,1,11.94,18011.64697,16000,0,500.65,409000005347,2-May-18,Indiaforensic RUPAY POS ACQ 0205,,2640640.43,-536759640.58,Tang,649,Spain,91167.19,0,1,0
5349,2011,1,RENT,1,Low,1,10000, 36 months,1,credit_card,1,High,2,Good Loan,0,14.27,C,3,17.22,12345.15513,10000,0,343.09,409000005348,2-May-18,Indiaforensic VISA ACQ DOM  2804,,1786806.50,-534972834.08,Byrne,547,Germany,175295.89,0,1,0
5350,2011,3,MORTGAGE,3,Low,1,16500, 60 months,2,debt_consolidation,6,High,2,Good Loan,0,14.27,C,3,11.9,19269.72,12854.16,0,386.24,409000005349,2-May-18,Indiaforensic VISA ACQ DOM  3004,,4070818.32,-530902015.76,Selwyn,684,Germany,127433.47,0,1,0
5351,2011,2,RENT,1,Low,1,5000, 36 months,1,home_improvement,7,Low,1,Good Loan,0,7.9,A,1,10.02,5616.278188,5000,0,156.46,409000005350,2-May-18,Indiaforensic VISA ACQ DOM  0105,,2107635.67,-528794380.09,Genovese,477,France,71167.17,0,1,0
5352,2011,0.5,MORTGAGE,3,Low,1,16000, 36 months,1,credit_card,1,Low,1,Good Loan,0,7.51,A,1,8.08,17681.01,16000,0,497.78,409000005351,2-May-18,Indiaforensic VISA ACQ DOM  0205,,2276385.18,-526517994.91,Koger,558,Germany,111184.67,0,1,0
5353,2011,10,MORTGAGE,3,Low,1,7200, 36 months,1,other,4,Low,1,Good Loan,0,11.71,B,2,12.27,8490.314881,7200,0,238.15,409000005352,2-May-18,IndiaforensicMASTRACQDOM2804-020,,6920176.73,-519597818.18,Baranov,695,France,141756.32,0,1,0
5354,2011,10,OWN,2,Low,1,23000, 60 months,2,major_purchase,8,Low,1,Good Loan,0,11.71,B,2,7.41,29901.51637,23000,0,508.26,409000005353,2-May-18,TRF TO  Indiaforensic SERVICES I,"15,000,000.00",,-534597818.18,Greco,592,Spain,72678.75,0,1,0
5355,2011,0.5,MORTGAGE,3,Low,1,14000, 60 months,2,debt_consolidation,6,High,2,Good Loan,0,17.27,D,4,15.72,20372.73898,14000,0,349.98,409000005354,2-May-18,TRF TO  Indiaforensic SERVICES I,"6,700,000.00",,-541297818.18,Owens,789,France,172832.90,0,1,0
5356,2011,2,MORTGAGE,3,Low,1,20000, 36 months,1,credit_card,1,High,2,Good Loan,0,13.49,C,3,17.6,24421.94068,20000,0,678.61,409000005355,2-May-18,TRF TO  Indiaforensic SERVICES I,"6,000,000.00",,-547297818.18,Y?,597,France,158086.33,0,1,0
5357,2011,8,RENT,1,Low,1,3450, 36 months,1,credit_card,1,Low,1,Good Loan,0,12.69,B,2,16.71,4164.290705,3450,0,115.73,409000005356,2-May-18,Indiaforensic VISA ACQ INT 26041,,1017.68,-547296800.50,Kendall,839,Germany,168184.62,0,1,0
5358,2011,2,RENT,1,Low,1,9500, 36 months,1,debt_consolidation,6,Low,1,Good Loan,0,8.9,A,1,8.19,10857.11704,9500,0,301.66,409000005357,2-May-18,17825-MASTERCARD BILL 290,"116,912.10",,-547413712.60,Ko,405,Germany,72950.14,0,1,0
5359,2011,3,MORTGAGE,3,Low,1,25000, 36 months,1,debt_consolidation,6,High,2,Good Loan,0,16.29,D,4,12.19,31765.72975,25000,0,882.51,409000005358,2-May-18,Indiaforensic MASTER INT SET 300,,3186.74,-547410525.86,Tang,658,France,48378.40,0,1,0
5360,2011,5,RENT,1,Low,1,6000, 36 months,1,credit_card,1,Low,1,Good Loan,0,9.91,B,2,22.56,6958.812044,6000,0,193.35,409000005359,3-May-18,Indiaforensic VISA ACQ DOM  0305,,2039309.61,-545371216.25,Lombardo,684,Germany,23135.65,0,1,0
5361,2011,10,MORTGAGE,3,Low,1,10000, 36 months,1,house,12,High,2,Good Loan,0,14.27,C,3,9.92,11515.88,10000,0,343.09,409000005360,3-May-18,Indiaforensic RUPAY POS ACQ 0305,,2561426.64,-542809789.61,Perkins,633,France,65675.47,0,1,0
5362,2011,10,OWN,2,Low,1,3000, 36 months,1,car,2,Low,1,Good Loan,0,7.51,A,1,3.35,3359.394652,3000,0,93.34,409000005361,3-May-18,Indiaforensic MASTER ACQ DOM 030,,417359.85,-542392429.76,Feng,589,France,170676.67,0,1,0
5363,2011,10,MORTGAGE,3,Low,1,17000, 36 months,1,debt_consolidation,6,Low,1,Good Loan,0,10.65,B,2,16.12,19370.99,17000,0,553.75,409000005362,3-May-18,TRF TO  Indiaforensic SERVICES I,"5,800,000.00",,-548192429.76,Lo,750,Germany,27366.77,0,1,0
5364,2011,5,MORTGAGE,3,Low,1,4800, 36 months,1,home_improvement,7,Low,1,Bad Loan,1,12.42,B,2,15.36,3339.14,2443.06,135.34,160.4,409000005363,3-May-18,17825-MASTERCARD BILL 300,"8,878.87",,-548201308.63,Piccio,771,Spain,152479.64,0,1,0
5365,2011,10,MORTGAGE,3,Low,1,8000, 36 months,1,debt_consolidation,6,Low,1,Good Loan,0,12.69,B,2,23.97,9657.708211,8000,0,268.36,409000005364,3-May-18,Indiaforensic MC BILL RECOVERY A,"65,768.99",,-548267077.62,Mazzanti,812,Germany,105383.49,0,1,0
5366,2011,2,RENT,1,Low,1,7000, 36 months,1,debt_consolidation,6,Low,1,Good Loan,0,6.03,A,1,1.73,7362.4,7000,0,213.05,409000005365,4-May-18,Indiaforensic MASTER ACQ DOM0405,,2420684.44,-545846393.18,Chukwualuka,539,Spain,48189.94,0,1,0
5367,2011,1,RENT,1,Low,1,10000, 36 months,1,major_purchase,8,Low,1,Good Loan,0,11.71,B,2,16.89,11149.3,10000,0,330.76,409000005366,4-May-18,Indiaforensic VISA ACQ DOM040518,,1960038.47,-543886354.71,Elliot,670,Germany,100324.01,0,1,0
5368,2011,8,RENT,1,Low,1,8000, 36 months,1,debt_consolidation,6,High,2,Good Loan,0,15.96,C,3,15.98,10114.92683,8000,0,281.1,409000005367,4-May-18,TRF TO  Indiaforensic SERVICES I,"4,300,000.00",,-548186354.71,Gratton,673,France,65657.29,0,1,0
5369,2011,10,RENT,1,Low,1,18000, 60 months,2,debt_consolidation,6,Low,1,Good Loan,0,10.65,B,2,9.44,18471.89,18000,0,388.23,409000005368,4-May-18,Indiaforensic RUPAY POS ACQ04051,,2522789.37,-545663565.34,Carandini,538,France,17682.02,0,1,0
5370,2011,9,MORTGAGE,3,Low,1,5750, 60 months,2,debt_consolidation,6,High,2,Good Loan,0,14.27,C,3,19.27,6717.96,4481.12,0,134.6,409000005369,5-May-18,TRF TO  Indiaforensic SERVICES I,"500,000.00",,-546163565.34,Robinson,575,Spain,111342.66,0,1,0
5371,2011,10,MORTGAGE,3,Low,1,18000, 36 months,1,debt_consolidation,6,Low,1,Good Loan,0,7.9,A,1,20.15,20273.70829,18000,0,563.23,409000005370,5-May-18,TRF TO  Indiaforensic SERVICES I,"2,000,000.00",,-548163565.34,Lo,682,France,134158.09,0,1,0
5372,2011,9,MORTGAGE,3,Low,1,14000, 60 months,2,debt_consolidation,6,Low,1,Bad Loan,1,7.9,A,1,20.31,9981.44,5610.83,2353.67,283.2,409000005371,5-May-18,Indiaforensic VISA ACQ DOM050518,,2320432.48,-545843132.86,Ma,712,France,79176.09,0,1,0
5373,2011,3,OWN,2,Low,1,8875, 36 months,1,house,12,High,2,Good Loan,0,14.27,C,3,14.64,10954.65852,8875,0,304.5,409000005372,5-May-18,Indiaforensic RUPAY POS ACQ05051,,2763039.35,-543080093.51,Vinogradova,598,Spain,83103.46,0,1,0
5374,2011,2,MORTGAGE,3,Low,1,7000, 36 months,1,debt_consolidation,6,Low,1,Good Loan,0,7.9,A,1,21.79,7833.454563,7000,0,219.04,409000005373,5-May-18,Indiaforensic VISA ACQ INT 02051,,989.00,-543079104.51,H?,776,Spain,63908.86,0,1,0
5375,2011,1,RENT,1,Low,1,11100, 36 months,1,debt_consolidation,6,Low,1,Good Loan,0,6.62,A,1,25.88,12266.75578,11100,0,340.82,409000005374,5-May-18,TRF TO  Indiaforensic SERVICES I,"5,000,000.00",,-548079104.51,Alexandrova,606,Spain,90896.04,0,1,0
5376,2011,10,MORTGAGE,3,Medium,2,10000, 36 months,1,major_purchase,8,Low,1,Good Loan,0,6.03,A,1,5.01,10956.34515,10000,0,304.36,409000005375,7-May-18,Indiaforensic VISA ACQ DOM070518,,4573066.02,-543506038.49,Yang,686,Spain,76076.20,0,1,0
5377,2011,10,RENT,1,Low,1,4000, 36 months,1,other,4,High,2,Good Loan,0,16.29,D,4,11.47,5081.225049,4000,0,141.21,409000005376,7-May-18,Indiaforensic RUPAY POS ACQ06051,,2648588.04,-540857450.45,Maslova,850,Spain,103902.11,0,1,0
5378,2011,10,MORTGAGE,3,Low,1,6000, 36 months,1,small_business,3,High,2,Good Loan,0,13.49,C,3,10.18,7325.851216,6000,0,203.59,409000005377,7-May-18,TRF TO  Indiaforensic SERVICES I,"4,000,000.00",,-544857450.45,Buccho,642,France,142223.94,0,1,0
5379,2011,5,MORTGAGE,3,Low,1,14000, 36 months,1,debt_consolidation,6,Low,1,Good Loan,0,6.03,A,1,17.19,15338.8772,14000,0,426.1,409000005378,7-May-18,TRF TO  Indiaforensic SERVICES I,"3,000,000.00",,-547857450.45,Young,606,Germany,147533.09,0,1,0
5380,2011,3,RENT,1,Low,1,20000, 60 months,2,debt_consolidation,6,High,2,Good Loan,0,19.42,E,5,15.57,26131.26,15174.11,0,523.45,409000005379,7-May-18,Indiaforensic MASTER ACQ DOM0705,,4142179.56,-543715270.89,Barker,627,France,169156.64,0,1,0
5381,2011,10,RENT,1,Low,1,30000, 60 months,2,debt_consolidation,6,Low,1,Good Loan,0,12.42,B,2,19.88,33664.44,23617.7,0,673.72,409000005380,7-May-18,Indiaforensic RUPAY POS ACQ07051,,1949655.70,-541765615.19,Sung,850,Spain,141242.57,0,1,0
5382,2011,10,MORTGAGE,3,Low,1,1825, 36 months,1,medical,9,High,2,Good Loan,0,14.27,C,3,18.17,2031.91,1825,0,62.62,409000005381,8-May-18,TRF TO  Indiaforensic SERVICES I,"6,500,000.00",,-548265615.19,Hansen,850,Germany,149458.73,0,1,0
5383,2011,0.5,MORTGAGE,3,Low,1,15000, 60 months,2,debt_consolidation,6,Low,1,Good Loan,0,12.69,B,2,12.25,20031.80695,15000,0,338.93,409000005382,8-May-18,Indiaforensic MASTER ACQ DOM0805,,1567349.60,-546698265.59,Brown,724,France,86950.72,0,1,0
5384,2011,6,RENT,1,Low,1,20400, 60 months,2,debt_consolidation,6,High,2,Bad Loan,1,14.65,C,3,10.38,16139.7,8361.62,1696.22,481.58,409000005383,8-May-18,Indiaforensic VISA ACQ DOM080518,,2245491.12,-544452774.47,Lo Duca,579,France,176925.69,0,1,0
5385,2011,5,MORTGAGE,3,Low,1,25000, 36 months,1,debt_consolidation,6,Low,1,Bad Loan,1,7.51,A,1,20.27,13999.43,11779.94,22.07,777.78,409000005384,8-May-18,TRF TO  Indiaforensic SERVICES I,"3,800,000.00",,-548252774.47,Ellis,727,Spain,40357.39,0,1,0
5386,2011,2,RENT,1,Low,1,12000, 36 months,1,credit_card,1,High,2,Good Loan,0,15.96,C,3,12.38,15171.99574,12000,0,421.65,409000005385,8-May-18,Indiaforensic MASTER INT SET 070,,396.42,-548252378.05,Korff,813,Germany,26687.22,0,1,0
5387,2011,1,MORTGAGE,3,Low,1,19200, 60 months,2,credit_card,1,High,2,Good Loan,0,17.58,D,4,10.47,24044.2,14677.16,0,483.18,409000005386,8-May-18,17825-MASTERCARD BILL 060,"18,990.35",,-548271368.40,Gardiner,642,France,78702.98,0,1,0
5388,2011,10,MORTGAGE,3,Medium,2,10000, 36 months,1,credit_card,1,Low,1,Good Loan,0,12.42,B,2,11.42,12027.22184,10000,0,334.16,409000005387,8-May-18,Indiaforensic RUPAY POS ACQ08051,,2507929.95,-545763438.45,Kiernan,669,Spain,176163.74,0,1,0
5389,2011,9,OWN,2,Low,1,3500, 60 months,2,debt_consolidation,6,High,2,Good Loan,0,17.27,D,4,19.32,4193.68,3500,0,87.5,409000005388,9-May-18,TRF TO  Indiaforensic SERVICES I,"2,000,000.00",,-547763438.45,Thompson,574,Germany,4896.11,0,1,0
5390,2011,0.5,RENT,1,Low,1,4800, 36 months,1,debt_consolidation,6,Low,1,Good Loan,0,8.9,A,1,20.47,5486.048262,4800,0,152.42,409000005389,9-May-18,Indiaforensic MASTER ACQ DOM0905,,1700570.48,-546062867.97,Mathews,774,France,114899.13,0,1,0
5391,2011,0.5,MORTGAGE,3,Low,1,4000, 36 months,1,car,2,Low,1,Good Loan,0,7.9,A,1,10.56,4213.05,4000,0,125.17,409000005390,9-May-18,Indiaforensic VISA ACQ DOM090518,,2048217.55,-544014650.42,Macrossan,735,France,92220.12,0,1,0
5392,2011,5,RENT,1,Low,1,7000, 36 months,1,debt_consolidation,6,Low,1,Good Loan,0,10.65,B,2,18.6,8136.530142,7000,0,228.02,409000005391,9-May-18,Indiaforensic RUPAY POS ACQ09051,,2485332.73,-541529317.69,Illingworth,639,Spain,6251.30,0,1,0
5393,2011,10,RENT,1,Low,1,5000, 36 months,1,other,4,Low,1,Good Loan,0,12.42,B,2,9.18,6013.473088,5000,0,167.08,409000005392,9-May-18,TRF TO  Indiaforensic SERVICES I,"6,700,000.00",,-548229317.69,Bowen,738,Spain,43018.82,0,1,0
5394,2011,0.5,RENT,1,Low,1,10000, 36 months,1,house,12,Low,1,Good Loan,0,8.9,A,1,1.42,10074.7,10000,0,317.54,409000005393,9-May-18,Indiaforensic VISA ACQ INT 07051,,752.14,-548228565.55,Craig,835,France,27548.06,0,1,0
5395,2011,0.5,RENT,1,Medium,2,15000, 36 months,1,credit_card,1,Low,1,Good Loan,0,6.03,A,1,5,16400.44677,15000,0,456.54,409000005394,10-May-18,Indiaforensic MASTER ACQ DOM1005,,1870284.56,-546358280.99,Menhennitt,637,Spain,120454.20,0,1,0
5396,2011,2,RENT,1,Medium,2,4000, 36 months,1,other,4,Low,1,Bad Loan,1,11.71,B,2,4.34,1746.77,1179.25,161.93,132.31,409000005395,10-May-18,Indiaforensic VISA ACQ DOM100518,,2372805.88,-543985475.11,Moore,589,Germany,133961.19,0,1,0
5397,2011,3,RENT,1,Low,1,13100, 60 months,2,credit_card,1,High,2,Bad Loan,1,19.03,E,5,20.97,5440.16,2371.76,0,340.04,409000005396,10-May-18,Indiaforensic RUPAY POS ACQ10051,,2592512.60,-541392962.51,Shoebridge,591,France,131753.97,0,1,0
5398,2011,0.5,RENT,1,Medium,2,18000, 36 months,1,debt_consolidation,6,Low,1,Good Loan,0,11.71,B,2,0.76,21433.91215,18000,0,595.37,409000005397,10-May-18,TRF TO  Indiaforensic SERVICES I,"5,000,000.00",,-546392962.51,Palermo,723,France,38019.74,0,1,0
5399,2011,10,MORTGAGE,3,Low,1,3600, 36 months,1,home_improvement,7,Low,1,Good Loan,0,7.9,A,1,5.05,4054.737083,3600,0,112.65,409000005398,10-May-18,TRF TO  Indiaforensic SERVICES I,"1,000,000.00",,-547392962.51,Reilly,831,Germany,28144.07,0,1,0
5400,2011,3,MORTGAGE,3,High,3,14000, 36 months,1,debt_consolidation,6,High,2,Good Loan,0,18.64,E,5,16.42,18405.84974,14000,0,510.64,409000005399,10-May-18,TRF TO  Indiaforensic SERVICES I,"500,000.00",,-547892962.51,Bowen,733,Spain,45959.86,0,1,0
5401,2011,10,RENT,1,Low,1,9600, 36 months,1,debt_consolidation,6,Low,1,Good Loan,0,11.71,B,2,11.35,11120.06,9600,0,317.53,409000005400,11-May-18,Indiaforensic MASTER ACQ DOM1105,,1317448.30,-546575514.21,Fyodorov,731,France,189528.72,0,1,0
5402,2011,10,MORTGAGE,3,Medium,2,28000, 36 months,1,other,4,Low,1,Good Loan,0,10.65,B,2,6.62,32230.29,28000,0,912.06,409000005401,11-May-18,Indiaforensic VISA ACQ DOM110518,,2099887.49,-544475626.72,Clements,654,France,170481.98,0,1,0
5403,2011,2,MORTGAGE,3,Low,1,10000, 36 months,1,debt_consolidation,6,Low,1,Good Loan,0,12.69,B,2,18.3,12070.59964,10000,0,335.45,409000005402,11-May-18,Indiaforensic RUPAY POS ACQ11051,,2540774.91,-541934851.81,McKenzie,828,France,94845.45,0,1,0
5404,2011,4,RENT,1,Low,1,3800, 36 months,1,debt_consolidation,6,High,2,Bad Loan,1,17.27,D,4,12.17,2440.52,1547.33,137.7,136,409000005403,11-May-18,Indiaforensic VISA ACQ INT 09051,,154.28,-541934697.53,Craig,590,Spain,161253.08,0,1,0
5405,2011,5,RENT,1,Medium,2,12000, 60 months,2,wedding,5,High,2,Good Loan,0,14.65,C,3,10.08,13257.17,12000,0,283.28,409000005404,11-May-18,Indiaforensic MASTER INT SET1005,,2017.56,-541932679.97,Iloerika,657,France,115260.72,0,1,0
5406,2011,3,MORTGAGE,3,Medium,2,25000, 60 months,2,debt_consolidation,6,High,2,Bad Loan,1,19.03,E,5,6.06,5350.2,1846.18,825.96,648.93,409000005405,11-May-18,TRF TO  Indiaforensic SERVICES I,"6,300,000.00",,-548232679.97,Dolgorukova,531,Germany,60721.40,0,1,0
5407,2011,7,MORTGAGE,3,Low,1,9350, 36 months,1,debt_consolidation,6,Low,1,Good Loan,0,12.69,B,2,12.34,11266.5918,9350,0,313.65,409000005406,14-May-18,Indiaforensic VISA ACQ DOM120518,,2463753.88,-545768926.09,Eva,516,France,121365.45,0,1,0
5408,2011,4,RENT,1,Medium,2,35000, 36 months,1,debt_consolidation,6,High,2,Good Loan,0,14.27,C,3,9.43,37034.26,35000,0,1200.82,409000005407,14-May-18,Indiaforensic RUPAY POS ACQ12051,,2672616.89,-543096309.20,Yeh,561,France,101693.73,0,1,0
5409,2011,10,MORTGAGE,3,Low,1,8000, 36 months,1,debt_consolidation,6,Low,1,Good Loan,0,10.65,B,2,18.82,9379.173983,8000,0,260.59,409000005408,14-May-18,Indiaforensic RUPAY POS ACQ13051,,2642429.63,-540453879.57,P'an,682,Spain,54132.93,0,1,0
5410,2011,10,OWN,2,Low,1,15000, 36 months,1,car,2,High,2,Good Loan,0,15.27,C,3,2.16,18779.05871,15000,0,521.97,409000005409,14-May-18,Indiaforensic MASTER ACQ DOM12-1,,4858349.67,-535595529.90,Howe,575,Spain,10666.05,0,1,0
5411,2011,9,MORTGAGE,3,Low,1,9000, 36 months,1,debt_consolidation,6,Low,1,Good Loan,0,6.62,A,1,14.44,9830.41,9000,0,276.34,409000005410,14-May-18,Indiaforensic VISA ACQ DOM140518,,4092941.01,-531502588.89,Jenkins,623,France,41227.67,0,1,0
5412,2011,0.5,MORTGAGE,3,Medium,2,30000, 60 months,2,debt_consolidation,6,High,2,Good Loan,0,13.49,C,3,15.96,34466.06,23482.66,0,690.15,409000005411,14-May-18,Indiaforensic RUPAY POS ACQ14051,,2352399.15,-529150189.74,Shih,642,France,10712.82,0,1,0
5413,2011,0.5,RENT,1,Low,1,4000, 36 months,1,moving,10,Low,1,Good Loan,0,7.9,A,1,11.37,4422.14,4000,0,125.17,409000005412,14-May-18,Indiaforensic MASTER INT SET1105,,98.87,-529150090.87,Nnamdi,779,France,98912.69,0,1,0
5414,2011,5,RENT,1,Low,1,14000, 60 months,2,small_business,3,High,2,Good Loan,0,15.27,C,3,9.09,18641.4676,14000,0,335.05,409000005413,14-May-18,TRF TO  Indiaforensic SERVICES I,"5,000,000.00",,-534150090.87,Mitchell,671,France,197202.48,0,1,0
5415,2011,7,RENT,1,Low,1,5000, 36 months,1,credit_card,1,High,2,Bad Loan,1,13.49,C,3,15.82,4039.4,2797.61,328.44,169.66,409000005414,14-May-18,TRF TO  Indiaforensic SERVICES I,"5,000,000.00",,-539150090.87,Findlay,495,France,150720.39,0,1,0
5416,2011,6,RENT,1,Medium,2,25000, 60 months,2,debt_consolidation,6,Low,1,Good Loan,0,12.69,B,2,18,29577.53,24999.99,0,564.87,409000005415,14-May-18,TRF TO  Indiaforensic SERVICES I,"4,000,000.00",,-543150090.87,Pisani,850,France,74780.13,0,1,0
5417,2011,6,MORTGAGE,3,Low,1,15000, 36 months,1,home_improvement,7,Low,1,Good Loan,0,6.03,A,1,0.36,15699.86,15000,0,456.54,409000005416,14-May-18,TRF TO  Indiaforensic SERVICES I,"5,000,000.00",,-548150090.87,Belisario,630,France,79377.45,0,1,0
5418,2011,6.05,RENT,1,Low,1,15000, 36 months,1,debt_consolidation,6,Low,1,Good Loan,0,6.03,A,1,6.43,16434.73515,15000,0,456.54,409000005417,14-May-18,Indiaforensic RUPAY POS ACQ C214,,755045.86,-547395045.01,Pomeroy,588,France,8763.87,0,1,0
5419,2011,3,RENT,1,Low,1,9600, 36 months,1,credit_card,1,High,2,Good Loan,0,14.27,C,3,12.69,10435.75,9600,0,329.37,409000005418,15-May-18,Indiaforensic MASTER ACQ DOM 150,,1738774.24,-545656270.77,Ibrahimova,562,Germany,177112.70,0,1,0
5420,2011,4,OWN,2,Low,1,15000, 36 months,1,debt_consolidation,6,Low,1,Good Loan,0,11.71,B,2,20.7,17827.39162,15000,0,496.14,409000005419,15-May-18,Indiaforensic VISA ACQ DOM150518,,2385513.17,-543270757.60,K?,740,Spain,85016.64,0,1,0
5421,2011,8,MORTGAGE,3,Low,1,14500, 36 months,1,debt_consolidation,6,Low,1,Good Loan,0,10.65,B,2,20.7,17006.05755,14500,0,472.32,409000005420,15-May-18,Indiaforensic RUPAY POS ACQ15051,,1972648.33,-541298109.27,Graham,695,France,88689.40,0,1,0
5422,2011,9,MORTGAGE,3,Low,1,10000, 36 months,1,debt_consolidation,6,High,2,Good Loan,0,15.27,C,3,8.97,12519.09883,10000,0,347.98,409000005421,15-May-18,Indiaforensic RUPAY POS C2 ACQ15,,704726.12,-540593383.15,Trevisano,589,France,95985.64,0,1,0
5423,2011,6,RENT,1,Medium,2,18000, 36 months,1,debt_consolidation,6,Low,1,Good Loan,0,8.9,A,1,3.67,20575.16028,18000,0,571.56,409000005422,15-May-18,Indiaforensic MASTER INT SET 120,,1110.98,-540592272.17,Trevisano,607,France,166792.71,0,1,0
5424,2011,5,MORTGAGE,3,Medium,2,21000, 36 months,1,home_improvement,7,Low,1,Good Loan,0,7.9,A,1,15.45,23655.21426,21000,0,657.1,409000005423,15-May-18,17825-MASTERCARD BILL 130,"46,586.39",,-540638858.56,K?,794,France,68730.91,0,1,0
5425,2011,7,MORTGAGE,3,Medium,2,14000, 60 months,2,debt_consolidation,6,High,2,Good Loan,0,18.64,E,5,6.97,17984.94,10668.93,0,360.41,409000005424,15-May-18,TRF TO  Indiaforensic SERVICES I,"7,600,000.00",,-548238858.56,Manning,580,Germany,146891.07,0,1,0
5426,2011,0.5,RENT,1,Medium,2,20000, 60 months,2,medical,9,High,2,Bad Loan,1,15.96,C,3,21.87,8228.57,3604.2,940.35,485.94,409000005425,15-May-18,Indiaforensic VISA ACQ INT 11051,,1473.00,-548237385.56,Tucker,644,Germany,148727.42,0,1,0
5427,2011,10,RENT,1,Low,1,23275, 60 months,2,debt_consolidation,6,Low,1,Good Loan,0,10.65,B,2,18.99,25035.54,18448.9,0,502.01,409000005426,15-May-18,Indiaforensic RUPAY POS C2 ACQ15,,689325.10,-547548060.46,Schaffer,636,Spain,43134.58,0,1,0
5428,2011,10,RENT,1,Low,1,8700, 60 months,2,debt_consolidation,6,High,2,Bad Loan,1,18.25,D,4,6.02,8218.07,4398.8,35.56,222.11,409000005427,15-May-18,Indiaforensic RUPAY POS C2 REV15,"704,726.12",,-548252786.58,Esomchi,599,Germany,40318.33,0,1,0
5429,2011,10,MORTGAGE,3,Low,1,6450, 60 months,2,other,4,High,2,Bad Loan,1,18.25,D,4,23.52,3417.36,558.05,2108.88,164.67,409000005428,16-May-18,Indiaforensic MASTER ACQ DOM 160,,1944216.67,-546308569.91,Ch'ang,507,France,97633.93,0,1,0
5430,2011,5,MORTGAGE,3,Medium,2,28000, 36 months,1,small_business,3,Low,1,Good Loan,0,7.9,A,1,16.67,29634.69,28000,0,876.13,409000005429,16-May-18,Indiaforensic VISA ACQ DOM160518,,2242024.53,-544066545.38,Walker,682,France,65069.03,0,1,0
5431,2011,0.5,RENT,1,Low,1,12000, 36 months,1,debt_consolidation,6,Low,1,Good Loan,0,8.9,A,1,2.89,13697.70228,12000,0,381.04,409000005430,16-May-18,Indiaforensic RUPAY POS ACQ16051,,2035902.75,-542030642.63,Chu,714,France,166335.00,0,1,0
5432,2011,1,MORTGAGE,3,Medium,2,28000, 36 months,1,home_improvement,7,Low,1,Good Loan,0,11.71,B,2,4.54,29540.61,28000,0,926.13,409000005431,16-May-18,Indiaforensic RUPAY POS C2 ACQ16,,672031.96,-541358610.67,Crawford,696,France,121904.44,0,1,0
5433,2011,6,RENT,1,Medium,2,8000, 60 months,2,small_business,3,High,2,Good Loan,0,19.42,E,5,11.38,10439.32,6067.13,0,209.38,409000005432,16-May-18,TRF TO  Indiaforensic SERVICES I,"6,900,000.00",,-548258610.67,Milne,599,Spain,175235.99,0,1,0
5434,2011,4,MORTGAGE,3,Low,1,15000, 60 months,2,home_improvement,7,Low,1,Good Loan,0,10.65,B,2,9.87,19054.54617,15000,0,323.53,409000005433,17-May-18,Indiaforensic MASTER ACQ DOM 170,,1651074.91,-546607535.76,Anenechukwu,577,France,56185.05,0,1,0
5435,2011,8,MORTGAGE,3,Low,1,25000, 60 months,2,debt_consolidation,6,High,2,Bad Loan,1,18.25,D,4,12.2,30615.03,18023.16,0,638.25,409000005434,17-May-18,Indiaforensic VISA ACQ DOM170518,,2177997.43,-544429538.33,Donaldson,733,Spain,131625.14,0,1,0
5436,2011,6,MORTGAGE,3,Low,1,12000, 60 months,2,debt_consolidation,6,Low,1,Good Loan,0,7.9,A,1,1.88,12079.55,12000,0,242.75,409000005435,17-May-18,Indiaforensic RUPAY POS ACQ17051,,1841592.19,-542587946.14,Kelly,647,France,152323.04,0,1,0
5437,2011,6,MORTGAGE,3,Medium,2,10000, 36 months,1,major_purchase,8,Low,1,Good Loan,0,6.03,A,1,4.91,10821.5,10000,0,304.36,409000005436,17-May-18,Indiaforensic RUPAY POS C2 ACQ17,,608910.25,-541979035.89,Ts'ao,831,France,165840.94,0,1,0
5438,2011,7,RENT,1,Low,1,20000, 60 months,2,small_business,3,High,2,Good Loan,0,15.96,C,3,11.54,27884.93269,20000,0,485.94,409000005437,17-May-18,TRF TO  Indiaforensic SERVICES I,"5,000,000.00",,-546979035.89,Gonzalez,543,Germany,176692.65,0,1,0
5439,2011,6.05,MORTGAGE,3,Low,1,2000, 36 months,1,other,4,Low,1,Good Loan,0,12.69,B,2,1.5,2190.14,2000,0,67.09,409000005438,17-May-18,TRF TO  Indiaforensic SERVICES I,"500,000.00",,-547479035.89,Tai,679,France,121904.14,0,1,0
5440,2011,0.5,MORTGAGE,3,Low,1,3675, 36 months,1,credit_card,1,Low,1,Bad Loan,1,10.65,B,2,16.72,1673.56,1290.38,0,119.71,409000005439,18-May-18,Indiaforensic MASTER ACQ DOM 180,,1546537.30,-545932498.59,Muravyova,713,Germany,123663.63,0,1,0
5441,2011,0.5,RENT,1,Low,1,4500, 36 months,1,credit_card,1,High,2,Good Loan,0,14.65,C,3,23.24,5558.010744,4500,0,155.23,409000005440,18-May-18,Indiaforensic VISA ACQ DOM180518,,1876027.77,-544056470.82,Milanesi,690,Germany,119644.59,0,1,0
5442,2011,1,RENT,1,Low,1,8150, 36 months,1,major_purchase,8,High,2,Good Loan,0,17.27,D,4,2.42,10281.41,8150,0,291.67,409000005441,18-May-18,Indiaforensic RUPAY POS ACQ18051,,831720.35,-543224750.47,Lin,751,France,66825.33,0,1,0
5443,2011,9,MORTGAGE,3,Low,1,12000, 60 months,2,debt_consolidation,6,Low,1,Good Loan,0,9.91,B,2,16.18,12721.44,9567.53,0,254.44,409000005442,18-May-18,Indiaforensic RUPAY POS C2 ACQ18,,1535054.20,-541689696.27,Lambert,613,Germany,94875.03,0,1,0
5444,2011,3,RENT,1,Low,1,15000, 60 months,2,debt_consolidation,6,High,2,Good Loan,0,17.58,D,4,13.86,21797.52635,15000,0,377.49,409000005443,18-May-18,TRF TO  Indiaforensic SERVICES I,"6,500,000.00",,-548189696.27,Temple,701,Spain,76304.73,0,1,0
5445,2011,6,MORTGAGE,3,Low,1,17000, 36 months,1,wedding,5,Low,1,Good Loan,0,6.03,A,1,7.13,18625.75892,17000,0,517.41,409000005444,19-May-18,Indiaforensic VISA ACQ DOM190518,,2274889.50,-545914806.77,Ridley,698,France,39755.00,0,1,0
5446,2011,8,MORTGAGE,3,Medium,2,27300, 36 months,1,debt_consolidation,6,Low,1,Good Loan,0,7.51,A,1,23.03,30171.64,27300,0,849.33,409000005445,19-May-18,Indiaforensic RUPAY POS ACQ19051,,1540689.63,-544374117.14,Young,451,France,180142.42,0,1,0
5447,2011,6,RENT,1,Low,1,7200, 60 months,2,house,12,High,2,Bad Loan,1,19.91,E,5,4.21,3943.02,1463.19,329.58,190.4,409000005446,19-May-18,Indiaforensic RUPAY POS C2 ACQ19,,647667.43,-543726449.71,Slye,665,France,83238.40,0,1,0
5448,2011,2,RENT,1,Low,1,3000, 36 months,1,major_purchase,8,High,2,Good Loan,0,19.42,E,5,18.77,3980.115264,3000,0,110.61,409000005447,19-May-18,Chq Book Issuance Charges,100,,-543726549.71,Pan,726,Germany,5078.90,0,1,0
5449,2011,4,MORTGAGE,3,Low,1,10000, 36 months,1,debt_consolidation,6,High,2,Good Loan,0,14.65,C,3,16.8,11750.99,10000,0,344.95,409000005448,19-May-18,GST,18,,-543726567.71,Hsueh,608,Germany,132424.69,0,1,0
5450,2011,1,RENT,1,Low,1,7000, 36 months,1,debt_consolidation,6,Low,1,Good Loan,0,10.65,B,2,16.93,8206.913187,7000,0,228.02,409000005449,19-May-18,TRF TO  Indiaforensic SERVICES I,"500,000.00",,-544226567.71,Roberts,549,France,109057.56,0,1,0
5451,2011,4,OWN,2,Low,1,10000, 36 months,1,house,12,High,2,Good Loan,0,14.65,C,3,21.54,12001.72,10000,0,344.95,409000005450,19-May-18,TRF TO  Indiaforensic SERVICES I,"3,000,000.00",,-547226567.71,Moss,803,France,115676.61,0,1,0
5452,2011,10,RENT,1,Low,1,23975, 60 months,2,credit_card,1,High,2,Good Loan,0,22.35,F,6,22.8,26585.72,23975,0,666.95,409000005451,21-May-18,Indiaforensic VISA ACQ DOM210518,,4478087.89,-542748479.82,Andrews,663,France,149401.33,0,1,0
5453,2011,8,OWN,2,Medium,2,15000, 36 months,1,home_improvement,7,Low,1,Good Loan,0,6.03,A,1,0.57,16434.45824,15000,0,456.54,409000005452,21-May-18,Indiaforensic MSTER ACQ DOM19-21,,4328512.48,-538419967.34,Takasuka,558,France,89891.40,0,1,0
5454,2011,5,MORTGAGE,3,Low,1,3350, 60 months,2,debt_consolidation,6,Low,1,Good Loan,0,12.42,B,2,11.42,3945.68,2868.06,0,75.24,409000005453,21-May-18,TRF TO  Indiaforensic SERVICES I,"1,000,000.00",,-539419967.34,Dawson,714,France,82500.84,0,1,0
5455,2011,1,RENT,1,Low,1,6000, 36 months,1,credit_card,1,High,2,Bad Loan,1,13.49,C,3,21,2435.4,1733.11,0,203.59,409000005454,21-May-18,TRF TO  Indiaforensic SERVICES I,"8,800,000.00",,-548219967.34,Bruche,704,France,6416.92,0,1,0
5456,2011,1,RENT,1,Low,1,3300, 36 months,1,car,2,Low,1,Good Loan,0,11.71,B,2,4.16,3928.067857,3300,0,109.16,409000005455,21-May-18,Indiaforensic RUPAY POS ACQ20051,,665162.40,-547554804.94,Oliver,805,Germany,189428.75,0,1,0
5457,2011,6,RENT,1,Low,1,14100, 36 months,1,debt_consolidation,6,Low,1,Good Loan,0,6.03,A,1,25.57,14959.96,14100,0,429.15,409000005456,21-May-18,Indiaforensic RUPAY POS ACQ21051,,2743731.03,-544811073.91,Ryan,659,Germany,178833.34,0,1,0
5458,2011,5,MORTGAGE,3,Low,1,7000, 36 months,1,debt_consolidation,6,Low,1,Good Loan,0,10.65,B,2,29.64,7554.69,7000,0,228.02,409000005457,21-May-18,Indiaforensic RUPAY POS C2 ACQ21,,792628.80,-544018445.11,Sabbatini,738,Germany,42766.03,0,1,0
5459,2011,2,RENT,1,Low,1,6700, 60 months,2,small_business,3,Low,1,Good Loan,0,11.71,B,2,4.86,7891.06,6700,0,148.06,409000005458,22-May-18,TRF TO  Indiaforensic SERVICES I,"4,000,000.00",,-548018445.11,Watt,635,Spain,90883.12,0,1,0
5460,2011,6.05,MORTGAGE,3,Low,1,31000, 60 months,2,debt_consolidation,6,Low,1,Bad Loan,1,9.91,B,2,9.48,23003.75,16207.27,0,657.29,409000005459,22-May-18,Indiaforensic VISA ACQ DOM220518,,2363062.07,-545655383.04,Wilson,530,Spain,80619.09,0,1,0
5461,2011,2,RENT,1,Low,1,6000, 36 months,1,debt_consolidation,6,Low,1,Good Loan,0,7.9,A,1,9.13,6757.895138,6000,0,187.75,409000005460,22-May-18,Indiaforensic MASTER ACQ DOM 220,,1468030.22,-544187352.82,Abramova,661,Germany,120646.40,0,1,0
5462,2011,10,MORTGAGE,3,Low,1,28000, 60 months,2,debt_consolidation,6,Low,1,Good Loan,0,12.42,B,2,29.3,36532.34126,28000,0,628.81,409000005461,22-May-18,Indiaforensic RUPAY POS ACQ22051,,1780694.23,-542406658.59,Purdy,531,Spain,41409.36,0,1,0
5463,2011,10,RENT,1,Low,1,5000, 60 months,2,debt_consolidation,6,High,2,Good Loan,0,17.58,D,4,12.47,6282.21,3823.59,0,125.83,409000005462,22-May-18,Indiaforensic RUPAY POS C2 ACQ22,,632535.73,-541774122.86,Higgins,694,France,112317.89,0,1,0
5464,2011,7,OWN,2,Medium,2,7000, 36 months,1,home_improvement,7,High,2,Bad Loan,1,14.65,C,3,8.26,3643.22,2363.64,266.28,241.46,409000005463,22-May-18,TRF TO  Indiaforensic SERVICES I,"3,000,000.00",,-544774122.86,Marshall,731,France,152128.36,0,1,0
5465,2011,9,RENT,1,Low,1,7075, 60 months,2,other,4,Low,1,Good Loan,0,12.42,B,2,12.82,7939.64,5570.28,0,158.89,409000005464,22-May-18,TRF TO  Indiaforensic SERVICES I,"3,000,000.00",,-547774122.86,Reye,556,France,177670.57,0,1,0
5466,2011,7,RENT,1,Low,1,23700, 60 months,2,other,4,Low,1,Good Loan,0,11.71,B,2,20.23,27746.08,23700,0,523.73,409000005465,22-May-18,TRF TO  Indiaforensic SERVICES I,"500,000.00",,-548274122.86,Chibueze,647,Germany,189159.97,0,1,0
5467,2011,4,RENT,1,Low,1,8625, 36 months,1,debt_consolidation,6,Low,1,Good Loan,0,7.9,A,1,16.25,9714.439136,8625,0,269.88,409000005466,23-May-18,Indiaforensic MASTER ACQ DOM 230,,1645932.08,-546628190.78,Kwemtochukwu,850,Germany,159403.68,0,1,0
5468,2011,10,MORTGAGE,3,Low,1,11500, 36 months,1,credit_card,1,High,2,Good Loan,0,14.65,C,3,19.74,14277.89512,11500,0,396.69,409000005467,23-May-18,Indiaforensic VISA ACQ DOM230518,,1912026.96,-544716163.82,Biryukova,573,Spain,149536.15,0,1,0
5469,2011,0.5,MORTGAGE,3,Low,1,31800, 60 months,2,house,12,Low,1,Good Loan,0,12.69,B,2,0.45,36977.55,31800,0,718.52,409000005468,23-May-18,Indiaforensic RUPAY POS ACQ23051,,1347961.46,-543368202.36,Chidozie,591,France,155492.87,0,1,0
5470,2011,0.5,RENT,1,Low,1,5800, 36 months,1,credit_card,1,Low,1,Good Loan,0,9.91,B,2,20.45,6361.64,5800,0,186.91,409000005469,23-May-18,Indiaforensic MASTER INT SET 220,,1211.40,-543366990.96,Barber,723,France,24847.02,0,1,0
5471,2011,7,RENT,1,Low,1,6000, 36 months,1,other,4,Low,1,Good Loan,0,8.9,A,1,0.6,6836.880497,6000,0,190.52,409000005470,23-May-18,Indiaforensic RUPAY POS C2 ACQ23,,555379.76,-542811611.20,Thompson,617,France,115387.40,0,1,0
5472,2011,6.05,OWN,2,Low,1,4000, 36 months,1,debt_consolidation,6,High,2,Bad Loan,1,16.29,D,4,13.95,3151.74,354.03,2588.1,141.21,409000005471,23-May-18,17825-MASTERCARD BILL 200,"54,996.23",,-542866607.43,Maslov,704,Germany,171971.25,0,1,0
5473,2011,0.5,MORTGAGE,3,Low,1,10000, 36 months,1,other,4,Low,1,Good Loan,0,6.03,A,1,8.34,10956.30145,10000,0,304.36,409000005472,23-May-18,TRF TO  Indiaforensic SERVICES I,"4,900,000.00",,-547766607.43,Jones,457,Germany,126106.40,0,1,0
5474,2011,2,RENT,1,Low,1,10000, 36 months,1,credit_card,1,Low,1,Good Loan,0,11.71,B,2,16.99,11734.02,10000,0,330.76,409000005473,23-May-18,Indiaforensic POS ACQ SETT DT 13,"151,771.14",,-547918378.57,Chidumaga,787,Germany,28228.35,0,1,0
5475,2011,10,MORTGAGE,3,Low,1,4000, 36 months,1,other,4,Low,1,Good Loan,0,7.9,A,1,10.43,4355.77,4000,0,125.17,409000005474,23-May-18,OXYGEN POS ACQ SETT DT 01,0.4,,-547918378.97,Hs?,651,France,138113.71,0,1,0
5476,2011,0.5,MORTGAGE,3,Low,1,6300, 36 months,1,vacation,11,Low,1,Good Loan,0,6.62,A,1,25.22,6961.984661,6300,0,193.44,409000005475,24-May-18,Indiaforensic VISA ACQ DOM240518,,1822995.24,-546095383.73,Trentini,612,Germany,43018.98,0,1,0
5477,2011,10,MORTGAGE,3,Low,1,35000, 60 months,2,debt_consolidation,6,High,2,Bad Loan,1,18.64,E,5,4.19,24325.51,11850.07,0,901.01,409000005476,24-May-18,Indiaforensic RUPAY POS ACQ24051,,1336190.54,-544759193.19,Lucas,828,Spain,83611.45,0,1,0
5478,2011,1,OWN,2,Low,1,12000, 36 months,1,debt_consolidation,6,Low,1,Good Loan,0,11.71,B,2,24.16,14284.37478,12000,0,396.92,409000005477,24-May-18,Indiaforensic MASTER ACQ DOM2405,,989175.21,-543770017.98,Willoughby,724,France,118863.38,0,1,0
5479,2011,6,MORTGAGE,3,Low,1,34000, 60 months,2,debt_consolidation,6,High,2,Bad Loan,1,19.42,E,5,17.26,20464.79,9352.99,0,889.86,409000005478,24-May-18,Indiaforensic RUPAY POS C2 ACQ24,,423888.81,-543346129.17,Jamieson,648,Germany,91947.74,0,1,0
5480,2011,3,RENT,1,Medium,2,6000, 36 months,1,credit_card,1,Low,1,Good Loan,0,7.9,A,1,3.88,6247.75,6000,0,187.75,409000005479,24-May-18,Indiaforensic VISA ACQ INT 19051,,1109.87,-543345019.30,Robertson,569,Spain,94488.82,0,1,0
5481,2011,0.5,RENT,1,Medium,2,15000, 36 months,1,debt_consolidation,6,High,2,Good Loan,0,17.58,D,4,12.48,19240.22341,15000,0,539.14,409000005480,24-May-18,Indiaforensic VISA ACQ INT 21051,,3921.20,-543341098.10,Ojiofor,765,Germany,47058.21,0,1,0
5482,2011,6.05,OWN,2,Low,1,5000, 36 months,1,debt_consolidation,6,Low,1,Bad Loan,1,10.65,B,2,20.22,3335.8,2435.96,147.16,162.87,409000005481,24-May-18,TRF TO  Indiaforensic SERVICES I,"4,000,000.00",,-547341098.10,Cameron,577,Germany,44719.50,0,1,0
5483,2011,7,MORTGAGE,3,Low,1,18250, 36 months,1,credit_card,1,Low,1,Good Loan,0,8.9,A,1,26.08,20534.3,18250,0,579.5,409000005482,24-May-18,TRF TO  Indiaforensic SERVICES I,"500,000.00",,-547841098.10,Mayne,603,Spain,174478.54,0,1,0
5484,2011,3,MORTGAGE,3,Low,1,11000, 36 months,1,debt_consolidation,6,Low,1,Good Loan,0,12.69,B,2,15.1,13277.70529,11000,0,369,409000005483,24-May-18,Indiaforensic MASTER INT SET 230,,19694.53,-547821403.57,Mancini,568,Spain,45611.51,0,1,0
5485,2011,5,MORTGAGE,3,Low,1,10000, 36 months,1,debt_consolidation,6,Low,1,Good Loan,0,6.03,A,1,28.65,10956.46378,10000,0,304.36,409000005484,24-May-18,Indiaforensic MASTER INT REV 230,"19,694.53",,-547841098.10,Paramor,748,Germany,73853.94,0,1,0
5486,2011,10,MORTGAGE,3,Low,1,7500, 36 months,1,credit_card,1,Low,1,Good Loan,0,7.51,A,1,4.17,8376.303583,7500,0,233.34,409000005485,25-May-18,Indiaforensic MASTER ACQ DOM2505,,1550590.03,-546290508.07,Young,573,Spain,196517.43,0,1,0
5487,2011,1,RENT,1,Low,1,12800, 36 months,1,debt_consolidation,6,Low,1,Good Loan,0,12.42,B,2,6.79,15391.90052,12800,0,427.72,409000005486,25-May-18,Indiaforensic VISA ACQ DOM250518,,1821144.86,-544469363.21,Daly,771,Spain,92914.67,0,1,0
5488,2011,10,RENT,1,Low,1,6000, 36 months,1,debt_consolidation,6,High,2,Good Loan,0,14.65,C,3,0.25,7449.250833,6000,0,206.97,409000005487,25-May-18,Indiaforensic RUPAY POS ACQ25051,,1558686.70,-542910676.51,Carter,763,France,31372.91,0,1,0
5489,2011,4,RENT,1,Low,1,26200, 60 months,2,debt_consolidation,6,High,2,Good Loan,0,22.74,G,7,17.77,36839.81,19845.87,0,734.69,409000005488,25-May-18,Indiaforensic RUPAY POS C2 ACQ25,,525478.13,-542385198.38,Dike,410,France,109733.73,0,1,0
5490,2011,10,MORTGAGE,3,Low,1,15000, 60 months,2,debt_consolidation,6,High,2,Bad Loan,1,19.03,E,5,18.31,18230.79,10406.34,0,389.36,409000005489,25-May-18,TRF TO  Indiaforensic SERVICES I,"5,300,000.00",,-547685198.38,Hughes,728,France,36083.96,0,1,0
5491,2011,3,RENT,1,Low,1,16200, 60 months,2,debt_consolidation,6,Low,1,Good Loan,0,12.42,B,2,23.19,18180.98,12754.95,0,363.81,409000005490,25-May-18,TRF TO  Indiaforensic SERVICES I,"500,000.00",,-548185198.38,Green,655,Spain,188435.38,0,1,0
5492,2011,4,RENT,1,Low,1,4400, 60 months,2,debt_consolidation,6,High,2,Good Loan,0,22.74,G,7,4.45,7043.571598,4400,0,123.39,409000005491,28-May-18,Indiaforensic VISA ACQ DOM260518,,1686864.84,-546498333.54,Chinomso,580,Germany,169963.20,0,1,0
5493,2011,5,RENT,1,Low,1,13000, 60 months,2,other,4,High,2,Bad Loan,1,19.03,E,5,7.84,12810.4,6046.29,1074.05,337.45,409000005492,28-May-18,Indiaforensic RUPAY POS ACQ26051,,1404747.30,-545093586.24,Gorshkov,712,France,69320.97,0,1,0
5494,2011,1,RENT,1,Low,1,5000, 60 months,2,debt_consolidation,6,High,2,Good Loan,0,14.65,C,3,18.1,5900.88,3895.04,0,118.04,409000005493,28-May-18,Indiaforensic VISA ACQ DOM280518,,4087600.82,-541005985.42,Chinomso,680,France,36145.53,0,1,0
5495,2011,8,MORTGAGE,3,Low,1,5600, 60 months,2,home_improvement,7,High,2,Good Loan,0,21.67,F,6,4.16,5701.1,5600,0,153.62,409000005494,28-May-18,Indiaforensic RUPAY POS ACQ28051,,2169989.48,-538835995.94,Ijendu,383,Spain,137702.01,0,1,0
5496,2011,2,RENT,1,Low,1,5200, 36 months,1,credit_card,1,High,2,Good Loan,0,17.27,D,4,11.75,6694.394426,5200,0,186.1,409000005495,28-May-18,Indiaforensic RUPAY POS ACQ27051,,1434923.48,-537401072.46,Yen,721,France,71594.26,0,1,0
5497,2011,5,MORTGAGE,3,Low,1,12000, 36 months,1,credit_card,1,Low,1,Good Loan,0,7.51,A,1,14.5,13287.7,12000,0,373.33,409000005496,28-May-18,IndforGN MSTR ACQ DOM26-2805,,4162866.21,-533238206.25,Arcuri,620,France,65565.92,0,1,0
5498,2011,10,MORTGAGE,3,Low,1,30000, 60 months,2,home_improvement,7,High,2,Good Loan,0,16.77,D,4,0.95,37004.86,23075.39,0,741.88,409000005497,28-May-18,Indiaforensic RUPAY POS C2 ACQ28,,771253.84,-532466952.41,Baresi,774,Spain,101828.39,0,1,0
5499,2011,10,MORTGAGE,3,Low,1,30000, 60 months,2,small_business,3,High,2,Bad Loan,1,22.74,G,7,18.53,20423.78,4317.89,8651.61,841.24,409000005498,28-May-18,TRF TO  Indiaforensic SERVICES I,"15,000,000.00",,-547466952.41,Field,563,France,39546.32,0,1,0
5500,2011,10,MORTGAGE,3,Medium,2,25000, 60 months,2,debt_consolidation,6,High,2,Good Loan,0,14.27,C,3,15.68,29234.12,19498.09,0,585.22,409000005499,28-May-18,17825 SETTLE _RECOVERY  P,"807,788.20",,-548274740.61,Christian,850,Germany,110805.79,0,1,0
5501,2011,3,RENT,1,Low,1,7200, 36 months,1,other,4,Low,1,Good Loan,0,11.71,B,2,22.24,8370.69,7200,0,238.15,409000005500,28-May-18,Indiaforensic MASTER INT SET 250,,1932.21,-548272808.40,Ross,681,France,2168.13,0,1,0
5502,2011,10,RENT,1,Low,1,22250, 60 months,2,debt_consolidation,6,High,2,Good Loan,0,13.49,C,3,19.2,27685.78,22250,0,511.86,409000005501,29-May-18,Indiaforensic MASTER ACQ DOM2905,,1343077.32,-546929731.08,Trevisani,631,France,190067.12,0,1,0
5503,2011,2,MORTGAGE,3,Low,1,10000, 60 months,2,car,2,High,2,Good Loan,0,14.27,C,3,12.74,11694.42,7799.76,0,234.09,409000005502,29-May-18,Indiaforensic RUPAY POS ACQ29051,,1396983.31,-545532747.77,Akabueze,614,Spain,77789.01,0,1,0
5504,2011,7,MORTGAGE,3,Low,1,7000, 36 months,1,debt_consolidation,6,Low,1,Good Loan,0,6.03,A,1,3.48,7669.43377,7000,0,213.05,409000005503,29-May-18,Indiaforensic VISA ACQ DOM290518,,2167808.29,-543364939.48,Dunn,704,Spain,127654.37,0,1,0
5505,2011,7,MORTGAGE,3,Low,1,30000, 60 months,2,debt_consolidation,6,High,2,Good Loan,0,18.64,E,5,4.47,40341.67,30000,0,772.29,409000005504,29-May-18,Indiaforensic RUPAY POS C2 ACQ29,,440382.64,-542924556.84,Martin,786,France,79602.86,0,1,0
5506,2011,1,RENT,1,Low,1,4500, 60 months,2,small_business,3,High,2,Good Loan,0,18.25,D,4,9.76,5720.7,3430.3,0,114.89,409000005505,29-May-18,TRF TO  Indiaforensic SERVICES I,"4,900,000.00",,-547824556.84,Donaldson,534,France,80619.17,0,1,0
5507,2011,10,MORTGAGE,3,Low,1,1000, 36 months,1,home_improvement,7,Low,1,Good Loan,0,7.51,A,1,23.44,1119.378505,1000,0,31.12,409000005506,30-May-18,Indiaforensic RUPAY POS ACQ30051,,1483645.34,-546340911.50,McClinton,590,Spain,160346.30,0,1,0
5508,2011,2,RENT,1,Low,1,3000, 36 months,1,moving,10,Low,1,Good Loan,0,12.69,B,2,7.2,3621.471187,3000,0,100.64,409000005507,30-May-18,Indiaforensic RUPAY POS C2 ACQ30,,429288.90,-545911622.60,Bentley,583,Spain,109638.78,0,1,0
5509,2011,5,MORTGAGE,3,Medium,2,35000, 60 months,2,wedding,5,Low,1,Bad Loan,1,12.42,B,2,8.84,23912.82,12555.77,3111.56,786.01,409000005508,30-May-18,Indiaforensic MASTER INT SET 260,,1956.96,-545909665.64,Ibezimako,656,France,1276.87,0,1,0
5510,2011,0.5,MORTGAGE,3,Medium,2,13000, 60 months,2,debt_consolidation,6,High,2,Good Loan,0,14.27,C,3,9.69,15177.64,10125.25,0,304.32,409000005509,30-May-18,17825-MASTERCARD BILL 270,"22,558.67",,-545932224.31,Thomson,597,France,49374.82,0,1,0
5511,2011,10,MORTGAGE,3,Medium,2,11000, 36 months,1,major_purchase,8,Low,1,Good Loan,0,6.62,A,1,4.79,12104.5872,11000,0,337.75,409000005510,30-May-18,Indiaforensic VISA ACQ DOM300518,,1540043.33,-544392180.98,Ch'in,588,Germany,31580.80,0,1,0
5512,2011,10,MORTGAGE,3,Low,1,9000, 36 months,1,debt_consolidation,6,Low,1,Good Loan,0,11.71,B,2,8.07,10198.93,9000,0,297.69,409000005511,30-May-18,TRF TO  Indiaforensic SERVICES I,"3,000,000.00",,-547392180.98,Holbrook,667,Germany,20560.69,0,1,0
5513,2011,2,RENT,1,Low,1,14000, 60 months,2,debt_consolidation,6,High,2,Good Loan,0,19.42,E,5,20.45,21097.0231,14000,0,366.42,409000005512,31-May-18,Indiaforensic VISA ACQ DOM310518,,2160618.13,-545231562.85,Solomina,627,France,84584.69,0,1,0
5514,2011,10,MORTGAGE,3,Low,1,25000, 60 months,2,credit_card,1,High,2,Good Loan,0,16.77,D,4,8.44,32421.41,25000,0,618.23,409000005513,31-May-18,Indiaforensic RUPAY POS ACQ31051,,1537728.91,-543693833.94,McDonald,708,France,15246.83,0,1,0
5515,2011,10,MORTGAGE,3,Low,1,12000, 60 months,2,debt_consolidation,6,Low,1,Good Loan,0,12.42,B,2,14.16,15732.88705,12000,0,269.49,409000005514,31-May-18,Indiaforensic RUPAY POS C2 ACQ31,,612456.09,-543081377.85,Dennis,641,France,32607.77,0,1,0
5516,2011,1,RENT,1,Medium,2,5000, 36 months,1,major_purchase,8,Low,1,Good Loan,0,8.9,A,1,8.94,5713.11646,5000,0,158.77,409000005515,31-May-18,Indiaforensic VISA ACQ INT 28051,,18864.93,-543062512.92,Faulk,527,Germany,155846.69,0,1,0
5517,2011,3,MORTGAGE,3,Low,1,12000, 60 months,2,debt_consolidation,6,Low,1,Good Loan,0,8.9,A,1,12.2,14676.87683,12000,0,248.52,409000005516,31-May-18,TRF TO  Indiaforensic SERVICES I,"5,000,000.00",,-548062512.92,Dale,592,France,3232.82,0,1,0
5518,2011,4,MORTGAGE,3,Low,1,31825, 60 months,2,debt_consolidation,6,High,2,Good Loan,0,15.96,C,3,20.01,38331.72,31825,0,773.25,409000005517,1-Jun-18,17825 SETTLE _RECOVERY  P,"145,822.29",,-548208335.21,Gorbunov,465,France,177668.55,0,1,0
5519,2011,10,RENT,1,Low,1,4800, 36 months,1,other,4,High,2,Bad Loan,1,16.29,D,4,24.31,5302,874.23,3947.68,169.45,409000005518,1-Jun-18,Indiaforensic MASTER ACQ DOM3005,,1434717.01,-546773618.20,Farrell,628,France,134441.60,0,1,0
5520,2011,10,RENT,1,Low,1,13000, 60 months,2,debt_consolidation,6,High,2,Good Loan,0,17.27,D,4,12.03,16197.48,9967.11,0,324.98,409000005519,1-Jun-18,Indiaforensic MASTER ACQ DOM3105,,1568332.50,-545205285.70,De Luca,678,France,111032.79,0,1,0
5521,2011,1,RENT,1,Low,1,3400, 36 months,1,other,4,High,2,Bad Loan,1,16.29,D,4,15.37,637.56,309.82,107.78,120.03,409000005520,1-Jun-18,Indiaforensic MASTER ACQ DOM0106,,1746404.08,-543458881.62,Walker,570,France,45214.04,0,1,0
5522,2011,7,MORTGAGE,3,High,3,20000, 60 months,2,debt_consolidation,6,Low,1,Good Loan,0,11.71,B,2,8.68,24465.80182,20000,0,441.97,409000005521,1-Jun-18,Indiaforensic VISA ACQ DOM010618,,2047683.47,-541411198.15,Forster,815,France,67208.30,0,1,0
5523,2011,5,MORTGAGE,3,Low,1,20000, 60 months,2,credit_card,1,High,2,Good Loan,0,15.96,C,3,23.95,28315.4824,20000,0,485.94,409000005522,1-Jun-18,Indiaforensic RUPAY POS ACQ01061,,1375121.56,-540036076.59,Brown,817,France,80985.88,0,1,0
5524,2011,4,MORTGAGE,3,Medium,2,2400, 36 months,1,credit_card,1,Low,1,Good Loan,0,12.42,B,2,10.96,2739.72,2400,0,80.2,409000005523,1-Jun-18,Indiaforensic RUPAY POS C2 ACQ01,,578396.11,-539457680.48,Monaldo,717,France,167573.06,0,1,0
5525,2011,5,RENT,1,Low,1,12500, 60 months,2,debt_consolidation,6,High,2,Good Loan,0,15.96,C,3,13.87,17128.29817,12500,0,303.72,409000005524,1-Jun-18,Indiaforensic VISA ACQ INT 30051,,13962.70,-539443717.78,Wu,641,France,160110.65,0,1,0
5526,2011,3,RENT,1,Low,1,14500, 36 months,1,debt_consolidation,6,Low,1,Good Loan,0,6.62,A,1,21.58,15481.5,14500,0,445.21,409000005525,1-Jun-18,TRF TO  Indiaforensic SERVICES I,"8,200,000.00",,-547643717.78,Pan,624,France,127825.25,0,1,0
5527,2011,10,RENT,1,Low,1,16000, 36 months,1,debt_consolidation,6,High,2,Good Loan,0,16.29,D,4,18.42,20123.80898,16000,0,564.81,409000005526,1-Jun-18,Indiaforensic MASTER INT SET 310,,8168.93,-547635548.85,Longo,579,Germany,123535.05,0,1,0
5528,2011,0.5,MORTGAGE,3,Medium,2,10000, 36 months,1,debt_consolidation,6,Low,1,Good Loan,0,6.62,A,1,16.15,11050.91572,10000,0,307.04,409000005527,2-Jun-18,Indiaforensic VISA ACQ DOM020618,,2010423.01,-545625125.84,Findlay,698,France,41595.30,0,1,0
5529,2011,4,RENT,1,Low,1,15000, 36 months,1,debt_consolidation,6,Low,1,Good Loan,0,7.9,A,1,6.47,16623.14,15000,0,469.36,409000005528,2-Jun-18,Indiaforensic RUPAY POS ACQ02061,,1564615.81,-544060510.03,Fu,645,France,97628.08,0,1,0
5530,2011,2,RENT,1,Low,1,12000, 36 months,1,debt_consolidation,6,Low,1,Good Loan,0,6.62,A,1,12.8,12481.87,12000,0,368.45,409000005529,2-Jun-18,TRF TO  Indiaforensic SERVICES I,"4,000,000.00",,-548060510.03,Yin,691,France,91359.79,0,1,0
5531,2011,10,MORTGAGE,3,Low,1,12000, 60 months,2,debt_consolidation,6,High,2,Bad Loan,1,19.91,E,5,24.96,5394.05,2272.5,9.67,317.33,409000005530,2-Jun-18,Indiaforensic RUPAY POS C2 ACQ02,,681686.42,-547378823.61,Hamilton,638,France,97755.29,0,1,0
5532,2011,5,RENT,1,Low,1,2000, 36 months,1,debt_consolidation,6,Low,1,Good Loan,0,9.91,B,2,6.86,2319.934698,2000,0,64.45,409000005531,4-Jun-18,Indiaforensic RUPAY POS ACQ03061,,1459607.79,-545919215.82,Miller,705,France,182528.44,0,1,0
5533,2011,3,MORTGAGE,3,Low,1,4000, 36 months,1,debt_consolidation,6,Low,1,Good Loan,0,12.69,B,2,21.45,4826.617853,4000,0,134.18,409000005532,4-Jun-18,Indiaforensic MASTER ACQ DOM0406,,4528557.54,-541390658.28,Hsing,720,France,142956.48,0,1,0
5534,2011,10,MORTGAGE,3,Low,1,35000, 60 months,2,small_business,3,High,2,Bad Loan,1,14.27,C,3,15.45,4092.6,2062,0,819.3,409000005533,4-Jun-18,Indiaforensic VISA ACQ DOM040618,,2123987.85,-539266670.43,Mitchell,553,Spain,10789.30,0,1,0
5535,2011,3,RENT,1,Low,1,10000, 36 months,1,debt_consolidation,6,High,2,Good Loan,0,14.27,C,3,7.74,11326.75,10000,0,343.09,409000005534,4-Jun-18,Indiaforensic RUPAY POS ACQ04061,,1680897.60,-537585772.83,Chamberlin,658,France,130461.09,0,1,0
5536,2011,4,RENT,1,Low,1,8325, 36 months,1,debt_consolidation,6,High,2,Good Loan,0,13.49,C,3,23.92,10101.31284,8325,0,282.48,409000005535,4-Jun-18,17825-MASTERCARD BILL 310,"15,988.52",,-537601761.35,Buttenshaw,648,Germany,190994.48,0,1,0
5537,2011,4,MORTGAGE,3,Low,1,5500, 36 months,1,major_purchase,8,Low,1,Good Loan,0,12.69,B,2,18.59,6024.63,5500,0,184.5,409000005536,4-Jun-18,Indiaforensic RUPAY POS C2 ACQ04,,664670.00,-536937091.35,Anayochukwu,636,Spain,159463.80,0,1,0
5538,2011,3,MORTGAGE,3,Medium,2,34675, 60 months,2,debt_consolidation,6,High,2,Good Loan,0,13.49,C,3,17.72,46602.14047,34675,0,797.69,409000005537,4-Jun-18,TRF TO  Indiaforensic SERVICES I,"10,600,000.00",,-547537091.35,Wallace,527,Germany,57589.29,0,1,0
5539,2011,1,MORTGAGE,3,Low,1,9950, 36 months,1,other,4,Low,1,Good Loan,0,7.9,A,1,11.57,10906.59,9950,0,311.34,409000005538,5-Jun-18,Indiaforensic MASTER ACQ DOM0406,,1583272.17,-545953819.18,Calabresi,717,Germany,40437.67,0,1,0
5540,2011,6.05,RENT,1,Low,1,9750, 36 months,1,credit_card,1,High,2,Good Loan,0,18.25,D,4,11.57,12728.02009,9750,0,353.71,409000005539,5-Jun-18,Indiaforensic VISA ACQ DOM040618,,4412724.20,-541541094.98,Sun,614,Spain,56459.45,0,1,0
5541,2011,3,MORTGAGE,3,High,3,15000, 60 months,2,home_improvement,7,High,2,Good Loan,0,18.25,D,4,7.13,19144.31,11457.48,0,382.95,409000005540,5-Jun-18,Indiaforensic MC BILL RECOVERY M,"59,830.75",,-541600925.73,Tuan,737,France,39920.00,0,1,0
5542,2011,10,RENT,1,Low,1,20000, 60 months,2,debt_consolidation,6,High,2,Good Loan,0,14.27,C,3,26.4,25782.18051,20000,0,468.17,409000005541,5-Jun-18,Indiaforensic VISA ACQ INT 01061,,2970.00,-541597955.73,Nazarova,587,Spain,148798.45,0,1,0
5543,2011,2,MORTGAGE,3,Medium,2,11025, 36 months,1,major_purchase,8,Low,1,Good Loan,0,7.9,A,1,9.12,12318.82,11025,0,344.98,409000005542,5-Jun-18,17825-MASTERCARD BILL 030,"30,413.84",,-541628369.57,Bryant,682,France,63737.19,0,1,0
5544,2011,0.5,RENT,1,Low,1,1600, 36 months,1,medical,9,Low,1,Good Loan,0,12.69,B,2,1.95,1945.631258,1600,0,53.68,409000005543,5-Jun-18,Indiaforensic RUPAY POS C2 ACQ04,,563098.78,-541065270.79,Pai,710,France,154997.64,0,1,0
5545,2011,1,MORTGAGE,3,Low,1,35000, 60 months,2,small_business,3,High,2,Good Loan,0,13.49,C,3,8.98,35393.82,35000,0,805.17,409000005544,5-Jun-18,Indiaforensic RUPAY POS ACQ04061,,1729441.59,-539335829.20,Power,507,France,34777.23,0,1,0
5546,2011,5,MORTGAGE,3,Low,1,11000, 36 months,1,debt_consolidation,6,Low,1,Good Loan,0,8.9,A,1,13.84,12057.7,11000,0,349.29,409000005545,5-Jun-18,TRF TO  Indiaforensic SERVICES I,"6,700,000.00",,-546035829.20,Hao,609,Germany,93718.16,0,1,0
5547,2011,4,RENT,1,Low,1,20000, 60 months,2,debt_consolidation,6,High,2,Good Loan,0,17.58,D,4,18.45,25093.2,15313.21,0,503.32,409000005546,6-Jun-18,TRF TO  Indiaforensic SERVICES I,"2,000,000.00",,-548035829.20,McMillan,786,France,133112.41,0,1,0
5548,2011,10,MORTGAGE,3,Low,1,5500, 36 months,1,debt_consolidation,6,High,2,Good Loan,0,16.77,D,4,10.91,6938.476814,5500,0,195.47,409000005547,6-Jun-18,Indiaforensic MASTER INT SET 050,,14732.87,-548021096.33,Merrett,688,France,175479.92,0,1,0
5549,2011,5,RENT,1,Low,1,10000, 36 months,1,debt_consolidation,6,Low,1,Good Loan,0,11.71,B,2,21.76,10943.44,10000,0,330.76,409000005548,6-Jun-18,Indiaforensic MASTER ACQ DOM0606,,1083675.16,-546937421.17,Phillips,710,France,96.27,0,1,0
5550,2011,9,MORTGAGE,3,Low,1,3000, 36 months,1,home_improvement,7,Low,1,Good Loan,0,11.71,B,2,15.45,3509.69,3000,0,99.23,409000005549,6-Jun-18,Indiaforensic VISA ACQ DOM060618,,1885106.57,-545052314.60,De Luca,779,Spain,30804.68,0,1,0
5551,2011,3,MORTGAGE,3,Low,1,35000, 60 months,2,home_improvement,7,Low,1,Good Loan,0,11.71,B,2,2.68,38623,27633.99,0,773.44,409000005550,6-Jun-18,Indiaforensic RUPAY POS ACQ06061,,1081298.45,-543971016.15,Tu,733,France,197193.49,0,1,0
5552,2011,4,RENT,1,Low,1,12000, 60 months,2,debt_consolidation,6,High,2,Bad Loan,1,18.64,E,5,11.27,9187.2,3881.97,1168.28,308.92,409000005551,6-Jun-18,Indiaforensic RUPAY POS C2 ACQ06,,427317.08,-543543699.07,Elder,583,Germany,96792.15,0,1,0
5553,2011,3,OWN,2,Low,1,4800, 36 months,1,major_purchase,8,Low,1,Good Loan,0,11.71,B,2,16.76,5632.3,4800,0,158.77,409000005552,6-Jun-18,Indiaforensic MASTER ACQ DOM INT,,1813.56,-543541885.51,Dilke,627,France,132719.80,0,1,0
5554,2011,2,MORTGAGE,3,Low,1,5000, 36 months,1,home_improvement,7,Low,1,Good Loan,0,12.69,B,2,7.99,5682.45,5000,0,167.73,409000005553,6-Jun-18,TRF TO  Indiaforensic SERVICES I,"4,000,000.00",,-547541885.51,Panicucci,666,Germany,112157.31,0,1,0
5555,2011,2,MORTGAGE,3,Low,1,8000, 36 months,1,credit_card,1,Low,1,Good Loan,0,12.69,B,2,16.86,9204.81,8000,0,268.36,409000005554,6-Jun-18,TRF TO  Indiaforensic SERVICES I,"500,000.00",,-548041885.51,Mason,620,Spain,38015.34,0,1,0
5556,2011,1,RENT,1,Low,1,17500, 36 months,1,debt_consolidation,6,Low,1,Good Loan,0,12.42,B,2,23.48,21047.65775,17500,0,584.77,409000005555,6-Jun-18,Indiaforensic VISA ACQ INT 02061,,2062.42,-548039823.09,Townsend,614,Spain,164018.98,0,1,0
5557,2011,4,MORTGAGE,3,Low,1,17200, 36 months,1,debt_consolidation,6,Low,1,Good Loan,0,7.51,A,1,9.19,19258.67309,17200,0,535.11,409000005556,6-Jun-18,Indiaforensic VISA ACQ INT 04061,,2001.60,-548037821.49,Gunson,606,France,46774.94,0,1,0
5558,2011,5,RENT,1,Low,1,10000, 36 months,1,debt_consolidation,6,Low,1,Good Loan,0,6.03,A,1,9.07,10902.18926,10000,0,304.36,409000005557,7-Jun-18,Indiaforensic MASTER INT REV 050,"14,732.87",,-548052554.36,Milano,700,Germany,189664.43,0,1,0
5559,2011,10,MORTGAGE,3,Low,1,6000, 36 months,1,debt_consolidation,6,High,2,Good Loan,0,14.27,C,3,16.46,7408.222412,6000,0,205.86,409000005558,7-Jun-18,Indiaforensic MASTER ACQ DOM0706,,1563685.34,-546488869.02,Macleod,677,Germany,26106.39,0,1,0
5560,2011,2,RENT,1,Low,1,3500, 36 months,1,wedding,5,Low,1,Good Loan,0,7.9,A,1,15.58,3942.020343,3500,0,109.52,409000005559,7-Jun-18,Indiaforensic VISA ACQ DOM070618,,1703002.31,-544785866.71,Olisaemeka,850,Germany,191535.11,0,1,0
5561,2011,0.5,MORTGAGE,3,Low,1,3000, 36 months,1,home_improvement,7,Low,1,Good Loan,0,11.71,B,2,15.23,3569.920996,3000,0,99.23,409000005560,7-Jun-18,Indiaforensic RUPAY POS ACQ07061,,1333410.23,-543452456.48,Gleeson,564,France,158937.55,0,1,0
5562,2011,6,RENT,1,Low,1,3600, 36 months,1,debt_consolidation,6,Low,1,Good Loan,0,12.69,B,2,24.06,3638.41,3600,0,120.77,409000005561,7-Jun-18,TRF TO  Indiaforensic SERVICES I,"4,800,000.00",,-548252456.48,Martin,771,Spain,25222.60,0,1,0
5563,2011,6,MORTGAGE,3,Low,1,6000, 36 months,1,major_purchase,8,Low,1,Good Loan,0,6.03,A,1,26.76,6573.755605,6000,0,182.62,409000005562,7-Jun-18,Indiaforensic RUPAY POS C2 ACQ07,,487642.24,-547764814.24,Liao,620,Spain,29296.74,0,1,0
5564,2011,6,RENT,1,Low,1,16500, 36 months,1,credit_card,1,Low,1,Good Loan,0,12.69,B,2,15.44,19586.57213,16500,0,553.49,409000005563,8-Jun-18,Indiaforensic MASTER ACQ DOM0806,,1712868.04,-546051946.20,Sung,610,Spain,54394.28,0,1,0
5565,2011,2,MORTGAGE,3,Low,1,7850, 36 months,1,credit_card,1,High,2,Good Loan,0,13.49,C,3,19.44,8168.84,7850,0,266.36,409000005564,8-Jun-18,Indiaforensic VISA ACQ DOM080618,,1783366.33,-544268579.87,Lai,609,Spain,9234.06,0,1,0
5566,2011,5,RENT,1,Low,1,18250, 60 months,2,debt_consolidation,6,High,2,Good Loan,0,13.49,C,3,24.41,24868.57999,18250,0,419.84,409000005565,8-Jun-18,Indiaforensic RUPAY POS ACQ08061,,1129595.63,-543138984.24,Cartwright,683,Germany,26796.73,0,1,0
5567,2011,9,MORTGAGE,3,Low,1,8400, 36 months,1,debt_consolidation,6,Low,1,Good Loan,0,6.03,A,1,13.55,9134.6,8400,0,255.66,409000005566,8-Jun-18,Indiaforensic RUPAY POS C2 ACQ08,,418795.40,-542720188.84,Wu,633,Germany,11796.89,0,1,0
5568,2011,10,MORTGAGE,3,Low,1,22000, 36 months,1,debt_consolidation,6,Low,1,Good Loan,0,7.51,A,1,15.3,24636.81473,22000,0,684.44,409000005567,8-Jun-18,TRF TO  Indiaforensic SERVICES I,"5,000,000.00",,-547720188.84,Ch'in,676,Germany,128461.29,0,1,0
5569,2011,2,MORTGAGE,3,Low,1,4000, 36 months,1,debt_consolidation,6,Low,1,Good Loan,0,6.03,A,1,22.21,4382.482682,4000,0,121.75,409000005568,8-Jun-18,TRF TO  Indiaforensic SERVICES I,"500,000.00",,-548220188.84,Biryukov,693,France,14278.18,0,1,0
5570,2011,5,RENT,1,Low,1,16000, 60 months,2,debt_consolidation,6,Low,1,Good Loan,0,11.71,B,2,23.02,20959.43,16000,0,353.58,409000005569,11-Jun-18,Indiaforensic VISA ACQ DOM090618,,2026125.18,-546194063.66,Ting,709,France,46811.77,0,1,0
5571,2011,0.5,RENT,1,Low,1,6000, 36 months,1,credit_card,1,Low,1,Good Loan,0,8.9,A,1,16.98,6807.61148,6000,0,190.52,409000005570,11-Jun-18,Indiaforensic RUPAY POS ACQ09061,,1510320.36,-544683743.30,P'eng,569,Germany,109393.19,0,1,0
5572,2011,1,MORTGAGE,3,Low,1,13200, 60 months,2,debt_consolidation,6,High,2,Bad Loan,1,21.28,F,6,12.61,14286.75,6457.74,984.54,359.19,409000005571,11-Jun-18,Indiaforensic RUPAY POS ACQ10061,,2093270.03,-542590473.27,Niu,684,Spain,3966.50,0,1,0
5573,2011,5,RENT,1,Low,1,14125, 36 months,1,debt_consolidation,6,Low,1,Good Loan,0,8.9,A,1,21.99,16143.67731,14125,0,448.52,409000005572,11-Jun-18,Indiaforensic VISA ACQ DOM110618,,4585234.72,-538005238.55,Mellor,565,France,63173.64,0,1,0
5574,2011,4,MORTGAGE,3,Low,1,14175, 60 months,2,debt_consolidation,6,High,2,Good Loan,0,17.27,D,4,16.34,20295.29404,14175,0,354.35,409000005573,11-Jun-18,Indiaforensic MASTER ACQ DOM1106,,5545911.66,-532459326.89,Power,681,France,66367.33,0,1,0
5575,2011,10,RENT,1,Low,1,4800, 36 months,1,other,4,Low,1,Good Loan,0,6.62,A,1,12.17,4971.16,4800,0,147.38,409000005574,11-Jun-18,TRF TO  Indiaforensic SERVICES I,"15,000,000.00",,-547459326.89,Arcuri,503,Spain,16274.67,0,1,0
5576,2011,2,MORTGAGE,3,Low,1,13200, 60 months,2,car,2,Low,1,Good Loan,0,9.91,B,2,20.36,15867.42088,13200,0,279.88,409000005575,11-Jun-18,TRF TO  Indiaforensic SERVICES I,"800,000.00",,-548259326.89,Lang,656,France,180553.48,0,1,0
5577,2011,0.5,RENT,1,Low,1,15000, 36 months,1,house,12,Low,1,Good Loan,0,11.71,B,2,11.48,17757.5982,15000,0,496.14,409000005576,11-Jun-18,Indiaforensic RUPAY POS C2 ACQ11,,789018.34,-547470308.55,Eve,566,Germany,107563.16,0,1,0
5578,2011,0.5,RENT,1,Low,1,8000, 36 months,1,major_purchase,8,Low,1,Good Loan,0,6.03,A,1,4.02,8604.06,8000,0,243.49,409000005577,12-Jun-18,Indiaforensic RUPAY POS C2 REV11,"789,018.34",,-548259326.89,Ch'in,592,France,100941.57,0,1,0
5579,2011,9,MORTGAGE,3,Low,1,19200, 60 months,2,debt_consolidation,6,High,2,Good Loan,0,16.77,D,4,21.21,26260.39177,19200,0,474.8,409000005578,12-Jun-18,Indiaforensic RUPAY POS ACQ11061,,2213418.38,-546045908.51,Napolitani,687,Spain,110230.40,0,1,0
5580,2011,2,RENT,1,Low,1,12000, 60 months,2,debt_consolidation,6,High,2,Good Loan,0,15.96,C,3,8.98,15711.07,12000,0,291.57,409000005579,12-Jun-18,Indiaforensic RUPAY POS C2 ACQ11,,704615.05,-545341293.46,Barker,686,Spain,142331.85,0,1,0
5581,2011,3,RENT,1,Low,1,12000, 60 months,2,debt_consolidation,6,High,2,Good Loan,0,14.65,C,3,21.55,14162.88,9347.89,0,283.28,409000005580,12-Jun-18,Indiaforensic MASTER ACQ DOM1206,,1996176.12,-543345117.34,Whitfield,616,Spain,199099.51,0,1,0
5582,2011,10,MORTGAGE,3,Medium,2,5000, 36 months,1,home_improvement,7,Low,1,Good Loan,0,11.71,B,2,13.93,5968.923402,5000,0,165.38,409000005581,12-Jun-18,Indiaforensic VISA ACQ DOM120618,,2335030.78,-541010086.56,Stradford,494,Spain,85890.16,0,1,0
5583,2011,6,MORTGAGE,3,Low,1,3900, 36 months,1,credit_card,1,Low,1,Good Loan,0,7.9,A,1,15.06,4392.240133,3900,0,122.04,409000005582,12-Jun-18,Indiaforensic RUPAY POS ACQ12061,,1896488.13,-539113598.43,Brownlow,534,France,143938.27,0,1,0
5584,2011,10,MORTGAGE,3,Low,1,15000, 60 months,2,debt_consolidation,6,High,2,Good Loan,0,18.64,E,5,21,19279.78,11435.84,0,386.15,409000005583,12-Jun-18,TRF TO  Indiaforensic SERVICES I,"9,100,000.00",,-548213598.43,Dunn,695,Spain,131644.41,0,1,0
5585,2011,3,MORTGAGE,3,Low,1,12000, 60 months,2,home_improvement,7,Low,1,Good Loan,0,12.69,B,2,9.13,13557.58,9428.7,0,271.14,409000005584,12-Jun-18,Indiaforensic RUPAY POS C2 ACQ12,,611402.77,-547602195.66,DeRose,579,Spain,112395.98,0,1,0
5586,2011,6,MORTGAGE,3,Low,1,19000, 60 months,2,debt_consolidation,6,High,2,Good Loan,0,18.64,E,5,18.03,23561.27,19000,0,489.12,409000005585,12-Jun-18,Indiaforensic MASTER INT SET 110,,3983.65,-547598212.01,Wang,432,Germany,71856.30,0,1,0
5587,2011,4,MORTGAGE,3,Low,1,3000, 36 months,1,debt_consolidation,6,Low,1,Good Loan,0,6.03,A,1,18.86,3258.94,3000,0,91.31,409000005586,13-Jun-18,Indiaforensic RUPAY POS C2 ACQ13,,514928.49,-547083283.52,Hobbs,816,Germany,35770.84,0,1,0
5588,2011,5,MORTGAGE,3,Low,1,8500, 36 months,1,home_improvement,7,Low,1,Good Loan,0,12.42,B,2,15.13,10249.38877,8500,0,284.03,409000005587,13-Jun-18,Indiaforensic MASTER ACQ DOM1306,,1743283.91,-545339999.61,Anderson,730,France,124364.63,0,1,0
5589,2011,10,MORTGAGE,3,Low,1,5000, 36 months,1,car,2,Low,1,Good Loan,0,7.9,A,1,0.89,5476.72,5000,0,156.46,409000005588,13-Jun-18,Indiaforensic VISA ACQ DOM130618,,2211209.73,-543128789.88,Ugochukwu,593,France,78101.29,0,1,0
5590,2011,3,RENT,1,Low,1,27300, 60 months,2,credit_card,1,High,2,Good Loan,0,23.13,G,7,22.89,41861.55308,27300,0,771.65,409000005589,13-Jun-18,Indiaforensic RUPAY POS ACQ13061,,2247589.61,-540881200.27,Kirsova,715,Germany,143096.49,0,1,0
5591,2011,10,MORTGAGE,3,Low,1,22500, 60 months,2,small_business,3,High,2,Good Loan,0,14.65,C,3,2.51,25582,22499.99,0,531.15,409000005590,13-Jun-18,Indiaforensic VISA ACQ INT 11061,,8901.00,-540872299.27,Tsou,775,Germany,14073.11,0,1,0
5592,2011,2,RENT,1,Low,1,7000, 36 months,1,home_improvement,7,Low,1,Bad Loan,1,6.62,A,1,2.31,3868.53,3127.06,222.03,214.93,409000005591,13-Jun-18,TRF TO  Indiaforensic SERVICES I,"7,300,000.00",,-548172299.27,Ozerova,539,France,47388.41,0,1,0
5593,2011,6,MORTGAGE,3,Low,1,18000, 60 months,2,debt_consolidation,6,High,2,Good Loan,0,16.77,D,4,6.91,19693.27,18000,0,445.13,409000005592,13-Jun-18,Indiaforensic MASTER INT SET 120,,9897.08,-548162402.19,Li,576,Spain,72306.07,0,1,0
5594,2011,3,MORTGAGE,3,Low,1,6400, 36 months,1,credit_card,1,High,2,Good Loan,0,15.96,C,3,17.43,7228.66,6400,0,224.88,409000005593,14-Jun-18,Indiaforensic VISA ACQ INT 10061,,176.45,-548162225.74,Fyans,617,Spain,184839.70,0,1,0
5595,2011,5,RENT,1,Low,1,3000, 36 months,1,debt_consolidation,6,Low,1,Good Loan,0,9.91,B,2,12.43,3493.652539,3000,0,96.68,409000005594,14-Jun-18,Indiaforensic MASTER INT SET 130,,9826.97,-548152398.77,Freeman,688,France,47886.44,0,1,0
5596,2011,10,MORTGAGE,3,Low,1,23000, 60 months,2,debt_consolidation,6,Low,1,Good Loan,0,11.71,B,2,28.92,29007.47338,23000,0,508.26,409000005595,14-Jun-18,Indiaforensic VISA ACQ DOM140618,,2345280.52,-545807118.25,Chiu,608,France,130474.03,0,1,0
5597,2011,4,RENT,1,Low,1,18000, 36 months,1,debt_consolidation,6,Low,1,Good Loan,0,9.91,B,2,17.67,20878.15916,18000,0,580.05,409000005596,14-Jun-18,Indiaforensic RUPAY POS ACQ14061,,1813253.42,-543993864.83,Iadanza,597,Spain,73181.39,0,1,0
5598,2011,9,MORTGAGE,3,Low,1,16800, 60 months,2,debt_consolidation,6,Low,1,Good Loan,0,9.91,B,2,16.97,17809.38,13393.95,0,356.21,409000005597,14-Jun-18,Indiaforensic MASTER ACQ DOM1406,,1825207.33,-542168657.50,Ferguson,670,France,65706.86,0,1,0
5599,2011,0.5,MORTGAGE,3,High,3,30000, 36 months,1,major_purchase,8,High,2,Good Loan,0,19.91,E,5,6.29,40004.93861,30000,0,1113.54,409000005598,14-Jun-18,Indiaforensic RUPAY POS C2 ACQ14,,690005.14,-541478652.36,Kelly,616,Germany,104379.36,0,1,0
5600,2011,0.5,OWN,2,Low,1,10000, 36 months,1,debt_consolidation,6,High,2,Good Loan,0,15.96,C,3,11.81,12641.98358,10000,0,351.38,409000005599,14-Jun-18,Indiaforensic MASTER INT SET 130,,9826.97,-541468825.39,She,579,Germany,192146.63,0,1,0
5601,2011,8,MORTGAGE,3,Low,1,14000, 36 months,1,debt_consolidation,6,Low,1,Good Loan,0,6.03,A,1,13.57,14621.83,14000,0,426.1,409000005600,14-Jun-18,TRF TO  Indiaforensic SERVICES I,"6,100,000.00",,-547568825.39,Christie,786,France,66977.68,0,1,0
5602,2011,8,RENT,1,Low,1,12000, 60 months,2,debt_consolidation,6,High,2,Good Loan,0,17.58,D,4,24.2,14699.27,12000,0,301.99,409000005601,14-Jun-18,Indiaforensic MASTER INT SET 130,"9,826.97",,-547578652.36,Creel,704,Spain,158742.81,0,1,0
5603,2011,10,RENT,1,Low,1,14000, 36 months,1,debt_consolidation,6,High,2,Good Loan,0,14.27,C,3,13.94,17281.83845,14000,0,480.33,409000005602,15-Jun-18,Indiaforensic MASTER ACQ DOM1506,,1697294.30,-545881358.06,Thompson,796,France,189414.74,0,1,0
5604,2011,7,MORTGAGE,3,Medium,2,15000, 36 months,1,debt_consolidation,6,High,2,Good Loan,0,14.65,C,3,9.49,16640.47,15000,0,517.42,409000005603,15-Jun-18,Indiaforensic VISA ACQ DOM150618,,2223735.65,-543657622.41,Lazareva,598,Spain,159130.32,0,1,0
5605,2011,3,RENT,1,Low,1,9000, 36 months,1,wedding,5,Low,1,Good Loan,0,6.03,A,1,6.83,9860.666918,9000,0,273.92,409000005604,15-Jun-18,Indiaforensic RUPAY POS ACQ15061,,1782763.43,-541874858.98,Boni,602,France,97640.20,0,1,0
5606,2011,9,MORTGAGE,3,Medium,2,2400, 60 months,2,car,2,Low,1,Good Loan,0,9.91,B,2,14.46,2884.917891,2400,0,50.89,409000005605,15-Jun-18,Indiaforensic MASTER INT SET 140,,11319.76,-541863539.22,Evseev,619,France,86022.09,0,1,0
5607,2011,8,RENT,1,Low,1,3500, 36 months,1,other,4,Low,1,Good Loan,0,6.62,A,1,23.33,3867.669435,3500,0,107.47,409000005606,15-Jun-18,TRF TO  Indiaforensic SERVICES I,"6,300,000.00",,-548163539.22,Marino,492,Germany,10014.72,0,1,0
5608,2011,0.5,MORTGAGE,3,Medium,2,12000, 36 months,1,other,4,Low,1,Good Loan,0,6.03,A,1,5.05,13147.60617,12000,0,365.23,409000005607,15-Jun-18,Indiaforensic RUPAY POS C2 ACQ15,,713128.56,-547450410.66,Mackenzie,641,Germany,17384.21,0,1,0
5609,2011,3,RENT,1,Low,1,5000, 36 months,1,debt_consolidation,6,High,2,Good Loan,0,13.49,C,3,14.23,5889.04,5000,0,169.66,409000005608,18-Jun-18,Indiaforensic VISA ACQ DOM160618,,2147130.16,-545303280.50,Sutherland,518,France,143315.57,0,1,0
5610,2011,6,MORTGAGE,3,Low,1,12000, 60 months,2,credit_card,1,Low,1,Good Loan,0,9.91,B,2,24.01,14835.24288,12000,0,254.44,409000005609,18-Jun-18,Indiaforensic RUPAY POS ACQ16061,,1886002.42,-543417278.08,Nicolay,623,Spain,31669.18,0,1,0
5611,2011,10,MORTGAGE,3,Medium,2,35000, 60 months,2,credit_card,1,High,2,Good Loan,0,19.42,E,5,20.79,45777.98,26593.94,0,916.03,409000005610,18-Jun-18,Indiaforensic RUPAY POS ACQ17061,,2179590.08,-541237688.00,Lori,733,France,12761.16,0,1,0
5612,2011,7,MORTGAGE,3,Low,1,7000, 36 months,1,credit_card,1,Low,1,Good Loan,0,11.71,B,2,13.13,8333.299399,7000,0,231.54,409000005611,18-Jun-18,Indiaforensic MASTER ACQ DOM1806,,5177340.05,-536060347.95,Piazza,625,Germany,93429.95,0,1,0
5613,2011,3,MORTGAGE,3,Low,1,15000, 36 months,1,debt_consolidation,6,Low,1,Bad Loan,1,8.9,A,1,9.6,6659.1,5357.22,0,476.3,409000005612,18-Jun-18,Indiaforensic VISA ACQ DOM180618,,4806591.74,-531253756.21,Somerville,759,France,42012.55,0,1,0
5614,2011,5,RENT,1,Low,1,6000, 36 months,1,other,4,High,2,Bad Loan,1,15.96,C,3,17.59,3981.12,2594.6,195.08,210.83,409000005613,18-Jun-18,Indiaforensic RUPAY POS ACQ18061,,2205189.39,-529048566.82,Christie,604,France,15798.70,0,1,0
5615,2011,5,RENT,1,Low,1,9000, 36 months,1,debt_consolidation,6,Low,1,Good Loan,0,6.03,A,1,15.03,9860.755891,9000,0,273.92,409000005614,18-Jun-18,Indiaforensic RUPAY POS C2 ACQ18,,646394.23,-528402172.59,Grave,512,Spain,56408.14,0,1,0
5616,2011,8,OWN,2,Low,1,6000, 36 months,1,debt_consolidation,6,Low,1,Good Loan,0,8.9,A,1,27.14,6695.29,6000,0,190.52,409000005615,18-Jun-18,TRF TO  Indiaforensic SERVICES I,"15,000,000.00",,-543402172.59,Lori,520,France,4696.44,0,1,0
5617,2011,6.05,MORTGAGE,3,Low,1,8000, 36 months,1,debt_consolidation,6,Low,1,Good Loan,0,6.62,A,1,15.63,8721.18,8000,0,245.63,409000005616,18-Jun-18,TRF TO  Indiaforensic SERVICES I,"4,000,000.00",,-547402172.59,Iloerika,805,Spain,25042.10,0,1,0
5618,2011,0.5,RENT,1,Low,1,6500, 36 months,1,debt_consolidation,6,Low,1,Good Loan,0,7.51,A,1,22.59,7025.04,6500,0,202.23,409000005617,18-Jun-18,Indiaforensic VISA ACQ INT 14061,,2977.33,-547399195.26,Muir,626,France,130442.08,0,1,0
5619,2011,9,RENT,1,Low,1,18200, 60 months,2,debt_consolidation,6,High,2,Bad Loan,1,20.3,E,5,23.91,16666.51,7125.36,1599.81,485.24,409000005618,19-Jun-18,Indiaforensic MASTER ACQ DOM1906,,2313815.18,-545085380.08,Pauley,656,France,136521.82,0,1,0
5620,2011,7,RENT,1,Low,1,6000, 36 months,1,debt_consolidation,6,Low,1,Good Loan,0,7.51,A,1,22.71,6718.095442,6000,0,186.67,409000005619,19-Jun-18,Indiaforensic VISA ACQ DOM190618,,3159932.31,-541925447.77,Kao,785,Spain,199108.88,0,1,0
5621,2011,10,MORTGAGE,3,Medium,2,6700, 36 months,1,debt_consolidation,6,Low,1,Good Loan,0,6.03,A,1,9.31,7189.34,6700,0,203.92,409000005620,19-Jun-18,Indiaforensic RUPAY POS ACQ19061,,2423389.01,-539502058.76,Grant,553,France,124596.63,0,1,0
5622,2011,3,RENT,1,Medium,2,8000, 36 months,1,debt_consolidation,6,Low,1,Good Loan,0,7.9,A,1,5.98,9010.529045,8000,0,250.33,409000005621,19-Jun-18,Indiaforensic RUPAY POS C2 ACQ19,,832306.56,-538669752.20,Chukwuma,569,France,134394.78,0,1,0
5623,2011,1,MORTGAGE,3,Low,1,21000, 60 months,2,debt_consolidation,6,High,2,Bad Loan,1,22.74,G,7,21.21,9476.51,3025.9,1033.26,588.87,409000005622,19-Jun-18,TRF TO  Indiaforensic SERVICES I,"8,700,000.00",,-547369752.20,Vincent,670,France,144275.39,0,1,0
5624,2011,2,MORTGAGE,3,Low,1,12000, 36 months,1,credit_card,1,Low,1,Good Loan,0,12.69,B,2,18.23,14301.89,12000,0,402.54,409000005623,19-Jun-18,Indiaforensic MASTER INT SET 180,,3752.40,-547365999.80,Lazareva,586,Spain,123410.23,0,1,0
5625,2011,10,RENT,1,Low,1,35000, 60 months,2,debt_consolidation,6,High,2,Bad Loan,1,14.27,C,3,7.93,5730.54,2917.36,9.09,819.3,409000005624,20-Jun-18,Indiaforensic VISA ACQ INT 13061,,209.47,-547365790.33,Ch'ien,617,Spain,143298.06,0,1,0
5626,2011,7,RENT,1,Low,1,13500, 60 months,2,debt_consolidation,6,High,2,Good Loan,0,16.77,D,4,24.01,16626.28,10370.97,0,333.85,409000005625,20-Jun-18,Indiaforensic RUPAY POS ACQ19061,,2146626.49,-545219163.84,Bishop,508,France,129562.74,0,1,0
5627,2011,4,MORTGAGE,3,Medium,2,24000, 36 months,1,credit_card,1,Low,1,Good Loan,0,7.51,A,1,6.01,26873.41561,24000,0,746.66,409000005626,20-Jun-18,Indiaforensic RUPAY POSREVACQ190,"2,423,389.01",,-547642552.85,Chibuzo,624,Spain,4595.05,0,1,0
5628,2011,1,RENT,1,Low,1,7800, 36 months,1,debt_consolidation,6,Low,1,Good Loan,0,7.9,A,1,12.75,8699.61,7800,0,244.07,409000005627,20-Jun-18,Indiaforensic MASTER ACQ DOM2006,,1863576.67,-545778976.18,Chang,654,France,146715.07,0,1,0
5629,2011,6,RENT,1,Low,1,12000, 60 months,2,debt_consolidation,6,High,2,Good Loan,0,14.65,C,3,6.35,16277.74972,12000,0,283.28,409000005628,20-Jun-18,Indiaforensic VISA ACQ DOM200618,,2570110.96,-543208865.22,Calabrese,681,Germany,163558.36,0,1,0
5630,2011,10,MORTGAGE,3,Medium,2,7000, 36 months,1,debt_consolidation,6,Low,1,Good Loan,0,6.62,A,1,4.84,7311.81,7000,0,214.93,409000005629,20-Jun-18,Indiaforensic RUPAY POS ACQ20061,,957006.69,-542251858.53,Tokaryev,578,Spain,6947.09,0,1,0
5631,2011,10,MORTGAGE,3,Low,1,16450, 60 months,2,debt_consolidation,6,High,2,Good Loan,0,18.64,E,5,16.01,21759.15,16450,0,423.48,409000005630,20-Jun-18,Indiaforensic MASTER INT SET 190,,5240.01,-542246618.52,Logan,621,Spain,9170.54,0,1,0
5632,2011,0.5,RENT,1,Low,1,8575, 36 months,1,debt_consolidation,6,High,2,Good Loan,0,14.65,C,3,7.96,10635.43436,8575,0,295.79,409000005631,20-Jun-18,TRF TO  Indiaforensic SERVICES I,"6,000,000.00",,-548246618.52,Ozerova,632,France,199674.83,0,1,0
5633,2011,5,RENT,1,Low,1,16000, 36 months,1,debt_consolidation,6,Low,1,Good Loan,0,7.9,A,1,8.49,17988.73092,16000,0,500.65,409000005632,20-Jun-18,Indiaforensic RUPAY POS C2 ACQ20,,1446203.32,-546800415.20,Goering,644,France,157166.79,0,1,0
5634,2011,6.05,RENT,1,Low,1,3000, 36 months,1,debt_consolidation,6,Low,1,Good Loan,0,6.03,A,1,7.84,3251.52,3000,0,91.31,409000005633,20-Jun-18,Indiaforensic VISA ACQ INT 16061,,11868.00,-546788547.20,Lo,821,France,46072.52,0,1,0
5635,2011,3,RENT,1,Low,1,12200, 36 months,1,debt_consolidation,6,Low,1,Good Loan,0,6.03,A,1,12.38,13195.53227,12200,0,371.32,409000005634,21-Jun-18,TRF TO  Indiaforensic SERVICES I,"1,000,000.00",,-547788547.20,Simmons,754,France,3524.69,0,1,0
5636,2011,6,RENT,1,Low,1,10800, 36 months,1,debt_consolidation,6,High,2,Bad Loan,1,16.77,D,4,18.23,765.7,467.85,0,383.82,409000005635,21-Jun-18,Indiaforensic MASTER ACQ DOM2106,,2114385.86,-545674161.34,Maduabuchim,568,Spain,45563.94,0,1,0
5637,2011,3,MORTGAGE,3,Low,1,30000, 60 months,2,other,4,Low,1,Bad Loan,1,11.71,B,2,0.22,9943.49,5940.22,13.64,662.95,409000005636,21-Jun-18,Indiaforensic VISA ACQ DOM210618,,2458111.48,-543216049.86,Linger,584,France,59103.13,0,1,0
5638,2011,0.5,MORTGAGE,3,Low,1,6000, 36 months,1,home_improvement,7,Low,1,Bad Loan,1,11.71,B,2,16.18,989.95,711.65,0,198.46,409000005637,21-Jun-18,Indiaforensic RUPAY POS ACQ21061,,1859055.86,-541356994.00,Yeh,549,France,189558.44,0,1,0
5639,2011,10,RENT,1,Low,1,20000, 60 months,2,debt_consolidation,6,Low,1,Good Loan,0,12.69,B,2,24.36,23706.94,20000,0,451.9,409000005638,21-Jun-18,Indiaforensic RUPAY POS C2 ACQ21,,709243.64,-540647750.36,Stevenson,729,France,45779.90,0,1,0
5640,2011,7,MORTGAGE,3,Low,1,18000, 60 months,2,house,12,Low,1,Good Loan,0,11.71,B,2,2.03,20808.02,18000,0,397.77,409000005639,21-Jun-18,Indiaforensic MASTER INT SET 200,,1007.57,-540646742.79,Ifeatu,523,France,21859.06,0,1,0
5641,2011,1,MORTGAGE,3,Low,1,20000, 60 months,2,debt_consolidation,6,High,2,Good Loan,0,14.65,C,3,26.4,23605.04,15580.23,0,472.14,409000005640,21-Jun-18,TRF TO  Indiaforensic SERVICES I,"7,600,000.00",,-548246742.79,Kenechukwu,477,Germany,162699.70,0,1,0
5642,2011,5,MORTGAGE,3,Low,1,5000, 36 months,1,other,4,Low,1,Good Loan,0,7.9,A,1,22.15,5631.559139,5000,0,156.46,409000005641,22-Jun-18,Indiaforensic MASTER ACQ DOM2206,,2019747.74,-546226995.05,Learmonth,675,Germany,8567.18,0,1,0
5643,2011,8,MORTGAGE,3,Low,1,21000, 60 months,2,debt_consolidation,6,High,2,Good Loan,0,14.27,C,3,11.27,28846.41296,21000,0,491.58,409000005642,22-Jun-18,Indiaforensic VISA ACQ DOM220618,,2833099.15,-543393895.90,Dickson,782,Spain,132943.88,0,1,0
5644,2011,10,MORTGAGE,3,Low,1,2000, 36 months,1,other,4,Low,1,Bad Loan,1,12.69,B,2,12.47,816.88,529.19,84.06,67.09,409000005643,22-Jun-18,Indiaforensic RUPAY POS ACQ22061,,1585745.42,-541808150.48,Volkova,616,Spain,12916.32,0,1,0
5645,2011,5,RENT,1,Low,1,15000, 36 months,1,debt_consolidation,6,Low,1,Good Loan,0,11.71,B,2,19.1,17550.79,15000,0,496.14,409000005644,22-Jun-18,Indiaforensic RUPAY POS C2 ACQ22,,730009.69,-541078140.79,Mitchell,738,Spain,128799.86,0,1,0
5646,2011,10,MORTGAGE,3,Medium,2,14000, 60 months,2,debt_consolidation,6,Low,1,Good Loan,0,8.9,A,1,8.21,16521.11707,14000,0,289.94,409000005645,22-Jun-18,Indiaforensic VISA ACQ INT 20061,,7490.44,-541070650.35,Wong,717,Spain,99347.80,0,1,0
5647,2011,6,RENT,1,Low,1,22000, 36 months,1,debt_consolidation,6,Low,1,Good Loan,0,12.69,B,2,9.55,26556.69159,22000,0,737.99,409000005646,22-Jun-18,TRF TO  Indiaforensic SERVICES I,"7,100,000.00",,-548170650.35,James,526,Germany,40980.87,0,1,0
5648,2011,3,RENT,1,Low,1,10600, 36 months,1,debt_consolidation,6,High,2,Good Loan,0,15.96,C,3,18.72,13268.11746,10600,0,372.46,409000005647,25-Jun-18,Indiaforensic VISA ACQ DOM230618,,3086020.94,-545084629.41,Shao,660,France,40368.65,0,1,0
5649,2011,5,RENT,1,Low,1,13600, 36 months,1,debt_consolidation,6,Low,1,Good Loan,0,12.42,B,2,19.05,16310.43352,13600,0,454.45,409000005648,25-Jun-18,Indiaforensic RUPAY POS ACQ23061,,1815935.72,-543268693.69,Walton,525,France,94738.54,0,1,0
5650,2011,3,RENT,1,Low,1,12000, 60 months,2,debt_consolidation,6,High,2,Good Loan,0,19.03,E,5,24.45,17554.16784,12000,0,311.49,409000005649,25-Jun-18,Indiaforensic RUPAY POS ACQ24061,,2540692.97,-540728000.72,Stanley,629,Spain,88842.80,0,1,0
5651,2011,1,MORTGAGE,3,Low,1,23675, 60 months,2,debt_consolidation,6,Low,1,Good Loan,0,12.69,B,2,20.07,26700.35,18597.28,0,534.93,409000005650,25-Jun-18,Indiaforensic VISA ACQ DOM250618,,5165269.37,-535562731.35,Watson,616,Germany,136934.91,0,1,0
5652,2011,1,RENT,1,Low,1,16425, 36 months,1,debt_consolidation,6,High,2,Good Loan,0,13.49,C,3,23.01,20053.21999,16425,0,557.31,409000005651,25-Jun-18,Indiaforensic RUPAY POS ACQ25061,,2301768.58,-533260962.77,Folliero,521,Germany,109356.53,0,1,0
5653,2011,10,MORTGAGE,3,Low,1,17600, 36 months,1,credit_card,1,Low,1,Good Loan,0,7.9,A,1,17.3,19823.3268,17600,0,550.71,409000005652,25-Jun-18,Indiaforensic MASTER ACQ DOM2506,,5739467.67,-527521495.10,Fitzgerald,691,France,199635.93,0,1,0
5654,2011,4,RENT,1,Low,1,13500, 60 months,2,debt_consolidation,6,High,2,Good Loan,0,19.42,E,5,9.47,15473.2,13500,0,353.33,409000005653,25-Jun-18,NEFT CHARGES AND GST/0000,29.5,,-527521524.60,Garner,687,Germany,158408.23,0,1,0
5655,2011,4,MORTGAGE,3,Low,1,14075, 60 months,2,debt_consolidation,6,Low,1,Good Loan,0,11.71,B,2,20.38,15539.68,11117.95,0,311.04,409000005654,25-Jun-18,NEFT/000041992898/Indiaforensic,"5,000,000.00",,-532521524.60,Folliero,677,Spain,95936.84,0,1,0
5656,2011,1,RENT,1,Low,1,3200, 60 months,2,debt_consolidation,6,High,2,Good Loan,0,19.42,E,5,3.62,4485.208598,3200,0,83.76,409000005655,25-Jun-18,Indiaforensic RUPAY POS C2 ACQ25,,701241.46,-531820283.14,Liao,695,Spain,126688.83,0,1,0
5657,2011,4,MORTGAGE,3,Low,1,9150, 36 months,1,debt_consolidation,6,High,2,Good Loan,0,16.29,D,4,22.33,10361.35,9150,0,323,409000005656,25-Jun-18,TRF TO  Indiaforensic SERVICES I,"15,000,000.00",,-546820283.14,Lucchesi,663,France,150850.29,0,1,0
5658,2011,4,MORTGAGE,3,Low,1,12000, 36 months,1,debt_consolidation,6,Low,1,Bad Loan,1,12.69,B,2,10.39,3778.37,2281.49,567.89,402.54,409000005657,25-Jun-18,TRF TO  Indiaforensic SERVICES I,"700,000.00",,-547520283.14,Chan,496,France,27802.00,0,1,0
5659,2011,7,MORTGAGE,3,Medium,2,35000, 60 months,2,debt_consolidation,6,Low,1,Good Loan,0,12.69,B,2,7.95,46119.94707,35000,0,790.82,409000005658,25-Jun-18,Indiaforensic VISA ACQ INT 21061,,9.89,-547520273.25,Ma,747,Spain,32430.94,0,1,0
5660,2011,3,MORTGAGE,3,High,3,19925, 36 months,1,home_improvement,7,Low,1,Good Loan,0,7.9,A,1,10.56,21369.92,19925,0,623.46,409000005659,26-Jun-18,Indiaforensic MASTER ACQ DOM2606,,1889215.32,-545631057.93,Nwabugwu,546,France,137332.37,0,1,0
5661,2011,2,MORTGAGE,3,Low,1,14400, 36 months,1,major_purchase,8,Low,1,Good Loan,0,11.71,B,2,12.23,17143.3485,14400,0,476.3,409000005660,26-Jun-18,Indiaforensic VISA ACQ DOM260618,,3229133.72,-542401924.21,P'eng,706,Spain,28601.68,0,1,0
5662,2011,10,MORTGAGE,3,Low,1,15000, 60 months,2,credit_card,1,Low,1,Good Loan,0,7.9,A,1,6.42,17803.00607,15000,0,303.43,409000005661,26-Jun-18,Indiaforensic RUPAY POS ACQ26061,,1816996.18,-540584928.03,Andrews,472,France,108411.66,0,1,0
5663,2011,10,MORTGAGE,3,Medium,2,30000, 60 months,2,debt_consolidation,6,High,2,Bad Loan,1,22.06,F,6,18.95,37610.61,20069.74,1466.57,829.6,409000005662,26-Jun-18,TRF TO  Indiaforensic SERVICES I,"7,600,000.00",,-548184928.03,Otutodilinna,703,France,122518.50,0,1,0
5664,2011,4,RENT,1,Low,1,12000, 60 months,2,small_business,3,High,2,Good Loan,0,14.27,C,3,8.61,14032.9,9359.56,0,280.91,409000005663,26-Jun-18,Indiaforensic RUPAY POS C2 ACQ26,,658789.31,-547526138.72,Grant,850,France,9015.07,0,1,0
5665,2011,9,MORTGAGE,3,Low,1,15000, 36 months,1,small_business,3,Low,1,Good Loan,0,10.65,B,2,16.15,17153.2,15000,0,488.6,409000005664,26-Jun-18,Indiaforensic VISA ACQ INT 22061,,509.09,-547525629.63,Abramovich,667,Spain,94433.08,0,1,0
5666,2011,10,MORTGAGE,3,Low,1,18800, 60 months,2,debt_consolidation,6,High,2,Good Loan,0,19.91,E,5,22.88,24848.54,14249.92,0,497.15,409000005665,26-Jun-18,Indiaforensic MASTER INT 23-2506,,3052.82,-547522576.81,Komarova,559,France,110371.84,0,1,0
5667,2011,6,MORTGAGE,3,Low,1,25000, 60 months,2,home_improvement,7,High,2,Good Loan,0,17.27,D,4,6.09,34294.35803,25000,0,624.95,409000005666,27-Jun-18,TRF TO  Indiaforensic SERVICES I,"700,000.00",,-548222576.81,Otutodilichukwu,636,Spain,141364.62,0,1,0
5668,2011,6.05,MORTGAGE,3,Medium,2,10000, 36 months,1,home_improvement,7,High,2,Good Loan,0,14.27,C,3,16.97,12347.07862,10000,0,343.09,409000005667,27-Jun-18,Indiaforensic MASTER ACQ DOM2706,,2222832.78,-545999744.03,Donaldson,672,France,16245.25,0,1,0
5669,2011,4,RENT,1,Low,1,12000, 36 months,1,credit_card,1,Low,1,Good Loan,0,6.62,A,1,15.32,13261.33925,12000,0,368.45,409000005668,27-Jun-18,Indiaforensic VISA ACQ DOM270618,,3279076.58,-542720667.45,Duggan,667,France,108348.94,0,1,0
5670,2011,5,MORTGAGE,3,Low,1,12000, 60 months,2,credit_card,1,High,2,Good Loan,0,14.65,C,3,21.42,15112.02,12000,0,283.28,409000005669,27-Jun-18,Indiaforensic RUPAY POS ACQ27061,,1854092.82,-540866574.63,Chinwendu,648,Germany,171668.20,0,1,0
5671,2011,10,MORTGAGE,3,Medium,2,3000, 36 months,1,home_improvement,7,High,2,Good Loan,0,13.49,C,3,17.82,3419.07,3000,0,101.8,409000005670,27-Jun-18,TRF TO  Indiaforensic SERVICES I,"7,400,000.00",,-548266574.63,Hamilton,497,France,67364.42,0,1,0
5672,2011,9,MORTGAGE,3,Low,1,9000, 36 months,1,renewable_energy,13,Low,1,Good Loan,0,11.71,B,2,23.25,10714.02969,9000,0,297.69,409000005671,27-Jun-18,Indiaforensic RUPAY POS C2 ACQ27,,626712.92,-547639861.71,Smith,743,France,107867.38,0,1,0
5673,2011,0.5,RENT,1,Low,1,30750, 60 months,2,debt_consolidation,6,High,2,Bad Loan,1,22.35,F,6,23.47,24483.78,8870.67,3155.54,855.42,409000005672,27-Jun-18,Indiaforensic MASTER INT 260618,,2027.87,-547637833.84,Mazzi,619,France,194310.10,0,1,0
5674,2011,10,MORTGAGE,3,Low,1,16400, 60 months,2,debt_consolidation,6,High,2,Bad Loan,1,16.77,D,4,9.38,4461.15,2066.95,0,405.56,409000005673,28-Jun-18,Indiaforensic VISA ACQ DOM280618,,2222406.45,-545415427.39,Krischock,639,Spain,33950.08,0,1,0
5675,2011,1,OWN,2,Low,1,18000, 60 months,2,other,4,Low,1,Bad Loan,1,12.42,B,2,4.4,7485.43,3013.03,2235.51,404.24,409000005674,28-Jun-18,Indiaforensic RUPAY POS ACQ28061,,1759959.01,-543655468.38,Kent,540,Spain,197588.32,0,1,0
5676,2011,4,MORTGAGE,3,Low,1,8400, 36 months,1,debt_consolidation,6,High,2,Bad Loan,1,14.65,C,3,18.16,2003.09,1149.68,253.04,289.76,409000005675,28-Jun-18,TRF TO  Indiaforensic SERVICES I,"4,600,000.00",,-548255468.38,Binder,766,France,428.23,0,1,0
5677,2011,2,RENT,1,Medium,2,10000, 36 months,1,small_business,3,Low,1,Good Loan,0,10.65,B,2,4.87,11715.10041,10000,0,325.74,409000005676,28-Jun-18,Indiaforensic VISA ACQ INT 26061,,308.37,-548255160.01,Zubarev,749,France,34948.77,0,1,0
5678,2011,4,RENT,1,Low,1,8000, 36 months,1,house,12,Low,1,Good Loan,0,6.62,A,1,15.23,8836.834072,8000,0,245.63,409000005677,28-Jun-18,Indiaforensic RUPAY POS C2 ACQ28,,522299.26,-547732860.75,Degtyarev,655,Germany,82084.30,0,1,0
5679,2011,2,MORTGAGE,3,Low,1,35000, 60 months,2,debt_consolidation,6,High,2,Good Loan,0,20.89,F,6,24.39,55906.9499,35000,0,944.71,409000005678,28-Jun-18,Indiaforensic MASTER ACQ DOM2806,,2017195.99,-545715664.76,Obialo,630,France,64804.59,0,1,0
5680,2011,6,MORTGAGE,3,Medium,2,35000, 60 months,2,debt_consolidation,6,High,2,Bad Loan,1,21.28,F,6,16.45,28444.75,4801.54,16066.02,952.39,409000005679,28-Jun-18,Indiaforensic MC RECOV JUL 17,"303,686.99",,-546019351.75,Davydova,778,Germany,83556.65,0,1,0
5681,2011,5,RENT,1,Low,1,21600, 36 months,1,debt_consolidation,6,High,2,Bad Loan,1,13.49,C,3,9.66,1922.8,489.37,1190.96,732.9,409000005680,29-Jun-18,TRF TO  Indiaforensic SERVICES I,"2,000,000.00",,-548019351.75,Teng,757,Germany,71926.28,0,1,0
5682,2011,3,RENT,1,Low,1,10000, 36 months,1,credit_card,1,High,2,Good Loan,0,17.58,D,4,19.32,12752.07,10000,0,359.43,409000005681,29-Jun-18,Indiaforensic MASTER ACQ DOM2906,,1735668.56,-546283683.19,Hsing,529,Spain,122925.44,0,1,0
5683,2011,0.5,MORTGAGE,3,Low,1,35000, 60 months,2,medical,9,High,2,Bad Loan,1,13.49,C,3,10.92,804.22,411.23,0,805.17,409000005682,29-Jun-18,Indiaforensic VISA ACQ DOM290618,,2285757.71,-543997925.48,Coleman,620,Spain,13133.88,0,1,0
5684,2011,2,RENT,1,Low,1,6000, 36 months,1,debt_consolidation,6,Low,1,Good Loan,0,7.9,A,1,16.58,6255.97,6000,0,187.75,409000005683,29-Jun-18,Indiaforensic RUPAY POS ACQ29061,,1627152.48,-542370773.00,Wilder,615,France,62845.64,0,1,0
5685,2011,3,MORTGAGE,3,Low,1,12000, 60 months,2,credit_card,1,Low,1,Good Loan,0,12.42,B,2,14.12,15275.45457,12000,0,269.49,409000005684,29-Jun-18,Indiaforensic MASTER INT 280618,,1975.35,-542368797.65,Molineux,735,France,28411.23,0,1,0
5686,2011,2,MORTGAGE,3,Low,1,35000, 60 months,2,debt_consolidation,6,High,2,Bad Loan,1,20.3,E,5,15.29,7463.94,2888.69,16.58,933.14,409000005685,29-Jun-18,TRF TO  Indiaforensic SERVICES I,"5,900,000.00",,-548268797.65,Cocci,705,Spain,28640.92,0,1,0
5687,2011,1,RENT,1,Low,1,21000, 36 months,1,debt_consolidation,6,Low,1,Good Loan,0,7.9,A,1,13.56,23641.21563,21000,0,657.1,409000005686,29-Jun-18,Indiaforensic RUPAY POS C2 ACQ29,,640678.86,-547628118.79,Chikwendu,644,Spain,156787.34,0,1,0
5688,2011,5,MORTGAGE,3,High,3,28000, 36 months,1,debt_consolidation,6,Low,1,Good Loan,0,9.91,B,2,10,32474.81977,28000,0,902.3,409000005687,30-Jun-18,Indiaforensic VISA ACQ DOM300618,,2614912.61,-545013206.18,Fraser,505,Germany,125307.87,0,1,0
5689,2011,1,RENT,1,Low,1,14275, 36 months,1,debt_consolidation,6,Low,1,Good Loan,0,9.91,B,2,10.58,15137.43,14275,0,460.02,409000005688,30-Jun-18,Indiaforensic RUPAY POS ACQ30061,,1270137.20,-543743068.98,Lai,471,Germany,131736.23,0,1,0
5690,2011,10,RENT,1,High,3,35000, 36 months,1,debt_consolidation,6,High,2,Bad Loan,1,18.64,E,5,8.59,37414.09,26055.47,1292.09,1276.6,409000005689,30-Jun-18,TRF TO  Indiaforensic SERVICES I,"4,000,000.00",,-547743068.98,Korovin,722,Spain,128262.14,0,1,0
5691,2011,6,MORTGAGE,3,Low,1,20000, 60 months,2,debt_consolidation,6,High,2,Good Loan,0,14.65,C,3,15.44,23605.04,15580.23,0,472.14,409000005690,30-Jun-18,TRF TO  Indiaforensic SERVICES I,"500,000.00",,-548243068.98,Sidorov,577,Spain,91366.42,0,1,0
5692,2011,0.5,MORTGAGE,3,High,3,25400, 60 months,2,small_business,3,High,2,Good Loan,0,13.49,C,3,3.87,28832.45,25399.99,0,584.32,409000005691,2-Jul-18,Indiaforensic VISA ACQ DOM010718,"12,753.61",,-548255822.59,Ibrahimova,744,Spain,82290.81,0,1,0
5693,2011,5,OWN,2,Low,1,16200, 60 months,2,debt_consolidation,6,High,2,Good Loan,0,18.25,D,4,19.43,20773.44,16200,0,413.58,409000005692,2-Jul-18,Indiaforensic RUPAY POS ACQ01071,,1467964.70,-546787857.89,Duigan,573,France,66190.21,0,1,0
5694,2011,2,MORTGAGE,3,Low,1,15000, 60 months,2,credit_card,1,High,2,Bad Loan,1,19.91,E,5,18.12,10564.51,3084.18,1594.73,396.66,409000005693,2-Jul-18,Indiaforensic VISA ACQ DOM020718,,4950516.77,-541837341.12,Taylor,653,France,23920.65,0,1,0
5695,2011,6.05,MORTGAGE,3,Low,1,8000, 36 months,1,other,4,Low,1,Good Loan,0,6.03,A,1,6.07,8724.592965,8000,0,243.49,409000005694,2-Jul-18,Indiaforensic RUPAY POS ACQ02071,,1751846.12,-540085495.00,Donaldson,660,France,45438.38,0,1,0
5696,2011,1,MORTGAGE,3,Medium,2,25000, 60 months,2,debt_consolidation,6,High,2,Good Loan,0,18.25,D,4,16.27,31870.67,19087.73,0,638.25,409000005695,2-Jul-18,Indiaforensic RUPAY POS C2 ACQ02,,615871.28,-539469623.72,Jobson,787,France,93360.35,0,1,0
5697,2011,10,MORTGAGE,3,Low,1,6500, 36 months,1,major_purchase,8,Low,1,Good Loan,0,7.9,A,1,21.19,7321.180705,6500,0,203.39,409000005696,2-Jul-18,Indiaforensic RUPAY POS C2 ACQ30,,631159.80,-538838463.92,Lu,617,France,14496.67,0,1,0
5698,2011,9,OWN,2,Low,1,9175, 36 months,1,debt_consolidation,6,High,2,Good Loan,0,19.42,E,5,12.46,12079.36749,9175,0,338.28,409000005697,2-Jul-18,Indiaforensic MASTER ACQ DOM0207,,5512890.81,-533325573.11,Nebechi,567,France,168521.72,0,1,0
5699,2011,10,MORTGAGE,3,Medium,2,30000, 36 months,1,debt_consolidation,6,Low,1,Good Loan,0,6.62,A,1,13.27,33155.47642,30000,0,921.11,409000005698,2-Jul-18,TRF TO  Indiaforensic SERVICES I,"14,900,000.00",,-548225573.11,Cross,682,Spain,103318.44,0,1,0
5700,2011,3,MORTGAGE,3,Low,1,30000, 60 months,2,debt_consolidation,6,Low,1,Good Loan,0,10.65,B,2,10.64,32306.02,23805.38,0,647.05,409000005699,3-Jul-18,Indiaforensic MASTER ACQ DOM0307,,2184316.24,-546041256.87,Wallace,684,France,87219.41,0,1,0
5701,2011,10,MORTGAGE,3,Low,1,14000, 36 months,1,debt_consolidation,6,Low,1,Good Loan,0,6.62,A,1,9.12,14899.27,14000,0,429.86,409000005700,3-Jul-18,Indiaforensic VISA ACQ DOM030718,,2459749.90,-543581506.97,Perreault,447,France,197490.39,0,1,0
5702,2011,4,RENT,1,Low,1,7200, 36 months,1,debt_consolidation,6,Low,1,Good Loan,0,7.9,A,1,21.94,8044.8,7200,0,225.29,409000005701,3-Jul-18,Indiaforensic VISA ACQ INT 28061,,1669.40,-543579837.57,Manna,625,Germany,126812.63,0,1,0
5703,2011,10,MORTGAGE,3,Low,1,6625, 36 months,1,debt_consolidation,6,High,2,Good Loan,0,16.77,D,4,24.96,8224.75,6625,0,235.45,409000005702,3-Jul-18,Indiaforensic RUPAY POS ACQ03071,,1654065.41,-541925772.16,Hsiung,585,France,94283.09,0,1,0
5704,2011,10,RENT,1,Medium,2,16000, 60 months,2,debt_consolidation,6,High,2,Good Loan,0,18.25,D,4,18.55,20390.72,12221.54,0,408.48,409000005703,3-Jul-18,Indiaforensic RUPAY POS C2 ACQ03,,444821.02,-541480951.14,Gibbons,516,France,46857.52,0,1,0
5705,2011,1,RENT,1,Low,1,21000, 60 months,2,debt_consolidation,6,High,2,Good Loan,0,15.27,C,3,10.05,25080.14,16283.45,0,502.57,409000005704,3-Jul-18,TRF TO  Indiaforensic SERVICES I,"5,000,000.00",,-546480951.14,Algeranoff,732,Germany,81491.70,0,1,0
5706,2011,10,MORTGAGE,3,Low,1,12500, 60 months,2,debt_consolidation,6,High,2,Good Loan,0,18.64,E,5,16.77,17663.05498,12500,0,321.79,409000005705,3-Jul-18,TRF TO  Indiaforensic SERVICES I,"1,000,000.00",,-547480951.14,Doherty,628,Germany,129107.97,0,1,0
5707,2011,1,RENT,1,Low,1,6600, 36 months,1,credit_card,1,Low,1,Good Loan,0,11.71,B,2,14.4,7856.032726,6600,0,218.31,409000005706,3-Jul-18,TRF TO  Indiaforensic SERVICES I,"500,000.00",,-547980951.14,Rowe,682,Spain,49732.90,0,1,0
5708,2011,8,RENT,1,Low,1,3000, 36 months,1,credit_card,1,Low,1,Good Loan,0,12.42,B,2,11.5,3475.17,3000,0,100.25,409000005707,4-Jul-18,Indiaforensic MASTER ACQ DOM0407,,2227803.74,-545753147.40,Yates,746,France,88728.47,0,1,0
5709,2011,5,MORTGAGE,3,Low,1,8500, 36 months,1,debt_consolidation,6,High,2,Bad Loan,1,14.65,C,3,21.47,4146.21,2645.64,342.8,293.21,409000005708,4-Jul-18,Indiaforensic VISA ACQ DOM040718,,2637725.76,-543115421.64,Galloway,655,France,86981.45,0,1,0
5710,2011,10,MORTGAGE,3,Medium,2,30000, 60 months,2,home_improvement,7,Low,1,Good Loan,0,11.71,B,2,13.85,38128.56552,30000,0,662.95,409000005709,4-Jul-18,Indiaforensic RUPAY POS ACQ04071,,1651030.40,-541464391.24,Genovese,644,France,3740.93,0,1,0
5711,2011,10,MORTGAGE,3,Low,1,25000, 60 months,2,debt_consolidation,6,High,2,Good Loan,0,18.25,D,4,2.88,26126.03,25000,0,638.25,409000005710,4-Jul-18,Indiaforensic VISA ACQ INT 02071,,495.00,-541463896.24,Arrington,778,France,67949.32,0,1,0
5712,2011,6,RENT,1,Low,1,16000, 36 months,1,small_business,3,Low,1,Good Loan,0,7.9,A,1,13.73,18011.5327,16000,0,500.65,409000005711,4-Jul-18,TRF TO  Indiaforensic SERVICES I,"6,800,000.00",,-548263896.24,Miah,617,France,147636.46,0,1,0
5713,2011,0.5,RENT,1,Low,1,8700, 36 months,1,other,4,Low,1,Good Loan,0,6.03,A,1,21.6,9531.990615,8700,0,264.79,409000005712,4-Jul-18,Indiaforensic RUPAY POS C2 ACQ04,,571457.10,-547692439.14,Chijindum,660,Germany,188891.96,0,1,0
5714,2011,7,MORTGAGE,3,Medium,2,8400, 36 months,1,small_business,3,Low,1,Good Loan,0,12.69,B,2,15.35,10139.27391,8400,0,281.78,409000005713,5-Jul-18,TRF TO  Indiaforensic SERVICES I,"500,000.00",,-548192439.14,Ferguson,537,France,25482.62,0,1,0
5715,2011,2,RENT,1,Medium,2,10000, 36 months,1,credit_card,1,High,2,Good Loan,0,14.27,C,3,4.38,12364.05216,10000,0,343.09,409000005714,5-Jul-18,Indiaforensic VISA ACQ DOM050718,,2748303.86,-545444135.28,Smith,554,France,18391.93,0,1,0
5716,2011,8,RENT,1,Low,1,10000, 36 months,1,debt_consolidation,6,High,2,Good Loan,0,18.64,E,5,21.37,13137.12433,10000,0,364.75,409000005715,5-Jul-18,Indiaforensic RUPAY POS ACQ05071,,1616233.08,-543827902.20,Marshall,806,France,140168.36,0,1,0
5717,2011,6.05,MORTGAGE,3,Low,1,35000, 60 months,2,debt_consolidation,6,High,2,Good Loan,0,22.06,F,6,21.08,55362.53931,35000,0,967.86,409000005716,5-Jul-18,Indiaforensic MASTER ACQ DOM0507,,2124003.08,-541703899.12,P'an,611,Germany,161064.29,0,1,0
5718,2011,6,RENT,1,Low,1,8000, 36 months,1,debt_consolidation,6,Low,1,Good Loan,0,7.9,A,1,26.78,8992.4464,8000,0,250.33,409000005717,5-Jul-18,Indiaforensic RUPAY POS C2 ACQ05,,638577.49,-541065321.63,Burton,665,France,183542.08,0,1,0
5719,2011,10,MORTGAGE,3,Low,1,4500, 36 months,1,debt_consolidation,6,Low,1,Good Loan,0,6.62,A,1,16.08,4971.326938,4500,0,138.17,409000005718,5-Jul-18,TRF TO  Indiaforensic SERVICES I,"6,500,000.00",,-547565321.63,Kamdibe,648,France,194238.92,0,1,0
5720,2011,3,RENT,1,Low,1,12750, 36 months,1,other,4,High,2,Good Loan,0,18.25,D,4,18.77,16645.7228,12750,0,462.55,409000005719,6-Jul-18,Indiaforensic MASTER ACQ DOM0607,,2020691.40,-545544630.23,Milani,692,France,7900.46,0,1,0
5721,2011,10,MORTGAGE,3,Low,1,25000, 60 months,2,debt_consolidation,6,High,2,Bad Loan,1,18.25,D,4,18.64,15955.85,7754.57,0,638.25,409000005720,6-Jul-18,Indiaforensic VISA ACQ DOM060718,,2256991.21,-543287639.02,Forbes,507,Spain,51424.29,0,1,0
5722,2011,10,MORTGAGE,3,Low,1,24000, 60 months,2,debt_consolidation,6,High,2,Good Loan,0,17.27,D,4,23.23,34425.01719,24000,0,599.96,409000005721,6-Jul-18,Indiaforensic RUPAY POS ACQ06071,,1513145.26,-541774493.76,Chiekwugo,696,Germany,152450.84,0,1,0
5723,2011,4,RENT,1,Low,1,7000, 36 months,1,debt_consolidation,6,Low,1,Good Loan,0,6.03,A,1,10.38,7256.84,7000,0,213.05,409000005722,6-Jul-18,Indiaforensic MASTER INT 300618,,1188.46,-541773305.30,Cousens,681,France,55816.20,0,1,0
5724,2011,1,RENT,1,Low,1,6200, 36 months,1,credit_card,1,Low,1,Good Loan,0,10.65,B,2,15.4,6999.24,6200,0,201.96,409000005723,6-Jul-18,Indiaforensic RUPAY POS C2 ACQ06,,580792.56,-541192512.74,Ross,687,France,32909.13,0,1,0
5725,2011,0.5,RENT,1,Low,1,2000, 36 months,1,wedding,5,Low,1,Good Loan,0,7.9,A,1,4.38,2177.74,2000,0,62.59,409000005724,6-Jul-18,TRF TO  Indiaforensic SERVICES I,"6,500,000.00",,-547692512.74,Wood,641,Spain,100637.07,0,1,0
5726,2011,10,RENT,1,Low,1,7800, 36 months,1,debt_consolidation,6,High,2,Good Loan,0,16.29,D,4,21.71,8667.26,7800,0,275.35,409000005725,6-Jul-18,Indiaforensic MASTER INT 050718,,3577.64,-547688935.10,Hawks,507,France,142911.99,0,1,0
5727,2011,1,RENT,1,Low,1,19200, 60 months,2,small_business,3,Low,1,Bad Loan,1,11.71,B,2,5.55,11583.91,6066.44,1841.11,424.29,409000005726,6-Jul-18,TRF TO  Indiaforensic SERVICES I,"500,000.00",,-548188935.10,T'ien,688,Spain,26287.21,0,1,0
5728,2011,10,MORTGAGE,3,Low,1,11000, 36 months,1,credit_card,1,High,2,Good Loan,0,15.96,C,3,24.18,13907.33008,11000,0,386.52,409000005727,6-Jul-18,ICA 17825 Indiaforensic INTG RVS,,171239.95,-548017695.15,Ting,535,Germany,60775.76,0,1,0
5729,2011,0.5,MORTGAGE,3,Medium,2,10000, 36 months,1,small_business,3,Low,1,Good Loan,0,7.9,A,1,11.13,11242.80092,10000,0,312.91,409000005728,7-Jul-18,Indiaforensic VISA ACQ DOM070718,,2596279.65,-545421415.50,Thynne,701,France,146257.77,0,1,0
5730,2011,5,MORTGAGE,3,Low,1,8000, 36 months,1,home_improvement,7,High,2,Bad Loan,1,14.27,C,3,2.11,6037.92,4459.9,0,274.48,409000005729,7-Jul-18,Indiaforensic RUPAY POS ACQ07071,,1808517.14,-543612898.36,Wang,488,France,28332.00,0,1,0
5731,2011,1,RENT,1,High,3,16000, 60 months,2,other,4,High,2,Bad Loan,1,19.91,E,5,13.99,5517.16,2264.11,0,423.11,409000005730,7-Jul-18,TRF TO  Indiaforensic SERVICES I,"3,000,000.00",,-546612898.36,Maclean,539,France,100919.19,0,1,0
5732,2011,2,RENT,1,Low,1,22000, 60 months,2,credit_card,1,Low,1,Good Loan,0,11.71,B,2,18.44,28381.33448,22000,0,486.16,409000005731,7-Jul-18,TRF TO  Indiaforensic SERVICES I,"1,000,000.00",,-547612898.36,Watson,674,France,102591.90,0,1,0
5733,2011,6.05,MORTGAGE,3,Low,1,13200, 60 months,2,debt_consolidation,6,High,2,Bad Loan,1,14.27,C,3,5.19,9579,5646.16,21.84,309,409000005732,7-Jul-18,TRF TO  Indiaforensic SERVICES I,"500,000.00",,-548112898.36,Gibson,538,Spain,25554.40,0,1,0
5734,2011,10,MORTGAGE,3,Low,1,13800, 60 months,2,small_business,3,Low,1,Good Loan,0,12.69,B,2,1.18,17514.39636,13800,0,311.81,409000005733,7-Jul-18,Indiaforensic RUPAY POS C2 ACQ07,,454985.56,-547657912.80,French,829,France,152107.93,0,1,0
5735,2011,10,MORTGAGE,3,Low,1,30000, 36 months,1,credit_card,1,Low,1,Good Loan,0,12.69,B,2,9.58,36215.52788,30000,0,1006.35,409000005734,7-Jul-18,2044913-20180707225219,"1,536.00",,-547659448.80,Henderson,768,France,69381.05,0,1,0
5736,2011,4,RENT,1,Low,1,2000, 36 months,1,other,4,Low,1,Bad Loan,1,7.51,A,1,16.73,89.89,0,89.89,62.23,409000005735,8-Jul-18,COMMISSION FOR Indiaforensic 201,,11.52,-547659437.28,Greenwood,585,Spain,101728.46,0,1,0
5737,2011,7,MORTGAGE,3,Low,1,3600, 36 months,1,debt_consolidation,6,Low,1,Good Loan,0,11.71,B,2,1.98,4283.888024,3600,0,119.08,409000005736,9-Jul-18,TRF TO  Indiaforensic SERVICES I,"500,000.00",,-548159437.28,Anderson,581,France,89040.61,0,1,0
5738,2011,6,MORTGAGE,3,Low,1,25000, 60 months,2,credit_card,1,High,2,Bad Loan,1,22.35,F,6,11.84,4858.35,1698.13,0,695.46,409000005737,9-Jul-18,Indiaforensic RUPAY POS ACQ08071,,1549439.10,-546609998.18,Mistry,682,Germany,16910.98,0,1,0
5739,2011,10,MORTGAGE,3,Medium,2,30000, 60 months,2,home_improvement,7,Low,1,Good Loan,0,11.71,B,2,11.8,33117.26,23693.88,0,662.95,409000005738,9-Jul-18,Indiaforensic VISA ACQ DOM090718,,5383803.73,-541226194.45,Tuan,653,France,150468.35,0,1,0
5740,2011,8,RENT,1,Low,1,16000, 60 months,2,small_business,3,High,2,Bad Loan,1,19.03,E,5,5.35,3015.53,1005.14,532.61,415.32,409000005739,9-Jul-18,Indiaforensic RUPAY POS ACQ09071,,1295798.19,-539930396.26,Fiorentini,712,France,177613.19,0,1,0
5741,2011,4,MORTGAGE,3,Low,1,4800, 60 months,2,home_improvement,7,Low,1,Good Loan,0,7.9,A,1,0.6,4837.92,3850.84,0,97.1,409000005740,9-Jul-18,Indiaforensic MASTER ACQ DOM0707,,2481297.39,-537449098.87,Scott,620,Germany,120672.09,0,1,0
5742,2011,10,MORTGAGE,3,Low,1,20000, 60 months,2,debt_consolidation,6,High,2,Bad Loan,1,21.28,F,6,22.69,15796.21,4771.64,2465.61,544.23,409000005741,9-Jul-18,TRF TO  Indiaforensic SERVICES I,"3,000,000.00",,-540449098.87,Jideofor,709,France,77142.85,0,1,0
5743,2011,10,MORTGAGE,3,Low,1,17825, 36 months,1,vacation,11,Low,1,Good Loan,0,6.62,A,1,1.85,19697.57478,17825,0,547.3,409000005742,9-Jul-18,TRF TO  Indiaforensic SERVICES I,"5,000,000.00",,-545449098.87,Yevseyev,832,France,127804.66,0,1,0
5744,2011,10,RENT,1,Low,1,24000, 60 months,2,credit_card,1,High,2,Bad Loan,1,21.67,F,6,19.03,27959.32,11682.06,3642.69,658.36,409000005743,9-Jul-18,Indiaforensic MASTER ACQ DOM08-0,,3987860.36,-541461238.51,Kelly,635,Spain,158344.63,0,1,0
5745,2011,0.5,RENT,1,Low,1,4000, 36 months,1,debt_consolidation,6,Low,1,Good Loan,0,7.9,A,1,12.73,4461.21,4000,0,125.17,409000005744,9-Jul-18,TRF TO  Indiaforensic SERVICES I,"2,800,000.00",,-544261238.51,Smith,749,Spain,167179.48,0,1,0
5746,2011,3,RENT,1,Low,1,12000, 36 months,1,debt_consolidation,6,Low,1,Bad Loan,1,12.69,B,2,24.53,13800.73,11164.85,170.16,402.54,409000005745,9-Jul-18,TRF TO  Indiaforensic SERVICES I,"3,000,000.00",,-547261238.51,Ogle,629,Spain,15404.64,0,1,0
5747,2011,1,MORTGAGE,3,Medium,2,12000, 36 months,1,debt_consolidation,6,Low,1,Good Loan,0,12.69,B,2,18.99,13877.78,12000,0,402.54,409000005746,9-Jul-18,TRF TO  Indiaforensic SERVICES I,"1,000,000.00",,-548261238.51,Moss,836,Spain,156036.19,0,1,0
5748,2011,0.5,RENT,1,Low,1,4000, 36 months,1,debt_consolidation,6,Low,1,Good Loan,0,7.9,A,1,15.81,4077.3,4000,0,125.17,409000005747,9-Jul-18,Indiaforensic RUPAY POS C2 ACQ09,,1447899.53,-546813338.98,Loggia,542,Spain,144725.14,0,1,0
5749,2011,7,RENT,1,Low,1,16875, 36 months,1,credit_card,1,Low,1,Good Loan,0,7.51,A,1,15.82,18891.49952,16875,0,525,409000005748,10-Jul-18,TRF TO  Indiaforensic SERVICES I,"1,000,000.00",,-547813338.98,Nwankwo,645,France,22558.74,0,1,0
5750,2011,6,RENT,1,Low,1,6000, 36 months,1,credit_card,1,Low,1,Bad Loan,1,11.71,B,2,19.69,6549.18,5407.42,10.92,198.46,409000005749,10-Jul-18,Indiaforensic MASTER ACQ DOM1007,,2759464.87,-545053874.11,Allan,844,France,147342.03,0,1,0
5751,2011,3,RENT,1,Low,1,11000, 36 months,1,credit_card,1,Low,1,Good Loan,0,11.71,B,2,20.86,13070.63392,11000,0,363.84,409000005750,10-Jul-18,Indiaforensic VISA ACQ DOM100718,,2829789.40,-542224084.71,Woronoff,747,Germany,85470.45,0,1,0
5752,2011,0.5,RENT,1,Low,1,6000, 36 months,1,debt_consolidation,6,Low,1,Good Loan,0,12.69,B,2,7.76,7236.809962,6000,0,201.27,409000005751,10-Jul-18,Indiaforensic RUPAY POS ACQ10071,,1743167.66,-540480917.05,Wolfe,645,France,194656.11,0,1,0
5753,2011,10,MORTGAGE,3,Low,1,9000, 36 months,1,home_improvement,7,High,2,Good Loan,0,15.27,C,3,3.41,11267.55475,9000,0,313.18,409000005752,10-Jul-18,Indiaforensic RUPAY POS C2 ACQ10,,578193.50,-539902723.55,Henderson,752,Spain,48505.10,0,1,0
5754,2011,0.5,RENT,1,Low,1,8500, 36 months,1,car,2,High,2,Good Loan,0,13.49,C,3,13.7,10170.37,8500,0,288.41,409000005753,10-Jul-18,Indiaforensic MASTER INT 060718,,17799.32,-539884924.23,Sutherland,760,Spain,101491.23,0,1,0
5755,2011,10,MORTGAGE,3,Low,1,10000, 36 months,1,debt_consolidation,6,Low,1,Good Loan,0,11.71,B,2,15.41,11901.4895,10000,0,330.76,409000005754,10-Jul-18,Indiaforensic VISA ACQ INT 05071,,3334.71,-539881589.52,Marsden,714,Germany,164117.69,0,1,0
5756,2011,2,RENT,1,Low,1,1600, 36 months,1,major_purchase,8,Low,1,Good Loan,0,6.62,A,1,4.75,1646.56,1600,0,49.13,409000005755,10-Jul-18,TRF TO  Indiaforensic SERVICES I,"7,700,000.00",,-547581589.52,Hyde,717,France,124626.57,0,1,0
5757,2011,1,RENT,1,Low,1,16000, 60 months,2,credit_card,1,High,2,Good Loan,0,13.49,C,3,21.7,21280.01806,16000,0,368.08,409000005756,10-Jul-18,TRF TO  Indiaforensic SERVICES I,"500,000.00",,-548081589.52,Kao,645,Germany,34490.06,0,1,0
5758,2011,10,RENT,1,Low,1,16000, 60 months,2,credit_card,1,High,2,Good Loan,0,15.96,C,3,14.6,19409.5,12367.22,0,388.75,409000005757,10-Jul-18,Indiaforensic MASTER INT 0707-09,,3254.07,-548078335.45,T'ang,681,France,90967.37,0,1,0
5759,2011,10,MORTGAGE,3,Low,1,15300, 60 months,2,house,12,Low,1,Good Loan,0,7.9,A,1,25.23,16891.08,15300,0,309.5,409000005758,11-Jul-18,Indiaforensic MASTER ACQ DOM1307,,2256789.01,-545821546.44,Crawford,681,Germany,24208.84,0,1,0
5760,2011,10,MORTGAGE,3,Low,1,15200, 60 months,2,credit_card,1,High,2,Good Loan,0,19.03,E,5,12.88,19639.29,11535.94,0,394.55,409000005759,11-Jul-18,Indiaforensic VISA ACQ DOM130718,,2854284.30,-542967262.14,Dilibe,679,Germany,174873.09,0,1,0
5761,2011,6,MORTGAGE,3,Medium,2,30000, 60 months,2,debt_consolidation,6,High,2,Good Loan,0,20.89,F,6,15.95,40455.58,22612.67,0,809.75,409000005760,11-Jul-18,Indiaforensic RUPAY POS ACQ13071,,1524436.63,-541442825.51,Austin,528,Spain,170262.97,0,1,0
5762,2011,4,MORTGAGE,3,Medium,2,35000, 60 months,2,debt_consolidation,6,High,2,Bad Loan,1,22.74,G,7,23.25,14713.05,5457.99,0,981.45,409000005761,11-Jul-18,Indiaforensic RUPAY POS C2 ACQ13,,604282.70,-540838542.81,Santiago,710,France,112289.06,0,1,0
5763,2011,10,MORTGAGE,3,Medium,2,8000, 36 months,1,other,4,Low,1,Good Loan,0,7.9,A,1,16.77,8844.27,8000,0,250.33,409000005762,11-Jul-18,Indiaforensic VISA ACQ INT 07061,,3380.34,-540835162.47,Chibugo,733,Germany,93783.00,0,1,0
5764,2011,7,RENT,1,Low,1,9000, 36 months,1,credit_card,1,High,2,Good Loan,0,13.49,C,3,6.25,10981.04596,9000,0,305.38,409000005763,11-Jul-18,Indiaforensic VISA ACQ INT 08061,,3861.90,-540831300.57,Toscano,724,France,150026.79,0,1,0
5765,2011,1,RENT,1,Low,1,9575, 36 months,1,debt_consolidation,6,Low,1,Good Loan,0,6.62,A,1,26.77,10585.12969,9575,0,293.99,409000005764,11-Jul-18,Indiaforensic VISA ACQ INT 09061,,3213.88,-540828086.69,Afanasyeva,726,France,102036.82,0,1,0
5766,2011,6,MORTGAGE,3,Medium,2,1500, 36 months,1,other,4,Low,1,Good Loan,0,7.9,A,1,22.45,1614.66,1500,0,46.94,409000005765,11-Jul-18,Indiaforensic MASTER INT 100718,,2274.53,-540825812.16,Sokolov,520,France,898.51,0,1,0
5767,2011,4,RENT,1,Medium,2,8000, 36 months,1,debt_consolidation,6,Low,1,Good Loan,0,12.42,B,2,8.81,8974.82,8000,0,267.33,409000005766,11-Jul-18,TRF TO  Indiaforensic SERVICES I,"600,000.00",,-541425812.16,Wei,556,France,95124.40,0,1,0
5768,2011,8,MORTGAGE,3,Low,1,14825, 36 months,1,debt_consolidation,6,Low,1,Good Loan,0,12.69,B,2,18.53,17714.19,14825,0,497.31,409000005767,11-Jul-18,TRF TO  Indiaforensic SERVICES I,"6,800,000.00",,-548225812.16,Olisanugo,579,France,11514.39,0,1,0
5769,2011,7,MORTGAGE,3,Low,1,12000, 60 months,2,debt_consolidation,6,High,2,Good Loan,0,19.03,E,5,15.29,16950.42489,12000,0,311.49,409000005768,12-Jul-18,Indiaforensic VISA ACQ DOM120718,,2832314.17,-545393497.99,Gorman,674,France,27468.72,0,1,0
5770,2011,2,RENT,1,Low,1,2400, 36 months,1,debt_consolidation,6,Low,1,Good Loan,0,8.9,A,1,16.82,2742.82888,2400,0,76.21,409000005769,12-Jul-18,Indiaforensic RUPAY POS ACQ12071,,1678111.90,-543715386.09,Priestley,570,France,37092.43,0,1,0
5771,2011,3,RENT,1,Low,1,15000, 60 months,2,debt_consolidation,6,High,2,Good Loan,0,20.89,F,6,11.19,22854.51518,15000,0,404.88,409000005770,12-Jul-18,Indiaforensic MASTER ACQ DOM1207,,1663265.14,-542052120.95,Lloyd,631,France,171587.90,0,1,0
5772,2011,2,RENT,1,Low,1,5000, 36 months,1,credit_card,1,Low,1,Good Loan,0,10.65,B,2,22.75,5501.51,4999.99,0,162.87,409000005771,12-Jul-18,Indiaforensic RUPAY POS C2 ACQ12,,547915.25,-541504205.70,Salmond,623,Spain,80828.78,0,1,0
5773,2011,4,MORTGAGE,3,Medium,2,21800, 60 months,2,house,12,High,2,Bad Loan,1,21.28,F,6,1.46,18749.95,13965.64,448.7,593.21,409000005772,12-Jul-18,TRF TO  Indiaforensic SERVICES I,"4,500,000.00",,-546004205.70,MacDonald,665,France,169287.99,0,1,0
5774,2011,8,MORTGAGE,3,Medium,2,35000, 60 months,2,home_improvement,7,Low,1,Good Loan,0,11.71,B,2,2.83,43078.87997,35000,0,773.44,409000005773,12-Jul-18,TRF TO  Indiaforensic SERVICES I,"2,000,000.00",,-548004205.70,Robertson,523,Spain,13197.44,0,1,0
5775,2011,10,MORTGAGE,3,Low,1,7600, 36 months,1,car,2,Low,1,Good Loan,0,6.03,A,1,11.22,7638.99,7600,0,231.32,409000005774,13-Jul-18,Indiaforensic VISA ACQ DOM130718,,2352101.11,-545652104.59,Chukwumaobim,706,Germany,54439.53,0,1,0
5776,2011,10,MORTGAGE,3,Low,1,25000, 60 months,2,other,4,High,2,Good Loan,0,17.58,D,4,22.43,31378.82,19148.19,0,629.14,409000005775,13-Jul-18,Indiaforensic RUPAY POS ACQ13071,,1705457.46,-543946647.13,Ifeanacho,619,France,38186.85,0,1,0
5777,2011,10,OWN,2,Low,1,17500, 60 months,2,home_improvement,7,Low,1,Good Loan,0,11.71,B,2,19.56,19319.2,13821.91,0,386.72,409000005776,13-Jul-18,Indiaforensic MASTER ACQ DOM1307,,662902.95,-543283744.18,Li Fonti,593,Germany,27274.60,0,1,0
5778,2011,2,MORTGAGE,3,Medium,2,8800, 36 months,1,credit_card,1,High,2,Good Loan,0,14.27,C,3,7.57,10191.45,8800.01,0,301.92,409000005777,13-Jul-18,Indiaforensic MASTER INT 120718,,1968.66,-543281775.52,Ko,608,Spain,65758.19,0,1,0
5779,2011,0.5,OWN,2,Medium,2,9250, 60 months,2,debt_consolidation,6,High,2,Good Loan,0,16.77,D,4,6.5,11433.67,9250,0,228.75,409000005778,13-Jul-18,TRF TO  Indiaforensic SERVICES I,"4,900,000.00",,-548181775.52,Goloubev,526,France,97767.63,0,1,0
5780,2011,0.5,RENT,1,Low,1,3600, 36 months,1,home_improvement,7,Low,1,Good Loan,0,8.9,A,1,6.46,4113.311735,3600,0,114.32,409000005779,13-Jul-18,Indiaforensic MASTER ACQ DOM INT,,48872.97,-548132902.55,Kruglov,684,Spain,115468.84,0,1,0
5781,2011,0.5,OWN,2,Low,1,6700, 36 months,1,credit_card,1,High,2,Good Loan,0,16.77,D,4,12.85,8237.89,6700,0,238.11,409000005780,16-Jul-18,Indiaforensic RUPAY POS C2 ACQ13,,514962.27,-547617940.28,Liao,604,Germany,98293.14,0,1,0
5782,2011,8,MORTGAGE,3,Low,1,6000, 36 months,1,small_business,3,Low,1,Good Loan,0,6.62,A,1,19.49,6540.75,6000,0,184.23,409000005781,16-Jul-18,Indiaforensic RUPAY POS ACQ15071,,2378651.13,-545239289.15,White,636,Germany,182059.28,0,1,0
5783,2011,4,MORTGAGE,3,Low,1,16000, 60 months,2,debt_consolidation,6,High,2,Good Loan,0,17.27,D,4,13.79,22732.06786,16000,0,399.97,409000005782,16-Jul-18,Indiaforensic VISA ACQ DOM140718,,2900874.80,-542338414.35,Sinclair,669,Spain,128538.05,0,1,0
5784,2011,10,RENT,1,Low,1,12000, 60 months,2,debt_consolidation,6,High,2,Good Loan,0,14.65,C,3,15.57,16207.15013,12000,0,283.28,409000005783,16-Jul-18,Indiaforensic RUPAY POS ACQ14071,,1701792.83,-540636621.52,Fiorentini,624,France,108841.83,0,1,0
5785,2011,6.05,MORTGAGE,3,Low,1,23200, 36 months,1,debt_consolidation,6,High,2,Good Loan,0,15.96,C,3,9.43,28658.14,23200,0,815.19,409000005784,16-Jul-18,TRF TO  Indiaforensic SERVICES I,"5,000,000.00",,-545636621.52,Shen,631,France,18581.84,0,1,0
5786,2011,0.5,RENT,1,Low,1,2200, 36 months,1,car,2,Low,1,Good Loan,0,7.9,A,1,21.9,2438.09,2200,0,68.84,409000005785,16-Jul-18,TRF TO  Indiaforensic SERVICES I,"1,000,000.00",,-546636621.52,Rapuokwu,753,France,146821.42,0,1,0
5787,2011,7,MORTGAGE,3,Low,1,6400, 36 months,1,debt_consolidation,6,Low,1,Good Loan,0,10.65,B,2,22.52,6457.32,6400,0,208.47,409000005786,16-Jul-18,TRF TO  Indiaforensic SERVICES I,"1,000,000.00",,-547636621.52,Woronoff,588,France,100727.68,0,1,0
5788,2011,10,MORTGAGE,3,Low,1,13800, 60 months,2,major_purchase,8,Low,1,Good Loan,0,10.65,B,2,6.74,17379.63652,13800,0,297.65,409000005787,16-Jul-18,Indiaforensic VISA ACQ DOM160718,,5924470.66,-541712150.86,Holden,729,Germany,39356.38,0,1,0
5789,2011,0.5,RENT,1,Low,1,16000, 60 months,2,home_improvement,7,High,2,Good Loan,0,14.65,C,3,3.33,16196.42,16000,0,377.71,409000005788,16-Jul-18,Indiaforensic RUPAY POS ACQ16071,,2051467.74,-539660683.12,Roberts,602,France,169921.11,0,1,0
5790,2011,3,RENT,1,Low,1,14475, 36 months,1,credit_card,1,High,2,Good Loan,0,15.27,C,3,23.69,18084.56468,14475,0,503.7,409000005789,16-Jul-18,Indiaforensic MASTER ACQ DOM1607,,7500124.07,-532160559.05,Tsou,689,Germany,42364.75,0,1,0
5791,2011,0.5,RENT,1,Low,1,2000, 36 months,1,moving,10,High,2,Good Loan,0,17.27,D,4,14.14,2211.99,2000,0,71.58,409000005790,16-Jul-18,Indiaforensic RUPAY POS C2 ACQ16,,512349.97,-531648209.08,Somerville,486,Spain,28823.04,0,1,0
5792,2011,2,RENT,1,Low,1,19200, 60 months,2,debt_consolidation,6,High,2,Bad Loan,1,18.25,D,4,21.92,15402.21,808.56,12783.53,490.17,409000005791,16-Jul-18,Indiaforensic VISA ACQ INT 12071,,8656.99,-531639552.09,Greco,809,Germany,182436.81,0,1,0
5793,2011,4,MORTGAGE,3,Low,1,17000, 36 months,1,debt_consolidation,6,Low,1,Good Loan,0,7.51,A,1,26.45,19035.79035,17000,0,528.89,409000005792,16-Jul-18,TRF TO  Indiaforensic SERVICES I,"15,000,000.00",,-546639552.09,Leonard,562,France,115700.20,0,1,0
5794,2011,7,RENT,1,Medium,2,18000, 36 months,1,other,4,Low,1,Bad Loan,1,7.51,A,1,12.22,12319.15,10495.01,24.01,560,409000005793,16-Jul-18,TRF TO  Indiaforensic SERVICES I,"1,000,000.00",,-547639552.09,McKenzie,763,Spain,16725.53,0,1,0
5795,2011,2,MORTGAGE,3,High,3,20000, 60 months,2,small_business,3,High,2,Bad Loan,1,16.77,D,4,9.22,14774.67,5758.47,3427.33,494.59,409000005794,17-Jul-18,Indiaforensic MASTER ACQ DOM1707,,1890735.44,-545748816.65,McElhone,669,France,56875.76,0,1,0
5796,2011,8,MORTGAGE,3,Low,1,9000, 60 months,2,debt_consolidation,6,High,2,Good Loan,0,18.25,D,4,15.36,9272.91,9000,0,229.77,409000005795,17-Jul-18,Indiaforensic POS ACQ SETTL17071,,3416328.36,-542332488.29,Dipietro,709,France,56214.09,0,1,0
5797,2011,5,MORTGAGE,3,High,3,21000, 36 months,1,credit_card,1,Low,1,Good Loan,0,8.9,A,1,14.79,24001.81042,21000,0,666.82,409000005796,17-Jul-18,Indiaforensic RUPAY POS ACQ17071,,1738033.41,-540594454.88,Kerr,554,Spain,193412.05,0,1,0
5798,2011,1,RENT,1,Low,1,3000, 36 months,1,moving,10,Low,1,Good Loan,0,8.9,A,1,5.36,3428.160962,3000,0,95.26,409000005797,17-Jul-18,Indiaforensic MASTER INT 160718,,1523.95,-540592930.93,Hunter,699,France,83263.04,0,1,0
5799,2011,10,MORTGAGE,3,High,3,20000, 60 months,2,other,4,High,2,Good Loan,0,18.25,D,4,1.99,25482.79,15273.67,0,510.6,409000005798,17-Jul-18,TRF TO  Indiaforensic SERVICES I,"7,600,000.00",,-548192930.93,Niehaus,732,Spain,13404.40,0,1,0
5800,2011,3,RENT,1,Low,1,20000, 60 months,2,debt_consolidation,6,Low,1,Good Loan,0,12.69,B,2,12.69,25777.1541,20000,0,451.9,409000005799,17-Jul-18,Indiaforensic RUPAY POS C2 ACQ17,,623971.71,-547568959.22,Craig,625,France,184474.15,0,1,0
5801,2011,4,OWN,2,Low,1,7000, 36 months,1,debt_consolidation,6,Low,1,Good Loan,0,6.62,A,1,14.61,7733.815693,7000,0,214.93,409000005800,17-Jul-18,Indiaforensic VISA ACQ INT 13071,,29600.00,-547539359.22,Barclay-Harvey,599,France,121124.53,0,1,0
5802,2011,10,MORTGAGE,3,Medium,2,30000, 60 months,2,debt_consolidation,6,High,2,Bad Loan,1,22.74,G,7,13.96,13454.24,5040.34,0,841.24,409000005801,18-Jul-18,Indiaforensic VISA ACQ DOM180718,,3064964.05,-544474395.17,Teng,584,Spain,152567.75,0,1,0
5803,2011,10,RENT,1,Low,1,5000, 36 months,1,moving,10,Low,1,Bad Loan,1,12.42,B,2,13.89,3482.11,2539.73,151.51,167.08,409000005802,18-Jul-18,Indiaforensic RUPAY POS ACQ18071,,1783095.72,-542691299.45,Milani,499,France,10722.54,0,1,0
5804,2011,6,MORTGAGE,3,Medium,2,16000, 36 months,1,debt_consolidation,6,Low,1,Good Loan,0,7.51,A,1,12.58,16475.41,16000,0,497.78,409000005803,18-Jul-18,Indiaforensic MASTER ACQ DOM1807,,2414600.91,-540276698.54,Mistry,526,Spain,58010.98,0,1,0
5805,2011,10,MORTGAGE,3,Medium,2,35000, 60 months,2,credit_card,1,High,2,Good Loan,0,21.67,F,6,22.82,50858.13742,35000,0,960.11,409000005804,18-Jul-18,TRF TO  Indiaforensic SERVICES I,"7,900,000.00",,-548176698.54,Jamieson,625,Germany,163440.80,0,1,0
5806,2011,10,MORTGAGE,3,Medium,2,35000, 36 months,1,other,4,Low,1,Good Loan,0,8.9,A,1,5.57,39824.66481,35000,0,1111.37,409000005805,18-Jul-18,Indiaforensic VISA ACQ INT 15071,,2189.08,-548174509.46,Kay,537,Spain,102606.92,0,1,0
5807,2011,0.5,RENT,1,Low,1,18500, 36 months,1,wedding,5,Low,1,Bad Loan,1,7.9,A,1,12.83,3629.22,2237.6,568,578.87,409000005806,18-Jul-18,Indiaforensic RUPAY POS C2 ACQ18,,626867.85,-547547641.61,Ikedinachukwu,696,Spain,80591.18,0,1,0
5808,2011,10,MORTGAGE,3,Low,1,14225, 60 months,2,debt_consolidation,6,Low,1,Good Loan,0,12.42,B,2,21.99,16277.19,11488.7,0,319.46,409000005807,19-Jul-18,TRF TO  Indiaforensic SERVICES I,"700,000.00",,-548247641.61,Holt,679,France,177362.45,0,1,0
5809,2011,3,MORTGAGE,3,Low,1,19000, 60 months,2,debt_consolidation,6,High,2,Good Loan,0,19.91,E,5,7.03,25362.94,19000,0,502.44,409000005808,19-Jul-18,Indiaforensic MASTER ACQ DOM1907,,2619236.29,-545628405.32,Nkemakolam,684,France,120257.70,0,1,0
5810,2011,10,MORTGAGE,3,Low,1,15000, 60 months,2,debt_consolidation,6,High,2,Good Loan,0,17.58,D,4,15.69,18195.55,15000,0,377.49,409000005809,19-Jul-18,Indiaforensic VISA ACQ DOM190718,,3015407.05,-542612998.27,Hartung,850,France,180622.02,0,1,0
5811,2011,5,MORTGAGE,3,Medium,2,10000, 36 months,1,wedding,5,High,2,Bad Loan,1,16.29,D,4,12.84,8711.61,5809.4,605.95,353.01,409000005810,19-Jul-18,Indiaforensic RUPAY POS ACQ19071,,1882275.64,-540730722.63,Ch'en,495,Spain,130404.53,0,1,0
5812,2011,4,MORTGAGE,3,Low,1,12000, 60 months,2,home_improvement,7,Low,1,Good Loan,0,12.69,B,2,25.11,14913.20893,12000,0,271.14,409000005811,19-Jul-18,TRF TO  Indiaforensic SERVICES I,"7,500,000.00",,-548230722.63,Baker,537,Spain,147797.54,0,1,0
5813,2011,1,MORTGAGE,3,Low,1,12000, 36 months,1,credit_card,1,Low,1,Good Loan,0,6.03,A,1,7.14,12844.5,12000,0,365.23,409000005812,19-Jul-18,Indiaforensic RUPAY POS C2 ACQ19,,618283.46,-547612439.17,Osinachi,850,France,57844.26,0,1,0
5814,2011,2,MORTGAGE,3,Low,1,6000, 36 months,1,home_improvement,7,Low,1,Good Loan,0,7.51,A,1,3.91,6160.02,6000,0,186.67,409000005813,20-Jul-18,Indiaforensic VISA ACQ DOM200718,,2515289.50,-545097149.67,Shih,513,France,162523.66,0,1,0
5815,2011,1,RENT,1,Low,1,6250, 60 months,2,small_business,3,Low,1,Bad Loan,1,12.42,B,2,17.4,893.73,306.72,333.57,140.36,409000005814,20-Jul-18,Indiaforensic RUPAY POS ACQ20071,,1696329.33,-543400820.34,Feng,618,Germany,54495.82,0,1,0
5816,2011,4,MORTGAGE,3,Low,1,21850, 36 months,1,debt_consolidation,6,Low,1,Good Loan,0,12.42,B,2,14.93,26280.40256,21850,0,730.13,409000005815,20-Jul-18,Indiaforensic MASTER ACQ DOM2007,,2137265.63,-541263554.71,Sternberg,802,Germany,169183.66,0,1,0
5817,2011,10,RENT,1,Low,1,11400, 36 months,1,other,4,Low,1,Good Loan,0,7.51,A,1,1.72,12764.61217,11400,0,354.67,409000005816,20-Jul-18,Indiaforensic MASTER INT 190718,,2764.47,-541260790.24,Adams,547,France,80262.91,0,1,0
5818,2011,6.05,OWN,2,Low,1,7000, 36 months,1,other,4,Low,1,Bad Loan,1,7.51,A,1,22.05,5834.03,4760.04,300.79,217.78,409000005817,20-Jul-18,TRF TO  Indiaforensic SERVICES I,"5,000,000.00",,-546260790.24,Gray,613,Germany,8751.59,0,1,0
5819,2011,6,MORTGAGE,3,High,3,35000, 36 months,1,debt_consolidation,6,Low,1,Bad Loan,1,10.65,B,2,8.96,35865.92,29516.29,20.79,1140.07,409000005818,20-Jul-18,TRF TO  Indiaforensic SERVICES I,"1,000,000.00",,-547260790.24,Shepherd,592,Germany,102628.98,0,1,0
5820,2011,10,MORTGAGE,3,Low,1,7000, 36 months,1,car,2,Low,1,Good Loan,0,6.03,A,1,11.69,7669.571937,7000,0,213.05,409000005819,20-Jul-18,TRF TO  Indiaforensic SERVICES I,"1,000,000.00",,-548260790.24,Walton,546,France,94823.95,0,1,0
5821,2011,2,RENT,1,Low,1,1600, 60 months,2,other,4,High,2,Good Loan,0,20.3,E,5,0,2239.14,1600,0,42.66,409000005820,20-Jul-18,Indiaforensic RUPAY POS C2 ACQ20,,548939.88,-547711850.36,Yang,721,Germany,90821.66,0,1,0
5822,2011,0.5,RENT,1,Low,1,5000, 36 months,1,credit_card,1,Low,1,Good Loan,0,11.71,B,2,23.9,5952.594722,5000,0,165.38,409000005821,21-Jul-18,Indiaforensic VISA ACQ DOM210718,,2761926.02,-544949924.34,Barnett,671,Germany,153194.32,0,1,0
5823,2011,4,RENT,1,Low,1,9800, 36 months,1,debt_consolidation,6,High,2,Good Loan,0,13.49,C,3,23.34,11971.78385,9800,0,332.52,409000005822,21-Jul-18,Indiaforensic RUPAY POS ACQ21071,,1729353.15,-543220571.19,Romani,624,Spain,87310.59,0,1,0
5824,2011,5,MORTGAGE,3,Low,1,8000, 36 months,1,debt_consolidation,6,High,2,Bad Loan,1,16.77,D,4,3.01,4281.69,2643.08,307.65,284.31,409000005823,21-Jul-18,TRF TO  Indiaforensic SERVICES I,"5,000,000.00",,-548220571.19,Greene,751,Germany,146411.41,0,1,0
5825,2011,6,RENT,1,Low,1,6000, 36 months,1,credit_card,1,Low,1,Good Loan,0,12.69,B,2,17.29,7244.457499,6000,0,201.27,409000005824,21-Jul-18,Indiaforensic RUPAY POS C2 ACQ21,,592541.41,-547628029.78,Hart,636,Spain,74048.10,0,1,0
5826,2011,9,MORTGAGE,3,Low,1,15000, 60 months,2,debt_consolidation,6,High,2,Bad Loan,1,14.27,C,3,8.09,16108.05,10410.96,0,351.13,409000005825,23-Jul-18,Indiaforensic VISA ACQ DOM220718,"10,217.79",,-547638247.57,Johnston,607,Spain,23386.77,0,1,0
5827,2011,6,MORTGAGE,3,Low,1,10000, 36 months,1,small_business,3,High,2,Good Loan,0,13.49,C,3,10.82,12213.50623,10000,0,339.31,409000005826,23-Jul-18,Indiaforensic RUPAY POS ACQ22071,,1612004.04,-546026243.53,Miller,509,Germany,92898.17,0,1,0
5828,2011,0.5,RENT,1,Low,1,7000, 36 months,1,debt_consolidation,6,Low,1,Good Loan,0,12.42,B,2,3.55,8434.201669,7000,0,233.91,409000005827,23-Jul-18,Indiaforensic VISA ACQ DOM230718,,5472894.38,-540553349.15,Robson,653,Spain,45956.05,0,1,0
5829,2011,7,MORTGAGE,3,Medium,2,16000, 36 months,1,debt_consolidation,6,Low,1,Good Loan,0,6.03,A,1,6.35,16828.28,16000,0,486.97,409000005828,23-Jul-18,Indiaforensic RUPAY POS ACQ23071,,1122498.77,-539430850.38,Wallace,709,Spain,71738.56,0,1,0
5830,2011,10,MORTGAGE,3,Medium,2,11000, 36 months,1,home_improvement,7,Low,1,Good Loan,0,6.03,A,1,8.7,12052.14439,11000,0,334.8,409000005829,23-Jul-18,Indiaforensic RUPAY POS C2 ACQ23,,1003030.61,-538427819.77,Cross,559,France,103560.98,0,1,0
5831,2011,1,RENT,1,Low,1,4200, 60 months,2,debt_consolidation,6,High,2,Good Loan,0,14.27,C,3,19.62,5260.69,4200,0,98.32,409000005830,23-Jul-18,Indiaforensic MASTER INT 200718,,10735.62,-538417084.15,Marcum,684,Germany,52367.29,0,1,0
5832,2011,1,MORTGAGE,3,Low,1,9500, 36 months,1,car,2,Low,1,Good Loan,0,7.51,A,1,2.78,10035.06,9500,0,295.56,409000005831,23-Jul-18,TRF TO  Indiaforensic SERVICES I,"1,000,000.00",,-539417084.15,North,635,France,152916.05,0,1,0
5833,2011,7,MORTGAGE,3,Low,1,8000, 36 months,1,credit_card,1,Low,1,Good Loan,0,6.62,A,1,17.02,8625.83,8000,0,245.63,409000005832,23-Jul-18,TRF TO  Indiaforensic SERVICES I,"8,800,000.00",,-548217084.15,Mao,709,France,4410.77,0,1,0
5834,2011,9,MORTGAGE,3,Low,1,12000, 36 months,1,credit_card,1,Low,1,Good Loan,0,6.62,A,1,13.21,13089.58789,12000,0,368.45,409000005833,23-Jul-18,Indiaforensic VISA ACQ INT 19071,,2816.93,-548214267.22,Calabrese,656,Germany,74771.22,0,1,0
5835,2011,2,RENT,1,Low,1,15000, 36 months,1,small_business,3,Low,1,Good Loan,0,7.9,A,1,11,16698.18,15000,0,469.36,409000005834,23-Jul-18,Indiaforensic MASTER ACQ DOM2307,,5510061.34,-542704205.88,Martin,793,France,193817.63,0,1,0
5836,2011,0.5,RENT,1,Low,1,5000, 36 months,1,debt_consolidation,6,Low,1,Good Loan,0,8.9,A,1,17.59,5533.75,5000,0,158.77,409000005835,24-Jul-18,TRF TO  Indiaforensic SERVICES I,"5,000,000.00",,-547704205.88,Fleming,609,Spain,26793.82,0,1,0
5837,2011,4,RENT,1,Low,1,10225, 36 months,1,credit_card,1,High,2,Good Loan,0,14.65,C,3,20.54,12085.48,10225,0,352.71,409000005836,24-Jul-18,Indiaforensic VISA ACQ DOM240718,,2883729.75,-544820476.13,Roberts,618,Germany,32526.64,0,1,0
5838,2011,10,RENT,1,Low,1,15000, 60 months,2,debt_consolidation,6,High,2,Good Loan,0,19.91,E,5,18.35,19823.48,11368.33,0,396.66,409000005837,24-Jul-18,Indiaforensic RUPAY POS ACQ24071,,1539784.98,-543280691.15,Finch,850,France,824.00,0,1,0
5839,2011,10,MORTGAGE,3,Low,1,15000, 36 months,1,debt_consolidation,6,High,2,Good Loan,0,13.49,C,3,11.5,18318.98278,15000,0,508.96,409000005838,24-Jul-18,Indiaforensic MASTER ACQ DOM2407,,2551257.29,-540729433.86,Whitelegge,669,Spain,85250.77,0,1,0
5840,2011,2,MORTGAGE,3,High,3,17625, 60 months,2,other,4,High,2,Bad Loan,1,23.91,G,7,16.08,20896.16,8674.89,1679.28,506.12,409000005839,24-Jul-18,Indiaforensic VISA ACQ INT 20071,,101096.90,-540628336.96,Rooke,594,Germany,83508.93,0,1,0
5841,2011,6,RENT,1,Low,1,27500, 60 months,2,debt_consolidation,6,Low,1,Good Loan,0,12.69,B,2,17.23,28640.61,27500,0,621.36,409000005840,24-Jul-18,TRF TO  Indiaforensic SERVICES I,"5,000,000.00",,-545628336.96,Lu,616,Spain,173599.38,0,1,0
5842,2011,6.05,MORTGAGE,3,Low,1,20000, 60 months,2,debt_consolidation,6,High,2,Good Loan,0,22.06,F,6,16.76,32013.07878,20000,0,553.07,409000005841,24-Jul-18,TRF TO  Indiaforensic SERVICES I,"2,000,000.00",,-547628336.96,Marcelo,676,France,79342.31,0,1,0
5843,2011,3,RENT,1,Low,1,5000, 36 months,1,major_purchase,8,Low,1,Good Loan,0,7.51,A,1,0.97,5202.43,5000,0,155.56,409000005842,24-Jul-18,TRF TO  Indiaforensic SERVICES I,"500,000.00",,-548128336.96,Matthews,608,Spain,57600.66,0,1,0
5844,2011,10,MORTGAGE,3,Low,1,8500, 36 months,1,debt_consolidation,6,Low,1,Good Loan,0,6.03,A,1,9.81,9313.03856,8500,0,258.71,409000005843,24-Jul-18,Indiaforensic RUPAY POS C2 ACQ24,,426866.28,-547701470.68,Romani,710,France,56191.99,0,1,0
5845,2011,10,MORTGAGE,3,Low,1,8875, 36 months,1,debt_consolidation,6,Low,1,Bad Loan,1,7.9,A,1,19.43,3419.44,2491.39,366.72,277.71,409000005844,25-Jul-18,Indiaforensic MASTER ACQ DOM2507,,2581144.68,-545120326.00,Scott,695,France,6770.44,0,1,0
5846,2011,3,RENT,1,Low,1,3500, 36 months,1,debt_consolidation,6,Low,1,Good Loan,0,7.9,A,1,5.4,3648.31,3500,0,109.52,409000005845,25-Jul-18,Indiaforensic VISA ACQ DOM250718,,2762574.82,-542357751.18,Mao,530,Germany,101694.67,0,1,0
5847,2011,5,OWN,2,Low,1,20000, 60 months,2,debt_consolidation,6,High,2,Good Loan,0,20.3,E,5,20.34,26631.26,15118.75,0,533.23,409000005846,25-Jul-18,Indiaforensic RUPAY POS ACQ25071,,1625939.36,-540731811.82,Horsley,509,Spain,69113.14,0,1,0
5848,2011,1,MORTGAGE,3,Low,1,4200, 60 months,2,other,4,Low,1,Good Loan,0,8.9,A,1,14.59,4343.9,3361.18,0,86.99,409000005847,25-Jul-18,Indiaforensic RUPAY POS C2 ACQ25,,448779.81,-540283032.01,Goddard,517,France,172674.36,0,1,0
5849,2011,10,MORTGAGE,3,Low,1,10000, 36 months,1,debt_consolidation,6,Low,1,Good Loan,0,6.62,A,1,6.21,11052.20638,10000,0,307.04,409000005848,25-Jul-18,Indiaforensic VISA ACQ INT 21071,,1526.57,-540281505.44,Eskridge,758,Germany,26606.28,0,1,0
5850,2011,4,RENT,1,Low,1,16000, 36 months,1,major_purchase,8,Low,1,Good Loan,0,6.03,A,1,5.15,16569.89,16000,0,486.97,409000005849,25-Jul-18,Indiaforensic VISA ACQ INT 22071,,1971.86,-540279533.58,Smith,665,France,53353.36,0,1,0
5851,2011,3,MORTGAGE,3,Low,1,3600, 36 months,1,car,2,Low,1,Good Loan,0,6.03,A,1,15.24,3768.34,3600,0,109.57,409000005850,25-Jul-18,TRF TO  Indiaforensic SERVICES I,"5,000,000.00",,-545279533.58,Simpson,631,Germany,63747.51,0,1,0
5852,2011,0.5,OWN,2,Low,1,9000, 36 months,1,car,2,Low,1,Good Loan,0,9.91,B,2,8.88,10404.67931,9000,0,290.03,409000005851,25-Jul-18,TRF TO  Indiaforensic SERVICES I,"2,000,000.00",,-547279533.58,Oguejiofor,576,Spain,190112.05,0,1,0
5853,2011,2,RENT,1,Low,1,15250, 60 months,2,debt_consolidation,6,High,2,Good Loan,0,20.89,F,6,18.8,20551.49,11462.31,0,411.63,409000005852,25-Jul-18,TRF TO  Indiaforensic SERVICES I,"500,000.00",,-547779533.58,Holloway,544,Spain,110317.39,0,1,0
5854,2011,7,MORTGAGE,3,Low,1,13225, 60 months,2,debt_consolidation,6,Low,1,Good Loan,0,7.9,A,1,26.88,15856.94313,13225,0,267.53,409000005853,26-Jul-18,Indiaforensic VISA ACQ DOM260718,,2758537.59,-545020995.99,L?,596,Germany,148623.43,0,1,0
5855,2011,0.5,RENT,1,Low,1,5000, 36 months,1,credit_card,1,Low,1,Bad Loan,1,8.9,A,1,8.78,4075.82,3180.26,269.42,158.77,409000005854,26-Jul-18,Indiaforensic RUPAY POS ACQ26071,,1355705.29,-543665290.70,Feng,481,France,125253.46,0,1,0
5856,2011,10,RENT,1,Low,1,7200, 36 months,1,debt_consolidation,6,Low,1,Good Loan,0,12.69,B,2,13.41,8693.426835,7200,0,241.53,409000005855,26-Jul-18,Indiaforensic MASTER ACQ DOM2607,,1645851.20,-542019439.50,Claiborne,498,France,101954.78,0,1,0
5857,2011,5,OWN,2,Low,1,20000, 60 months,2,credit_card,1,Low,1,Good Loan,0,12.42,B,2,11.29,23159.4,20000,0,449.15,409000005856,26-Jul-18,Indiaforensic RUPAY POS C2 ACQ26,,479266.53,-541540172.97,Egobudike,512,Spain,168462.26,0,1,0
5858,2011,8,MORTGAGE,3,Low,1,14125, 36 months,1,debt_consolidation,6,Low,1,Good Loan,0,10.65,B,2,16.65,16561.56538,14125,0,460.1,409000005857,26-Jul-18,Indiaforensic VISA ACQ INT 24071,,2018.44,-541538154.53,Folliero,594,France,26215.85,0,1,0
5859,2011,10,MORTGAGE,3,Low,1,17000, 36 months,1,debt_consolidation,6,High,2,Good Loan,0,14.27,C,3,8.53,20480.97,17000,0,583.26,409000005858,26-Jul-18,TRF TO  Indiaforensic SERVICES I,"2,000,000.00",,-543538154.53,Bray,570,France,97045.32,0,1,0
5860,2011,10,MORTGAGE,3,Low,1,10000, 36 months,1,credit_card,1,High,2,Good Loan,0,16.29,D,4,7.61,12706.93408,10000,0,353.01,409000005859,26-Jul-18,Indiaforensic MASTER INT 250718,,7104.62,-543531049.91,Ibrahimov,721,Spain,53534.80,0,1,0
5861,2011,10,RENT,1,Low,1,11400, 36 months,1,debt_consolidation,6,High,2,Good Loan,0,17.58,D,4,7.75,14713.00113,11400,0,409.74,409000005860,26-Jul-18,TRF TO  Indiaforensic SERVICES I,"4,600,000.00",,-548131049.91,Carpenter,453,France,8949.20,0,1,0
5862,2011,5,RENT,1,Low,1,7000, 36 months,1,credit_card,1,Low,1,Good Loan,0,6.62,A,1,24.22,7751.242214,7000,0,214.93,409000005861,27-Jul-18,Indiaforensic MASTER ACQ DOM2707,,1858255.03,-546272794.88,Walsh,562,France,163116.75,0,1,0
5863,2011,5,MORTGAGE,3,Medium,2,25000, 60 months,2,debt_consolidation,6,Low,1,Good Loan,0,12.42,B,2,9.44,27212.45,25000,0,561.44,409000005862,27-Jul-18,TRF TO  Indiaforensic SERVICES I,"2,000,000.00",,-548272794.88,Woods,682,France,140745.91,0,1,0
5864,2011,3,RENT,1,Low,1,4000, 60 months,2,car,2,Low,1,Good Loan,0,11.71,B,2,13.17,4147.12,4000,0,88.4,409000005863,27-Jul-18,Indiaforensic RUPAY POS C2 ACQ27,,1203587.56,-547069207.32,Wu,748,France,171515.84,0,1,0
5865,2011,10,RENT,1,Low,1,6000, 36 months,1,vacation,11,Low,1,Good Loan,0,6.03,A,1,0.88,6452.98,6000,0,182.62,409000005864,27-Jul-18,Indiaforensic VISA ACQ DOM270718,,3035309.00,-544033898.32,Forbes,729,France,150803.44,0,1,0
5866,2011,10,MORTGAGE,3,Low,1,4000, 36 months,1,other,4,Low,1,Good Loan,0,6.62,A,1,24.33,4420.788578,4000,0,122.82,409000005865,27-Jul-18,Indiaforensic RUPAY POS ACQ27071,,1034933.71,-542998964.61,Lynch,663,France,76884.05,0,1,0
5867,2011,4,RENT,1,Low,1,5000, 36 months,1,small_business,3,Low,1,Good Loan,0,10.65,B,2,24.52,5604.37,5000,0,162.87,409000005866,27-Jul-18,TRF TO Indiaforensic SERVICES IN,"3,000,000.00",,-545998964.61,Amaechi,735,France,170454.93,0,1,0
5868,2011,0.5,MORTGAGE,3,Low,1,12000, 36 months,1,debt_consolidation,6,Low,1,Good Loan,0,11.71,B,2,17.11,13044.42,12000,0,396.92,409000005867,27-Jul-18,TRF TO Indiaforensic SERVICES IN,"1,000,000.00",,-546998964.61,Enriquez,627,Germany,143104.30,0,1,0
5869,2011,5,RENT,1,Low,1,12000, 36 months,1,debt_consolidation,6,High,2,Good Loan,0,16.29,D,4,1.96,15076.57767,12000,0,423.61,409000005868,27-Jul-18,TRF TO Indiaforensic SERVICES IN,"1,000,000.00",,-547998964.61,Y?an,713,France,55701.62,0,1,0
5870,2011,9,MORTGAGE,3,Low,1,12000, 36 months,1,other,4,Low,1,Good Loan,0,8.9,A,1,15.56,13716.15907,12000,0,381.04,409000005869,27-Jul-18,Indiaforensic MASTER INT 260718,,1017.24,-547997947.37,Brooks,562,Germany,186370.30,0,1,0
5871,2011,0.5,MORTGAGE,3,Low,1,12000, 60 months,2,debt_consolidation,6,High,2,Good Loan,0,15.27,C,3,16.44,16938.03444,12000,0,287.19,409000005870,30-Jul-18,Indiaforensic RUPAY POS ACQ28071,,853117.15,-547144830.22,Wang,632,France,24275.32,0,1,0
5872,2011,10,MORTGAGE,3,Low,1,15250, 60 months,2,debt_consolidation,6,Low,1,Good Loan,0,12.69,B,2,27.03,17213.94,11987.62,0,344.57,409000005871,30-Jul-18,Indiaforensic VISA ACQ INT 25071,,1010.97,-547143819.25,Burke,479,France,50774.81,0,1,0
5873,2011,8,RENT,1,Low,1,6000, 36 months,1,credit_card,1,Low,1,Good Loan,0,7.9,A,1,17.31,6596.99,6000,0,187.75,409000005872,30-Jul-18,Indiaforensic VISA ACQ DOM290718,,2972450.64,-544171368.61,Meng,658,Spain,154279.87,0,1,0
5874,2011,8,MORTGAGE,3,Low,1,16200, 36 months,1,debt_consolidation,6,High,2,Good Loan,0,14.65,C,3,9.33,18802.91,16200,0,558.81,409000005873,30-Jul-18,Indiaforensic RUPAY POS ACQ29071,,2133218.50,-542038150.11,Chiganu,598,France,68462.59,0,1,0
5875,2011,3,MORTGAGE,3,Low,1,10000, 36 months,1,medical,9,High,2,Good Loan,0,14.27,C,3,2.49,10774.76,10000,0,343.09,409000005874,30-Jul-18,Indiaforensic VISA ACQ DOM300718,,5436022.74,-536602127.37,Hunt,597,France,91036.74,0,1,0
5876,2011,10,RENT,1,Medium,2,6400, 36 months,1,debt_consolidation,6,Low,1,Good Loan,0,6.62,A,1,2.12,6871.13,6400,0,196.51,409000005875,30-Jul-18,Indiaforensic MASTER ACQ DOM3007,,4579311.04,-532022816.33,Lucchese,512,France,83681.97,0,1,0
5877,2011,8,RENT,1,Low,1,11000, 36 months,1,debt_consolidation,6,Low,1,Good Loan,0,9.91,B,2,13.2,12604.26,11000,0,354.48,409000005876,30-Jul-18,TRF TO  Indiaforensic SERVICES I,"5,000,000.00",,-537022816.33,Humphries,704,France,199484.96,0,1,0
5878,2011,10,RENT,1,Low,1,17000, 60 months,2,debt_consolidation,6,Low,1,Bad Loan,1,11.71,B,2,16.3,12368.91,6169.26,2609.81,375.67,409000005877,30-Jul-18,Indiaforensic RUPAY POS ACQ30071,,1946193.38,-535076622.95,Frolova,474,France,152491.22,0,1,0
5879,2011,10,RENT,1,Low,1,5500, 60 months,2,debt_consolidation,6,High,2,Good Loan,0,18.64,E,5,16.6,7616.583895,5500,0,141.59,409000005878,30-Jul-18,Indiaforensic RUPAY POS C2 ACQ30,,1293745.33,-533782877.62,Hsing,604,Germany,134875.37,0,1,0
5880,2011,2,MORTGAGE,3,Low,1,12800, 60 months,2,home_improvement,7,Low,1,Good Loan,0,12.69,B,2,11.97,14448.4,10061.98,0,289.22,409000005879,30-Jul-18,TRF TO  Indiaforensic SERVICES I,"11,200,000.00",,-544982877.62,Parkes,683,France,184366.14,0,1,0
5881,2011,5,MORTGAGE,3,Low,1,4800, 36 months,1,other,4,Low,1,Good Loan,0,7.51,A,1,20.75,5304.73,4800,0,149.34,409000005880,30-Jul-18,Indiaforensic VISA ACQ INT 26071,,509.09,-544982368.53,Gregory,537,France,189839.93,0,1,0
5882,2011,8,MORTGAGE,3,Medium,2,22000, 36 months,1,credit_card,1,Low,1,Good Loan,0,7.9,A,1,14.68,22558.19,22000,0,688.39,409000005881,30-Jul-18,TRF TO  Indiaforensic SERVICES I,"3,000,000.00",,-547982368.53,Obiuto,794,Spain,175643.44,0,1,0
5883,2011,10,MORTGAGE,3,Low,1,25000, 60 months,2,debt_consolidation,6,High,2,Bad Loan,1,21.67,F,6,12.75,32215.4,17103.65,0,685.8,409000005882,31-Jul-18,Indiaforensic MASTER ACQ DOM3107,,4254434.37,-543727934.16,Longo,732,France,3268.17,0,1,0
5884,2011,3,MORTGAGE,3,Low,1,2000, 36 months,1,home_improvement,7,Low,1,Good Loan,0,7.9,A,1,9.78,2013.37,2000,0,62.59,409000005883,31-Jul-18,Indiaforensic VISA ACQ DOM310718,,3440720.04,-540287214.12,Lombardo,495,France,47089.72,0,1,0
5885,2011,2,RENT,1,Low,1,2500, 36 months,1,other,4,High,2,Bad Loan,1,16.77,D,4,3.8,2430.53,1668.76,130.83,88.85,409000005884,31-Jul-18,Indiaforensic RUPAY POS ACQ31071,,1927006.77,-538360207.35,Lombardo,552,Germany,46562.02,0,1,0
5886,2011,10,MORTGAGE,3,Low,1,3000, 36 months,1,medical,9,High,2,Bad Loan,1,14.27,C,3,20.01,2357.5,1759.72,0,102.93,409000005885,31-Jul-18,TRF TO  Indiaforensic SERVICES I,"9,900,000.00",,-548260207.35,Gonzalez,602,France,62487.97,0,1,0
5887,2011,1,RENT,1,Low,1,5200, 60 months,2,credit_card,1,High,2,Bad Loan,1,17.27,D,4,19.4,1816.37,712.03,266.93,129.99,409000005886,31-Jul-18,Indiaforensic MASTER INT 300718,,2180.69,-548258026.66,Nwabugwu,607,Germany,181598.25,0,1,0
5888,2011,10,MORTGAGE,3,Low,1,22250, 60 months,2,house,12,High,2,Good Loan,0,18.25,D,4,18.19,30405.37303,22250,0,568.04,409000005887,31-Jul-18,Indiaforensic RUPAY POS C2 ACQ31,,556278.03,-547701748.63,Ford,675,Germany,64815.05,0,1,0
5889,2011,4,RENT,1,Low,1,12000, 60 months,2,debt_consolidation,6,High,2,Good Loan,0,19.91,E,5,23.31,16886.75705,12000,0,317.33,409000005888,31-Jul-18,Indiaforensic VISA ACQ INT 27071,,9517.48,-547692231.15,Gilleland,443,France,70196.23,0,1,0
5890,2011,1,RENT,1,Low,1,8000, 36 months,1,debt_consolidation,6,Low,1,Good Loan,0,6.03,A,1,5.2,8765.20704,8000,0,243.49,409000005889,1-Aug-18,Indiaforensic MASTER ACQ DOM0108,,334337.56,-547357893.59,Fullwood,727,France,160383.47,0,1,0
5891,2011,7,RENT,1,Low,1,6500, 60 months,2,car,2,Low,1,Good Loan,0,11.71,B,2,1.75,8291.548078,6500,0,143.64,409000005890,1-Aug-18,Indiaforensic VISA ACQ DOM010818,,3960856.97,-543397036.62,Kao,482,France,35848.12,0,1,0
5892,2011,10,MORTGAGE,3,Low,1,8000, 36 months,1,major_purchase,8,Low,1,Good Loan,0,7.9,A,1,5.29,8820.67,8000,0,250.33,409000005891,1-Aug-18,Indiaforensic RUPAY POS ACQ01081,,1134826.43,-542262210.19,Montalvo,686,France,87278.48,0,1,0
5893,2011,2,RENT,1,Low,1,17600, 60 months,2,debt_consolidation,6,High,2,Good Loan,0,16.77,D,4,23.27,21746.88,13556.94,0,435.24,409000005892,1-Aug-18,Indiaforensic RUPAY POS C2 ACQ01,,1632967.41,-540629242.78,Wilson,588,Germany,94498.82,0,1,0
5894,2011,5,OWN,2,Low,1,21000, 36 months,1,debt_consolidation,6,High,2,Good Loan,0,14.65,C,3,10.21,25612.24,21000,0,724.38,409000005893,1-Aug-18,Indiaforensic MASTER INT 310718,,1009.56,-540628233.22,Doyne,605,Spain,133486.36,0,1,0
5895,2011,4,MORTGAGE,3,Medium,2,24000, 36 months,1,debt_consolidation,6,High,2,Good Loan,0,13.49,C,3,21.48,27191.69,24000,0,814.34,409000005894,1-Aug-18,TRF TO  Indiaforensic SERVICES I,"1,600,000.00",,-542228233.22,Onwuamaeze,583,France,73107.60,0,1,0
5896,2011,10,MORTGAGE,3,Low,1,12000, 60 months,2,credit_card,1,Low,1,Good Loan,0,12.42,B,2,14.41,13470.58,9450.13,0,269.49,409000005895,1-Aug-18,TRF TO  Indiaforensic SERVICES I,"4,000,000.00",,-546228233.22,K'ung,738,Germany,195333.98,0,1,0
5897,2011,6.05,MORTGAGE,3,Low,1,8000, 36 months,1,other,4,Low,1,Good Loan,0,6.62,A,1,15.73,8841.451611,8000,0,245.63,409000005896,1-Aug-18,TRF TO  Indiaforensic SERVICES I,"2,000,000.00",,-548228233.22,O'Donnell,744,Spain,121525.48,0,1,0
5898,2011,10,MORTGAGE,3,Low,1,2400, 36 months,1,major_purchase,8,Low,1,Good Loan,0,9.91,B,2,10.95,2632.21,2400,0,77.34,409000005897,2-Aug-18,Indiaforensic VISA ACQ INT 28071,,2996.18,-548225237.04,McMillan,781,France,173843.21,0,1,0
5899,2011,4,RENT,1,Low,1,12000, 36 months,1,debt_consolidation,6,Low,1,Good Loan,0,6.62,A,1,23.49,13256.93338,12000,0,368.45,409000005898,2-Aug-18,Indiaforensic VISA ACQ DOM020818,,3278925.14,-544946311.90,Chinedum,699,France,185227.42,0,1,0
5900,2011,9,MORTGAGE,3,Low,1,3600, 36 months,1,medical,9,Low,1,Good Loan,0,7.51,A,1,21.82,3847.96,3600,0,112,409000005899,2-Aug-18,Indiaforensic RUPAY POS ACQ02081,,1570705.34,-543375606.56,Capon,639,France,125244.18,0,1,0
5901,2011,10,MORTGAGE,3,Medium,2,5600, 36 months,1,home_improvement,7,Low,1,Good Loan,0,6.62,A,1,14.58,5718.9,5600,0,171.95,409000005900,2-Aug-18,Indiaforensic MASTER ACQ DOM0208,,2364675.24,-541010931.32,Rawling,583,France,163113.41,0,1,0
5902,2011,0.5,RENT,1,Low,1,8000, 60 months,2,other,4,High,2,Good Loan,0,18.25,D,4,18.13,12076.51,8000,0,204.24,409000005901,2-Aug-18,Indiaforensic RUPAY POS C2 ACQ02,,558557.73,-540452373.59,Duncan,587,France,123006.91,0,1,0
5903,2011,10,MORTGAGE,3,Medium,2,35000, 60 months,2,debt_consolidation,6,High,2,Good Loan,0,14.27,C,3,11.23,40944.28,27306.59,0,819.3,409000005902,2-Aug-18,TRF TO  Indiaforensic SERVICES I,"7,200,000.00",,-547652373.59,Trevisani,694,France,40463.03,0,1,0
5904,2011,10,RENT,1,Low,1,16000, 60 months,2,debt_consolidation,6,High,2,Good Loan,0,15.96,C,3,16.62,22433.85824,16000,0,388.75,409000005903,2-Aug-18,Indiaforensic VISA ACQ INT 31071,,3369.39,-547649004.20,Ankudinova,570,France,131363.57,0,1,0
5905,2011,7,MORTGAGE,3,Medium,2,6000, 36 months,1,small_business,3,High,2,Good Loan,0,17.27,D,4,13.01,7029.76,6000,0,214.73,409000005904,2-Aug-18,Indiaforensic MASTER ACQ DOM0108,,2676548.96,-544972455.24,Balsillie,692,Germany,188305.85,0,1,0
5906,2011,10,RENT,1,Low,1,30000, 60 months,2,debt_consolidation,6,High,2,Good Loan,0,14.27,C,3,20.39,41399.85401,30000,0,702.26,409000005905,3-Aug-18,TRF TO  Indiaforensic SERVICES I,"3,000,000.00",,-547972455.24,Kerr,511,France,143994.86,0,1,0
5907,2011,0.5,MORTGAGE,3,Low,1,12000, 36 months,1,debt_consolidation,6,Low,1,Good Loan,0,12.42,B,2,19.99,14322.71659,12000,0,400.99,409000005906,3-Aug-18,Indiaforensic MASTER ACQ DOM0308,,2994466.06,-544977989.18,Worsnop,788,France,89368.59,0,1,0
5908,2011,6,RENT,1,Low,1,6025, 36 months,1,debt_consolidation,6,Low,1,Good Loan,0,10.65,B,2,16.48,7063.844429,6025,0,196.26,409000005907,3-Aug-18,Indiaforensic VISA ACQ DOM030818,,3358436.60,-541619552.58,Yevseyev,526,Spain,158365.89,0,1,0
5909,2011,10,MORTGAGE,3,Low,1,12000, 60 months,2,debt_consolidation,6,High,2,Good Loan,0,14.27,C,3,4.36,15643.90238,12000,0,280.91,409000005908,3-Aug-18,Indiaforensic RUPAY POS ACQ03081,,1919868.91,-539699683.67,Manna,749,Spain,78753.12,0,1,0
5910,2011,5,MORTGAGE,3,Medium,2,30000, 60 months,2,credit_card,1,Low,1,Good Loan,0,11.71,B,2,10.67,38418.37723,30000,0,662.95,409000005909,3-Aug-18,Indiaforensic RUPAY POS C2 ACQ03,,666002.66,-539033681.01,Siciliani,691,France,100408.31,0,1,0
5911,2011,10,RENT,1,Low,1,8000, 36 months,1,debt_consolidation,6,High,2,Good Loan,0,14.65,C,3,0.77,8377.47,8000,0,275.96,409000005910,3-Aug-18,TRF TO  Indiaforensic SERVICES I,"8,500,000.00",,-547533681.01,Powell,481,France,24677.54,0,1,0
5912,2011,4,RENT,1,High,3,12000, 60 months,2,debt_consolidation,6,High,2,Good Loan,0,19.42,E,5,16.5,18387.2016,12000,0,314.07,409000005911,3-Aug-18,Indiaforensic MASTER INT 020818,,38564.42,-547495116.59,Bazarova,752,France,39570.78,0,1,0
5913,2011,6,MORTGAGE,3,Medium,2,21000, 36 months,1,debt_consolidation,6,Low,1,Good Loan,0,12.42,B,2,12.16,25259.24472,21000,0,701.73,409000005912,3-Aug-18,Indiaforensic VISA ACQ INT 01081,,5531.99,-547489584.60,White,658,France,155665.76,0,1,0
5914,2011,5,RENT,1,Low,1,20000, 60 months,2,debt_consolidation,6,High,2,Good Loan,0,18.64,E,5,22.35,25714.72,15251.56,0,514.86,409000005913,4-Aug-18,Indiaforensic RUPAY POS C2 ACQ04,,668470.29,-546821114.31,Buda,679,Spain,168294.27,0,1,0
5915,2011,10,MORTGAGE,3,Low,1,10000, 36 months,1,debt_consolidation,6,Low,1,Good Loan,0,7.51,A,1,15.16,10123.71,10000,0,311.11,409000005914,4-Aug-18,Indiaforensic VISA ACQ DOM040818,,3198963.45,-543622150.86,Cattaneo,754,Germany,87908.01,0,1,0
5916,2011,2,RENT,1,Low,1,6000, 36 months,1,debt_consolidation,6,Low,1,Good Loan,0,7.9,A,1,24.82,6534.01,6000,0,187.75,409000005915,4-Aug-18,Indiaforensic RUPAY POS ACQ04081,,2119957.61,-541502193.25,Lo,679,France,191198.92,0,1,0
5917,2011,10,RENT,1,Low,1,10000, 36 months,1,debt_consolidation,6,Low,1,Good Loan,0,12.69,B,2,9.67,10616.54,10000,0,335.45,409000005916,4-Aug-18,TRF TO  Indiaforensic SERVICES I,"4,000,000.00",,-545502193.25,Brown,633,Spain,191207.03,0,1,0
5918,2011,10,RENT,1,Medium,2,16000, 36 months,1,debt_consolidation,6,Low,1,Good Loan,0,6.03,A,1,12.16,17530.47612,16000,0,486.97,409000005917,4-Aug-18,TRF TO  Indiaforensic SERVICES I,"2,000,000.00",,-547502193.25,Rose,674,France,128954.05,0,1,0
5919,2011,4,MORTGAGE,3,Medium,2,28000, 60 months,2,major_purchase,8,Low,1,Good Loan,0,12.42,B,2,6.66,32867.51,28000,0,628.81,409000005918,4-Aug-18,TRF TO  Indiaforensic SERVICES I,"500,000.00",,-548002193.25,Lombardo,600,Germany,59905.29,0,1,0
5920,2011,9,RENT,1,Low,1,10000, 60 months,2,moving,10,High,2,Bad Loan,1,19.03,E,5,23.12,2852.63,1202.22,0,259.58,409000005919,6-Aug-18,Indiaforensic VISA ACQ DOM050818,,1997.00,-548000196.25,McMillan,645,Spain,162012.60,0,1,0
5921,2011,6,RENT,1,Medium,2,10650, 60 months,2,debt_consolidation,6,High,2,Good Loan,0,19.42,E,5,18.12,16279.0785,10650,0,278.74,409000005920,6-Aug-18,Indiaforensic RUPAY POS ACQ05081,,1735960.81,-546264235.44,Howe,698,France,19231.98,0,1,0
5922,2011,0.5,MORTGAGE,3,Medium,2,7100, 36 months,1,debt_consolidation,6,Low,1,Good Loan,0,8.9,A,1,13.57,8115.1333,7100,0,225.45,409000005921,6-Aug-18,Indiaforensic VISA ACQ DOM060818,,6157567.12,-540106668.32,Hsu,508,Spain,175749.36,0,1,0
5923,2011,10,MORTGAGE,3,Medium,2,21000, 60 months,2,debt_consolidation,6,High,2,Good Loan,0,19.91,E,5,11.28,31939.07995,21000,0,555.33,409000005922,6-Aug-18,Indiaforensic RUPAY POS ACQ06081,,2288150.04,-537818518.28,Han,555,France,60533.96,0,1,0
5924,2011,6,OWN,2,Low,1,18000, 60 months,2,debt_consolidation,6,High,2,Bad Loan,1,17.58,D,4,22.73,5910.6,2680.07,11.69,452.98,409000005923,6-Aug-18,Indiaforensic MSTR ACQ DOM04-060,,7393401.46,-530425116.82,Calabrese,751,France,137508.42,0,1,0
5925,2011,8,MORTGAGE,3,Medium,2,35000, 36 months,1,debt_consolidation,6,Low,1,Good Loan,0,8.9,A,1,7.54,39384.62,35000,0,1111.37,409000005924,6-Aug-18,Indiaforensic RUPAY POS C2 ACQ06,,550324.20,-529874792.62,Riley,738,France,189430.86,0,1,0
5926,2011,5,RENT,1,Low,1,10000, 36 months,1,debt_consolidation,6,Low,1,Good Loan,0,7.51,A,1,10.2,11073.9,10000,0,311.11,409000005925,6-Aug-18,Indiaforensic MASTER INT 030818,,1017.61,-529873775.01,Biryukov,706,Germany,6723.66,0,1,0
5927,2011,8,RENT,1,Low,1,15000, 60 months,2,debt_consolidation,6,High,2,Good Loan,0,13.49,C,3,23,15662.44,15000,0,345.08,409000005926,6-Aug-18,TRF TO  Indiaforensic SERVICES I,"10,000,000.00",,-539873775.01,Broadhurst,595,France,41371.68,0,1,0
5928,2011,3,MORTGAGE,3,Low,1,18000, 60 months,2,small_business,3,High,2,Good Loan,0,13.49,C,3,29.3,24147.92016,18000,0,414.09,409000005927,6-Aug-18,TRF TO  Indiaforensic SERVICES I,"7,800,000.00",,-547673775.01,Genovesi,577,Germany,125140.72,0,1,0
5929,2011,10,MORTGAGE,3,Medium,2,4800, 36 months,1,medical,9,Low,1,Good Loan,0,11.71,B,2,8.73,5216.35,4800,0,158.77,409000005928,7-Aug-18,Indiaforensic VISA ACQ DOM070818,,3991059.33,-543682715.68,Hsieh,578,Germany,143683.75,0,1,0
5930,2011,3,OWN,2,Low,1,3000, 36 months,1,debt_consolidation,6,Low,1,Good Loan,0,7.9,A,1,2.48,3359.680796,3000,0,93.88,409000005929,7-Aug-18,Indiaforensic RUPAY POS ACQ07081,,1840178.24,-541842537.44,Kemp,699,France,170770.44,0,1,0
5931,2011,3,OWN,2,Low,1,24000, 36 months,1,debt_consolidation,6,Low,1,Good Loan,0,9.91,B,2,16.48,26576.89,24000,0,773.4,409000005930,7-Aug-18,Indiaforensic MASTER ACQ DOM0708,,356189.49,-541486347.95,Chukwudi,826,France,157397.57,0,1,0
5932,2011,10,MORTGAGE,3,Low,1,3000, 36 months,1,debt_consolidation,6,Low,1,Good Loan,0,10.65,B,2,0.5,3378.52,3000,0,97.72,409000005931,7-Aug-18,TRF TO  Indiaforensic SERVICES I,"6,400,000.00",,-547886347.95,Iqbal,656,Germany,50595.15,0,1,0
5933,2011,8,MORTGAGE,3,Low,1,22000, 60 months,2,debt_consolidation,6,Low,1,Good Loan,0,12.69,B,2,27.96,27200.41,22000,0,497.09,409000005932,7-Aug-18,Indiaforensic MASTER INT 040818,,2793.28,-547883554.67,Teng,556,France,50390.98,0,1,0
5934,2011,10,OWN,2,Low,1,20000, 60 months,2,credit_card,1,Low,1,Good Loan,0,11.71,B,2,7.58,21267.54,20000,0,441.97,409000005933,7-Aug-18,Indiaforensic RUPAY POS C2 ACQ07,,691905.97,-547191648.70,Tao,569,France,163150.03,0,1,0
5935,2011,2,RENT,1,Low,1,6500, 36 months,1,wedding,5,High,2,Good Loan,0,13.49,C,3,13.43,7851.555698,6500,0,220.55,409000005934,7-Aug-18,Indiaforensic VISA ACQ INT 03081,,1390.73,-547190257.97,Chinedum,765,France,138280.17,0,1,0
5936,2011,10,RENT,1,Low,1,12000, 36 months,1,debt_consolidation,6,Low,1,Good Loan,0,11.71,B,2,4.96,14287.73902,12000,0,396.92,409000005935,8-Aug-18,Indiaforensic MASTER ACQ DOM0908,,4429078.72,-542761179.25,Stevenson,544,Spain,135067.02,0,1,0
5937,2011,3,MORTGAGE,3,Low,1,12725, 36 months,1,credit_card,1,Low,1,Good Loan,0,12.42,B,2,5.46,15216.50977,12725,0,425.21,409000005936,8-Aug-18,Indiaforensic VISA ACQ DOM080818,,3093491.53,-539667687.72,Duncan,588,Spain,163534.75,0,1,0
5938,2011,6,MORTGAGE,3,Medium,2,35000, 60 months,2,debt_consolidation,6,High,2,Good Loan,0,13.49,C,3,8.96,46892.77779,34999.98,0,805.17,409000005937,8-Aug-18,Indiaforensic RUPAY POS ACQ08081,,1452095.46,-538215592.26,Garrett,740,Spain,86657.48,0,1,0
5939,2011,5,MORTGAGE,3,Low,1,21000, 36 months,1,medical,9,Low,1,Good Loan,0,8.9,A,1,8.47,24003.21179,21000,0,666.82,409000005938,8-Aug-18,TRF TO  Indiaforensic SERVICES I,"10,000,000.00",,-548215592.26,Yao,850,Spain,162087.82,0,1,0
5940,2011,0.5,RENT,1,Low,1,6000, 36 months,1,other,4,High,2,Good Loan,0,15.96,C,3,10.54,7587.47555,6000,0,210.83,409000005939,8-Aug-18,Indiaforensic RUPAY POS C2 ACQ08,,616577.17,-547599015.09,He,766,Germany,28879.30,0,1,0
5941,2011,3,OWN,2,Low,1,18000, 60 months,2,debt_consolidation,6,High,2,Good Loan,0,13.49,C,3,24.12,19364.94,18000,0,414.09,409000005940,8-Aug-18,Indiaforensic MASTER INT 070818,,2010.10,-547597004.99,Mazzi,849,France,169203.51,0,1,0
5942,2011,6,RENT,1,Low,1,2400, 36 months,1,debt_consolidation,6,Low,1,Good Loan,0,10.65,B,2,18.16,2813.152487,2400,0,78.18,409000005941,8-Aug-18,TRF TO  Indiaforensic SERVICES I,"600,000.00",,-548197004.99,Edwards,612,France,102426.12,0,1,0
5943,2011,4,MORTGAGE,3,Low,1,6000, 36 months,1,debt_consolidation,6,Low,1,Good Loan,0,7.9,A,1,3.64,6679.2,6000,0,187.75,409000005942,8-Aug-18,Indiaforensic VISA ACQ INT 04081,,14577.06,-548182427.93,Lucchesi,517,Germany,54676.10,0,1,0
5944,2011,6,RENT,1,Low,1,12650, 36 months,1,debt_consolidation,6,Low,1,Good Loan,0,6.62,A,1,18.24,13579.85,12650,0,388.41,409000005943,8-Aug-18,Indiaforensic VISA ACQ INT 05081,,7624.11,-548174803.82,Siciliani,645,France,18369.33,0,1,0
5945,2011,2,RENT,1,Low,1,25975, 60 months,2,debt_consolidation,6,High,2,Good Loan,0,17.27,D,4,22.55,29188.67,25975,0,649.33,409000005944,9-Aug-18,Indiaforensic MASTER ACQ DOM0908,,2734406.19,-545440397.63,Shih,696,Germany,159888.10,0,1,0
5946,2011,10,RENT,1,Low,1,4500, 36 months,1,other,4,Low,1,Bad Loan,1,12.42,B,2,15.23,2984.63,2161.05,133.86,150.37,409000005945,9-Aug-18,Indiaforensic VISA ACQ DOM090818,,3533239.51,-541907158.12,Logue,716,France,167636.15,0,1,0
5947,2011,8,MORTGAGE,3,Low,1,12000, 36 months,1,small_business,3,Low,1,Good Loan,0,9.91,B,2,18.46,12725.05,12000,0,386.7,409000005946,9-Aug-18,Indiaforensic RUPAY POS ACQ09081,,1594196.83,-540312961.29,Rechner,590,France,138889.15,0,1,0
5948,2011,4,MORTGAGE,3,Low,1,24000, 60 months,2,credit_card,1,High,2,Good Loan,0,22.06,F,6,15.67,32626.95,24000,0,663.68,409000005947,9-Aug-18,TRF TO  Indiaforensic SERVICES I,"7,900,000.00",,-548212961.29,O'Brien,656,France,199392.14,0,1,0
5949,2011,6.05,OWN,2,Low,1,14000, 36 months,1,debt_consolidation,6,Low,1,Good Loan,0,9.91,B,2,18.18,15282.04,14000,0,451.15,409000005948,9-Aug-18,Indiaforensic RUPAY POS C2 ACQ09,,539209.85,-547673751.44,Stewart,473,Germany,189560.43,0,1,0
5950,2011,3,MORTGAGE,3,Low,1,18000, 36 months,1,debt_consolidation,6,Low,1,Bad Loan,1,12.69,B,2,14.33,10890.2,7644.92,604.08,603.81,409000005949,9-Aug-18,Indiaforensic MASTER INT 080818,,3262.44,-547670489.00,Batt,742,Germany,17375.27,0,1,0
5951,2011,5,RENT,1,Low,1,6300, 36 months,1,debt_consolidation,6,Low,1,Good Loan,0,10.65,B,2,9.57,7228.4,6300,0,205.22,409000005950,9-Aug-18,Indiaforensic VISA ACQ INT 07081,,5832.89,-547664656.11,Hope,834,Germany,140225.14,0,1,0
5952,2011,2,RENT,1,Low,1,12000, 60 months,2,debt_consolidation,6,High,2,Bad Loan,1,13.49,C,3,16.22,3094.66,1327.55,613,276.06,409000005951,10-Aug-18,Indiaforensic VISA ACQ DOM100818,,3674356.61,-543990299.50,Ahmed,721,France,61018.85,0,1,0
5953,2011,10,OWN,2,Medium,2,30000, 60 months,2,debt_consolidation,6,High,2,Good Loan,0,13.49,C,3,5.06,39284.12592,30000,0,690.15,409000005952,10-Aug-18,Indiaforensic RUPAY POS ACQ10081,,1719972.28,-542270327.22,Pearson,590,Spain,51907.72,0,1,0
5954,2011,6,MORTGAGE,3,Low,1,14275, 60 months,2,home_improvement,7,High,2,Good Loan,0,20.3,E,5,19.31,20599.32166,14275,0,380.59,409000005953,10-Aug-18,Indiaforensic MASTER ACQ DOM1008,,2976343.33,-539293983.89,Kruglov,516,Spain,47018.75,0,1,0
5955,2011,6,MORTGAGE,3,Low,1,5600, 36 months,1,debt_consolidation,6,Low,1,Good Loan,0,11.71,B,2,22.29,6661.866876,5600,0,185.23,409000005954,10-Aug-18,TRF TO  Indiaforensic SERVICES I,"8,900,000.00",,-548193983.89,Gordon,850,France,33700.52,0,1,0
5956,2011,6.05,OWN,2,Low,1,29175, 60 months,2,debt_consolidation,6,Low,1,Good Loan,0,10.65,B,2,26.14,32035.98,23717.98,0,629.26,409000005955,10-Aug-18,Indiaforensic RUPAY POS C2 ACQ10,,740399.39,-547453584.50,Trujillo,748,France,59636.43,0,1,0
5957,2011,1,RENT,1,Medium,2,8000, 36 months,1,debt_consolidation,6,High,2,Good Loan,0,16.29,D,4,17.63,9621.86,8000,0,282.41,409000005956,10-Aug-18,Indiaforensic MASTER INT 090818,,3624.55,-547449959.95,Pagnotto,798,Germany,157147.59,0,1,0
5958,2011,1,RENT,1,Low,1,9600, 36 months,1,debt_consolidation,6,High,2,Good Loan,0,14.27,C,3,14.5,10953.03,9600,0,329.37,409000005957,10-Aug-18,Indiaforensic VISA ACQ INT 08081,,16246.02,-547433713.93,Horton,612,Germany,191393.26,0,1,0
5959,2011,4,MORTGAGE,3,Low,1,12000, 60 months,2,debt_consolidation,6,High,2,Good Loan,0,22.35,F,6,23,17483.22387,12000,0,333.82,409000005958,13-Aug-18,Indiaforensic VISA ACQ DOM110818,,3813353.52,-543620360.41,DeRose,540,France,199862.75,0,1,0
5960,2011,6,MORTGAGE,3,Medium,2,28000, 36 months,1,debt_consolidation,6,Low,1,Good Loan,0,8.9,A,1,4.95,32004.01967,28000,0,889.09,409000005959,13-Aug-18,Indiaforensic RUPAY POS ACQ11081,,1799837.52,-541820522.89,Chiang,719,Spain,20016.59,0,1,0
5961,2011,4,MORTGAGE,3,Low,1,7000, 36 months,1,credit_card,1,Low,1,Good Loan,0,6.03,A,1,18.76,7669.577437,7000,0,213.05,409000005960,13-Aug-18,Indiaforensic RUPAY POS ACQ12081,,2405658.23,-539414864.66,Gill,598,France,30635.52,0,1,0
5962,2011,2,MORTGAGE,3,Low,1,12800, 60 months,2,debt_consolidation,6,Low,1,Good Loan,0,12.69,B,2,8.97,14740.7,10324.22,0,289.22,409000005961,13-Aug-18,Indiaforensic MASTER ACQ DOM1308,,7784381.35,-531630483.31,Trevisano,796,Spain,117832.88,0,1,0
5963,2011,3,RENT,1,Low,1,29000, 36 months,1,debt_consolidation,6,Low,1,Good Loan,0,12.69,B,2,21.77,34655.47313,29000,0,972.81,409000005962,13-Aug-18,Indiaforensic VISA ACQ DOM130818,,6140621.11,-525489862.20,Morrison,579,Germany,22497.10,0,1,0
5964,2011,7,RENT,1,Low,1,8400, 36 months,1,debt_consolidation,6,Low,1,Good Loan,0,9.91,B,2,24.62,9743.379562,8400,0,270.69,409000005963,13-Aug-18,Indiaforensic RUPAY POS ACQ13081,,2227181.93,-523262680.27,Onuora,850,Germany,747.88,0,1,0
5965,2011,3,MORTGAGE,3,Low,1,14825, 36 months,1,debt_consolidation,6,Low,1,Good Loan,0,6.03,A,1,13.94,16223.91847,14825,0,451.21,409000005964,13-Aug-18,TRF TO  Indiaforensic SERVICES I,"4,000,000.00",,-527262680.27,Ikenna,599,Spain,76870.81,0,1,0
5966,2011,5,RENT,1,Low,1,10000, 36 months,1,other,4,Low,1,Good Loan,0,8.9,A,1,18.46,11430.01593,10000,0,317.54,409000005965,13-Aug-18,TRF TO  Indiaforensic SERVICES I,"2,000,000.00",,-529262680.27,Mancini,724,France,107848.24,0,1,0
5967,2011,9,RENT,1,Low,1,12600, 36 months,1,credit_card,1,Low,1,Good Loan,0,10.65,B,2,15.63,14773.92262,12600,0,410.43,409000005966,13-Aug-18,NEFT CHARGES AND GST/0000,29.5,,-529262709.77,Moss,508,France,103726.71,0,1,0
5968,2011,4,MORTGAGE,3,Low,1,20000, 60 months,2,credit_card,1,Low,1,Good Loan,0,10.65,B,2,16.35,24145.13046,20000,0,431.37,409000005967,13-Aug-18,NEFT/000046766266/Indiaforensic,"15,000,000.00",,-544262709.77,Ting,773,Spain,178268.36,0,1,0
5969,2011,10,MORTGAGE,3,High,3,31400, 36 months,1,small_business,3,High,2,Good Loan,0,14.27,C,3,7.86,38777.00276,31400,0,1077.3,409000005968,13-Aug-18,Indiaforensic RUPAY POS C2 ACQ13,,529291.20,-543733418.57,Tai,526,France,126281.83,0,1,0
5970,2011,0.5,RENT,1,Low,1,8000, 36 months,1,small_business,3,Low,1,Good Loan,0,7.9,A,1,16.06,8682.39,8000,0,250.33,409000005969,13-Aug-18,TRF TO  Indiaforensic SERVICES I,"4,000,000.00",,-547733418.57,Pan,542,France,196651.72,0,1,0
5971,2011,6.05,MORTGAGE,3,Low,1,30000, 60 months,2,debt_consolidation,6,Low,1,Good Loan,0,9.91,B,2,9.19,32439.75,24504.47,0,636.09,409000005970,14-Aug-18,Indiaforensic MASTER INT 130818,,4110.93,-547729307.64,Wilson,470,France,5962.30,0,1,0
5972,2011,2,RENT,1,Low,1,11000, 60 months,2,small_business,3,High,2,Good Loan,0,17.27,D,4,11.97,16245.72,11000,0,274.98,409000005971,14-Aug-18,Indiaforensic MASTER ACQ DOM1408,,2486077.35,-545243230.29,Bianchi,805,Spain,21928.81,0,1,0
5973,2011,0.5,RENT,1,Low,1,12000, 36 months,1,car,2,Low,1,Good Loan,0,6.03,A,1,5.52,13079.50394,12000,0,365.23,409000005972,14-Aug-18,Indiaforensic VISA ACQ DOM140818,,3662821.93,-541580408.36,Holman,548,Germany,127022.87,0,1,0
5974,2011,6.05,MORTGAGE,3,Low,1,13700, 60 months,2,home_improvement,7,High,2,Good Loan,0,18.64,E,5,5.09,20582.37578,13700,0,352.68,409000005973,14-Aug-18,Indiaforensic RUPAY POS ACQ14081,,1918832.75,-539661575.61,Obidimkpa,672,France,162763.01,0,1,0
5975,2011,3,MORTGAGE,3,Low,1,4625, 60 months,2,debt_consolidation,6,Low,1,Good Loan,0,9.91,B,2,28.51,5001.29,3776.6,0,98.07,409000005974,14-Aug-18,Indiaforensic RUPAY POS C2 ACQ14,,350602.07,-539310973.54,Wallace,773,France,113950.51,0,1,0
5976,2011,1,RENT,1,Low,1,7250, 36 months,1,credit_card,1,Low,1,Good Loan,0,10.65,B,2,14.08,8498.310898,7250,0,236.16,409000005975,14-Aug-18,Indiaforensic VISA ACQ INT 10081,,2484.96,-539308488.58,Ash,614,France,104930.46,0,1,0
5977,2011,3,MORTGAGE,3,Low,1,8500, 36 months,1,debt_consolidation,6,Low,1,Bad Loan,1,12.42,B,2,8.94,6761.81,4791.09,516.65,284.03,409000005976,14-Aug-18,TRF TO  Indiaforensic SERVICES I,"8,900,000.00",,-548208488.58,Ku,537,France,52337.97,0,1,0
5978,2011,0.5,RENT,1,Low,1,5000, 36 months,1,small_business,3,Low,1,Good Loan,0,8.9,A,1,18.54,5523.41,5000,0,158.77,409000005977,16-Aug-18,Indiaforensic VISA ACQ DOM150818,,4374248.60,-543834239.98,Uspensky,704,France,179964.55,0,1,0
5979,2011,6.05,OWN,2,Low,1,20000, 60 months,2,debt_consolidation,6,Low,1,Good Loan,0,11.71,B,2,18.33,20195.74,20000,0,441.97,409000005978,16-Aug-18,Indiaforensic RUPAY POS ACQ15081,,1966311.39,-541867928.59,Shih,586,Spain,83753.64,0,1,0
5980,2011,7,MORTGAGE,3,Low,1,7200, 36 months,1,credit_card,1,Low,1,Good Loan,0,11.71,B,2,7.82,8570.9467,7200,0,238.15,409000005979,16-Aug-18,TRF TO  Indiaforensic SERVICES I,"3,000,000.00",,-544867928.59,Kumm,677,France,182913.95,0,1,0
5981,2011,10,MORTGAGE,3,Low,1,21000, 60 months,2,debt_consolidation,6,High,2,Good Loan,0,17.27,D,4,19.51,26246.77,16133.4,0,524.96,409000005980,16-Aug-18,TRF TO  Indiaforensic SERVICES I,"3,000,000.00",,-547867928.59,Carey,558,Spain,166720.28,0,1,0
5982,2011,10,MORTGAGE,3,Low,1,12000, 36 months,1,debt_consolidation,6,Low,1,Good Loan,0,7.51,A,1,14.36,13168.14,12000,0,373.33,409000005981,16-Aug-18,Indiaforensic VISA ACQ DOM160818,,3196572.65,-544671355.94,Farber,634,Germany,192721.98,0,1,0
5983,2011,9,RENT,1,Low,1,18000, 60 months,2,credit_card,1,High,2,Good Loan,0,18.25,D,4,23,25226.95022,18000,0,459.54,409000005982,16-Aug-18,Indiaforensic RUPAY POS ACQ16081,,2485112.43,-542186243.51,Calabrese,655,Germany,180241.44,0,1,0
5984,2011,5,RENT,1,Low,1,21250, 60 months,2,debt_consolidation,6,High,2,Bad Loan,1,24.11,G,7,22.59,10258.65,1380.65,3322.86,612.68,409000005983,16-Aug-18,Indiaforensic MASTER ACQ DOM15-1,,5082342.79,-537103900.72,Findlay,619,Germany,48475.12,0,1,0
5985,2011,10,MORTGAGE,3,Low,1,2200, 36 months,1,vacation,11,Low,1,Good Loan,0,12.42,B,2,6.35,2222.88,2200,0,73.52,409000005984,16-Aug-18,Indiaforensic VISA ACQ INT 11081,,5892.00,-537098008.72,Yu,662,France,126551.48,0,1,0
5986,2011,8,MORTGAGE,3,Low,1,35000, 60 months,2,debt_consolidation,6,High,2,Good Loan,0,23.13,G,7,7.82,47183.29,35000,0,989.29,409000005985,16-Aug-18,Indiaforensic VISA ACQ INT 13081,,5084.70,-537092924.02,Edments,705,Spain,64872.55,0,1,0
5987,2011,10,RENT,1,Low,1,16000, 60 months,2,debt_consolidation,6,High,2,Bad Loan,1,13.49,C,3,18.36,5149.34,2834.38,0,368.08,409000005986,16-Aug-18,Indiaforensic MASTER INT 150818,,2739.33,-537090184.69,Brown,527,Spain,98031.53,0,1,0
5988,2011,10,MORTGAGE,3,Low,1,16000, 60 months,2,small_business,3,High,2,Bad Loan,1,16.29,D,4,28.53,8517.99,3973.42,691.39,391.56,409000005987,16-Aug-18,TRF TO  Indiaforensic SERVICES I,"10,000,000.00",,-547090184.69,Lindon,630,Germany,93524.22,0,1,0
5989,2011,2,RENT,1,Low,1,4200, 36 months,1,medical,9,High,2,Good Loan,0,14.27,C,3,14.3,5037.06,4200,0,144.1,409000005988,16-Aug-18,TRF TO  Indiaforensic SERVICES I,"1,000,000.00",,-548090184.69,Chukwudi,850,France,56991.66,0,1,0
5990,2011,6.05,RENT,1,Low,1,2000, 36 months,1,small_business,3,Low,1,Good Loan,0,10.65,B,2,14.1,2344.152379,2000,0,65.15,409000005989,16-Aug-18,Indiaforensic RUPAY POS C2 ACQ16,,639214.75,-547450969.94,Caldwell,668,France,183980.56,0,1,0
5991,2011,4,RENT,1,Low,1,4000, 36 months,1,medical,9,High,2,Good Loan,0,13.49,C,3,13.41,4882.912722,4000,0,135.73,409000005990,16-Aug-18,MDR REIMBURSEMENT Q1-2018,,225649.03,-547225320.91,Li Fonti,573,France,130234.63,0,1,0
5992,2011,1,RENT,1,Low,1,10000, 36 months,1,debt_consolidation,6,Low,1,Good Loan,0,7.51,A,1,27.36,11027.1,10000,0,311.11,409000005991,17-Aug-18,TRF TO  Indiaforensic SERVICES I,"500,000.00",,-547725320.91,Pitcher,680,France,32454.26,0,1,0
5993,2011,5,RENT,1,Low,1,14400, 60 months,2,debt_consolidation,6,High,2,Good Loan,0,16.77,D,4,16.54,20438.12713,14400,0,356.1,409000005992,17-Aug-18,TRF TO  Indiaforensic SERVICES I,"500,000.00",,-548225320.91,Capon,758,France,75396.43,0,1,0
5994,2011,1,RENT,1,Low,1,14000, 60 months,2,debt_consolidation,6,High,2,Good Loan,0,18.64,E,5,23.64,21150.46135,14000,0,360.41,409000005993,17-Aug-18,Indiaforensic RUPAY POS ACQ17081,,1748185.48,-546477135.43,Kable,597,France,167756.45,0,1,0
5995,2011,2,RENT,1,Low,1,12000, 36 months,1,major_purchase,8,Low,1,Good Loan,0,6.62,A,1,9.44,12314.06,12000,0,368.45,409000005994,17-Aug-18,Indiaforensic RUPAY POS C2 ACQ17,,732649.70,-545744485.73,Lo Duca,580,Germany,24799.47,0,1,0
5996,2011,4,RENT,1,Low,1,9600, 36 months,1,other,4,Low,1,Good Loan,0,7.9,A,1,20.56,10813.13816,9600,0,300.39,409000005995,17-Aug-18,TRF TO  Indiaforensic SERVICES I,"1,700,000.00",,-547444485.73,Kulikova,622,France,60429.43,0,1,0
5997,2011,5,RENT,1,Low,1,18825, 36 months,1,debt_consolidation,6,Low,1,Good Loan,0,7.9,A,1,22.74,20957.62,18825,0,589.04,409000005996,18-Aug-18,Indiaforensic VISA ACQ DOM170818,,3019250.24,-544425235.49,Navarrete,638,Germany,74241.09,0,1,0
5998,2011,10,OWN,2,Low,1,11500, 36 months,1,other,4,Low,1,Good Loan,0,6.03,A,1,7.26,12599.98803,11500,0,350.01,409000005997,18-Aug-18,Indiaforensic VISA ACQ DOM180818,,3121194.10,-541304041.39,Huguley,640,France,78310.82,0,1,0
5999,2011,1,RENT,1,Low,1,5500, 36 months,1,credit_card,1,Low,1,Good Loan,0,7.9,A,1,25.48,6132.1,5500,0,172.1,409000005998,18-Aug-18,Indiaforensic RUPAY POS ACQ18081,,682930.85,-540621110.54,Han,644,Spain,119419.37,0,1,0
6000,2011,10,MORTGAGE,3,Low,1,19075, 60 months,2,debt_consolidation,6,High,2,Good Loan,0,13.49,C,3,14.08,23747.61,19075,0,438.82,409000005999,18-Aug-18,Indiaforensic VISA ACQ INT 14081,,6147.37,-540614963.17,Horsley,753,France,91305.77,0,1,0
6001,2011,8,MORTGAGE,3,Low,1,9000, 36 months,1,home_improvement,7,Low,1,Good Loan,0,6.03,A,1,9.86,9720.26,9000,0,273.92,409000006000,18-Aug-18,Indiaforensic VISA ACQ INT 15081,,6189.11,-540608774.06,Massie,629,France,25136.95,0,1,0
6002,2011,10,MORTGAGE,3,Low,1,24000, 60 months,2,credit_card,1,High,2,Bad Loan,1,14.65,C,3,18.85,8046.03,3512.61,1177.12,566.56,409000006001,18-Aug-18,TRF TO  Indiaforensic SERVICES I,"500,000.00",,-541108774.06,Singh,775,France,193880.60,0,1,0
6003,2011,0.5,RENT,1,Low,1,1000, 36 months,1,moving,10,Low,1,Good Loan,0,7.51,A,1,0.6,1110.82,1000,0,31.12,409000006002,18-Aug-18,TRF TO  Indiaforensic SERVICES I,"5,000,000.00",,-546108774.06,H?,701,France,47856.78,0,1,0
6004,2011,10,MORTGAGE,3,Low,1,2400, 36 months,1,medical,9,High,2,Bad Loan,1,17.58,D,4,6.31,503.88,262.02,74.38,86.27,409000006003,18-Aug-18,TRF TO  Indiaforensic SERVICES I,"500,000.00",,-546608774.06,Doyle,708,Spain,4491.77,0,1,0
6005,2011,10,RENT,1,Low,1,3500, 36 months,1,credit_card,1,Low,1,Good Loan,0,12.69,B,2,21.15,4124.08,3500,0,117.41,409000006004,18-Aug-18,Indiaforensic RUPAY POS C2 ACQ18,,1424414.33,-545184359.73,Grant,521,Spain,101311.95,0,1,0
6006,2011,0.5,RENT,1,Low,1,7000, 36 months,1,credit_card,1,Low,1,Good Loan,0,8.9,A,1,18,7292.1,7000,0,222.28,409000006005,18-Aug-18,TRF TO  Indiaforensic SERVICES I,"500,000.00",,-545684359.73,Law,636,France,38830.72,0,1,0
6007,2011,0.5,RENT,1,Low,1,3600, 36 months,1,debt_consolidation,6,Low,1,Good Loan,0,7.9,A,1,10.08,4045.486128,3600,0,112.65,409000006006,20-Aug-18,TRF TO  Indiaforensic SERVICES I,"2,500,000.00",,-548184359.73,King,529,France,26817.23,0,1,0
6008,2011,1,RENT,1,Low,1,5500, 36 months,1,car,2,Low,1,Bad Loan,1,11.71,B,2,20.43,1708.56,1060.27,255.2,181.92,409000006007,20-Aug-18,Indiaforensic RUPAY POS ACQ19081,,1867793.60,-546316566.13,Onwubiko,757,France,199727.72,0,1,0
6009,2011,0.5,RENT,1,Low,1,20000, 60 months,2,debt_consolidation,6,High,2,Good Loan,0,19.91,E,5,20.04,26438.12,15160.98,0,528.88,409000006008,20-Aug-18,Indiaforensic RUPAY POS ACQ20081,,2103335.60,-544213230.53,Romano,767,Spain,67445.85,0,1,0
6010,2011,10,MORTGAGE,3,Low,1,6000, 36 months,1,home_improvement,7,Low,1,Good Loan,0,7.51,A,1,2.52,6211.19,6000,0,186.67,409000006009,20-Aug-18,Indiaforensic VISA ACQ DOM200818,,6146407.50,-538066823.03,Okwudilichukwu,525,Spain,161002.29,0,1,0
6011,2011,10,OWN,2,High,3,30000, 60 months,2,home_improvement,7,High,2,Good Loan,0,20.3,E,5,4.72,46733.99768,30000,0,799.84,409000006010,20-Aug-18,TRF TO  Indiaforensic SERVICES I,"10,000,000.00",,-548066823.03,Milano,759,Spain,20778.39,0,1,0
6012,2011,6.05,RENT,1,Low,1,1550, 36 months,1,other,4,High,2,Bad Loan,1,15.27,C,3,8.86,317.58,175.49,47.88,53.94,409000006011,20-Aug-18,Indiaforensic MASTER ACQ DOM2008,,10609275.97,-537457547.06,Parker,520,Germany,41042.40,0,1,0
6013,2011,5,MORTGAGE,3,Low,1,20000, 60 months,2,other,4,Low,1,Good Loan,0,12.69,B,2,15.73,23026.74,16127.92,0,451.9,409000006012,20-Aug-18,Indiaforensic RUPAY POS C2 ACQ20,,712729.76,-536744817.30,Aitken,738,France,67484.16,0,1,0
6014,2011,0.5,MORTGAGE,3,Low,1,9600, 36 months,1,car,2,Low,1,Good Loan,0,6.62,A,1,22.27,10370.04,9600,0,294.76,409000006013,20-Aug-18,Indiaforensic MASTER INT 160818,,1054.58,-536743762.72,Obiora,548,Spain,121763.68,0,1,0
6015,2011,10,MORTGAGE,3,Low,1,30000, 60 months,2,credit_card,1,Low,1,Good Loan,0,11.71,B,2,8.04,33789.45,24301.38,0,662.95,409000006014,20-Aug-18,Indiaforensic MASTER INT 170818,,2108.70,-536741654.02,Vasilyeva,535,Spain,157358.43,0,1,0
6016,2011,5,MORTGAGE,3,Low,1,2700, 36 months,1,home_improvement,7,High,2,Good Loan,0,14.27,C,3,11.32,3332.912211,2700,0,92.64,409000006015,20-Aug-18,TRF TO  Indiaforensic SERVICES I,"10,800,000.00",,-547541654.02,Chiabuotu,615,Spain,110275.17,0,1,0
6017,2011,1,MORTGAGE,3,Low,1,5600, 36 months,1,small_business,3,Low,1,Good Loan,0,12.42,B,2,19.78,6697.634732,5600,0,187.13,409000006016,21-Aug-18,Indiaforensic VISA ACQ DOM210818,,3572383.72,-543969270.30,Slater,850,Germany,43801.27,0,1,0
6018,2011,6.05,OWN,2,Low,1,2500, 36 months,1,house,12,Low,1,Good Loan,0,6.03,A,1,15.56,2754.017852,2500,0,76.09,409000006017,21-Aug-18,Indiaforensic RUPAY POS ACQ21081,,2045231.80,-541924038.50,Hughes,487,France,9085.00,0,1,0
6019,2011,10,MORTGAGE,3,Low,1,8600, 36 months,1,credit_card,1,High,2,Good Loan,0,19.42,E,5,5.72,11413.4448,8600,0,317.08,409000006018,21-Aug-18,Indiaforensic MASTER ACQ DOM2108,,2640659.52,-539283378.98,Menkens,731,France,143086.09,0,1,0
6020,2011,2,RENT,1,Low,1,8000, 36 months,1,credit_card,1,Low,1,Good Loan,0,7.51,A,1,4.53,8903.380748,8000,0,248.89,409000006019,21-Aug-18,Indiaforensic MASTER INT 180818,,4954.03,-539278424.95,Pisani,726,Spain,100556.98,0,1,0
6021,2011,0.5,MORTGAGE,3,Medium,2,7000, 36 months,1,credit_card,1,Low,1,Good Loan,0,7.49,A,1,20.53,7257.89,7000,0,217.72,409000006020,21-Aug-18,TRF TO  Indiaforensic SERVICES I,"6,300,000.00",,-545578424.95,Y?an,609,France,140000.29,0,1,0
6022,2011,6.05,OWN,2,Low,1,18500, 60 months,2,home_improvement,7,Low,1,Bad Loan,1,11.71,B,2,12,20440.44,14622.83,0,408.82,409000006021,21-Aug-18,TRF TO  Indiaforensic SERVICES I,"2,600,000.00",,-548178424.95,Milani,714,France,186775.25,0,1,0
6023,2011,10,RENT,1,Low,1,23850, 60 months,2,debt_consolidation,6,High,2,Good Loan,0,19.03,E,5,21.23,31547.04,18683.28,0,619.08,409000006022,21-Aug-18,Indiaforensic RUPAY POS C2 ACQ21,,605709.01,-547572715.94,Chin,694,Spain,133570.43,0,1,0
6024,2011,10,MORTGAGE,3,Low,1,24000, 60 months,2,debt_consolidation,6,Low,1,Good Loan,0,12.42,B,2,27.52,29707.41,24000,0,538.98,409000006023,21-Aug-18,Indiaforensic VISA ACQ INT 16081,,3054.53,-547569661.41,Fu,786,France,154990.58,0,1,0
6025,2011,10,OWN,2,Low,1,2800, 36 months,1,debt_consolidation,6,Low,1,Good Loan,0,9.91,B,2,3.5,3239.493645,2800,0,90.23,409000006024,21-Aug-18,Indiaforensic VISA ACQ INT 17081,,8056.12,-547561605.29,Howells,698,Spain,27654.44,0,1,0
6026,2011,3,RENT,1,Low,1,18000, 36 months,1,debt_consolidation,6,Low,1,Bad Loan,1,10.65,B,2,8.1,11311.58,8279.99,558.56,586.32,409000006025,23-Aug-18,TRF TO  Indiaforensic SERVICES I,"700,000.00",,-548261605.29,Ni,601,France,137763.93,0,1,0
6027,2011,6,RENT,1,Medium,2,12000, 60 months,2,debt_consolidation,6,High,2,Good Loan,0,19.42,E,5,10.57,16007.49,9384.65,0,314.07,409000006026,23-Aug-18,Indiaforensic VISA ACQ DOM220818,,3732174.79,-544529430.50,Maslova,769,Spain,25723.73,0,1,0
6028,2011,1,RENT,1,Low,1,5000, 36 months,1,other,4,Low,1,Good Loan,0,7.51,A,1,14.73,5598.998855,5000,0,155.56,409000006027,23-Aug-18,Indiaforensic RUPAY POS ACQ22081,,2110843.66,-542418586.84,Forster,850,Germany,186285.52,0,1,0
6029,2011,10,MORTGAGE,3,Low,1,6600, 36 months,1,home_improvement,7,Low,1,Good Loan,0,7.51,A,1,27.74,7406.318257,6600,0,205.34,409000006028,23-Aug-18,TRF TO  Indiaforensic SERVICES I,"5,800,000.00",,-548218586.84,Sun,646,Spain,142208.50,0,1,0
6030,2011,0.5,OWN,2,Low,1,2400, 36 months,1,debt_consolidation,6,Low,1,Good Loan,0,9.91,B,2,19.94,2783.070292,2400,0,77.34,409000006029,23-Aug-18,Indiaforensic RUPAY POS ACQ23081,,2217738.39,-546000848.45,Bocharova,659,France,169862.01,0,1,0
6031,2011,3,RENT,1,Low,1,7000, 36 months,1,debt_consolidation,6,High,2,Bad Loan,1,14.27,C,3,4.66,4535.79,3122.4,222.09,240.17,409000006030,23-Aug-18,Indiaforensic VISA ACQ DOM230818,,3635811.20,-542365037.25,Y?an,487,Spain,41365.85,0,1,0
6032,2011,5,MORTGAGE,3,Low,1,12500, 36 months,1,debt_consolidation,6,Low,1,Good Loan,0,6.03,A,1,12.48,13146.87,12500,0,380.45,409000006031,23-Aug-18,TRF TO  Indiaforensic SERVICES I,"5,900,000.00",,-548265037.25,Singh,740,Germany,30812.84,0,1,0
6033,2011,3,MORTGAGE,3,Low,1,2400, 36 months,1,debt_consolidation,6,Low,1,Good Loan,0,8.9,A,1,9.19,2742.408407,2400,0,76.21,409000006032,23-Aug-18,Indiaforensic MASTER ACQ DOM2308,,5748219.23,-542516818.02,Nkemakonam,686,France,155023.93,0,1,0
6034,2011,5,MORTGAGE,3,Low,1,18000, 36 months,1,credit_card,1,Low,1,Good Loan,0,7.9,A,1,11.1,19730.94,18000,0,563.23,409000006033,23-Aug-18,Indiaforensic RUPAY POS C2 ACQ23,,517752.75,-541999065.27,Chiemenam,612,Spain,159416.58,0,1,0
6035,2011,10,MORTGAGE,3,High,3,12000, 36 months,1,debt_consolidation,6,High,2,Good Loan,0,16.29,D,4,17.36,15248.33772,12000,0,423.61,409000006034,23-Aug-18,Indiaforensic MASTER INT 210818,,72473.17,-541926592.10,Angelo,655,Spain,76259.23,0,1,0
6036,2011,2,RENT,1,Medium,2,3000, 36 months,1,credit_card,1,High,2,Good Loan,0,14.65,C,3,18.84,3689.82985,3000,0,103.49,409000006035,23-Aug-18,Indiaforensic VISA ACQ INT 18081,,8846.89,-541917745.21,Frolov,617,France,105965.25,0,1,0
6037,2011,5,MORTGAGE,3,Low,1,1000, 36 months,1,medical,9,High,2,Good Loan,0,14.27,C,3,12.26,1011.96,1000,0,34.31,409000006036,23-Aug-18,Indiaforensic VISA ACQ INT 20081,,814.54,-541916930.67,West,674,France,50743.83,0,1,0
6038,2011,5,OWN,2,Low,1,4000, 36 months,1,wedding,5,High,2,Good Loan,0,16.29,D,4,20.83,5081.295725,4000,0,141.21,409000006037,23-Aug-18,TRF TO  Indiaforensic SERVICES I,"5,700,000.00",,-547616930.67,Beatham,711,Spain,147720.27,0,1,0
6039,2011,2,RENT,1,Low,1,3625, 36 months,1,credit_card,1,Low,1,Good Loan,0,7.9,A,1,24.6,3947.41,3625,0,113.43,409000006038,23-Aug-18,TRF TO  Indiaforensic SERVICES I,"500,000.00",,-548116930.67,Pollard,624,Germany,167387.36,0,1,0
6040,2011,3,RENT,1,Low,1,3600, 36 months,1,small_business,3,Low,1,Good Loan,0,11.71,B,2,18.48,4283.897059,3600,0,119.08,409000006039,24-Aug-18,Indiaforensic VISA ACQ DOM240818,,3678765.45,-544438165.22,Hsing,597,Spain,95159.13,0,1,0
6041,2011,10,MORTGAGE,3,Low,1,10950, 36 months,1,debt_consolidation,6,Low,1,Good Loan,0,7.51,A,1,25.1,12241.03378,10950,0,340.67,409000006040,24-Aug-18,Indiaforensic RUPAY POS ACQ24081,,1736286.43,-542701878.79,Dowse,682,Spain,4654.28,0,1,0
6042,2011,6.05,MORTGAGE,3,Low,1,14400, 60 months,2,credit_card,1,High,2,Bad Loan,1,20.3,E,5,13.13,3829.9,1511.31,0,383.92,409000006041,24-Aug-18,Indiaforensic MASTER ACQ DOM2408,,2697229.07,-540004649.72,Lucciano,775,France,130376.68,0,1,0
6043,2011,0.5,RENT,1,Low,1,10000, 36 months,1,debt_consolidation,6,High,2,Good Loan,0,19.03,E,5,7.5,11708.03,10000,0,366.72,409000006042,24-Aug-18,Indiaforensic RUPAY POS C2 ACQ24,,410319.22,-539594330.50,Godfrey,727,France,173486.39,0,1,0
6044,2011,1,MORTGAGE,3,Medium,2,24000, 60 months,2,home_improvement,7,Low,1,Bad Loan,1,11.71,B,2,16.71,11851.24,3092.23,6552.54,530.36,409000006043,24-Aug-18,TRF TO  Indiaforensic SERVICES I,"5,500,000.00",,-545094330.50,Gratton,629,France,93881.75,0,1,0
6045,2011,0.5,MORTGAGE,3,Low,1,5000, 36 months,1,small_business,3,Low,1,Good Loan,0,6.03,A,1,4.88,5451.168773,5000,0,152.18,409000006044,24-Aug-18,Indiaforensic VISA ACQ INT 21081,,5046.07,-545089284.43,Manning,684,France,36376.97,0,1,0
6046,2011,10,OWN,2,Low,1,1000, 36 months,1,debt_consolidation,6,Low,1,Good Loan,0,6.62,A,1,7.03,1056.58,1000,0,30.71,409000006045,24-Aug-18,Indiaforensic VISA ACQ INT 22081,,53908.43,-545035376.00,Mazzi,549,Germany,128499.94,0,1,0
6047,2011,0.5,OWN,2,Low,1,2500, 36 months,1,small_business,3,High,2,Good Loan,0,14.27,C,3,15.84,3041.22,2500,0,85.78,409000006046,24-Aug-18,Indiaforensic MASTER INT 230818,,3256.98,-545032119.02,Wall,593,Germany,105898.69,0,1,0
6048,2011,5,RENT,1,Low,1,5000, 36 months,1,small_business,3,Low,1,Good Loan,0,7.9,A,1,4.41,5646.679849,5000,0,156.46,409000006047,24-Aug-18,TRF TO  Indiaforensic SERVICES I,"3,180,000.00",,-548212119.02,Sims,536,Spain,11959.03,0,1,0
6049,2011,2,RENT,1,Low,1,10000, 36 months,1,wedding,5,Low,1,Good Loan,0,12.42,B,2,11.91,11151.29,10000,0,334.16,409000006048,27-Aug-18,Indiaforensic VISA ACQ DOM250818,,2923178.17,-545288940.85,Allan,707,France,98810.78,0,1,0
6050,2011,3,RENT,1,Low,1,10000, 60 months,2,debt_consolidation,6,Low,1,Bad Loan,1,10.65,B,2,24.34,9274.67,6602.87,12.04,215.69,409000006049,27-Aug-18,Indiaforensic RUPAY POS ACQ25081,,1771847.06,-543517093.79,Griffen,592,Spain,65906.07,0,1,0
6051,2011,6,RENT,1,Medium,2,15000, 36 months,1,small_business,3,High,2,Good Loan,0,15.27,C,3,7.85,18786.55042,15000,0,521.97,409000006050,27-Aug-18,Indiaforensic RUPAY POS ACQ26081,,3327441.43,-540189652.36,Russell,703,France,151516.70,0,1,0
6052,2011,6,MORTGAGE,3,Low,1,12000, 60 months,2,debt_consolidation,6,High,2,Good Loan,0,14.27,C,3,20.63,14321.65,9613.7,0,280.91,409000006051,27-Aug-18,Indiaforensic VISA ACQ DOM270818,,7371878.89,-532817773.47,Brown,723,Spain,37214.39,0,1,0
6053,2011,6,MORTGAGE,3,Low,1,6000, 36 months,1,debt_consolidation,6,Low,1,Good Loan,0,7.51,A,1,8.74,6630.68,5999.99,0,186.67,409000006052,27-Aug-18,Indiaforensic RUPAY POS ACQ27081,,2520143.87,-530297629.60,Palerma,452,Germany,92033.98,0,1,0
6054,2011,0.5,RENT,1,Medium,2,9000, 36 months,1,debt_consolidation,6,High,2,Bad Loan,1,14.65,C,3,1.37,8495.47,6134.9,397.1,310.45,409000006053,27-Aug-18,Indiaforensic RUPAY POS C2 ACQ27,,579344.56,-529718285.04,Gilbert,552,Spain,195692.30,0,1,0
6055,2011,3,RENT,1,Low,1,5000, 36 months,1,debt_consolidation,6,High,2,Good Loan,0,14.65,C,3,17.41,6148.55218,5000,0,172.48,409000006054,27-Aug-18,Indiaforensic MASTER ACQ DOM25-2,,9268664.96,-520449620.08,Uvarov,633,France,6342.84,0,1,0
6056,2011,1,RENT,1,Low,1,25000, 60 months,2,debt_consolidation,6,High,2,Good Loan,0,19.03,E,5,15.05,33062.39,19581.3,0,648.93,409000006055,27-Aug-18,TRF TO  Indiaforensic SERVICES I,"3,000,000.00",,-523449620.08,Wisdom,479,Germany,95148.28,0,1,0
6057,2011,2,RENT,1,Low,1,20000, 60 months,2,debt_consolidation,6,High,2,Good Loan,0,17.27,D,4,11.84,21679.68,20000,0,499.96,409000006056,27-Aug-18,TRF TO  Indiaforensic SERVICES I,"15,000,000.00",,-538449620.08,Hussain,768,France,21215.67,0,1,0
6058,2011,2,MORTGAGE,3,Low,1,10400, 60 months,2,home_improvement,7,High,2,Bad Loan,1,21.67,F,6,0.77,2579.08,400.19,1439.16,285.29,409000006057,27-Aug-18,TRF TO  Indiaforensic SERVICES I,"9,700,000.00",,-548149620.08,Woods,742,France,19700.24,0,1,0
6059,2011,4,RENT,1,Medium,2,15000, 36 months,1,other,4,Low,1,Bad Loan,1,12.69,B,2,4.73,12863.55,9346.32,801.63,503.18,409000006058,28-Aug-18,Indiaforensic MASTER ACQ DOM2808,,2937776.19,-545211843.89,Cameron,668,Germany,134396.64,0,1,0
6060,2011,10,MORTGAGE,3,Low,1,3000, 36 months,1,debt_consolidation,6,Low,1,Good Loan,0,6.03,A,1,14.26,3240,3000,0,91.31,409000006059,28-Aug-18,Indiaforensic VISA ACQ DOM280818,,3866649.81,-541345194.08,Mai,707,Spain,135077.01,0,1,0
6061,2011,5,MORTGAGE,3,Low,1,4000, 36 months,1,small_business,3,Low,1,Good Loan,0,6.62,A,1,8.67,4081.6,4000,0,122.82,409000006060,28-Aug-18,Indiaforensic RUPAY POS ACQ28081,,2107692.96,-539237501.12,Gibson,754,Spain,133600.89,0,1,0
6062,2011,2,RENT,1,Low,1,2000, 36 months,1,vacation,11,Low,1,Bad Loan,1,11.71,B,2,16.12,1185.66,908.98,0,66.16,409000006061,28-Aug-18,Indiaforensic VISA ACQ INT 23081,,2514.18,-539234986.94,Grigoryeva,544,Germany,99922.08,0,1,0
6063,2011,4,RENT,1,Low,1,3600, 36 months,1,medical,9,Low,1,Good Loan,0,7.9,A,1,4.4,4054.133484,3600,0,112.65,409000006062,28-Aug-18,Indiaforensic MASTER INT 25-2708,,3042.21,-539231944.73,Gunter,718,Spain,41399.33,0,1,0
6064,2011,4,OWN,2,Low,1,26375, 60 months,2,major_purchase,8,Low,1,Good Loan,0,10.65,B,2,28.32,28981.85,21455.35,0,568.87,409000006063,28-Aug-18,TRF TO  Indiaforensic SERVICES I,"9,000,000.00",,-548231944.73,Arcuri,762,France,159344.43,0,1,0
6065,2011,10,RENT,1,Low,1,20000, 60 months,2,debt_consolidation,6,High,2,Good Loan,0,17.58,D,4,16.36,27045.17901,20000,0,503.32,409000006064,28-Aug-18,Indiaforensic VISA ACQ INT 24081,,505.48,-548231439.25,Tung,772,France,18364.19,0,1,0
6066,2011,5,RENT,1,Low,1,13600, 36 months,1,debt_consolidation,6,Low,1,Good Loan,0,6.03,A,1,22.94,14152.03,13600,0,413.93,409000006065,28-Aug-18,Indiaforensic RUPAY POS C2 ACQ28,,463026.31,-547768412.94,Smith,691,Germany,98162.44,0,1,0
6067,2011,10,MORTGAGE,3,Low,1,3000, 36 months,1,other,4,Low,1,Bad Loan,1,7.9,A,1,18.03,1625.79,1243.43,127.39,93.88,409000006066,29-Aug-18,Indiaforensic VISA ACQ DOM290818,,3456562.43,-544311850.51,Lori,502,France,84663.21,0,1,0
6068,2011,3,MORTGAGE,3,Low,1,8250, 36 months,1,home_improvement,7,Low,1,Good Loan,0,7.51,A,1,28.05,8626.57,8250,0,256.67,409000006067,29-Aug-18,Indiaforensic RUPAY POS ACQ29081,,1938212.68,-542373637.83,Chidimma,563,France,36536.93,0,1,0
6069,2011,1,MORTGAGE,3,Low,1,5500, 36 months,1,home_improvement,7,High,2,Good Loan,0,13.49,C,3,1.34,6715.692391,5500,0,186.62,409000006068,29-Aug-18,Indiaforensic MASTER ACQ DOM2908,,2857275.74,-539516362.09,Ting,676,France,79101.67,0,1,0
6070,2011,2,RENT,1,Low,1,20000, 36 months,1,debt_consolidation,6,Low,1,Good Loan,0,9.91,B,2,12.04,22511.25,20000,0,644.5,409000006069,29-Aug-18,TRF FROM  Indiaforensic SERVICES,"8,700,000.00",,-548216362.09,Tsao,576,Spain,16644.16,0,1,0
6071,2011,10,RENT,1,Low,1,34475, 60 months,2,other,4,High,2,Good Loan,0,14.27,C,3,29.56,36114.92,34475,0,807.01,409000006070,29-Aug-18,Indiaforensic RUPAY POS C2 ACQ29,,601630.01,-547614732.08,Collee,629,Spain,158420.14,0,1,0
6072,2011,5,MORTGAGE,3,Low,1,5000, 36 months,1,home_improvement,7,Low,1,Good Loan,0,12.69,B,2,20.69,6039.370816,5000,0,167.73,409000006071,29-Aug-18,Indiaforensic MASTER INT 280818,,3573.96,-547611158.12,Lettiere,625,Spain,48988.28,0,1,0
6073,2011,0.5,OWN,2,Low,1,10075, 60 months,2,small_business,3,Low,1,Good Loan,0,12.42,B,2,25.87,13013.29291,10075,0,226.26,409000006072,29-Aug-18,Indiaforensic VISA ACQ INT 25081,,1463.72,-547609694.40,Fu,628,France,96862.56,0,1,0
6074,2011,8,MORTGAGE,3,Low,1,23325, 60 months,2,medical,9,High,2,Good Loan,0,17.58,D,4,23.48,23667.3,23325,0,586.99,409000006073,29-Aug-18,Indiaforensic VISA ACQ INT 26081,,31823.05,-547577871.35,Bergamaschi,471,Germany,96366.70,0,1,0
6075,2011,10,MORTGAGE,3,Low,1,32000, 60 months,2,debt_consolidation,6,Low,1,Good Loan,0,11.71,B,2,23.65,40434.77488,32000,0,707.15,409000006074,29-Aug-18,Indiaforensic VISA ACQ INT 27081,,2021.94,-547575849.41,Dyer,811,France,146123.19,0,1,0
6076,2011,6,OWN,2,Low,1,14000, 60 months,2,car,2,Low,1,Good Loan,0,7.9,A,1,9.04,14092.27,14000,0,283.2,409000006075,30-Aug-18,Indiaforensic VISA ACQ DOM300818,,3662754.29,-543913095.12,Buccho,504,France,135178.91,0,1,0
6077,2011,10,MORTGAGE,3,Medium,2,16000, 36 months,1,debt_consolidation,6,High,2,Good Loan,0,13.49,C,3,23.9,19415.51969,16000,0,542.89,409000006076,30-Aug-18,Indiaforensic RUPAY POS ACQ30081,,1692205.26,-542220889.86,Jones,687,France,158615.41,0,1,0
6078,2011,2,OWN,2,Low,1,3600, 36 months,1,home_improvement,7,Low,1,Good Loan,0,11.71,B,2,13.95,4284.267836,3600,0,119.08,409000006077,30-Aug-18,Indiaforensic MASTER ACQ DOM3008,,3087297.88,-539133591.98,Nebechi,660,Germany,71433.88,0,1,0
6079,2011,9,RENT,1,Low,1,12000, 36 months,1,house,12,Low,1,Good Loan,0,7.9,A,1,4.06,13509.02054,12000,0,375.49,409000006078,30-Aug-18,Indiaforensic RUPAY POS C2 ACQ30,,655832.55,-538477759.43,Ibekwe,548,France,55672.09,0,1,0
6080,2011,0.5,RENT,1,Low,1,6400, 36 months,1,debt_consolidation,6,Low,1,Good Loan,0,9.91,B,2,19.99,7444.612908,6400,0,206.24,409000006079,30-Aug-18,Indiaforensic VISA ACQ INT 28081,,4372.39,-538473387.04,Gorshkov,609,Germany,150218.11,0,1,0
6081,2011,8,OWN,2,Low,1,8000, 36 months,1,debt_consolidation,6,Low,1,Good Loan,0,9.91,B,2,14.09,9266.077664,8000,0,257.8,409000006080,30-Aug-18,TRF TO  Indiaforensic SERVICES I,"9,100,000.00",,-547573387.04,Nweke,659,Spain,162734.31,0,1,0
6082,2011,1,RENT,1,Low,1,1000, 36 months,1,debt_consolidation,6,Low,1,Good Loan,0,11.71,B,2,3.28,1189.839148,1000,0,33.08,409000006081,30-Aug-18,TRF TO  Indiaforensic SERVICES I,"600,000.00",,-548173387.04,Hairston,526,France,21228.71,0,1,0
6083,2011,2,MORTGAGE,3,Low,1,35000, 60 months,2,other,4,High,2,Good Loan,0,19.91,E,5,14.22,48746.83,35000,0,925.54,409000006082,31-Aug-18,Indiaforensic VISA ACQ DOM310818,,4019263.03,-544154124.01,Loggia,725,Germany,62027.90,0,1,0
6084,2011,5,RENT,1,Low,1,10000, 36 months,1,wedding,5,Low,1,Good Loan,0,6.03,A,1,16.37,10914.29983,10000,0,304.36,409000006083,31-Aug-18,Indiaforensic RUPAY POS ACQ31081,,1581449.02,-542572674.99,Morgan,519,Germany,60988.21,0,1,0
6085,2011,5,MORTGAGE,3,Low,1,3100, 36 months,1,credit_card,1,Low,1,Bad Loan,1,7.51,A,1,17.55,2721.58,2243.06,135.52,96.45,409000006084,31-Aug-18,Indiaforensic MASTER ACQ DOM3108,,2681385.66,-539891289.33,Abdulov,562,Germany,108675.01,0,1,0
6086,2011,9,MORTGAGE,3,Low,1,1500, 36 months,1,other,4,Low,1,Good Loan,0,12.42,B,2,19.78,1515.57,1500,0,50.13,409000006085,31-Aug-18,Indiaforensic MASTER INT 300818,,1014.64,-539890274.69,Norris,482,Germany,72643.95,0,1,0
6087,2011,10,RENT,1,Low,1,14000, 60 months,2,debt_consolidation,6,High,2,Good Loan,0,14.27,C,3,17.75,16702.57,11198.71,0,327.72,409000006086,31-Aug-18,Indiaforensic RUPAY POS C2 ACQ31,,606218.89,-539284055.80,Clark,535,Spain,9241.52,0,1,0
6088,2011,0.5,RENT,1,Low,1,3400, 36 months,1,debt_consolidation,6,High,2,Good Loan,0,13.49,C,3,16.09,3851.46,3400,0,115.37,409000006087,31-Aug-18,FUNDS TRF  Indiaforensic SERVICE,"8,300,000.00",,-547584055.80,Chukwudi,561,France,153080.40,0,1,0
6089,2011,6.05,OWN,2,Low,1,16000, 36 months,1,debt_consolidation,6,Low,1,Good Loan,0,8.9,A,1,20.33,17389.98,16000,0,508.06,409000006088,31-Aug-18,TRF TO  Indiaforensic SERVICES I,"600,000.00",,-548184055.80,Perkin,661,France,72196.57,0,1,0
6090,2011,2,RENT,1,Low,1,7000, 36 months,1,medical,9,Low,1,Good Loan,0,7.51,A,1,7.55,7837.316437,7000,0,217.78,409000006089,1-Sep-18,Indiaforensic RUPAY POS ACQ01091,,1452754.86,-546731300.94,Ch'ang,771,France,199527.34,0,1,0
6091,2011,1,MORTGAGE,3,High,3,35000, 60 months,2,credit_card,1,High,2,Good Loan,0,22.35,F,6,3.6,49618.68,26984.69,0,973.64,409000006090,1-Sep-18,Indiaforensic VISA ACQ DOM010918,,4037598.98,-542693701.96,Kang,545,France,156598.23,0,1,0
6092,2011,6,MORTGAGE,3,Medium,2,14400, 60 months,2,debt_consolidation,6,High,2,Good Loan,0,19.03,E,5,10.88,19888.83,12113.82,0,373.79,409000006091,1-Sep-18,TRF TO  Indiaforensic SERVICES I,"2,000,000.00",,-544693701.96,Chukwudi,850,Germany,74917.64,0,1,0
6093,2011,3,MORTGAGE,3,Low,1,20000, 60 months,2,other,4,High,2,Bad Loan,1,19.91,E,5,19.65,8888.15,3323.68,957.95,528.88,409000006092,1-Sep-18,TRF TO  Indiaforensic SERVICES I,"3,000,000.00",,-547693701.96,Frolova,601,Germany,111249.62,0,1,0
6094,2011,1,RENT,1,Low,1,12000, 36 months,1,debt_consolidation,6,Low,1,Good Loan,0,6.03,A,1,6.79,13039.36,12000,0,365.23,409000006093,1-Sep-18,TRF TO  Indiaforensic SERVICES I,"500,000.00",,-548193701.96,Chiu,712,Germany,59115.77,0,1,0
6095,2011,10,MORTGAGE,3,Low,1,14000, 60 months,2,credit_card,1,High,2,Good Loan,0,14.27,C,3,18.37,16705.6,11213.92,0,327.72,409000006094,1-Sep-18,Indiaforensic RUPAY POS C2 ACQ01,,611814.84,-547581887.12,Simpson,589,France,148218.86,0,1,0
6096,2011,10,MORTGAGE,3,Low,1,2500, 36 months,1,debt_consolidation,6,Low,1,Good Loan,0,11.71,B,2,2.4,2970.17379,2500,0,82.69,409000006095,1-Sep-18,TRF TO  Indiaforensic SERVICES I,"500,000.00",,-548081887.12,McLean,600,Spain,77142.32,0,1,0
6097,2011,10,RENT,1,Low,1,10000, 36 months,1,other,4,Low,1,Good Loan,0,6.62,A,1,16.38,11041.80999,10000,0,307.04,409000006096,3-Sep-18,Indiaforensic RUPAY POS ACQ03091,,2323065.00,-545758822.12,Hu,642,Germany,67484.60,0,1,0
6098,2011,10,MORTGAGE,3,Medium,2,20000, 60 months,2,home_improvement,7,Low,1,Good Loan,0,12.42,B,2,5.09,25460.85646,20000,0,449.15,409000006097,3-Sep-18,Indiaforensic RUPAY POS ACQ02091,,2028367.81,-543730454.31,Savage,575,Germany,63452.18,0,1,0
6099,2011,3,RENT,1,Low,1,4000, 36 months,1,house,12,Low,1,Good Loan,0,11.71,B,2,8.9,4776.327759,4000,0,132.31,409000006098,3-Sep-18,Indiaforensic VISA ACQ DOM030918,,7174743.68,-536555710.63,Wallace,570,Germany,103660.31,0,1,0
6100,2011,10,MORTGAGE,3,Low,1,8000, 36 months,1,car,2,Low,1,Good Loan,0,6.03,A,1,2.5,8765.176811,8000,0,243.49,409000006099,3-Sep-18,Indiaforensic MASTER ACQ DOM0309,,9897149.02,-526658561.61,Winter,532,Germany,163191.99,0,1,0
6101,2011,3,RENT,1,Low,1,18400, 36 months,1,debt_consolidation,6,Low,1,Good Loan,0,9.91,B,2,13.75,21343.18087,18400,0,592.94,409000006100,3-Sep-18,Indiaforensic MASTER INT 310818,,1016.83,-526657544.78,Ho,796,France,62905.29,0,1,0
6102,2011,10,MORTGAGE,3,Low,1,17000, 36 months,1,debt_consolidation,6,Low,1,Good Loan,0,7.51,A,1,12.54,18988.20988,17000,0,528.89,409000006101,3-Sep-18,TRF TO  Indiaforensic SERVICES I,"10,000,000.00",,-536657544.78,Su,833,Spain,44323.22,0,1,0
6103,2011,5,MORTGAGE,3,Medium,2,20000, 36 months,1,credit_card,1,Low,1,Good Loan,0,10.65,B,2,12.5,23330.85119,20000,0,651.47,409000006102,3-Sep-18,TRF TO  Indiaforensic SERVICES I,"10,000,000.00",,-546657544.78,Li Fonti,642,Spain,97938.59,0,1,0
6104,2011,10,RENT,1,Low,1,1200, 36 months,1,vacation,11,Low,1,Good Loan,0,8.9,A,1,9.15,1371.367832,1200,0,38.11,409000006103,3-Sep-18,TRF TO  Indiaforensic SERVICES I,"1,000,000.00",,-547657544.78,Ives,655,France,126565.21,0,1,0
6105,2011,3,RENT,1,Low,1,4950, 36 months,1,debt_consolidation,6,Low,1,Good Loan,0,8.9,A,1,14.96,5342.65,4950,0,157.18,409000006104,3-Sep-18,TRF TO  Indiaforensic SERVICES I,"500,000.00",,-548157544.78,Trevisani,736,Germany,185360.40,0,1,0
6106,2011,6.05,MORTGAGE,3,Low,1,1500, 36 months,1,other,4,Low,1,Good Loan,0,10.65,B,2,10.45,1556.33,1500,0,48.86,409000006105,3-Sep-18,Indiaforensic RUPAY POS C2 ACQ03,,727402.53,-547430142.25,Bond,617,France,183229.02,0,1,0
6107,2011,9,RENT,1,Low,1,3000, 36 months,1,debt_consolidation,6,Low,1,Good Loan,0,11.71,B,2,3.18,3543.796187,3000,0,99.23,409000006106,3-Sep-18,TRF TO  Indiaforensic SERVICES I,"500,000.00",,-547930142.25,Lettiere,762,Germany,106024.02,0,1,0
6108,2011,10,MORTGAGE,3,Medium,2,5700, 60 months,2,other,4,High,2,Good Loan,0,18.64,E,5,5.47,7479.82,4474.88,0,146.74,409000006107,4-Sep-18,Indiaforensic MASTER ACQ DOM0409,,2975294.11,-544954848.14,Houghton,703,Germany,167810.26,0,1,0
6109,2011,3,RENT,1,Low,1,5000, 36 months,1,debt_consolidation,6,High,2,Bad Loan,1,18.25,D,4,15.83,2903.47,1757.73,186.22,181.39,409000006108,4-Sep-18,Indiaforensic VISA ACQ DOM040918,,3810101.92,-541144746.22,Lei,507,France,138536.09,0,1,0
6110,2011,10,RENT,1,Low,1,15000, 60 months,2,medical,9,High,2,Bad Loan,1,14.27,C,3,13.84,4208.64,2211.58,0,351.13,409000006109,4-Sep-18,Indiaforensic RUPAY POS ACQ04091,,1787794.25,-539356951.97,Stirling,581,Germany,184520.00,0,1,0
6111,2011,2,RENT,1,Medium,2,30000, 36 months,1,debt_consolidation,6,High,2,Good Loan,0,16.29,D,4,11.16,35871.83,30000,0,1059.02,409000006110,4-Sep-18,Indiaforensic RUPAY POS C2 ACQ04,,625885.12,-538731066.85,Grant,593,France,20492.16,0,1,0
6112,2011,10,OWN,2,Low,1,2000, 36 months,1,credit_card,1,Low,1,Good Loan,0,11.71,B,2,16.56,2380.221525,2000,0,66.16,409000006111,4-Sep-18,Indiaforensic VISA ACQ INT 30081,,2172.07,-538728894.78,Baresi,648,France,134676.72,0,1,0
6113,2011,10,MORTGAGE,3,Low,1,6000, 36 months,1,car,2,Low,1,Good Loan,0,6.03,A,1,7.08,6573.666638,6000,0,182.62,409000006112,4-Sep-18,TRF TO  Indiaforensic SERVICES I,"8,900,000.00",,-547628894.78,Pearce,462,Germany,138478.20,0,1,0
6114,2011,6.05,MORTGAGE,3,Low,1,8000, 36 months,1,debt_consolidation,6,Low,1,Good Loan,0,11.71,B,2,20.8,9522.391241,8000,0,264.61,409000006113,4-Sep-18,TRF TO  Indiaforensic SERVICES I,"500,000.00",,-548128894.78,Rutledge,596,Spain,125557.95,0,1,0
6115,2011,5,MORTGAGE,3,Low,1,22000, 60 months,2,debt_consolidation,6,High,2,Good Loan,0,14.27,C,3,13.48,26253.57,17623.04,0,514.99,409000006114,5-Sep-18,Indiaforensic RUPAY POS ACQ05091,,1933424.86,-546195469.92,Udegbunam,627,France,82969.61,0,1,0
6116,2011,10,MORTGAGE,3,Low,1,4500, 36 months,1,debt_consolidation,6,Low,1,Good Loan,0,7.9,A,1,23.34,4587.44,4500,0,140.81,409000006115,5-Sep-18,Indiaforensic VISA ACQ DOM050918,,3719198.83,-542476271.09,Zaytseva,494,France,158071.69,0,1,0
6117,2011,2,RENT,1,Low,1,15000, 36 months,1,car,2,Low,1,Good Loan,0,6.03,A,1,1.4,16434.74875,15000,0,456.54,409000006116,5-Sep-18,Indiaforensic MASTER ACQ DOM0509,,3099035.19,-539377235.90,Onyemauchechukwu,627,France,43615.67,0,1,0
6118,2011,4,RENT,1,Low,1,6450, 36 months,1,moving,10,Low,1,Bad Loan,1,9.91,B,2,17.62,1638.13,1106.83,186.4,207.86,409000006117,5-Sep-18,Indiaforensic RUPAY POS C2 ACQ05,,503373.11,-538873862.79,Mullah,850,Spain,119969.99,0,1,0
6119,2011,5,MORTGAGE,3,Low,1,5000, 36 months,1,debt_consolidation,6,Low,1,Good Loan,0,6.03,A,1,20.95,5292.99,5000,0,152.18,409000006118,5-Sep-18,Indiaforensic MASTER INT 03-0409,,6123.72,-538867739.07,Candler,632,France,140201.21,0,1,0
6120,2011,7,MORTGAGE,3,Medium,2,25000, 36 months,1,debt_consolidation,6,High,2,Bad Loan,1,14.27,C,3,14.59,15546.72,10651.83,836.96,857.73,409000006119,5-Sep-18,TRF TO  Indiaforensic SERVICES I,"8,800,000.00",,-547667739.07,Konovalova,490,France,80792.83,0,1,0
6121,2011,3,RENT,1,Low,1,2400, 36 months,1,other,4,High,2,Good Loan,0,13.49,C,3,21.44,2680.96,2400,0,81.44,409000006120,5-Sep-18,Indiaforensic VISA ACQ INT 01091,,189.69,-547667549.38,Lei,715,France,141359.11,0,1,0
6122,2011,10,MORTGAGE,3,Low,1,12000, 36 months,1,credit_card,1,Low,1,Good Loan,0,6.62,A,1,14.36,13262.72515,12000,0,368.45,409000006121,5-Sep-18,Indiaforensic VISA ACQ INT 02091,,8130.99,-547659418.39,Hollis,679,France,23344.94,0,1,0
6123,2011,6,MORTGAGE,3,Low,1,10000, 36 months,1,credit_card,1,Low,1,Good Loan,0,11.71,B,2,15.51,11624.29,10000,0,330.76,409000006122,5-Sep-18,TRF TO  Indiaforensic SERVICES I,"500,000.00",,-548159418.39,Lionel,619,France,5075.17,0,1,0
6124,2011,4,MORTGAGE,3,Medium,2,34000, 36 months,1,credit_card,1,Low,1,Good Loan,0,9.91,B,2,23.61,38747.17573,34000,0,1095.65,409000006123,6-Sep-18,Indiaforensic MASTER ACQ DOM0609,,3500828.78,-544658589.61,Francis,465,Spain,95500.98,0,1,0
6125,2011,8,MORTGAGE,3,High,3,20000, 60 months,2,debt_consolidation,6,High,2,Good Loan,0,14.65,C,3,4.4,21449.33,20000,0,472.14,409000006124,6-Sep-18,Indiaforensic VISA ACQ DOM060918,,3779849.68,-540878739.93,Carter,736,Spain,79082.62,0,1,0
6126,2011,6,RENT,1,High,3,31700, 60 months,2,debt_consolidation,6,High,2,Good Loan,0,20.89,F,6,17.62,42685.73,23869.8,0,855.64,409000006125,6-Sep-18,Indiaforensic RUPAY POS ACQ06091,,1790930.88,-539087809.05,Mai,501,Germany,199805.63,0,1,0
6127,2011,8,RENT,1,Medium,2,7500, 36 months,1,debt_consolidation,6,High,2,Good Loan,0,16.29,D,4,2.25,9224.52,7500,0,264.76,409000006126,6-Sep-18,Indiaforensic MASTER INT 050918,,4031.54,-539083777.51,Johnson,535,France,52709.55,0,1,0
6128,2011,8,MORTGAGE,3,Low,1,3800, 36 months,1,car,2,Low,1,Good Loan,0,8.9,A,1,15.82,4311.54,3800,0,120.67,409000006127,6-Sep-18,TRF TO  Indiaforensic SERVICES I,"9,100,000.00",,-548183777.51,Sherman,759,France,56583.88,0,1,0
6129,2011,6,MORTGAGE,3,Low,1,8000, 36 months,1,debt_consolidation,6,Low,1,Good Loan,0,6.62,A,1,25.31,8841.742812,8000,0,245.63,409000006128,6-Sep-18,Indiaforensic RUPAY POS C2 ACQ06,,560611.28,-547623166.23,Sabbatini,819,France,3385.04,0,1,0
6130,2011,6,MORTGAGE,3,Low,1,6000, 36 months,1,medical,9,Low,1,Good Loan,0,8.9,A,1,19.02,6853.643633,6000,0,190.52,409000006129,7-Sep-18,Indiaforensic VISA ACQ DOM070918,,3782758.89,-543840407.34,Shih,533,Germany,12537.42,0,1,0
6131,2011,6,MORTGAGE,3,Low,1,6000, 36 months,1,credit_card,1,Low,1,Bad Loan,1,10.65,B,2,12.33,4685.12,3778.7,0,195.44,409000006130,7-Sep-18,Indiaforensic RUPAY POS ACQ07091,,1673134.21,-542167273.13,Yao,632,Germany,64722.61,0,1,0
6132,2011,4,RENT,1,Low,1,8875, 36 months,1,debt_consolidation,6,Low,1,Good Loan,0,6.62,A,1,24.32,9808.439812,8875,0,272.5,409000006131,7-Sep-18,Indiaforensic MASTER INT 060918,,2537.04,-542164736.09,Ko,686,France,75246.21,0,1,0
6133,2011,5,RENT,1,Low,1,3500, 36 months,1,debt_consolidation,6,Low,1,Good Loan,0,7.9,A,1,16.36,3649.46,3500,0,109.52,409000006132,7-Sep-18,Indiaforensic VISA ACQ INT 05091,,426.58,-542164309.51,Kazakova,687,France,198929.84,0,1,0
6134,2011,2,RENT,1,High,3,35000, 60 months,2,debt_consolidation,6,High,2,Good Loan,0,19.42,E,5,11.29,52189.50997,35000,0,916.03,409000006133,7-Sep-18,Indiaforensic RUPAY POS C2 ACQ07,,582582.43,-541581727.08,Chiganu,667,Germany,69011.66,0,1,0
6135,2011,10,RENT,1,High,3,35000, 36 months,1,house,12,Low,1,Good Loan,0,8.9,A,1,6.57,39644.62,35000,0,1111.37,409000006134,7-Sep-18,Indiaforensic MASTER ACQ DOM0709,,3335038.44,-538246688.64,Nucci,699,Spain,52404.47,0,1,0
6136,2011,10,MORTGAGE,3,Low,1,27300, 60 months,2,credit_card,1,High,2,Good Loan,0,21.67,F,6,18.37,37449,20413.91,0,748.89,409000006135,7-Sep-18,TRF TO  Indiaforensic SERVICES I,"6,100,000.00",,-544346688.64,Marsden,497,Spain,163641.53,0,1,0
6137,2011,5,MORTGAGE,3,Medium,2,31200, 60 months,2,debt_consolidation,6,Low,1,Good Loan,0,12.42,B,2,4.03,37332.59,31200,0,700.67,409000006136,7-Sep-18,TRF TO  Indiaforensic SERVICES I,"3,900,000.00",,-548246688.64,Serena,780,Spain,154598.56,0,1,0
6138,2011,6.05,RENT,1,Low,1,4800, 36 months,1,debt_consolidation,6,Low,1,Good Loan,0,6.03,A,1,19.24,5259.020734,4800,0,146.1,409000006137,10-Sep-18,Indiaforensic VISA ACQ DOM080918,,3810469.95,-544436218.69,McLean,652,France,173989.47,0,1,0
6139,2011,1,MORTGAGE,3,Medium,2,7000, 36 months,1,car,2,Low,1,Good Loan,0,6.62,A,1,9.94,7736.236082,7000,0,214.93,409000006138,10-Sep-18,Indiaforensic RUPAY POS ACQ08091,,1899292.19,-542536926.50,Longo,477,France,61315.37,0,1,0
6140,2011,10,RENT,1,Low,1,4200, 36 months,1,debt_consolidation,6,Low,1,Good Loan,0,7.51,A,1,3.74,4412.49,4200,0,130.67,409000006139,10-Sep-18,Indiaforensic RUPAY POS ACQ09091,,2613455.08,-539923471.42,Wilson,652,France,143393.24,0,1,0
6141,2011,5,RENT,1,Low,1,3000, 36 months,1,moving,10,Low,1,Good Loan,0,12.69,B,2,16.54,3582.402742,3000,0,100.64,409000006140,10-Sep-18,TRF TO  Indiaforensic SERVICES I,"2,000,000.00",,-541923471.42,Hsiung,488,France,124210.53,0,1,0
6142,2011,10,MORTGAGE,3,Low,1,5875, 36 months,1,other,4,Low,1,Good Loan,0,6.03,A,1,11.11,6255.3,5875,0,178.81,409000006141,10-Sep-18,TRF TO  Indiaforensic SERVICES I,"3,000,000.00",,-544923471.42,Wright,572,France,151460.84,0,1,0
6143,2011,2,MORTGAGE,3,Low,1,17000, 36 months,1,debt_consolidation,6,Low,1,Good Loan,0,7.51,A,1,3.36,18654.64,17000,0,528.89,409000006142,10-Sep-18,TRF TO  Indiaforensic SERVICES I,"3,000,000.00",,-547923471.42,Folliero,755,France,20734.81,0,1,0
6144,2011,4,OWN,2,Low,1,35000, 60 months,2,debt_consolidation,6,Low,1,Good Loan,0,11.71,B,2,8.31,40977,35000,0,773.44,409000006143,10-Sep-18,Indiaforensic MASTER INT 070918,,2032.59,-547921438.83,Johnston,779,Germany,43705.56,0,1,0
6145,2011,1,RENT,1,Low,1,2000, 36 months,1,debt_consolidation,6,Low,1,Bad Loan,1,12.69,B,2,21.43,1262.46,899.81,62.58,67.09,409000006144,10-Sep-18,Indiaforensic MASTER ACQ DOM1009,,10195651.51,-537725787.32,Palermo,693,Spain,180736.24,0,1,0
6146,2011,0.5,RENT,1,Low,1,18000, 36 months,1,debt_consolidation,6,Low,1,Bad Loan,1,11.71,B,2,10.34,4686.47,3022.21,523.36,595.37,409000006145,10-Sep-18,Indiaforensic RUPAY POS C2 ACQ10,,1648788.83,-536076998.49,Nwabugwu,530,Spain,104170.48,0,1,0
6147,2011,0.5,MORTGAGE,3,Low,1,2000, 36 months,1,small_business,3,Low,1,Good Loan,0,8.9,A,1,4.12,2108.2,2000,0,63.51,409000006146,10-Sep-18,Indiaforensic VISA ACQ DOM100918,,8588677.49,-527488321.00,Endrizzi,738,Spain,27867.59,0,1,0
6148,2011,5,MORTGAGE,3,Medium,2,7000, 36 months,1,debt_consolidation,6,Low,1,Good Loan,0,9.91,B,2,6.42,8106.82927,7000,0,225.58,409000006147,10-Sep-18,Indiaforensic RUPAY POS ACQ10091,,1555893.84,-525932427.16,Tuan,690,Germany,55387.28,0,1,0
6149,2011,4,RENT,1,Low,1,35000, 60 months,2,credit_card,1,Low,1,Good Loan,0,12.42,B,2,10.97,40074.75,28271.63,0,786.01,409000006148,10-Sep-18,Indiaforensic VISA ACQ INT 06091,,4657.67,-525927769.49,Udobata,611,France,196332.45,0,1,0
6150,2011,3,MORTGAGE,3,Low,1,15000, 60 months,2,home_improvement,7,Low,1,Good Loan,0,10.65,B,2,8.84,17864.28,15000,0,323.53,409000006149,10-Sep-18,TRF TO  Indiaforensic SERVICES I,"10,000,000.00",,-535927769.49,Ibezimako,643,Spain,116046.22,0,1,0
6151,2011,0.5,MORTGAGE,3,Low,1,15000, 36 months,1,home_improvement,7,Low,1,Good Loan,0,6.03,A,1,11.65,16434.74875,15000,0,456.54,409000006150,10-Sep-18,TRF TO  Indiaforensic SERVICES I,"10,000,000.00",,-545927769.49,Maclean,632,Germany,93874.87,0,1,0
6152,2011,5,MORTGAGE,3,Low,1,15000, 60 months,2,debt_consolidation,6,High,2,Good Loan,0,18.25,D,4,17.08,21545.61362,15000,0,382.95,409000006151,10-Sep-18,TRFTO  Indiaforensic SERVICES IN,"2,000,000.00",,-547927769.49,Shaw,727,Spain,76614.04,0,1,0
6153,2011,1,MORTGAGE,3,Medium,2,22000, 60 months,2,debt_consolidation,6,Low,1,Good Loan,0,12.69,B,2,0.16,23566.63,22000,0,497.09,409000006152,11-Sep-18,Indiaforensic MASTER ACQ DOM1109,,2908886.79,-545018882.70,Cummins,508,France,6076.62,0,1,0
6154,2011,10,RENT,1,Low,1,12000, 60 months,2,debt_consolidation,6,Low,1,Good Loan,0,7.9,A,1,21,12375.49,9882.44,0,242.75,409000006153,11-Sep-18,Indiaforensic VISA ACQ DOM110918,,3591350.17,-541427532.53,Lavrentiev,550,France,122221.71,0,1,0
6155,2011,9,MORTGAGE,3,Medium,2,7000, 36 months,1,home_improvement,7,Low,1,Good Loan,0,6.03,A,1,2.3,7574.97,7000,0,213.05,409000006154,11-Sep-18,Indiaforensic RUPAY POS ACQ11091,,936400.67,-540491131.86,Saunders,754,Germany,24156.03,0,1,0
6156,2011,7,MORTGAGE,3,Low,1,22000, 36 months,1,debt_consolidation,6,Low,1,Good Loan,0,7.51,A,1,16.15,24635.97164,22000,0,684.44,409000006155,11-Sep-18,TRF TO  Indiaforensic SERVICES I,"7,700,000.00",,-548191131.86,Fiorentino,759,France,135394.62,0,1,0
6157,2011,1,RENT,1,Low,1,1875, 36 months,1,credit_card,1,High,2,Good Loan,0,13.49,C,3,18.83,2299.791373,1875,0,63.62,409000006156,11-Sep-18,Indiaforensic MASTER INT 100918,,2552.71,-548188579.15,Knight,794,Spain,91340.02,0,1,0
6158,2011,2,MORTGAGE,3,Medium,2,12000, 36 months,1,other,4,High,2,Bad Loan,1,15.27,C,3,17.91,3497.51,1923.56,578.86,417.58,409000006157,11-Sep-18,Indiaforensic RUPAY POS C2 ACQ11,,655208.10,-547533371.05,Manfrin,549,France,146090.38,0,1,0
6159,2011,5,MORTGAGE,3,Low,1,10000, 36 months,1,major_purchase,8,Low,1,Good Loan,0,6.62,A,1,17.79,11046.86755,10000,0,307.04,409000006158,11-Sep-18,TRFT O  Indiaforensic SERVICES I,"700,000.00",,-548233371.05,Zetticci,671,France,172096.08,0,1,0
6160,2011,5,RENT,1,Low,1,15500, 60 months,2,debt_consolidation,6,High,2,Good Loan,0,13.49,C,3,22.46,18181.66,12462.19,0,356.58,409000006159,12-Sep-18,Indiaforensic VISA ACQ DOM120918,,4889386.57,-543343984.48,Angelo,756,Germany,135034.57,0,1,0
6161,2011,9,MORTGAGE,3,Low,1,16300, 60 months,2,debt_consolidation,6,High,2,Bad Loan,1,20.3,E,5,19.93,14775.72,7206.05,29.12,434.58,409000006160,12-Sep-18,Indiaforensic RUPAY POS ACQ12091,,2483737.13,-540860247.35,Zhdanov,632,France,84008.66,0,1,0
6162,2011,7,MORTGAGE,3,Low,1,4800, 36 months,1,debt_consolidation,6,Low,1,Good Loan,0,10.65,B,2,6.95,5626.703405,4800,0,156.36,409000006161,12-Sep-18,Indiaforensic MASTER ACQ DOM1209,,2844050.08,-538016197.27,Peck,579,France,91763.67,0,1,0
6163,2011,2,MORTGAGE,3,Low,1,15850, 60 months,2,other,4,High,2,Good Loan,0,18.64,E,5,23.44,20790.21,12438.39,0,408.03,409000006162,12-Sep-18,TRF TO  Indiaforensic SERVICES I,"7,400,000.00",,-545416197.27,Uwaezuoke,748,France,137001.10,0,1,0
6164,2011,5,RENT,1,Low,1,12550, 60 months,2,debt_consolidation,6,Low,1,Good Loan,0,11.71,B,2,16.23,14136.22,10166.89,0,277.34,409000006163,12-Sep-18,TRF TO  Indiaforensic SERVICES I,"2,700,000.00",,-548116197.27,White,488,Germany,106799.49,0,1,0
6165,2011,1,RENT,1,Low,1,5200, 36 months,1,debt_consolidation,6,High,2,Good Loan,0,15.96,C,3,9.89,6572.187865,5200,0,182.72,409000006164,13-Sep-18,Indiaforensic RUPAY POS ACQ13091,,1803361.41,-546312835.86,Greco,710,Germany,10494.64,0,1,0
6166,2011,6.05,MORTGAGE,3,Low,1,29700, 60 months,2,debt_consolidation,6,High,2,Good Loan,0,19.91,E,5,24.29,33137.53,29700,0,785.39,409000006165,13-Sep-18,Indiaforensic RUPAY POS C2 ACQ12,,1461479.98,-544851355.88,Chu,619,Spain,79866.73,0,1,0
6167,2011,6,MORTGAGE,3,Low,1,4800, 36 months,1,other,4,Low,1,Good Loan,0,7.51,A,1,15.33,5374.386753,4800,0,149.34,409000006166,13-Sep-18,Indiaforensic RUPAY POS C2 ACQ13,,889359.55,-543961996.33,Kodilinyechukwu,773,France,186172.85,0,1,0
6168,2011,4,MORTGAGE,3,Low,1,12000, 36 months,1,home_improvement,7,High,2,Bad Loan,1,15.27,C,3,17.7,5345.08,1922.17,2428.53,417.58,409000006167,13-Sep-18,TRF TO  Indiaforensic SERVICES I,"4,300,000.00",,-548261996.33,Scott,657,Spain,91673.60,0,1,0
6169,2011,3,RENT,1,Low,1,5000, 36 months,1,other,4,Low,1,Good Loan,0,6.03,A,1,16.27,5477.330992,5000,0,152.18,409000006168,14-Sep-18,Indiaforensic VISA ACQ DOM130918,,5547889.69,-542714106.64,Enyinnaya,579,France,18458.20,0,1,0
6170,2011,1,RENT,1,Low,1,11725, 60 months,2,debt_consolidation,6,High,2,Bad Loan,1,20.89,F,6,4.7,1970.23,581.01,389.83,316.48,409000006169,14-Sep-18,Indiaforensic VISA ACQ DOM140918,,5194622.45,-537519484.19,Hao,542,France,8342.35,0,1,0
6171,2011,4,MORTGAGE,3,Medium,2,12000, 36 months,1,credit_card,1,Low,1,Good Loan,0,6.62,A,1,18.27,13262.46631,12000,0,368.45,409000006170,14-Sep-18,Indiaforensic MASTER INT 120918,,851.36,-537518632.83,McElhone,709,France,138578.37,0,1,0
6172,2011,0.5,RENT,1,Low,1,12000, 60 months,2,debt_consolidation,6,High,2,Good Loan,0,19.91,E,5,15.69,14764.4,12000,0,317.33,409000006171,14-Sep-18,TRFT O  Indiaforensic SERVICES I,"10,000,000.00",,-547518632.83,Ko,617,Spain,38129.22,0,1,0
6173,2011,0.5,RENT,1,Low,1,17500, 60 months,2,medical,9,Low,1,Good Loan,0,11.71,B,2,19.65,19709.56,14175.17,0,386.72,409000006172,14-Sep-18,Indiaforensic RUPAY POS ACQ14091,,1897124.31,-545621508.52,Day,568,Germany,107155.40,0,1,0
6174,2011,2,OWN,2,Low,1,15000, 36 months,1,debt_consolidation,6,Low,1,Good Loan,0,7.9,A,1,13.4,16895.71906,15000,0,469.36,409000006173,14-Sep-18,Indiaforensic MASTER ACQ DOM1409,,6878167.60,-538743340.92,Harris,769,France,29792.11,0,1,0
6175,2011,10,MORTGAGE,3,Low,1,30000, 36 months,1,debt_consolidation,6,Low,1,Good Loan,0,10.65,B,2,24.52,35174.46461,30000,0,977.2,409000006174,14-Sep-18,TRFT O  Indiaforensic SERVICES I,"700,000.00",,-539443340.92,Gerald,608,Germany,7063.60,0,1,0
6176,2011,10,RENT,1,Low,1,30000, 60 months,2,debt_consolidation,6,High,2,Good Loan,0,16.77,D,4,24.4,35781,30000,0,741.88,409000006175,14-Sep-18,Indiaforensic VISA ACQ INT 09091,,7873.94,-539435466.98,Nebeuwa,503,Spain,21645.06,0,1,0
6177,2011,7,MORTGAGE,3,Low,1,12000, 60 months,2,other,4,Low,1,Good Loan,0,8.9,A,1,24.64,12665.84,9838.01,0,248.52,409000006176,14-Sep-18,Indiaforensic VISA ACQ INT 11091,,610.91,-539434856.07,Kaodilinakachukwu,608,Germany,137079.86,0,1,0
6178,2011,7,RENT,1,Low,1,7200, 36 months,1,car,2,Low,1,Bad Loan,1,8.9,A,1,18.72,5844.57,4580.3,362.49,228.63,409000006177,14-Sep-18,Indiaforensic RUPAY POS C2 ACQ14,,727827.14,-538707028.93,Maruff,731,Germany,172718.35,0,1,0
6179,2011,3,MORTGAGE,3,Low,1,14400, 36 months,1,debt_consolidation,6,Low,1,Bad Loan,1,11.71,B,2,17.57,3718.42,1360.65,1816.38,476.3,409000006178,14-Sep-18,TRF TO  Indiaforensic SERVICES I,"8,800,000.00",,-547507028.93,Howe,850,Germany,106691.02,0,1,0
6180,2011,4,MORTGAGE,3,Low,1,12000, 36 months,1,debt_consolidation,6,Low,1,Good Loan,0,11.71,B,2,17.52,12858.14,12000,0,396.92,409000006179,15-Sep-18,Indiaforensic VISA ACQ DOM150918,,4484441.34,-543022587.59,Knepper,591,Germany,72274.84,0,1,0
6181,2011,1,RENT,1,Low,1,10000, 36 months,1,small_business,3,Low,1,Good Loan,0,12.69,B,2,10.84,11800.88,10000,0,335.45,409000006180,15-Sep-18,Indiaforensic RUPAY POS ACQ15091,,2054952.63,-540967634.96,Fennell,579,Spain,32246.63,0,1,0
6182,2011,6.05,RENT,1,Low,1,5000, 36 months,1,debt_consolidation,6,Low,1,Good Loan,0,12.42,B,2,8.59,5421.32,5000,0,167.08,409000006181,15-Sep-18,TRF TO  Indiaforensic SERVICES I,"2,000,000.00",,-542967634.96,T'ao,570,France,80552.36,0,1,0
6183,2011,1,RENT,1,Low,1,3500, 36 months,1,debt_consolidation,6,Low,1,Good Loan,0,11.71,B,2,23.31,4126.24,3500,0,115.77,409000006182,15-Sep-18,TRF TO  Indiaforensic SERVICES I,"5,000,000.00",,-547967634.96,Morris,709,France,16733.59,0,1,0
6184,2011,5,MORTGAGE,3,Low,1,2500, 36 months,1,debt_consolidation,6,Low,1,Good Loan,0,7.9,A,1,6.43,2815.341544,2500,0,78.23,409000006183,15-Sep-18,Indiaforensic RUPAY POS C2 ACQ15,,722352.03,-547245282.93,Holmes,611,France,1235.49,0,1,0
6185,2011,5,RENT,1,Low,1,5000, 36 months,1,other,4,Low,1,Good Loan,0,8.9,A,1,15.48,5729.112502,5000,0,158.77,409000006184,15-Sep-18,TRF TO  Indiaforensic SERVICES I,"1,000,000.00",,-548245282.93,Yu,775,Spain,50168.41,0,1,0
6186,2011,2,MORTGAGE,3,Low,1,19200, 60 months,2,debt_consolidation,6,High,2,Good Loan,0,19.42,E,5,20.59,26106.43,19200,0,502.51,409000006185,17-Sep-18,Indiaforensic RUPAY POS ACQ17091,,3801066.65,-544444216.28,Walker,699,Germany,33687.90,0,1,0
6187,2011,6,RENT,1,Medium,2,22600, 60 months,2,small_business,3,High,2,Good Loan,0,18.64,E,5,7.14,32332.82753,22600,0,581.79,409000006186,17-Sep-18,Indiaforensic RUPAY POS ACQ16091,,458605.83,-543985610.45,Edwards,618,France,178705.45,0,1,0
6188,2011,10,MORTGAGE,3,Low,1,10000, 36 months,1,other,4,Low,1,Good Loan,0,12.42,B,2,9.04,12027.38548,10000,0,334.16,409000006187,17-Sep-18,Indiaforensic RUPAY POS ACQ REV1,"458,605.83",,-544444216.28,Harvey,704,France,66810.48,0,1,0
6189,2011,10,RENT,1,Low,1,9800, 36 months,1,other,4,Low,1,Bad Loan,1,7.51,A,1,27.26,2741.22,2245.42,0,304.89,409000006188,17-Sep-18,Indiaforensic RUPAY POS ACQ16091,,1089064.92,-543355151.36,McDonald,835,Germany,45859.55,0,1,0
6190,2011,0.5,RENT,1,Low,1,5000, 36 months,1,debt_consolidation,6,High,2,Good Loan,0,13.49,C,3,5.94,6103.326837,5000,0,169.66,409000006189,17-Sep-18,Indiaforensic MASTER ACQ DOM1709,,10379899.39,-532975251.97,Chambers,714,Germany,63846.36,0,1,0
6191,2011,6,MORTGAGE,3,Low,1,12700, 36 months,1,credit_card,1,High,2,Good Loan,0,17.27,D,4,19.85,16294.40692,12700,0,454.5,409000006190,17-Sep-18,Indiaforensic VISA ACQ DOM170918,,8848842.47,-524126409.50,Reed,581,Spain,100236.02,0,1,0
6192,2011,10,MORTGAGE,3,Low,1,6000, 36 months,1,medical,9,Low,1,Good Loan,0,8.9,A,1,22.09,6576.87,6000,0,190.52,409000006191,17-Sep-18,TRF TO  Indiaforensic SERVICES I,"4,000,000.00",,-528126409.50,Shih,592,France,19645.65,0,1,0
6193,2011,3,OWN,2,Low,1,7200, 36 months,1,credit_card,1,Low,1,Good Loan,0,10.65,B,2,11.42,8440.216566,7200,0,234.53,409000006192,17-Sep-18,TRF TO  Indiaforensic SERVICES I,"10,000,000.00",,-538126409.50,Onyemachukwu,551,France,178393.68,0,1,0
6194,2011,6.05,MORTGAGE,3,Low,1,10500, 36 months,1,medical,9,Low,1,Good Loan,0,7.51,A,1,0.51,11758.00473,10500,0,326.67,409000006193,17-Sep-18,TRF TO  Indiaforensic SERVICES I,"10,000,000.00",,-548126409.50,Teng,689,Germany,78591.15,0,1,0
6195,2011,3,OWN,2,Medium,2,28000, 36 months,1,small_business,3,Low,1,Good Loan,0,9.91,B,2,15.95,32479.37191,28000,0,902.3,409000006194,17-Sep-18,Indiaforensic RUPAY POS C2 ACQ17,,711362.08,-547415047.42,Hand,604,France,124954.56,0,1,0
6196,2011,5,MORTGAGE,3,Low,1,30000, 36 months,1,small_business,3,Low,1,Bad Loan,1,6.62,A,1,15.4,19230.57,15908.04,808.96,921.11,409000006195,17-Sep-18,Indiaforensic VISA ACQ INT 12091,,2505.88,-547412541.54,Onyemauchechukwu,514,France,3756.65,0,1,0
6197,2011,8,RENT,1,Low,1,2500, 60 months,2,other,4,High,2,Good Loan,0,16.77,D,4,0.56,3137.65,1972.82,0,61.83,409000006196,17-Sep-18,Indiaforensic VISA ACQ INT 13091,,791.20,-547411750.34,Bailey,698,France,152723.23,0,1,0
6198,2011,4,MORTGAGE,3,Low,1,28000, 60 months,2,debt_consolidation,6,High,2,Good Loan,0,18.64,E,5,14.97,37954.94,28000,0,720.81,409000006197,17-Sep-18,TRF TO  Indiaforensic SERVICES I,"800,000.00",,-548211750.34,Chiang,581,Germany,187597.98,0,1,0
6199,2011,6.05,OWN,2,Low,1,25000, 36 months,1,credit_card,1,Low,1,Good Loan,0,9.91,B,2,20,28646.13,25000,0,805.63,409000006198,18-Sep-18,Indiaforensic VISA ACQ DOM180918,,4287912.00,-543923838.34,Maclean,573,Germany,70381.49,0,1,0
6200,2011,5,RENT,1,High,3,24000, 60 months,2,wedding,5,High,2,Good Loan,0,18.25,D,4,0.09,31226.6,18872.21,0,612.72,409000006199,18-Sep-18,Indiaforensic RUPAY POS ACQ18091,,2253557.87,-541670280.47,Yobachi,449,Spain,156792.89,0,1,0
6201,2011,0.5,OWN,2,Low,1,35000, 60 months,2,home_improvement,7,Low,1,Good Loan,0,12.42,B,2,22.43,45975.11903,35000,0,786.01,409000006200,18-Sep-18,Indiaforensic MASTER ACQ DOM1809,,3531438.70,-538138841.77,Munro,850,Germany,35534.68,0,1,0
6202,2011,5,MORTGAGE,3,Low,1,6000, 36 months,1,debt_consolidation,6,Low,1,Bad Loan,1,6.62,A,1,13.76,2093.87,1546.01,255.57,184.23,409000006201,18-Sep-18,TRF TO  Indiaforensic SERVICES I,"10,000,000.00",,-548138841.77,Chidi,612,France,151256.22,0,1,0
6203,2011,6,RENT,1,Low,1,14000, 36 months,1,major_purchase,8,Low,1,Bad Loan,1,7.9,A,1,10,7880.4,6583.15,0,438.07,409000006202,18-Sep-18,Indiaforensic MASTER INT15-17091,,2544.31,-548136297.46,Chamberlain,690,Spain,51011.29,0,1,0
6204,2011,2,RENT,1,Low,1,6000, 36 months,1,debt_consolidation,6,Low,1,Good Loan,0,6.62,A,1,17.87,6527.03,6000,0,184.23,409000006203,18-Sep-18,Indiaforensic RUPAY POS C2 ACQ18,,719024.80,-547417272.66,Trujillo,599,Spain,111190.53,0,1,0
6205,2011,7,MORTGAGE,3,Medium,2,18000, 36 months,1,credit_card,1,Low,1,Good Loan,0,7.51,A,1,15.99,20156.8738,18000,0,560,409000006204,18-Sep-18,Indiaforensic VISA ACQ INT 14091,,916.36,-547416356.30,Tang,498,France,69664.35,0,1,0
6206,2011,2,RENT,1,Low,1,12000, 60 months,2,debt_consolidation,6,Low,1,Good Loan,0,12.69,B,2,14.84,14920.21803,12000,0,271.14,409000006205,19-Sep-18,TRF TO  Indiaforensic SERVICES I,"800,000.00",,-548216356.30,Wilson,497,France,63233.02,0,1,0
6207,2011,7,MORTGAGE,3,Low,1,12600, 60 months,2,debt_consolidation,6,High,2,Good Loan,0,13.49,C,3,8.77,14776.42,10128.27,0,289.86,409000006206,19-Sep-18,Indiaforensic VISA ACQ DOM190918,,4620810.48,-543595545.82,Mann,802,Spain,40855.79,0,1,0
6208,2011,9,MORTGAGE,3,Medium,2,16800, 60 months,2,home_improvement,7,High,2,Good Loan,0,20.3,E,5,13.7,22809.19,13074.85,0,447.91,409000006207,19-Sep-18,Indiaforensic RUPAY POS ACQ19091,,2075213.08,-541520332.74,Parry,644,France,95673.05,0,1,0
6209,2011,10,RENT,1,Low,1,16500, 60 months,2,debt_consolidation,6,High,2,Bad Loan,1,18.25,D,4,17.64,2523.18,1059.67,0,421.24,409000006208,19-Sep-18,TRF TO  Indiaforensic SERVICES I,"1,000,000.00",,-542520332.74,Manfrin,714,France,80234.14,0,1,0
6210,2011,10,OWN,2,Low,1,26500, 60 months,2,debt_consolidation,6,High,2,Bad Loan,1,19.42,E,5,17.56,7079.67,806.31,5000.88,693.57,409000006209,19-Sep-18,Indiaforensic MASTER ACQ DOM1909,,3259083.71,-539261249.03,Millar,690,France,189051.59,0,1,0
6211,2011,5,RENT,1,Low,1,3600, 36 months,1,wedding,5,Low,1,Good Loan,0,12.69,B,2,7.27,4329.711218,3600,0,120.77,409000006210,19-Sep-18,TRF TO  Indiaforensic SERVICES I,"5,000,000.00",,-544261249.03,Simmons,522,Spain,145490.85,0,1,0
6212,2011,10,MORTGAGE,3,Low,1,35000, 60 months,2,debt_consolidation,6,High,2,Good Loan,0,14.27,C,3,23.91,41765.54,28035.69,0,819.3,409000006211,19-Sep-18,Indiaforensic RUPAY POS C2 ACQ19,,604523.51,-543656725.52,Beneventi,502,Germany,196278.32,0,1,0
6213,2011,10,MORTGAGE,3,Medium,2,35000, 60 months,2,debt_consolidation,6,High,2,Good Loan,0,17.27,D,4,8.55,49381.9722,35000,0,874.93,409000006212,19-Sep-18,TRF TO  Indiaforensic SERVICES I,"500,000.00",,-544156725.52,Chung,730,Spain,162889.10,0,1,0
6214,2011,10,MORTGAGE,3,Low,1,10000, 60 months,2,other,4,Low,1,Good Loan,0,11.71,B,2,10.83,11263.77,8101.08,0,220.99,409000006213,19-Sep-18,TRF TO  Indiaforensic SERVICES I,"4,000,000.00",,-548156725.52,Maxwell,590,Germany,174667.58,0,1,0
6215,2011,6,MORTGAGE,3,Low,1,2500, 36 months,1,house,12,High,2,Good Loan,0,13.49,C,3,15.99,3050.640562,2500,0,84.83,409000006214,19-Sep-18,Indiaforensic VISA ACQ INT 15091,,2463.68,-548154261.84,Dale,458,Germany,3476.38,0,1,0
6216,2011,0.5,MORTGAGE,3,Medium,2,6000, 36 months,1,credit_card,1,Low,1,Good Loan,0,9.91,B,2,24.92,6956.898246,6000,0,193.35,409000006215,19-Sep-18,Indiaforensic VISA ACQ INT 16091,,2021.94,-548152239.90,Stevens,553,Spain,19344.92,0,1,0
6217,2011,2,MORTGAGE,3,Low,1,4000, 36 months,1,credit_card,1,Low,1,Good Loan,0,7.9,A,1,15.05,4370.82,4000,0,125.17,409000006216,19-Sep-18,Indiaforensic VISA ACQ INT 17091,,3639.49,-548148600.41,Wei,479,France,95270.83,0,1,0
6218,2011,10,MORTGAGE,3,Low,1,12000, 60 months,2,major_purchase,8,Low,1,Good Loan,0,12.69,B,2,12.42,14033.64,12000,0,271.14,409000006217,20-Sep-18,Indiaforensic RUPAY POS ACQ20091,,2024638.20,-546123962.21,Chiu,693,France,107759.31,0,1,0
6219,2011,3,RENT,1,Low,1,5300, 36 months,1,wedding,5,Low,1,Good Loan,0,6.62,A,1,2.99,5709.23,5300,0,162.73,409000006218,20-Sep-18,Indiaforensic RUPAY POS C2 ACQ20,,613675.86,-545510286.35,Duncan,707,Spain,118368.20,0,1,0
6220,2011,10,MORTGAGE,3,Low,1,12000, 36 months,1,debt_consolidation,6,Low,1,Good Loan,0,7.9,A,1,16.8,13515.98732,12000,0,375.49,409000006219,20-Sep-18,TRF TO  Indiaforensic SERVICES I,"2,700,000.00",,-548210286.35,Brady,636,Spain,52484.01,0,1,0
6221,2011,10,MORTGAGE,3,Low,1,3600, 36 months,1,debt_consolidation,6,High,2,Good Loan,0,16.77,D,4,20.6,3747.35,3600,0,127.94,409000006220,21-Sep-18,Indiaforensic VISA ACQ DOM200918,,5095510.17,-543114776.18,Macleod,807,France,178153.65,0,1,0
6222,2011,2,MORTGAGE,3,Medium,2,28000, 60 months,2,debt_consolidation,6,High,2,Good Loan,0,14.65,C,3,8.43,33708.81,22397.98,0,660.99,409000006221,21-Sep-18,FUND TRF TO  Indiaforensic SERVI,"5,000,000.00",,-548114776.18,Berkeley,513,France,49915.52,0,1,0
6223,2011,8,MORTGAGE,3,Medium,2,12000, 60 months,2,house,12,High,2,Bad Loan,1,18.64,E,5,10.31,9258.08,4632.48,0,308.92,409000006222,21-Sep-18,Indiaforensic MASTER ACQ DOM20-2,,8137653.92,-539977122.26,Kaur,582,France,33747.03,0,1,0
6224,2011,10,MORTGAGE,3,Low,1,6000, 60 months,2,debt_consolidation,6,High,2,Good Loan,0,17.27,D,4,2.18,7629.33,4732.05,0,149.99,409000006223,21-Sep-18,Indiaforensic VISA ACQ DOM210918,,4940834.91,-535036287.35,Bell,694,France,59961.81,0,1,0
6225,2011,10,RENT,1,Low,1,9000, 36 months,1,debt_consolidation,6,High,2,Good Loan,0,17.58,D,4,7.56,9260.65,9000,0,323.48,409000006224,21-Sep-18,Indiaforensic RUPAY POS ACQ21091,,1849903.02,-533186384.33,Nwokike,777,France,18613.52,0,1,0
6226,2011,0.5,RENT,1,Low,1,13200, 60 months,2,debt_consolidation,6,High,2,Bad Loan,1,19.91,E,5,22.19,13919.13,6475.41,972.82,349.06,409000006225,21-Sep-18,Indiaforensic RUPAY POS C2 ACQ21,,889018.24,-532297366.09,Williamson,598,Germany,198894.42,0,1,0
6227,2011,2,RENT,1,Low,1,6000, 36 months,1,debt_consolidation,6,Low,1,Good Loan,0,7.9,A,1,4.62,6757.857048,6000,0,187.75,409000006226,21-Sep-18,NEFT CHARGES AND GST/0000,29.5,,-532297395.59,Mountgarrett,762,Germany,57014.17,0,1,0
6228,2011,1,RENT,1,Medium,2,25000, 36 months,1,debt_consolidation,6,High,2,Bad Loan,1,15.27,C,3,17.83,3472.28,2244.93,0,869.95,409000006227,21-Sep-18,NEFT/000050794506/Indiaforensic,"10,000,000.00",,-542297395.59,Wreford,588,France,131729.52,0,1,0
6229,2011,1,MORTGAGE,3,Low,1,7200, 36 months,1,major_purchase,8,Low,1,Good Loan,0,8.9,A,1,24.48,8170.05,7200,0,228.63,409000006228,21-Sep-18,NEFT CHARGES AND GST/0000,29.5,,-542297425.09,Paterson,663,Germany,79169.73,0,1,0
6230,2011,1,OWN,2,Low,1,7500, 36 months,1,major_purchase,8,Low,1,Good Loan,0,7.9,A,1,11.79,8447.402429,7500,0,234.68,409000006229,21-Sep-18,NEFT/000050794647/Indiaforensic,"5,000,000.00",,-547297425.09,Hou,777,France,106472.34,0,1,0
6231,2011,10,MORTGAGE,3,Low,1,7125, 36 months,1,debt_consolidation,6,Low,1,Good Loan,0,7.51,A,1,17.14,7873.45,7125,0,221.67,409000006230,21-Sep-18,Indiaforensic MASTER INT190918,,5021.80,-547292403.29,Smith,592,France,17013.54,0,1,0
6232,2011,4,MORTGAGE,3,Low,1,1800, 36 months,1,debt_consolidation,6,Low,1,Good Loan,0,7.51,A,1,15.37,2015.178977,1800,0,56,409000006231,21-Sep-18,Indiaforensic MASTER INT200918,,2002.91,-547290400.38,Peng,631,Germany,150661.42,0,1,0
6233,2011,3,MORTGAGE,3,Low,1,24000, 60 months,2,debt_consolidation,6,High,2,Good Loan,0,14.65,C,3,12.52,31497.47882,24000,0,566.56,409000006232,21-Sep-18,Indiaforensic VISA ACQ INT 18091,,3026.11,-547287374.27,Wollstonecraft,725,Germany,86622.56,0,1,0
6234,2011,10,MORTGAGE,3,Low,1,2100, 36 months,1,debt_consolidation,6,Low,1,Good Loan,0,6.03,A,1,3.32,2300.670968,2100,0,63.92,409000006233,21-Sep-18,FUND TRF TO  Indiaforensic SERVI,"900,000.00",,-548187374.27,Bolton,850,France,115767.93,0,1,0
6235,2011,0.5,RENT,1,Low,1,12000, 60 months,2,debt_consolidation,6,High,2,Bad Loan,1,19.42,E,5,4.92,6193.87,2478.79,547.27,314.07,409000006234,24-Sep-18,Indiaforensic VISA ACQ DOM220918,,5362262.85,-542825111.42,Corrie,540,France,141998.89,0,1,0
6236,2011,6,MORTGAGE,3,Low,1,7800, 36 months,1,home_improvement,7,Low,1,Good Loan,0,6.62,A,1,4.46,8619.897364,7800,0,239.49,409000006235,24-Sep-18,Indiaforensic RUPAY POS ACQ22091,,2208240.16,-540616871.26,Boyle,674,Spain,182787.17,0,1,0
6237,2011,10,MORTGAGE,3,Low,1,8000, 36 months,1,credit_card,1,Low,1,Good Loan,0,9.91,B,2,14.91,9278.537209,8000,0,257.8,409000006236,24-Sep-18,Indiaforensic VISA ACQ DOM230918,"2,000.00",,-540618871.26,Lambie,553,France,187915.70,0,1,0
6238,2011,10,MORTGAGE,3,Low,1,25000, 60 months,2,debt_consolidation,6,Low,1,Good Loan,0,12.69,B,2,23.79,33210.64721,25000,0,564.87,409000006237,24-Sep-18,Indiaforensic RUPAY POS ACQ23091,,2763472.14,-537855399.12,Cartwright,630,France,133267.78,0,1,0
6239,2011,6,RENT,1,Low,1,12000, 36 months,1,credit_card,1,Low,1,Good Loan,0,8.9,A,1,20.91,13715.2568,12000,0,381.04,409000006238,24-Sep-18,TRF TO  Indiaforensic SERVICES I,"10,000,000.00",,-547855399.12,Lu,466,France,137476.09,0,1,0
6240,2011,5,MORTGAGE,3,Low,1,1500, 36 months,1,other,4,Low,1,Good Loan,0,6.62,A,1,4.88,1657.042279,1500,0,46.06,409000006239,24-Sep-18,Indiaforensic MASTER ACQ DOM2409,,10828620.68,-537026778.44,Pisano,613,France,77146.14,0,1,0
6241,2011,10,MORTGAGE,3,Low,1,5600, 60 months,2,car,2,Low,1,Good Loan,0,8.9,A,1,16.38,6024.66,5600,0,115.98,409000006240,24-Sep-18,Indiaforensic VISA ACQ DOM240918,,8384692.62,-528642085.82,Chukwubuikem,558,France,183271.15,0,1,0
6242,2011,0.5,MORTGAGE,3,Medium,2,10400, 36 months,1,home_improvement,7,Low,1,Good Loan,0,9.91,B,2,7.03,11705.13,10400,0,335.14,409000006241,24-Sep-18,Indiaforensic RUPAY POS ACQ24091,,2381076.28,-526261009.54,Harper,775,Germany,26362.40,0,1,0
6243,2011,10,RENT,1,Low,1,6225, 36 months,1,debt_consolidation,6,Low,1,Good Loan,0,7.9,A,1,24.3,6676.54,6225,0,194.79,409000006242,24-Sep-18,TRF TO  Indiaforensic SERVICES I,"15,000,000.00",,-541261009.54,Wilson,698,Germany,153373.71,0,1,0
6244,2011,3,MORTGAGE,3,Medium,2,12000, 36 months,1,small_business,3,Low,1,Good Loan,0,6.62,A,1,4.38,13082.83,12000,0,368.45,409000006243,24-Sep-18,TRF TO  Indiaforensic SERVICES I,"5,000,000.00",,-546261009.54,Ch'in,608,Germany,70705.58,0,1,0
6245,2011,4,MORTGAGE,3,Medium,2,28000, 60 months,2,home_improvement,7,Low,1,Good Loan,0,12.69,B,2,6.66,31657.91,22010.41,0,632.66,409000006244,24-Sep-18,TRF TO  Indiaforensic SERVICES I,"2,000,000.00",,-548261009.54,Streeton,670,Spain,119759.24,0,1,0
6246,2011,7,MORTGAGE,3,Medium,2,4800, 36 months,1,other,4,Low,1,Bad Loan,1,8.9,A,1,16.79,3179.17,2499.36,141.97,152.42,409000006245,24-Sep-18,Indiaforensic RUPAY POS C2 ACQ24,,626670.73,-547634338.81,Ch'ang,591,Spain,42392.24,0,1,0
6247,2011,7,RENT,1,Low,1,21000, 36 months,1,debt_consolidation,6,Low,1,Good Loan,0,12.69,B,2,17.84,24957.15,21000,0,704.45,409000006246,24-Sep-18,Indiaforensic VISA ACQ INT 19091,,1162.62,-547633176.19,Pennington,633,France,34670.62,0,1,0
6248,2011,6.05,RENT,1,Low,1,5575, 36 months,1,credit_card,1,Low,1,Good Loan,0,7.9,A,1,10.08,6129.72,5575,0,174.45,409000006247,24-Sep-18,Indiaforensic VISA ACQ INT 20091,,2021.94,-547631154.25,T'ien,678,France,82106.19,0,1,0
6249,2011,4,RENT,1,Low,1,15250, 60 months,2,small_business,3,High,2,Bad Loan,1,19.42,E,5,23.82,4004.27,1118.15,812.22,399.13,409000006248,24-Sep-18,TRF TO  Indiaforensic SERVICES I,"500,000.00",,-548131154.25,Liu,590,France,171774.50,0,1,0
6250,2011,10,RENT,1,Low,1,12000, 36 months,1,credit_card,1,Low,1,Good Loan,0,6.03,A,1,11.55,13147.72266,12000,0,365.23,409000006249,25-Sep-18,Indiaforensic MASTER ACQ DOM2509,,3364041.58,-544767112.67,Cunningham,705,France,149772.61,0,1,0
6251,2011,9,OWN,2,Low,1,17625, 60 months,2,debt_consolidation,6,High,2,Good Loan,0,15.27,C,3,14.59,22359.2829,17625,0,421.8,409000006250,25-Sep-18,Indiaforensic VISA ACQ DOM250918,,4448670.26,-540318442.41,Ch'in,608,France,38866.85,0,1,0
6252,2011,10,OWN,2,Low,1,20000, 60 months,2,debt_consolidation,6,Low,1,Bad Loan,1,12.69,B,2,11.47,17624.1,11515.32,24.36,451.9,409000006251,25-Sep-18,Indiaforensic RUPAY POS ACQ25091,,1823030.98,-538495411.43,Smith,682,France,35179.18,0,1,0
6253,2011,1,MORTGAGE,3,Low,1,15000, 36 months,1,credit_card,1,Low,1,Good Loan,0,12.42,B,2,11.99,18009.81256,15000,0,501.23,409000006252,25-Sep-18,TRF TO  Indiaforensic SERVICES I,"9,700,000.00",,-548195411.43,Anderson,596,Germany,41788.37,0,1,0
6254,2011,10,OWN,2,Low,1,7000, 36 months,1,debt_consolidation,6,Low,1,Good Loan,0,6.03,A,1,28.42,7362.35,7000,0,213.05,409000006253,25-Sep-18,Indiaforensic RUPAY POS C2 ACQ25,,785412.70,-547409998.73,Forbes,395,Germany,17376.57,0,1,0
6255,2011,10,MORTGAGE,3,Medium,2,15000, 36 months,1,other,4,High,2,Good Loan,0,16.77,D,4,19.78,18457.88,15000,0,533.08,409000006254,25-Sep-18,Indiaforensic MASTER INT220918,,2866.68,-547407132.05,Ansell,578,Germany,199428.19,0,1,0
6256,2011,7,RENT,1,Low,1,9200, 60 months,2,credit_card,1,High,2,Good Loan,0,16.77,D,4,6.27,11176.66,9200,0,227.51,409000006255,25-Sep-18,Indiaforensic VISA ACQ INT 21091,,1525.41,-547405606.64,Chiu,547,Germany,16922.28,0,1,0
6257,2011,0.5,RENT,1,Low,1,12000, 36 months,1,other,4,High,2,Good Loan,0,13.49,C,3,1.63,13654.67,12000,0,407.17,409000006256,26-Sep-18,TRF TO  Indiaforensic SERVICES I,"800,000.00",,-548205606.64,Yevdokimova,609,France,178291.89,0,1,0
6258,2011,10,RENT,1,Low,1,6000, 36 months,1,moving,10,Low,1,Good Loan,0,7.9,A,1,16.42,6757.514239,6000,0,187.75,409000006257,26-Sep-18,Indiaforensic MASTER ACQ DOM2609,,3929121.50,-544276485.14,Chamberlin,774,Germany,152290.28,0,1,0
6259,2011,0.5,RENT,1,Low,1,7200, 36 months,1,debt_consolidation,6,Low,1,Bad Loan,1,9.91,B,2,17.72,1378.27,875.39,220.52,232.02,409000006258,26-Sep-18,Indiaforensic VISA ACQ DOM260918,,4710129.14,-539566356.00,Johnston,712,France,126809.15,0,1,0
6260,2011,8,RENT,1,Low,1,12800, 36 months,1,debt_consolidation,6,Low,1,Good Loan,0,8.9,A,1,12.59,14629.45676,12800,0,406.45,409000006259,26-Sep-18,Indiaforensic RUPAY POS ACQ26091,,2069945.73,-537496410.27,McDonald,585,Germany,40385.61,0,1,0
6261,2011,10,MORTGAGE,3,Low,1,23000, 60 months,2,small_business,3,Low,1,Bad Loan,1,12.42,B,2,7.88,20128.55,12059.77,1542.86,516.52,409000006260,26-Sep-18,Indiaforensic RUPAY POS C2 ACQ26,,618219.68,-536878190.59,Chen,666,France,34350.54,0,1,0
6262,2011,10,MORTGAGE,3,Medium,2,8000, 36 months,1,credit_card,1,Low,1,Good Loan,0,8.9,A,1,8.09,9143.246964,8000,0,254.03,409000006261,26-Sep-18,Indiaforensic MASTER INT250918,,610.79,-536877579.80,Cattaneo,708,Spain,199005.88,0,1,0
6263,2011,10,RENT,1,Medium,2,35000, 60 months,2,debt_consolidation,6,High,2,Bad Loan,1,22.74,G,7,17.46,39129.06,16821.53,2663.28,981.45,409000006262,26-Sep-18,TRF TO  Indiaforensic SERVICES I,"10,000,000.00",,-546877579.80,Barclay-Harvey,513,France,52629.73,0,1,0
6264,2011,4,RENT,1,Low,1,4450, 60 months,2,debt_consolidation,6,High,2,Good Loan,0,19.42,E,5,12.48,5823.38,3394.07,0,116.47,409000006263,26-Sep-18,TRF TO  Indiaforensic SERVICES I,"500,000.00",,-547377579.80,Dawson,445,France,180012.39,0,1,0
6265,2011,10,MORTGAGE,3,Low,1,5400, 36 months,1,other,4,Low,1,Good Loan,0,8.9,A,1,22.39,6126.87,5400,0,171.47,409000006264,26-Sep-18,Indiaforensic VISA ACQ INT 22091,,3028.49,-547374551.31,Costa,690,Germany,35342.33,0,1,0
6266,2011,0.5,RENT,1,Low,1,12000, 36 months,1,debt_consolidation,6,Low,1,Good Loan,0,11.71,B,2,16.68,14039.85,12000,0,396.92,409000006265,26-Sep-18,Indiaforensic VISA ACQ INT 23091,,1527.26,-547373024.05,Chikwado,850,France,109291.22,0,1,0
6267,2011,6,MORTGAGE,3,Low,1,3000, 36 months,1,major_purchase,8,Low,1,Good Loan,0,6.03,A,1,1.24,3286.699868,3000,0,91.31,409000006266,26-Sep-18,PENDING SETTL -DT 110317,,770755.56,-546602268.49,Ch'eng,537,Spain,62746.54,0,1,0
6268,2011,2,RENT,1,Low,1,4800, 36 months,1,other,4,Low,1,Good Loan,0,7.9,A,1,10.17,5403.455244,4800,0,150.2,409000006267,26-Sep-18,OXYGEN POS ACQ SETTL 0409,"742,776.21",,-547345044.70,Harrison,705,Germany,173273.20,0,1,0
6269,2011,1,RENT,1,Low,1,6500, 36 months,1,debt_consolidation,6,High,2,Good Loan,0,15.96,C,3,6.29,8112.801278,6500,0,228.4,409000006268,26-Sep-18,TRF TO  Indiaforensic SERVICES I,"800,000.00",,-548145044.70,Crawford,670,France,54340.24,0,1,0
6270,2011,10,MORTGAGE,3,Low,1,10000, 36 months,1,debt_consolidation,6,Low,1,Good Loan,0,6.62,A,1,9.41,11026.44184,10000,0,307.04,409000006269,27-Sep-18,Indiaforensic VISA ACQ DOM270918,,3983092.06,-544161952.64,Gibson,652,Spain,19302.78,0,1,0
6271,2011,7,MORTGAGE,3,Low,1,3600, 36 months,1,debt_consolidation,6,Low,1,Good Loan,0,10.65,B,2,10.77,4085.85,3600,0,117.27,409000006270,27-Sep-18,Indiaforensic RUPAY POS ACQ27091,,1582522.62,-542579430.02,Martin,696,Spain,10883.52,0,1,0
6272,2011,5,RENT,1,Low,1,2000, 36 months,1,debt_consolidation,6,Low,1,Good Loan,0,11.71,B,2,13.11,2380.207023,2000,0,66.16,409000006271,27-Sep-18,Indiaforensic RUPAY POS C2 ACQ27,,629228.89,-541950201.13,Stokes,747,France,17298.72,0,1,0
6273,2011,8,MORTGAGE,3,Low,1,1400, 36 months,1,debt_consolidation,6,Low,1,Bad Loan,1,8.9,A,1,22.25,62.86,0,62.86,44.46,409000006272,27-Sep-18,Indiaforensic MASTER ACQ DOM2709,,3566752.62,-538383448.51,Niu,511,France,115779.48,0,1,0
6274,2011,1,RENT,1,Low,1,4200, 36 months,1,debt_consolidation,6,High,2,Bad Loan,1,17.58,D,4,3.67,1321.09,749.18,119.89,150.96,409000006273,27-Sep-18,TRF TO  Indiaforensic SERVICES I,"5,000,000.00",,-543383448.51,Ampt,743,Spain,93228.86,0,1,0
6275,2011,6,MORTGAGE,3,Medium,2,30000, 60 months,2,debt_consolidation,6,High,2,Good Loan,0,20.3,E,5,16.36,37383.75,30000,0,799.84,409000006274,27-Sep-18,TRF TO  Indiaforensic SERVICES I,"1,300,000.00",,-544683448.51,Wynn,532,Germany,148704.77,0,1,0
6276,2011,3,RENT,1,Low,1,23000, 60 months,2,debt_consolidation,6,Low,1,Good Loan,0,12.42,B,2,20.74,28320.91,23000,0,516.52,409000006275,27-Sep-18,Indiaforensic VISA ACQ INT 25091,,3134.00,-544680314.51,Lawrence,642,Spain,150475.14,0,1,0
6277,2011,1,OWN,2,Low,1,5000, 36 months,1,credit_card,1,High,2,Good Loan,0,18.25,D,4,4.36,6006.96,5000,0,181.39,409000006276,27-Sep-18,TRF TO  Indiaforensic SERVICES I,"3,000,000.00",,-547680314.51,Wagner,554,Germany,40914.32,0,1,0
6278,2011,10,MORTGAGE,3,Low,1,23275, 36 months,1,debt_consolidation,6,Low,1,Good Loan,0,12.42,B,2,19.84,27986.39043,23275,0,777.75,409000006277,28-Sep-18,TRF TO  Indiaforensic SERVICES I,"500,000.00",,-548180314.51,Argyle,604,Spain,38587.70,0,1,0
6279,2011,10,MORTGAGE,3,Low,1,30000, 60 months,2,debt_consolidation,6,High,2,Bad Loan,1,19.03,E,5,19.09,1719.57,0,1719.57,778.72,409000006278,28-Sep-18,Indiaforensic MASTER ACQ DOM2809,,3402144.50,-544778170.01,Ofodile,602,France,171260.66,0,1,0
6280,2011,10,OWN,2,Low,1,4000, 36 months,1,wedding,5,Low,1,Good Loan,0,6.62,A,1,27.93,4419.202897,4000,0,122.82,409000006279,28-Sep-18,Indiaforensic VISA ACQ DOM280918,,4491980.38,-540286189.63,Chiemenam,757,Spain,94187.47,0,1,0
6281,2011,7,MORTGAGE,3,Low,1,8400, 36 months,1,debt_consolidation,6,Low,1,Good Loan,0,8.9,A,1,8.98,9597.730132,8400,0,266.73,409000006280,28-Sep-18,Indiaforensic RUPAY POS ACQ28091,,1599830.58,-538686359.05,Akobundu,491,Germany,145900.89,0,1,0
6282,2011,6,MORTGAGE,3,Low,1,15600, 36 months,1,credit_card,1,Low,1,Good Loan,0,7.9,A,1,16.35,17571.6833,15600,0,488.13,409000006281,28-Sep-18,Indiaforensic RUPAY POS C2 ACQ28,,592337.81,-538094021.24,Locke,850,France,152298.28,0,1,0
6283,2011,10,MORTGAGE,3,Medium,2,28000, 60 months,2,credit_card,1,Low,1,Good Loan,0,12.69,B,2,13.99,34620.21,28000,0,632.66,409000006282,28-Sep-18,TRF TO  Indiaforensic SERVICES I,"9,500,000.00",,-547594021.24,Bullen,521,France,99828.45,0,1,0
6284,2011,4,MORTGAGE,3,Medium,2,11800, 36 months,1,debt_consolidation,6,Low,1,Good Loan,0,6.03,A,1,19.43,12795.57334,11800,0,359.14,409000006283,28-Sep-18,TRF TO  Indiaforensic SERVICES I,"500,000.00",,-548094021.24,Forster,726,France,34743.98,0,1,0
6285,2011,4,RENT,1,Low,1,4200, 36 months,1,other,4,Low,1,Good Loan,0,7.9,A,1,12.5,4730.091827,4200,0,131.42,409000006284,29-Sep-18,Indiaforensic VISA ACQ DOM290918,,4743583.33,-543350437.91,Smith,596,France,121189.30,0,1,0
6286,2011,4,MORTGAGE,3,Medium,2,12000, 36 months,1,moving,10,Low,1,Good Loan,0,6.03,A,1,8.28,12811.29,12000,0,365.23,409000006285,29-Sep-18,Indiaforensic RUPAY POS ACQ29091,,1811308.94,-541539128.97,Craig,850,Germany,129660.59,0,1,0
6287,2011,9,RENT,1,Low,1,13000, 36 months,1,debt_consolidation,6,Low,1,Good Loan,0,11.71,B,2,16.2,13252.18,13000,0,429.99,409000006286,29-Sep-18,Indiaforensic RUPAY POS C2 ACQ29,,730811.78,-540808317.19,Archer,637,France,145477.36,0,1,0
6288,2011,10,MORTGAGE,3,Low,1,12000, 60 months,2,debt_consolidation,6,High,2,Good Loan,0,19.42,E,5,20.94,18263.31013,12000,0,314.07,409000006287,29-Sep-18,TRF TO  Indiaforensic SERVICES I,"5,000,000.00",,-545808317.19,McWilliams,690,Spain,151822.66,0,1,0
6289,2011,10,RENT,1,Low,1,7200, 36 months,1,debt_consolidation,6,Low,1,Good Loan,0,7.9,A,1,15.55,7916.42,7200,0,225.29,409000006288,29-Sep-18,TRF TO  Indiaforensic SERVICES I,"1,000,000.00",,-546808317.19,Moss,689,France,49656.24,0,1,0
6290,2011,3,RENT,1,Low,1,35000, 60 months,2,debt_consolidation,6,Low,1,Bad Loan,1,11.71,B,2,9.84,1545.4,867.18,0,773.44,409000006289,29-Sep-18,TRF TO  Indiaforensic SERVICES I,"500,000.00",,-547308317.19,Townsend,633,Spain,73856.28,0,1,0
6291,2011,10,RENT,1,Low,1,8600, 60 months,2,debt_consolidation,6,Low,1,Good Loan,0,10.65,B,2,24.08,9446.83,6993.78,0,185.49,409000006290,29-Sep-18,Indiaforensic VISA ACQ INT 26091,,1018.18,-547307299.01,Brown,555,France,116757.00,0,1,0
6292,2011,10,MORTGAGE,3,Low,1,12000, 36 months,1,debt_consolidation,6,Low,1,Good Loan,0,6.62,A,1,7.16,13262.36925,12000,0,368.45,409000006291,1-Oct-18,Indiaforensic VISA ACQ DOM300918,"1,497.75",,-547308796.76,Munson,563,Spain,16319.56,0,1,0
6293,2011,6,MORTGAGE,3,Low,1,6000, 36 months,1,other,4,High,2,Good Loan,0,14.27,C,3,17.55,7405.322954,6000,0,205.86,409000006292,1-Oct-18,Indiaforensic RUPAY POS ACQ30091,,2087393.53,-545221403.23,T'ien,494,France,90273.85,0,1,0
6294,2011,5,MORTGAGE,3,Medium,2,12000, 36 months,1,home_improvement,7,High,2,Good Loan,0,15.27,C,3,4.18,13596.93,12000,0,417.58,409000006293,1-Oct-18,TRF TO  Indiaforensic SERVICES I,"3,000,000.00",,-548221403.23,Shubin,534,France,161344.13,0,1,0
6295,2011,5,RENT,1,Low,1,35000, 60 months,2,debt_consolidation,6,High,2,Good Loan,0,18.64,E,5,13.82,47441.59,35000,0,901.01,409000006294,1-Oct-18,Indiaforensic VISA ACQ DOM011018,,10088103.89,-538133299.34,Isayeva,696,Germany,121061.89,0,1,0
6296,2011,6,MORTGAGE,3,Medium,2,30000, 60 months,2,home_improvement,7,High,2,Good Loan,0,19.03,E,5,10.81,45300.30175,30000,0,778.72,409000006295,1-Oct-18,Indiaforensic RUPAY POS ACQ01101,,1739866.69,-536393432.65,Hung,535,Spain,69531.22,0,1,0
6297,2011,3,RENT,1,Low,1,10250, 36 months,1,debt_consolidation,6,Low,1,Good Loan,0,6.62,A,1,22.1,10724.81,10250,0,314.72,409000006296,1-Oct-18,Indiaforensic MASTER ACQ DOM0110,,10614031.83,-525779400.82,Webb,600,France,3756.23,0,1,0
6298,2011,0.5,MORTGAGE,3,Low,1,14000, 36 months,1,major_purchase,8,Low,1,Good Loan,0,11.71,B,2,16.26,16541.76339,14000,0,463.07,409000006297,1-Oct-18,Indiaforensic RUPAY POS C2 ACQ01,,1527959.32,-524251441.50,Scott,807,France,114448.13,0,1,0
6299,2011,10,MORTGAGE,3,Low,1,24000, 36 months,1,debt_consolidation,6,High,2,Good Loan,0,19.42,E,5,23.66,31849.31852,24000,0,884.85,409000006298,1-Oct-18,TRF TO  Indiaforensic SERVICES I,"15,000,000.00",,-539251441.50,Rahman,714,France,144045.08,0,1,0
6300,2011,5,MORTGAGE,3,Medium,2,35000, 36 months,1,debt_consolidation,6,High,2,Good Loan,0,18.25,D,4,13.74,45689.68089,35000,0,1269.73,409000006299,1-Oct-18,TRF TO  Indiaforensic SERVICES I,"7,400,000.00",,-546651441.50,Lori,590,France,58781.11,0,1,0
6301,2011,9,RENT,1,Low,1,35000, 60 months,2,debt_consolidation,6,High,2,Good Loan,0,19.91,E,5,22.64,54000.1313,35000,0,925.54,409000006300,1-Oct-18,TRF TO  Indiaforensic SERVICES I,"1,600,000.00",,-548251441.50,Cooke,614,France,179227.52,0,1,0
6302,2011,1,RENT,1,Low,1,2000, 36 months,1,other,4,High,2,Good Loan,0,13.49,C,3,15.95,2441.01667,2000,0,67.87,409000006301,3-Oct-18,Indiaforensic VISA ACQ DOM021018,,5265869.44,-542985572.06,Volkova,766,Germany,127332.33,0,1,0
6303,2011,3,RENT,1,Medium,2,35000, 60 months,2,debt_consolidation,6,Low,1,Good Loan,0,11.71,B,2,5.54,45586.55408,35000,0,773.44,409000006302,3-Oct-18,Indiaforensic RUPAY POS ACQ02101,,2342981.61,-540642590.45,Lamb,557,Spain,86642.38,0,1,0
6304,2011,10,MORTGAGE,3,Low,1,2000, 36 months,1,debt_consolidation,6,High,2,Bad Loan,1,14.27,C,3,8,967.53,624.05,78.72,68.62,409000006303,3-Oct-18,Indiaforensic VISA ACQ INT 27091,,14835.00,-540627755.45,Hawes,788,Germany,184178.29,0,1,0
6305,2011,3,MORTGAGE,3,Low,1,10000, 36 months,1,debt_consolidation,6,Low,1,Good Loan,0,9.91,B,2,12.09,10431.87,10000,0,322.25,409000006304,3-Oct-18,Indiaforensic VISA ACQ DOM031018,,5317080.62,-535310674.83,Smith,648,France,9551.49,0,1,0
6306,2011,3,MORTGAGE,3,Medium,2,5000, 36 months,1,home_improvement,7,Low,1,Good Loan,0,12.42,B,2,18.37,6012.035901,5000,0,167.08,409000006305,3-Oct-18,Indiaforensic RUPAY POS ACQ03101,,3527074.28,-531783600.55,Swanton,726,Germany,56053.06,0,1,0
6307,2011,5,MORTGAGE,3,Low,1,5200, 36 months,1,debt_consolidation,6,Low,1,Good Loan,0,7.9,A,1,28.74,5856.542102,5200,0,162.71,409000006306,3-Oct-18,TRF TO  Indiaforensic SERVICES I,"12,200,000.00",,-543983600.55,Mitchell,773,France,1118.31,0,1,0
6308,2011,10,RENT,1,Low,1,12000, 36 months,1,other,4,Low,1,Good Loan,0,6.62,A,1,28.87,13262.27218,12000,0,368.45,409000006307,3-Oct-18,Indiaforensic MASTER ACQ DOM0310,,8233183.51,-535750417.04,Colombo,583,Germany,195732.04,0,1,0
6309,2011,3,MORTGAGE,3,Low,1,4000, 36 months,1,wedding,5,High,2,Good Loan,0,17.58,D,4,8.82,5171.491559,4000,0,143.77,409000006308,3-Oct-18,Indiaforensic RUPAY POS C2 ACQ03,,660066.66,-535090350.38,Shaw,565,Germany,175070.94,0,1,0
6310,2011,1,RENT,1,Low,1,1500, 36 months,1,major_purchase,8,Low,1,Good Loan,0,7.51,A,1,19.24,1536.12,1500,0,46.67,409000006309,3-Oct-18,Indiaforensic MASTER INT2909-011,,10742.67,-535079607.71,Shipp,705,France,112331.19,0,1,0
6311,2011,10,MORTGAGE,3,Low,1,14000, 60 months,2,medical,9,Low,1,Bad Loan,1,10.65,B,2,4.47,10046.12,5831.22,1289.28,301.96,409000006310,3-Oct-18,TRF TO  Indiaforensic SERVICES I,"4,200,000.00",,-539279607.71,Jonathan,685,Spain,43956.83,0,1,0
6312,2011,0.5,RENT,1,Low,1,12000, 60 months,2,wedding,5,Low,1,Good Loan,0,8.9,A,1,1.63,14327.45175,12000,0,248.52,409000006311,4-Oct-18,TRF TO  Indiaforensic SERVICES I,"8,500,000.00",,-547779607.71,Hernandez,741,France,115994.52,0,1,0
6313,2011,10,RENT,1,Medium,2,35000, 60 months,2,debt_consolidation,6,High,2,Bad Loan,1,14.27,C,3,9.6,38471.57,25166.4,0,819.3,409000006312,4-Oct-18,Indiaforensic MASTER ACQ DOM0410,,4252285.78,-543527321.93,Green,658,Germany,166682.57,0,1,0
6314,2011,3,RENT,1,Medium,2,5000, 36 months,1,other,4,Low,1,Good Loan,0,10.65,B,2,6.44,5875.105566,5000,0,162.87,409000006313,4-Oct-18,Indiaforensic VISA ACQ DOM041018,,6244561.32,-537282760.61,Young,575,France,99843.98,0,1,0
6315,2011,10,MORTGAGE,3,Low,1,6000, 36 months,1,credit_card,1,Low,1,Good Loan,0,9.91,B,2,10.86,6934.236495,6000,0,193.35,409000006314,4-Oct-18,Indiaforensic RUPAY POS ACQ04101,,2429243.92,-534853516.69,Han,844,France,141175.18,0,1,0
6316,2011,5,RENT,1,Low,1,4200, 36 months,1,car,2,Low,1,Good Loan,0,8.9,A,1,6.17,4736.85,4200,0,133.37,409000006315,4-Oct-18,Indiaforensic MASTER INT031018,,513.55,-534853003.14,Highland,559,Spain,175910.95,0,1,0
6317,2011,5,MORTGAGE,3,Low,1,9000, 36 months,1,credit_card,1,Low,1,Good Loan,0,12.42,B,2,14.44,10217.67,9000,0,300.74,409000006316,4-Oct-18,Indiaforensic RUPAY POS C2 ACQ04,,606308.94,-534246694.20,Hamilton,725,France,176984.34,0,1,0
6318,2011,10,MORTGAGE,3,Low,1,6000, 36 months,1,car,2,Low,1,Good Loan,0,8.9,A,1,23.35,6673.3,6000,0,190.52,409000006317,4-Oct-18,TRF TO  Indiaforensic SERVICES I,"13,400,000.00",,-547646694.20,Yobanna,450,France,43480.63,0,1,0
6319,2011,10,MORTGAGE,3,Low,1,10500, 36 months,1,debt_consolidation,6,Low,1,Good Loan,0,6.62,A,1,20.19,11136.09,10500,0,322.39,409000006318,4-Oct-18,TRF TO  Indiaforensic SERVICES I,"600,000.00",,-548246694.20,Crawford,738,Germany,155047.11,0,1,0
6320,2011,10,RENT,1,Low,1,3875, 60 months,2,debt_consolidation,6,High,2,Good Loan,0,19.03,E,5,14.86,5110.21,3028.4,0,100.59,409000006319,4-Oct-18,Indiaforensic VISA ACQ INT 29091,,3026.73,-548243667.47,Beavers,642,Germany,176137.20,0,1,0
6321,2011,10,MORTGAGE,3,Low,1,4800, 36 months,1,car,2,Low,1,Good Loan,0,7.51,A,1,5,5373.732306,4800,0,149.34,409000006320,4-Oct-18,Indiaforensic VISA ACQ INT 30091,,328.15,-548243339.32,Williamson,618,Spain,154843.40,0,1,0
6322,2011,2,RENT,1,Low,1,11000, 36 months,1,debt_consolidation,6,Low,1,Good Loan,0,12.42,B,2,8.7,13083.21,11000,0,367.57,409000006321,4-Oct-18,Indiaforensic VISA ACQ INT 01101,,209.22,-548243130.10,Beneventi,590,France,8214.46,0,1,0
6323,2011,7,MORTGAGE,3,Low,1,8000, 36 months,1,credit_card,1,High,2,Good Loan,0,16.29,D,4,13.8,10162.76354,8000,0,282.41,409000006322,4-Oct-18,Indiaforensic VISA ACQ INT 02101,,2036.35,-548241093.75,Chidumaga,735,France,147075.69,0,1,0
6324,2011,1,RENT,1,Low,1,12000, 36 months,1,debt_consolidation,6,Low,1,Good Loan,0,10.65,B,2,9.78,13449.8,12000,0,390.88,409000006323,5-Oct-18,Indiaforensic MASTER ACQ DOM 051,,4548892.59,-543692201.16,Mitchell,550,France,116495.55,0,1,0
6325,2011,10,MORTGAGE,3,Medium,2,30000, 60 months,2,debt_consolidation,6,High,2,Good Loan,0,22.35,F,6,22.41,42525.2,23128.4,0,834.55,409000006324,5-Oct-18,Indiaforensic RUPAY POS ACQ05101,,2088062.12,-541604139.04,Chibugo,729,Spain,31165.06,0,1,0
6326,2011,3,RENT,1,Low,1,5000, 36 months,1,moving,10,Low,1,Good Loan,0,6.03,A,1,5.96,5477.972786,5000,0,152.18,409000006325,5-Oct-18,Indiaforensic VISA ACQ DOM051018,,5949288.33,-535654850.71,Hyde,743,Germany,192127.22,0,1,0
6327,2011,6.05,MORTGAGE,3,Low,1,9600, 36 months,1,debt_consolidation,6,Low,1,Good Loan,0,6.03,A,1,15.04,10518.10464,9600,0,292.19,409000006326,5-Oct-18,TRFTO  Indiaforensic SERVICES IN,"3,000,000.00",,-538654850.71,Alekseeva,555,France,137491.23,0,1,0
6328,2011,10,RENT,1,Low,1,33000, 60 months,2,debt_consolidation,6,High,2,Good Loan,0,18.64,E,5,19.67,50304.07006,33000,0,849.52,409000006327,5-Oct-18,TRF TO  Indiaforensic SERVICES I,"3,000,000.00",,-541654850.71,Abdulov,667,Spain,186841.71,0,1,0
6329,2011,10,MORTGAGE,3,Low,1,7125, 36 months,1,debt_consolidation,6,Low,1,Good Loan,0,6.62,A,1,21.94,7809.1,7125,0,218.77,409000006328,5-Oct-18,Indiaforensic RUPAY POS C2 ACQ05,,771744.96,-540883105.75,Buckley,790,Spain,86776.38,0,1,0
6330,2011,5,MORTGAGE,3,High,3,8400, 36 months,1,car,2,Low,1,Good Loan,0,7.51,A,1,5.72,9406.270521,8400,0,261.34,409000006329,5-Oct-18,TRF TO  Indiaforensic SERVICES I,"6,600,000.00",,-547483105.75,Howard,727,Germany,72073.72,0,1,0
6331,2011,2,MORTGAGE,3,Low,1,35000, 60 months,2,debt_consolidation,6,Low,1,Good Loan,0,11.71,B,2,7.29,39424.72,28353.92,0,773.44,409000006330,5-Oct-18,Indiaforensic MASTER INT041018,,4099.21,-547479006.54,Peel,744,France,10662.58,0,1,0
6332,2011,2,RENT,1,Low,1,19000, 36 months,1,major_purchase,8,Low,1,Good Loan,0,8.9,A,1,3.22,21624.64997,19000,0,603.32,409000006331,5-Oct-18,Indiaforensic VISA ACQ INT 03101,,1017.97,-547477988.57,Herz,629,Germany,91001.02,0,1,0
6333,2011,10,MORTGAGE,3,Low,1,15000, 60 months,2,debt_consolidation,6,Low,1,Bad Loan,1,10.65,B,2,14.1,14751.07,9623.34,1188.01,323.53,409000006332,5-Oct-18,TRF TO  Indiaforensic SERVICES I,"700,000.00",,-548177988.57,Holden,619,France,20555.21,0,1,0
6334,2011,0.5,RENT,1,Low,1,8000, 36 months,1,debt_consolidation,6,High,2,Good Loan,0,15.96,C,3,16.37,10107.68086,8000,0,281.1,409000006333,6-Oct-18,Indiaforensic VISA ACQ DOM061018,,5667933.35,-542510055.22,McLean,634,France,123164.97,0,1,0
6335,2011,10,MORTGAGE,3,Medium,2,20000, 60 months,2,debt_consolidation,6,Low,1,Good Loan,0,12.69,B,2,6.14,26801.37,20000,0,451.9,409000006334,6-Oct-18,Indiaforensic RUPAY POS ACQ06101,,2117607.10,-540392448.12,Findlay,608,Spain,143463.28,0,1,0
6336,2011,1,RENT,1,Low,1,15000, 36 months,1,debt_consolidation,6,Low,1,Good Loan,0,12.42,B,2,12.71,17988.21685,15000,0,501.23,409000006335,6-Oct-18,TRF TO  Indiaforensic SERVICES I,"4,000,000.00",,-544392448.12,Wyatt,507,France,92131.54,0,1,0
6337,2011,7,MORTGAGE,3,Medium,2,35000, 60 months,2,other,4,High,2,Bad Loan,1,20.3,E,5,9.87,18398.01,7096.88,1624.71,933.14,409000006336,6-Oct-18,Indiaforensic RUPAY POS C2 ACQ06,,648714.71,-543743733.41,Rapuluolisa,536,Germany,77178.42,0,1,0
6338,2011,3,RENT,1,Low,1,10000, 36 months,1,credit_card,1,High,2,Good Loan,0,14.27,C,3,14.74,11483.79,10000,0,343.09,409000006337,6-Oct-18,TRFV TO  Indiaforensic SERVICES,"3,000,000.00",,-546743733.41,Buckland,730,Spain,193650.16,0,1,0
6339,2011,8,RENT,1,Low,1,25200, 60 months,2,wedding,5,High,2,Good Loan,0,13.49,C,3,4.58,29551.44,20255.7,0,579.72,409000006338,6-Oct-18,TRF TO  Indiaforensic SERVICES I,"500,000.00",,-547243733.41,Hargreaves,583,Germany,52861.89,0,1,0
6340,2011,10,MORTGAGE,3,Medium,2,9000, 36 months,1,debt_consolidation,6,Low,1,Good Loan,0,10.65,B,2,16.1,10542.51051,9000,0,293.16,409000006339,6-Oct-18,TRF TO  Indiaforensic SERVICES I,"1,000,000.00",,-548243733.41,Onyeoruru,644,France,35896.75,0,1,0
6341,2011,5,RENT,1,Low,1,13275, 36 months,1,credit_card,1,High,2,Good Loan,0,17.58,D,4,9.78,17155.57833,13275,0,477.14,409000006340,8-Oct-18,Indiaforensic RUPAY POS ACQ07101,,2106907.54,-546136825.87,Salas,790,Spain,149418.41,0,1,0
6342,2011,8,RENT,1,Low,1,18000, 60 months,2,medical,9,Low,1,Bad Loan,1,11.71,B,2,18.27,15513.3,9509.7,1204.78,397.77,409000006341,8-Oct-18,TRF TO  Indiaforensic SERVICES I,"2,000,000.00",,-548136825.87,Laney,807,Germany,46253.65,0,1,0
6343,2011,9,MORTGAGE,3,Low,1,5500, 36 months,1,other,4,Low,1,Good Loan,0,6.03,A,1,22.52,6025.834541,5500,0,167.4,409000006342,8-Oct-18,Indiaforensic MASTER ACQ DOM0810,,12243224.61,-535893601.26,Fu,581,France,86609.37,0,1,0
6344,2011,6,RENT,1,Low,1,10000, 36 months,1,debt_consolidation,6,Low,1,Good Loan,0,7.51,A,1,12.1,10879.07,10000,0,311.11,409000006343,8-Oct-18,Indiaforensic VISA ACQ DOM081018,,9825517.55,-526068083.71,Tien,627,Spain,91943.94,0,1,0
6345,2011,5,OWN,2,Low,1,6500, 36 months,1,major_purchase,8,Low,1,Good Loan,0,6.03,A,1,14.69,6711.89,6500,0,197.84,409000006344,8-Oct-18,Indiaforensic RUPAY POS ACQ08101,,2276266.93,-523791816.78,Sazonova,850,France,128892.36,0,1,0
6346,2011,1,RENT,1,Low,1,2400, 36 months,1,debt_consolidation,6,High,2,Good Loan,0,16.29,D,4,7.33,3048.420486,2400,0,84.73,409000006345,8-Oct-18,Indiaforensic RUPAY POS C2 ACQ08,,584292.66,-523207524.12,Tuan,754,France,44830.71,0,1,0
6347,2011,10,MORTGAGE,3,Low,1,1000, 36 months,1,debt_consolidation,6,High,2,Good Loan,0,16.29,D,4,19.95,1270.212888,1000,0,35.31,409000006346,8-Oct-18,TRF TO  Indiaforensic SERVICES I,"4,000,000.00",,-527207524.12,Wei,551,Germany,84508.44,0,1,0
6348,2011,6.05,OWN,2,Low,1,5000, 36 months,1,major_purchase,8,Low,1,Good Loan,0,6.03,A,1,7.81,5478.002443,5000,0,152.18,409000006347,8-Oct-18,TRF TO  Indiaforensic SERVICES I,"4,000,000.00",,-531207524.12,Bergamaschi,637,Germany,84760.70,0,1,0
6349,2011,5,MORTGAGE,3,Low,1,3800, 36 months,1,car,2,Low,1,Good Loan,0,10.65,B,2,13.6,3890.76,3800,0,123.78,409000006348,8-Oct-18,TRF TO  Indiaforensic SERVICES I,"4,000,000.00",,-535207524.12,Taylor,699,Spain,147661.47,0,1,0
6350,2011,2,MORTGAGE,3,Low,1,10000, 36 months,1,major_purchase,8,Low,1,Good Loan,0,11.71,B,2,18.06,11440.27,10000,0,330.76,409000006349,8-Oct-18,TRF TO  Indiaforensic SERVICES I,"5,000,000.00",,-540207524.12,Messersmith,542,France,82393.08,0,1,0
6351,2011,10,MORTGAGE,3,Low,1,1500, 36 months,1,debt_consolidation,6,High,2,Good Loan,0,16.29,D,4,24.63,1905.333339,1500,0,52.96,409000006350,8-Oct-18,TRF TO  Indiaforensic SERVICES I,"5,000,000.00",,-545207524.12,Coles,640,Germany,135995.58,0,1,0
6352,2011,9,RENT,1,Low,1,4800, 36 months,1,other,4,Low,1,Good Loan,0,7.51,A,1,17.31,5065.63,4800,0,149.34,409000006351,8-Oct-18,Indiaforensic MASTER INT051018,,3410.53,-545204113.59,Brookes,553,France,159800.16,0,1,0
6353,2011,5,OWN,2,Medium,2,23800, 36 months,1,home_improvement,7,Low,1,Bad Loan,1,8.9,A,1,17.91,5239.12,3537.55,708.34,755.73,409000006352,8-Oct-18,TRF TO  Indiaforensic SERVICES I,"3,000,000.00",,-548204113.59,Reid,741,France,14379.01,0,1,0
6354,2011,1,RENT,1,Low,1,2000, 36 months,1,debt_consolidation,6,Low,1,Good Loan,0,7.9,A,1,13.22,2252.246487,2000,0,62.59,409000006353,9-Oct-18,Indiaforensic MASTER ACQ DOM0910,,4466303.48,-543737810.11,Etheridge,598,France,74322.85,0,1,0
6355,2011,7,MORTGAGE,3,Low,1,20000, 36 months,1,credit_card,1,Low,1,Good Loan,0,10.65,B,2,14.29,23440.40224,20000,0,651.47,409000006354,9-Oct-18,Indiaforensic VISA ACQ DOM091018,,5383168.21,-538354641.90,Jolly,660,Spain,189016.24,0,1,0
6356,2011,3,RENT,1,Low,1,14500, 60 months,2,debt_consolidation,6,High,2,Good Loan,0,17.27,D,4,9.91,18833.52,11845.81,0,362.48,409000006355,9-Oct-18,Indiaforensic RUPAY POS ACQ09101,,2490161.94,-535864479.96,Chizoba,618,Spain,136435.75,0,1,0
6357,2011,10,MORTGAGE,3,Low,1,8325, 36 months,1,debt_consolidation,6,Low,1,Good Loan,0,7.51,A,1,25.5,9250.46,8325,0,259,409000006356,9-Oct-18,Indiaforensic POS ACQ C2 SETTL09,,625812.54,-535238667.42,Eberegbulam,647,France,78488.39,0,1,0
6358,2011,5,MORTGAGE,3,Medium,2,35000, 60 months,2,credit_card,1,High,2,Good Loan,0,22.74,G,7,15.83,42532.22,35000,0,981.45,409000006357,9-Oct-18,TRF TO  Indiaforensic SERVICES I,"5,000,000.00",,-540238667.42,Pagnotto,491,France,113695.99,0,1,0
6359,2011,2,MORTGAGE,3,Medium,2,16000, 60 months,2,home_improvement,7,High,2,Good Loan,0,15.27,C,3,14.79,19504.84,12750.47,0,382.92,409000006358,9-Oct-18,TRF TO  Indiaforensic SERVICES I,"4,000,000.00",,-544238667.42,Lucchesi,652,France,54628.11,0,1,0
6360,2011,4,RENT,1,Low,1,2000, 60 months,2,other,4,High,2,Good Loan,0,14.27,C,3,19.31,2383.06,1600.1,0,46.82,409000006359,9-Oct-18,TRF  Indiaforensic SERVICES INDI,"2,000,000.00",,-546238667.42,Hughes,650,Germany,150835.21,0,1,0
6361,2011,1,RENT,1,Low,1,9600, 36 months,1,credit_card,1,Low,1,Good Loan,0,9.91,B,2,14.92,11134.08667,9600,0,309.36,409000006360,9-Oct-18,TRF TO  Indiaforensic SERVICES I,"2,000,000.00",,-548238667.42,Panicucci,413,Germany,158891.79,0,1,0
6362,2011,10,RENT,1,Low,1,3000, 36 months,1,medical,9,High,2,Good Loan,0,14.27,C,3,20.1,3698.760372,3000,0,102.93,409000006361,10-Oct-18,Indiaforensic MASTER ACQ DOM1010,,4879119.87,-543359547.55,Burns,416,Germany,160523.33,0,1,0
6363,2011,10,OWN,2,Low,1,32000, 60 months,2,credit_card,1,Low,1,Good Loan,0,12.42,B,2,7.38,33301.14,32000,0,718.64,409000006362,10-Oct-18,Indiaforensic VISA ACQ DOM101018,,5974259.57,-537385287.98,Ricci,629,Spain,180595.02,0,1,0
6364,2011,8,OWN,2,Low,1,2500, 36 months,1,major_purchase,8,Low,1,Good Loan,0,6.03,A,1,26.43,2669,2500,0,76.09,409000006363,10-Oct-18,Indiaforensic RUPAY POS ACQ10101,,2239495.94,-535145792.04,Lambert,678,Spain,16618.76,0,1,0
6365,2011,9,MORTGAGE,3,Low,1,25000, 60 months,2,debt_consolidation,6,High,2,Good Loan,0,14.27,C,3,10.88,31497.73,25000,0,585.22,409000006364,10-Oct-18,Indiaforensic RUPAY POS C2 ACQ10,,681131.17,-534464660.87,Esposito,527,Spain,79919.97,0,1,0
6366,2011,5,MORTGAGE,3,Low,1,19075, 36 months,1,debt_consolidation,6,Low,1,Good Loan,0,7.9,A,1,11.06,21461.68545,19075,0,596.87,409000006365,10-Oct-18,TRF TO  Indiaforensic SERVICES I,"3,800,000.00",,-538264660.87,Benson,743,Spain,186489.14,0,1,0
6367,2011,9,RENT,1,Low,1,12000, 60 months,2,debt_consolidation,6,Low,1,Good Loan,0,12.42,B,2,19.5,13737.55,9691.69,0,269.49,409000006366,10-Oct-18,Indiaforensic MASTER INT0910018,,208.85,-538264452.02,Botts,683,Germany,51999.50,0,1,0
6368,2011,2,MORTGAGE,3,Medium,2,8000, 36 months,1,home_improvement,7,Low,1,Good Loan,0,6.62,A,1,4.59,8839.672051,8000,0,245.63,409000006367,10-Oct-18,TRF TO  Indiaforensic SERVICES I,"10,000,000.00",,-548264452.02,Parkes,536,France,121299.14,0,1,0
6369,2011,0.5,RENT,1,Low,1,5000, 60 months,2,debt_consolidation,6,High,2,Good Loan,0,19.42,E,5,7.8,6656.45,3904.3,0,130.87,409000006368,11-Oct-18,MDR REIMBURSEMENT Q2-2018,,335379.00,-547929073.02,Mai,663,Spain,144593.30,0,1,0
6370,2011,10,MORTGAGE,3,Low,1,12000, 36 months,1,debt_consolidation,6,Low,1,Good Loan,0,12.42,B,2,21.87,14430.60338,12000,0,400.99,409000006369,11-Oct-18,Indiaforensic MASTER INT0910018,,3028.19,-547926044.83,Castiglione,646,France,178752.73,0,1,0
6371,2011,5,MORTGAGE,3,Low,1,7500, 60 months,2,debt_consolidation,6,High,2,Good Loan,0,18.25,D,4,13.84,9435.15,7500,0,191.48,409000006370,11-Oct-18,Indiaforensic MC BILL PARTIAL RE,"335,379.00",,-548261423.83,Manna,707,France,94148.30,0,1,0
6372,2011,4,MORTGAGE,3,High,3,21000, 60 months,2,other,4,High,2,Good Loan,0,19.42,E,5,5.53,25989.5,21000,0,549.62,409000006371,12-Oct-18,Indiaforensic MASTER ACQ DOM1110,,4966212.66,-543295211.17,Lin,602,France,77414.45,0,1,0
6373,2011,1,OWN,2,Low,1,15600, 60 months,2,credit_card,1,High,2,Bad Loan,1,19.42,E,5,18.68,9292.51,3852.35,736.48,408.29,409000006372,12-Oct-18,Indiaforensic VISA ACQ DOM111018,,5728242.35,-537566968.82,Fink,635,France,63236.97,0,1,0
6374,2011,9,MORTGAGE,3,Low,1,5600, 36 months,1,car,2,High,2,Good Loan,0,15.96,C,3,11.8,6964.03,5600,0,196.77,409000006373,12-Oct-18,Indiaforensic RUPAY POS ACQ11101,,2594958.14,-534972010.68,Baresi,597,France,108645.85,0,1,0
6375,2011,6,RENT,1,Low,1,2400, 36 months,1,debt_consolidation,6,High,2,Good Loan,0,16.29,D,4,20.75,3048.276428,2400,0,84.73,409000006374,12-Oct-18,Indiaforensic RUPAY POS C2 ACQ11,,759693.61,-534212317.07,Morehead,503,France,95153.24,0,1,0
6376,2011,4,RENT,1,Low,1,7000, 36 months,1,wedding,5,Low,1,Good Loan,0,6.62,A,1,8.67,7717.678848,7000,0,214.93,409000006375,12-Oct-18,Indiaforensic VISA ACQ INT 06101,,916.36,-534211400.71,Afamefuna,524,Spain,136079.64,0,1,0
6377,2011,1,MORTGAGE,3,Low,1,6000, 36 months,1,debt_consolidation,6,Low,1,Good Loan,0,6.62,A,1,20.02,6623.88339,6000,0,184.23,409000006376,12-Oct-18,Indiaforensic VISA ACQ INT 07101,,7169.83,-534204230.88,Greco,700,France,98273.01,0,1,0
6378,2011,9,MORTGAGE,3,Low,1,3000, 36 months,1,vacation,11,Low,1,Good Loan,0,7.51,A,1,19.74,3358.372198,3000,0,93.34,409000006377,12-Oct-18,Indiaforensic VISA ACQ INT 08101,,1722.15,-534202508.73,Balashova,692,France,113505.93,0,1,0
6379,2011,6,MORTGAGE,3,Low,1,12000, 36 months,1,credit_card,1,Low,1,Good Loan,0,6.62,A,1,14.76,13261.98099,12000,0,368.45,409000006378,12-Oct-18,Indiaforensic VISA ACQ INT 09101,,4058.30,-534198450.43,Bogdanov,562,France,52525.15,0,1,0
6380,2011,3,MORTGAGE,3,Low,1,5000, 36 months,1,credit_card,1,Low,1,Good Loan,0,6.03,A,1,1.75,5477.913472,5000,0,152.18,409000006379,12-Oct-18,TRF TO  Indiaforensic SERVICES I,"4,000,000.00",,-538198450.43,Lowe,679,France,194617.98,0,1,0
6381,2011,10,MORTGAGE,3,Low,1,16500, 60 months,2,debt_consolidation,6,Low,1,Good Loan,0,7.9,A,1,8.21,18529.45,16500,0,333.78,409000006380,12-Oct-18,TRF TO  Indiaforensic SERVICES I,"10,000,000.00",,-548198450.43,Ponce,603,Germany,152541.89,0,1,0
6382,2011,7,MORTGAGE,3,Low,1,11200, 60 months,2,debt_consolidation,6,High,2,Bad Loan,1,20.89,F,6,15.8,7845.93,2837.28,1219.09,302.31,409000006381,12-Oct-18,Indiaforensic MASTER INT1110018,,9373.87,-548189076.56,Trevisano,720,Spain,142903.44,0,1,0
6383,2011,0.5,MORTGAGE,3,Low,1,16000, 60 months,2,credit_card,1,Low,1,Good Loan,0,12.69,B,2,16.65,18417.92,12900.2,0,361.52,409000006382,12-Oct-18,Indiaforensic MASTER ACQ DOM1210,,5100396.10,-543088680.46,Gardner,797,France,182257.61,0,1,0
6384,2011,5,MORTGAGE,3,Low,1,17000, 60 months,2,debt_consolidation,6,Low,1,Bad Loan,1,12.42,B,2,12.34,8347.01,4544.9,716.01,381.78,409000006383,12-Oct-18,Indiaforensic VISA ACQ DOM121018,,5558289.64,-537530390.82,Lorenzo,594,France,135431.72,0,1,0
6385,2011,1,MORTGAGE,3,Low,1,5000, 36 months,1,home_improvement,7,High,2,Good Loan,0,15.27,C,3,11.72,6254.743315,5000,0,173.99,409000006384,12-Oct-18,Indiaforensic VISA ACQ INT 10101,,3460.75,-537526930.07,Palmer,529,France,175697.87,0,1,0
6386,2011,4,RENT,1,Low,1,14000, 60 months,2,debt_consolidation,6,High,2,Good Loan,0,14.27,C,3,16.12,19283.89597,14000,0,327.72,409000006385,12-Oct-18,Indiaforensic RUPAY POS ACQ12101,,2705507.78,-534821422.29,Zuyeva,606,Germany,59061.25,0,1,0
6387,2011,8,OWN,2,Low,1,12875, 60 months,2,home_improvement,7,High,2,Good Loan,0,17.27,D,4,19.02,16395.03,10166.32,0,321.85,409000006386,12-Oct-18,Indiaforensic RUPAY POS C2 ACQ12,,788029.41,-534033392.88,Jen,621,Spain,131283.60,0,1,0
6388,2011,9,MORTGAGE,3,Low,1,6500, 36 months,1,debt_consolidation,6,Low,1,Good Loan,0,6.03,A,1,22.34,7139.446605,6500,0,197.84,409000006387,12-Oct-18,TRF TO  Indiaforensic SERVICES I,"10,000,000.00",,-544033392.88,Alekseeva,513,France,152499.80,0,1,0
6389,2011,10,MORTGAGE,3,Medium,2,12000, 36 months,1,credit_card,1,Low,1,Good Loan,0,6.62,A,1,4.09,13025.98,12000,0,368.45,409000006388,12-Oct-18,TRF TO  Indiaforensic SERVICES I,"4,200,000.00",,-548233392.88,Manfrin,753,Germany,15523.09,0,1,0
6390,2011,5,RENT,1,Low,1,2800, 36 months,1,major_purchase,8,High,2,Good Loan,0,14.65,C,3,4.63,3475.57398,2800,0,96.59,409000006389,15-Oct-18,Indiaforensic MASTER ACQ DOM1510,,14607747.66,-533625645.22,Chiemenam,605,France,186418.85,0,1,0
6391,2011,2,MORTGAGE,3,Low,1,8150, 36 months,1,other,4,Low,1,Good Loan,0,7.51,A,1,12.91,9125.192138,8150,0,253.56,409000006390,15-Oct-18,Indiaforensic VISA ACQ DOM131018,,6805365.64,-526820279.58,Chiemenam,574,Spain,32262.28,0,1,0
6392,2011,10,MORTGAGE,3,Low,1,16450, 60 months,2,debt_consolidation,6,High,2,Good Loan,0,17.58,D,4,22.8,18301.62,16450,0,413.98,409000006391,15-Oct-18,Indiaforensic VISA ACQ DOM151018,,12028184.93,-514792094.65,Clark,726,France,128052.29,0,1,0
6393,2011,9,MORTGAGE,3,Medium,2,15000, 60 months,2,debt_consolidation,6,Low,1,Good Loan,0,12.42,B,2,19.09,18164.23,15000,0,336.86,409000006392,15-Oct-18,Indiaforensic RUPAY POS ACQ15101,,3152198.40,-511639896.25,Fanucci,611,Spain,181419.29,0,1,0
6394,2011,2,MORTGAGE,3,Low,1,8000, 36 months,1,home_improvement,7,High,2,Good Loan,0,14.65,C,3,21.6,9931.234667,8000,0,275.96,409000006393,15-Oct-18,Indiaforensic RUPAY POS C2 ACQ15,,832521.26,-510807374.99,Cattaneo,593,Germany,109783.29,0,1,0
6395,2011,1,MORTGAGE,3,Low,1,14800, 36 months,1,debt_consolidation,6,High,2,Good Loan,0,19.42,E,5,20.76,16852.44,14800,0,545.66,409000006394,15-Oct-18,Indiaforensic VISA ACQ INT 11101,,3040.12,-510804334.87,Udinesi,466,Germany,181879.56,0,1,0
6396,2011,6,MORTGAGE,3,Low,1,12800, 36 months,1,medical,9,Low,1,Good Loan,0,11.71,B,2,18.1,15237.23106,12800,0,423.38,409000006395,15-Oct-18,Indiaforensic RUPAY POS ACQ13101,,2434867.93,-508369466.94,Bentley,741,Germany,74260.16,0,1,0
6397,2011,9,RENT,1,Low,1,14000, 36 months,1,debt_consolidation,6,Low,1,Good Loan,0,12.42,B,2,23.13,16835.7082,14000,0,467.82,409000006396,15-Oct-18,Indiaforensic RUPAY POS ACQ14101,,3700385.18,-504669081.76,Holmes,684,Germany,49865.04,0,1,0
6398,2011,4,RENT,1,Low,1,8000, 36 months,1,credit_card,1,Low,1,Good Loan,0,12.69,B,2,13.45,9653.17325,8000,0,268.36,409000006397,15-Oct-18,TRF TO  Indiaforensic SERVICES I,"15,000,000.00",,-519669081.76,Austin,550,Spain,103608.06,0,1,0
6399,2011,10,MORTGAGE,3,Low,1,2500, 60 months,2,car,2,High,2,Good Loan,0,13.49,C,3,13.19,2928.95,2500,0,57.52,409000006398,15-Oct-18,TRF TO  Indiaforensic SERVICES I,"15,000,000.00",,-534669081.76,Mackenzie,593,Spain,167564.82,0,1,0
6400,2011,10,RENT,1,Low,1,1500, 36 months,1,other,4,Low,1,Good Loan,0,12.69,B,2,10.64,1602.93,1500,0,50.32,409000006399,15-Oct-18,TRF TO  Indiaforensic SERVICES I,"10,000,000.00",,-544669081.76,Booth,601,Germany,41816.49,0,1,0
6401,2011,2,RENT,1,Low,1,6000, 36 months,1,debt_consolidation,6,Low,1,Good Loan,0,9.91,B,2,13.83,6958.107505,6000,0,193.35,409000006400,15-Oct-18,Indiaforensic MASTER INT121018,,887.97,-544668193.79,Collier,676,Spain,179066.58,0,1,0
6402,2011,10,MORTGAGE,3,Medium,2,35000, 60 months,2,credit_card,1,Low,1,Good Loan,0,11.71,B,2,11.27,40849.48,35000,0,773.44,409000006401,15-Oct-18,TRF TO  Indiaforensic SERVICES I,"3,600,000.00",,-548268193.79,Hs?,556,France,109184.24,0,1,0
6403,2011,1,MORTGAGE,3,Low,1,10000, 36 months,1,debt_consolidation,6,High,2,Good Loan,0,13.49,C,3,23.64,12208.84152,10000,0,339.31,409000006402,16-Oct-18,Indiaforensic MASTER ACQ DOM1610,,4626494.44,-543641699.35,Oluchukwu,719,France,199841.32,0,1,0
6404,2011,1,RENT,1,Low,1,9000, 36 months,1,credit_card,1,Low,1,Good Loan,0,7.51,A,1,21.37,10007.9931,9000,0,280,409000006403,16-Oct-18,Indiaforensic VISA ACQ DOM161018,,6345468.65,-537296230.70,Sung,850,Germany,83617.17,0,1,0
6405,2011,10,MORTGAGE,3,Low,1,21600, 60 months,2,credit_card,1,Low,1,Good Loan,0,11.71,B,2,20.82,24333.4,17497.56,0,477.33,409000006404,16-Oct-18,Indiaforensic RUPAY POS ACQ16101,,2431187.27,-534865043.43,Marino,649,Spain,84863.85,0,1,0
6406,2011,10,RENT,1,Medium,2,3000, 36 months,1,other,4,High,2,Good Loan,0,14.27,C,3,16.63,3701.92076,3000,0,102.93,409000006405,16-Oct-18,Indiaforensic VISA ACQ INT 12101,,2138.17,-534862905.26,Vinogradov,509,Spain,114775.53,0,1,0
6407,2011,10,RENT,1,Low,1,35000, 60 months,2,debt_consolidation,6,High,2,Good Loan,0,13.49,C,3,19.76,43312.7,35000,0,805.17,409000006406,16-Oct-18,TRF TO  Indiaforensic SERVICES I,"10,000,000.00",,-544862905.26,Burns,684,France,103557.93,0,1,0
6408,2011,8,RENT,1,Low,1,4900, 36 months,1,major_purchase,8,Low,1,Good Loan,0,9.91,B,2,14.37,5682.284594,4900,0,157.91,409000006407,16-Oct-18,TRF TO  Indiaforensic SERVICES I,"3,400,000.00",,-548262905.26,Fanucci,806,Germany,85028.36,0,1,0
6409,2011,3,RENT,1,Medium,2,12000, 36 months,1,debt_consolidation,6,Low,1,Bad Loan,1,7.9,A,1,4.89,8191.47,6642.99,318.99,375.49,409000006408,16-Oct-18,Indiaforensic RUPAY POS C2 ACQ16,,1130242.14,-547132663.12,Chukwujamuike,729,Spain,153064.87,0,1,0
6410,2011,6.05,OWN,2,Low,1,7500, 36 months,1,credit_card,1,Low,1,Good Loan,0,6.62,A,1,15.56,8288.423229,7500,0,230.28,409000006409,16-Oct-18,Indiaforensic MASTER INT1510018,,7749.74,-547124913.38,Flynn,683,France,38784.42,0,1,0
6411,2011,6.05,RENT,1,Low,1,1000, 36 months,1,debt_consolidation,6,Low,1,Good Loan,0,8.9,A,1,6.35,1142.556076,1000,0,31.76,409000006410,16-Oct-18,TRF TO  Indiaforensic SERVICES I,"1,100,000.00",,-548224913.38,Chao,689,Spain,186526.12,0,1,0
6412,2011,2,RENT,1,Low,1,1000, 36 months,1,other,4,Low,1,Good Loan,0,6.03,A,1,25.17,1095.54558,1000,0,30.44,409000006411,17-Oct-18,Indiaforensic MASTER ACQ DOM1710,,5123996.66,-543100916.72,Yeh,672,Germany,28789.94,0,1,0
6413,2011,10,MORTGAGE,3,Low,1,4000, 60 months,2,major_purchase,8,Low,1,Good Loan,0,12.69,B,2,14.81,4598.46,3221.35,0,90.38,409000006412,17-Oct-18,Indiaforensic VISA ACQ DOM171018,,5651220.62,-537449696.10,Klein,602,Germany,45038.29,0,1,0
6414,2011,0.5,RENT,1,Low,1,4500, 36 months,1,car,2,Low,1,Good Loan,0,6.62,A,1,18.45,4972.198868,4500,0,138.17,409000006413,17-Oct-18,Indiaforensic RUPAY POS ACQ17101,,2776591.89,-534673104.21,Mahmood,739,France,150245.81,0,1,0
6415,2011,4,RENT,1,Low,1,5000, 36 months,1,major_purchase,8,Low,1,Good Loan,0,6.62,A,1,15.8,5501.514965,5000,0,153.52,409000006414,17-Oct-18,Indiaforensic RUPAY POS C2 ACQ17,,885466.39,-533787637.82,Tu,618,France,57762.00,0,1,0
6416,2011,4,RENT,1,Low,1,9000, 60 months,2,other,4,High,2,Bad Loan,1,14.27,C,3,5.64,9059.24,5766.51,14.28,210.68,409000006415,17-Oct-18,Indiaforensic VISA ACQ INT 13101,,3412.11,-533784225.71,Shcherbakov,674,France,4292.72,0,1,0
6417,2011,3,RENT,1,Medium,2,35000, 60 months,2,debt_consolidation,6,Low,1,Good Loan,0,12.69,B,2,9.5,40312.22,28233.18,0,790.82,409000006416,17-Oct-18,Indiaforensic VISA ACQ INT 14101,,104929.64,-533679296.07,Zetticci,762,France,173365.89,0,1,0
6418,2011,5,RENT,1,Low,1,8000, 60 months,2,other,4,High,2,Good Loan,0,15.96,C,3,14.61,10469.12771,8000,0,194.38,409000006417,17-Oct-18,Indiaforensic VISA ACQ INT 15101,,4345.98,-533674950.09,Carr,790,Spain,119484.01,0,1,0
6419,2011,10,RENT,1,Medium,2,12000, 36 months,1,debt_consolidation,6,High,2,Good Loan,0,17.27,D,4,13.84,15449.17833,12000,0,429.45,409000006418,17-Oct-18,TRF TO  Indiaforensic SERVICES I,"10,000,000.00",,-543674950.09,Browne,754,Spain,121821.16,0,1,0
6420,2011,6.05,MORTGAGE,3,Low,1,23600, 60 months,2,debt_consolidation,6,High,2,Good Loan,0,18.25,D,4,19.79,35244.38848,23600,0,602.5,409000006419,17-Oct-18,TRF TO  Indiaforensic SERVICES I,"4,500,000.00",,-548174950.09,Feng,729,France,151733.43,0,1,0
6421,2011,5,MORTGAGE,3,Low,1,12000, 36 months,1,debt_consolidation,6,Low,1,Good Loan,0,6.03,A,1,15.64,13147.45575,12000,0,365.23,409000006420,17-Oct-18,Indiaforensic MASTER INT161018,,1004.61,-548173945.48,Ferguson,606,Germany,53784.22,0,1,0
6422,2011,6,RENT,1,Low,1,2400, 36 months,1,debt_consolidation,6,Low,1,Good Loan,0,12.69,B,2,22.04,2564.72,2400,0,80.51,409000006421,18-Oct-18,Indiaforensic RUPAY POS ACQ18101,,3046105.69,-545127839.79,Shaw,616,France,62733.05,0,1,0
6423,2011,8,RENT,1,Low,1,7500, 36 months,1,debt_consolidation,6,Low,1,Good Loan,0,8.9,A,1,1.9,8570.942011,7500,0,238.15,409000006422,18-Oct-18,Indiaforensic RUPAY POS C2 ACQ18,,849069.63,-544278770.16,Palermo,772,France,17671.78,0,1,0
6424,2011,10,MORTGAGE,3,Medium,2,34525, 60 months,2,debt_consolidation,6,High,2,Good Loan,0,14.27,C,3,17.66,47862.73008,34525,0,808.18,409000006423,18-Oct-18,TRF TO  Indiaforensic SERVICES I,"3,000,000.00",,-547278770.16,Moore,652,Spain,188905.43,0,1,0
6425,2011,4,MORTGAGE,3,Low,1,6000, 36 months,1,home_improvement,7,Low,1,Good Loan,0,6.03,A,1,9.03,6116.6,6000,0,182.62,409000006424,18-Oct-18,TRF TO  Indiaforensic SERVICES I,"900,000.00",,-548178770.16,Huang,743,France,113079.19,0,1,0
6426,2011,7,MORTGAGE,3,Medium,2,3950, 36 months,1,renewable_energy,13,Low,1,Good Loan,0,6.03,A,1,2.73,4008.28,3950,0,120.23,409000006425,19-Oct-18,Indiaforensic MASTER ACQ DOM1810,,4906649.53,-543272120.63,Gray,793,France,83997.79,0,1,0
6427,2011,2,RENT,1,Low,1,1800, 36 months,1,debt_consolidation,6,Low,1,Good Loan,0,11.99,B,2,21.25,2166.966358,1800,0,59.78,409000006426,19-Oct-18,Indiaforensic VISA ACQ DOM181018,,6311491.94,-536960628.69,Sokolova,743,Spain,125424.42,0,1,0
6428,2011,7,RENT,1,Low,1,6800, 36 months,1,debt_consolidation,6,Low,1,Good Loan,0,11.71,B,2,10.91,8092.524613,6800,0,224.92,409000006427,19-Oct-18,Indiaforensic MASTER ACQ DOM1910,,4725521.98,-532235106.71,Henderson,746,France,143194.05,0,1,0
6429,2011,2,RENT,1,Low,1,6650, 36 months,1,credit_card,1,Low,1,Good Loan,0,12.69,B,2,23.36,7497.68,6650,0,223.08,409000006428,19-Oct-18,Indiaforensic VISA ACQ DOM191018,,5205840.45,-527029266.26,Mosley,627,Germany,93132.61,0,1,0
6430,2011,3,MORTGAGE,3,Low,1,31025, 60 months,2,debt_consolidation,6,High,2,Good Loan,0,22.06,F,6,20.01,43738.98,23961.45,0,857.94,409000006429,19-Oct-18,Indiaforensic RUPAY POS ACQ19101,,2529003.04,-524500263.22,Nnaemeka,713,Spain,76038.38,0,1,0
6431,2011,0.5,RENT,1,Low,1,1500, 36 months,1,other,4,Low,1,Good Loan,0,12.69,B,2,3.06,1791.32,1500,0,50.32,409000006430,19-Oct-18,Indiaforensic RUPAY POS C2 ACQ19,,690283.81,-523809979.41,Everett,678,Spain,168658.30,0,1,0
6432,2011,0.5,MORTGAGE,3,Low,1,14000, 36 months,1,debt_consolidation,6,Low,1,Good Loan,0,12.69,B,2,14.88,16210.14,14000.01,0,469.63,409000006431,19-Oct-18,Indiaforensic VISA ACQ INT 16101,,509.09,-523809470.32,Goddard,540,Spain,108419.41,0,1,0
6433,2011,0.5,RENT,1,Low,1,6000, 36 months,1,other,4,Low,1,Good Loan,0,7.9,A,1,8.61,6723.631578,6000,0,187.75,409000006432,19-Oct-18,Indiaforensic MASTER INT171018,,1819.26,-523807651.06,Kuo,615,Germany,171657.57,0,1,0
6434,2011,10,MORTGAGE,3,Low,1,7500, 36 months,1,other,4,Low,1,Good Loan,0,6.03,A,1,9.03,8084.11,7500,0,228.27,409000006433,19-Oct-18,TFR TO 1196428  Indiaforensic SE,"5,000,000.00",,-528807651.06,Bianchi,415,Spain,22357.25,0,1,0
6435,2011,10,MORTGAGE,3,Medium,2,35000, 60 months,2,credit_card,1,Low,1,Good Loan,0,11.71,B,2,10.99,39430.6,28357.67,0,773.44,409000006434,19-Oct-18,TFR TO 1196428  Indiaforensic SE,"5,000,000.00",,-533807651.06,Rouse,628,France,193903.06,0,1,0
6436,2011,2,RENT,1,Low,1,16400, 60 months,2,debt_consolidation,6,High,2,Good Loan,0,22.35,F,6,21.07,25494.89821,16400,0,456.22,409000006435,19-Oct-18,TFR TO 1196428  Indiaforensic SE,"5,000,000.00",,-538807651.06,Nwoye,700,France,141926.43,0,1,0
6437,2011,6,MORTGAGE,3,Low,1,16800, 60 months,2,debt_consolidation,6,High,2,Good Loan,0,15.27,C,3,12.91,21025.3,16800,0,402.06,409000006436,19-Oct-18,TFR TO 1196428  Indiaforensic SE,"5,000,000.00",,-543807651.06,Greco,623,Germany,104079.62,0,1,0
6438,2011,9,RENT,1,Low,1,3700, 36 months,1,car,2,Low,1,Good Loan,0,9.91,B,2,6.14,3730.86,3700,0,119.24,409000006437,19-Oct-18,TFR TO 1196428  Indiaforensic SE,"2,000,000.00",,-545807651.06,Fang,623,France,93832.33,0,1,0
6439,2011,1,MORTGAGE,3,Low,1,5000, 36 months,1,debt_consolidation,6,Low,1,Good Loan,0,6.03,A,1,4.8,5477.972786,5000,0,152.18,409000006438,19-Oct-18,TFR TO 1196428  Indiaforensic SE,"2,000,000.00",,-547807651.06,Chiemenam,679,France,1568.91,0,1,0
6440,2011,0.5,RENT,1,Low,1,3000, 36 months,1,other,4,Low,1,Good Loan,0,10.65,B,2,20.11,3515.959551,3000,0,97.72,409000006439,19-Oct-18,Indiaforensic MASTER INT181018,,1007.49,-547806643.57,Artemiev,632,Spain,60778.11,0,1,0
6441,2011,10,RENT,1,Low,1,7000, 36 months,1,credit_card,1,Low,1,Good Loan,0,7.9,A,1,17.25,7875.032012,7000,0,219.04,409000006440,20-Oct-18,Indiaforensic VISA ACQ DOM201018,,4454020.13,-543352623.44,Burrows,790,France,16119.96,0,1,0
6442,2011,10,MORTGAGE,3,Low,1,20000, 60 months,2,debt_consolidation,6,Low,1,Good Loan,0,10.65,B,2,18.44,25179.61787,20000,0,431.37,409000006441,20-Oct-18,Indiaforensic RUPAY POS ACQ20101,,2195898.18,-541156725.26,Chizuoke,514,France,60375.18,0,1,0
6443,2011,7,RENT,1,Low,1,9600, 36 months,1,credit_card,1,Low,1,Good Loan,0,11.71,B,2,18.18,11451.23617,9600,0,317.53,409000006442,20-Oct-18,TRF TO  Indiaforensic SERVICES I,"1,000,000.00",,-542156725.26,T'ien,491,France,187946.55,0,1,0
6444,2011,10,OWN,2,Low,1,14500, 60 months,2,credit_card,1,High,2,Good Loan,0,17.27,D,4,16.26,21047.43392,14500,0,362.48,409000006443,20-Oct-18,TRF TO  Indiaforensic SERVICES I,"3,000,000.00",,-545156725.26,Rogova,753,France,195563.99,0,1,0
6445,2011,4,MORTGAGE,3,Low,1,19425, 60 months,2,debt_consolidation,6,High,2,Good Loan,0,13.49,C,3,20.3,25775.3193,19425,0,446.87,409000006444,20-Oct-18,TRF TO  Indiaforensic SERVICES I,"3,000,000.00",,-548156725.26,Trevisano,693,Germany,38196.24,0,1,0
6446,2011,6,MORTGAGE,3,Medium,2,24000, 60 months,2,debt_consolidation,6,High,2,Bad Loan,1,18.64,E,5,10.03,21624.05,11265.46,31.08,617.83,409000006445,20-Oct-18,Indiaforensic RUPAY POS C2 ACQ20,,616358.29,-547540366.97,Sagese,679,France,179435.21,0,1,0
6447,2011,10,MORTGAGE,3,Low,1,9100, 36 months,1,debt_consolidation,6,Low,1,Good Loan,0,6.03,A,1,13.15,9932.339812,9100,0,276.97,409000006446,22-Oct-18,Indiaforensic MASTER INT191018,,502.80,-547539864.17,Artyomova,529,Spain,93208.22,0,1,0
6448,2011,10,MORTGAGE,3,Low,1,20000, 36 months,1,debt_consolidation,6,Low,1,Good Loan,0,10.65,B,2,20.32,22516.62,20000,0,651.47,409000006447,22-Oct-18,Indiaforensic RUPAY POS ACQ21101,,2478198.85,-545061665.32,Long,619,Spain,61531.86,0,1,0
6449,2011,2,RENT,1,Medium,2,35000, 36 months,1,credit_card,1,Low,1,Good Loan,0,7.9,A,1,4.14,39424.34542,35000,0,1095.16,409000006448,22-Oct-18,Indiaforensic MASTER ACQ DOM2210,,12664093.19,-532397572.13,Hsueh,680,Spain,92826.35,0,1,0
6450,2011,0.5,RENT,1,Low,1,21000, 60 months,2,other,4,High,2,Good Loan,0,13.49,C,3,3.39,24624.66,16878.83,0,483.1,409000006449,22-Oct-18,Indiaforensic VISA ACQ DOM221018,,10567320.54,-521830251.59,White,693,Germany,23140.28,0,1,0
6451,2011,4,RENT,1,Low,1,4500, 36 months,1,small_business,3,Low,1,Good Loan,0,6.03,A,1,19.03,4627.36,4500,0,136.96,409000006450,22-Oct-18,Indiaforensic RUPAY POS ACQ22101,,2795619.44,-519034632.15,Lazarev,834,France,74287.53,0,1,0
6452,2011,10,RENT,1,Low,1,35000, 60 months,2,credit_card,1,High,2,Good Loan,0,20.89,F,6,15.44,37739.89,35000,0,944.71,409000006451,22-Oct-18,Indiaforensic RUPAY POS C2 ACQ22,,884282.35,-518150349.80,Benjamin,636,Spain,101102.39,0,1,0
6453,2011,10,MORTGAGE,3,Low,1,24250, 60 months,2,credit_card,1,High,2,Good Loan,0,17.58,D,4,16.45,31067.21,19110.78,0,610.27,409000006452,22-Oct-18,Indiaforensic VISA ACQ INT 17101,,2634.78,-518147715.02,Wan,538,Spain,126933.73,0,1,0
6454,2011,10,MORTGAGE,3,Low,1,35000, 60 months,2,debt_consolidation,6,Low,1,Good Loan,0,12.42,B,2,21.36,39288.74,27562.52,0,786.01,409000006453,22-Oct-18,Indiaforensic VISA ACQ INT 18101,,14012.55,-518133702.47,Romano,566,Germany,68408.74,0,1,0
6455,2011,0.5,MORTGAGE,3,Medium,2,35000, 36 months,1,debt_consolidation,6,Low,1,Good Loan,0,8.9,A,1,17.25,40006.80007,35000,0,1111.37,409000006454,22-Oct-18,TRF TO  Indiaforensic SERVICES I,"15,000,000.00",,-533133702.47,Craig,597,Spain,155356.34,0,1,0
6456,2011,10,MORTGAGE,3,Medium,2,5000, 36 months,1,home_improvement,7,Low,1,Good Loan,0,7.51,A,1,9.27,5031.76,5000,0,155.56,409000006455,22-Oct-18,TRF TO  Indiaforensic SERVICES I,"15,000,000.00",,-548133702.47,Yermolayeva,711,France,3234.80,0,1,0
6457,2011,6,MORTGAGE,3,Low,1,10000, 36 months,1,other,4,Low,1,Good Loan,0,12.69,B,2,15.17,11099.93,10000,0,335.45,409000006456,23-Oct-18,Indiaforensic MASTER ACQ DOM2310,,3974847.74,-544158854.73,Tseng,606,France,195209.40,0,1,0
6458,2011,7,OWN,2,Low,1,12000, 36 months,1,debt_consolidation,6,High,2,Bad Loan,1,14.65,C,3,15.89,3470.31,1939.05,577.21,413.94,409000006457,23-Oct-18,Indiaforensic VISA ACQ DOM231018,,6270696.80,-537888157.93,Tseng,615,Spain,169149.38,0,1,0
6459,2011,0.5,RENT,1,Low,1,25000, 60 months,2,debt_consolidation,6,High,2,Good Loan,0,18.64,E,5,21.12,32165.5,19075.63,0,643.58,409000006458,23-Oct-18,Indiaforensic RUPAY POS ACQ23101,,2553401.49,-535334756.44,Le Hunte,589,France,68075.14,0,1,0
6460,2011,0.5,RENT,1,Low,1,6000, 36 months,1,credit_card,1,Low,1,Good Loan,0,6.03,A,1,8.92,6573.607326,6000,0,182.62,409000006459,23-Oct-18,Indiaforensic RUPAY POS C2 ACQ23,,807380.70,-534527375.74,Blake,606,Germany,93707.80,0,1,0
6461,2011,10,MORTGAGE,3,Medium,2,25000, 60 months,2,debt_consolidation,6,High,2,Good Loan,0,14.27,C,3,15.23,34147.81174,25000,0,585.22,409000006460,23-Oct-18,TRF TO  Indiaforensic SERVICES I,"5,000,000.00",,-539527375.74,Lane,582,France,156153.27,0,1,0
6462,2011,3,MORTGAGE,3,Low,1,20000, 60 months,2,debt_consolidation,6,High,2,Good Loan,0,14.27,C,3,8.84,26794.00792,20000,0,468.17,409000006461,23-Oct-18,TRF TO  Indiaforensic SERVICES I,"5,000,000.00",,-544527375.74,Sparks,710,France,58601.61,0,1,0
6463,2011,6.05,MORTGAGE,3,Low,1,10800, 60 months,2,home_improvement,7,High,2,Good Loan,0,17.27,D,4,15.53,13756.38,8529.8,0,269.98,409000006462,23-Oct-18,Indiaforensic MASTER INT221018,,5854.91,-544521520.83,Tu,467,France,114448.77,0,1,0
6464,2011,10,MORTGAGE,3,Low,1,2400, 36 months,1,car,2,Low,1,Bad Loan,1,10.65,B,2,20.59,1278.22,652.19,420.88,78.18,409000006463,23-Oct-18,TRF TO  Indiaforensic SERVICES I,"3,700,000.00",,-548221520.83,Tochukwu,749,France,126551.65,0,1,0
6465,2011,10,MORTGAGE,3,Medium,2,16000, 36 months,1,debt_consolidation,6,High,2,Good Loan,0,15.96,C,3,19.68,19388.14,16000,0,562.2,409000006464,24-Oct-18,Indiaforensic MASTER ACQ DOM2410,,4191533.88,-544029986.95,Whittaker,564,Germany,112350.21,0,1,0
6466,2011,10,RENT,1,Low,1,14000, 36 months,1,debt_consolidation,6,Low,1,Good Loan,0,6.03,A,1,12.13,15339.11422,14000,0,426.1,409000006465,24-Oct-18,Indiaforensic VISA ACQ DOM241018,,6545888.72,-537484098.23,Wang,730,Spain,185808.70,0,1,0
6467,2011,10,MORTGAGE,3,Low,1,6500, 36 months,1,debt_consolidation,6,Low,1,Good Loan,0,6.62,A,1,8.88,7152.115413,6500,0,199.58,409000006466,24-Oct-18,Indiaforensic RUPAY POS ACQ24101,,2830036.69,-534654061.54,Northern,678,Germany,118235.52,0,1,0
6468,2011,4,RENT,1,Low,1,5000, 36 months,1,debt_consolidation,6,Low,1,Bad Loan,1,9.91,B,2,21.16,2281.77,1633.01,192.8,161.13,409000006467,24-Oct-18,Indiaforensic RUPAY POS C2 ACQ24,,864088.07,-533789973.47,Humphries,540,France,183051.60,0,1,0
6469,2011,10,OWN,2,Low,1,10000, 36 months,1,home_improvement,7,Low,1,Good Loan,0,6.03,A,1,22.91,10956.24214,10000,0,304.36,409000006468,24-Oct-18,Indiaforensic VISA ACQ INT 20101,,509.09,-533789464.38,Cremonesi,767,France,27922.45,0,1,0
6470,2011,5,MORTGAGE,3,Medium,2,35000, 60 months,2,debt_consolidation,6,High,2,Bad Loan,1,18.64,E,5,11.45,44130.73,25945.22,0,901.01,409000006469,24-Oct-18,Indiaforensic VISA ACQ INT 21101,,3219.02,-533786245.36,Ku,615,France,196476.19,0,1,0
6471,2011,3,MORTGAGE,3,Low,1,2500, 36 months,1,major_purchase,8,Low,1,Good Loan,0,8.9,A,1,14.64,2664.26,2500,0,79.39,409000006470,24-Oct-18,Indiaforensic VISA ACQ INT 22101,,2638.82,-533783606.54,Tobenna,583,Germany,190429.52,0,1,0
6472,2011,8,RENT,1,Low,1,9600, 36 months,1,debt_consolidation,6,Low,1,Good Loan,0,12.69,B,2,11.46,10985.41,9600,0,322.04,409000006471,24-Oct-18,TRF TO  Indiaforensic SERVICES I,"14,400,000.00",,-548183606.54,Okwuadigbo,850,France,35034.15,0,1,0
6473,2011,3,RENT,1,Low,1,4000, 36 months,1,credit_card,1,Low,1,Good Loan,0,7.9,A,1,14.08,4502.091711,4000,0,125.17,409000006472,25-Oct-18,Indiaforensic MASTER ACQ DOM2510,,4614937.75,-543568668.79,Johnston,651,Germany,66389.43,0,1,0
6474,2011,3,MORTGAGE,3,Medium,2,21000, 60 months,2,debt_consolidation,6,High,2,Good Loan,0,14.27,C,3,10.16,28129.20064,21000,0,491.58,409000006473,25-Oct-18,Indiaforensic VISA ACQ DOM251018,,5710056.99,-537858611.80,Li,798,France,107615.43,0,1,0
6475,2011,7,MORTGAGE,3,Low,1,16000, 60 months,2,debt_consolidation,6,High,2,Good Loan,0,16.77,D,4,22.11,23495.36257,16000,0,395.67,409000006474,25-Oct-18,Indiaforensic RUPAY POS ACQ25101,,2295581.71,-535563030.09,Talbot,695,France,99692.65,0,1,0
6476,2011,4,MORTGAGE,3,Medium,2,29700, 60 months,2,debt_consolidation,6,High,2,Good Loan,0,23.91,G,7,8.52,37444.88,29700,0,852.86,409000006475,25-Oct-18,Indiaforensic RUPAY POS C2 ACQ25,,720324.88,-534842705.21,Tu,497,Germany,88729.22,0,1,0
6477,2011,10,RENT,1,Low,1,9000, 36 months,1,debt_consolidation,6,High,2,Good Loan,0,16.77,D,4,21.69,9599.62,9000,0,319.85,409000006476,25-Oct-18,TRF TO  Indiaforensic SERVICES I,"4,000,000.00",,-538842705.21,T'ien,739,France,173321.65,0,1,0
6478,2011,1,MORTGAGE,3,Medium,2,35000, 60 months,2,debt_consolidation,6,High,2,Good Loan,0,18.25,D,4,22.89,51921.6577,35000,0,893.54,409000006477,25-Oct-18,TRF TO  Indiaforensic SERVICES I,"4,000,000.00",,-542842705.21,Ross,549,France,139463.57,0,1,0
6479,2011,4,MORTGAGE,3,Medium,2,7200, 36 months,1,medical,9,Low,1,Good Loan,0,7.51,A,1,29.62,8054.20772,7200,0,224,409000006478,25-Oct-18,TRF TO  Indiaforensic SERVICES I,"3,000,000.00",,-545842705.21,Maclean,850,France,3769.71,0,1,0
6480,2011,7,MORTGAGE,3,Low,1,2500, 36 months,1,home_improvement,7,Low,1,Good Loan,0,11.71,B,2,17.65,2974.503483,2500,0,82.69,409000006479,25-Oct-18,TRF TO  Indiaforensic SERVICES I,"2,000,000.00",,-547842705.21,Wan,648,Spain,149946.43,0,1,0
6481,2011,10,MORTGAGE,3,Low,1,7000, 36 months,1,debt_consolidation,6,High,2,Good Loan,0,16.29,D,4,10.93,8313.13,7000,0,247.11,409000006480,25-Oct-18,Indiaforensic MASTER INT241018,,2233.37,-547840471.84,Tsou,679,France,135768.25,0,1,0
6482,2011,4,RENT,1,Low,1,15000, 60 months,2,wedding,5,High,2,Good Loan,0,14.27,C,3,20.99,15874.24,15000,0,351.13,409000006481,25-Oct-18,TRF TO  Indiaforensic SERVICES I,"400,000.00",,-548240471.84,Jack,606,Germany,31708.53,0,1,0
6483,2011,9,MORTGAGE,3,Medium,2,7500, 36 months,1,debt_consolidation,6,Low,1,Good Loan,0,6.62,A,1,5.69,8287.096666,7500,0,230.28,409000006482,26-Oct-18,Indiaforensic MASTER ACQ DOM2610,,5218682.49,-543021789.35,Lucchesi,850,France,151677.31,0,1,0
6484,2011,8,MORTGAGE,3,Low,1,15000, 60 months,2,debt_consolidation,6,Low,1,Good Loan,0,11.71,B,2,17.29,16576.82,11847.07,0,331.48,409000006483,26-Oct-18,Indiaforensic VISA ACQ DOM261018,,7045712.77,-535976076.58,Ch'eng,619,Germany,170518.83,0,1,0
6485,2011,10,MORTGAGE,3,Low,1,30000, 36 months,1,home_improvement,7,Low,1,Good Loan,0,6.62,A,1,7.56,33156.6095,30000,0,921.11,409000006484,26-Oct-18,Indiaforensic RUPAY POS ACQ26101,,2692052.23,-533284024.35,Saunders,719,Spain,196582.19,0,1,0
6486,2011,3,RENT,1,Low,1,3625, 36 months,1,debt_consolidation,6,Low,1,Good Loan,0,6.03,A,1,14.18,3733.21,3625,0,110.33,409000006485,26-Oct-18,Indiaforensic RUPAY POS C2 ACQ26,,709683.72,-532574340.63,Glover,640,Germany,3298.65,0,1,0
6487,2011,4,RENT,1,Low,1,20000, 36 months,1,debt_consolidation,6,Low,1,Good Loan,0,8.9,A,1,5.58,20834.8,20000,0,635.07,409000006486,26-Oct-18,Indiaforensic VISA ACQ INT 24101,,1628.07,-532572712.56,Tung,710,France,162878.96,0,1,0
6488,2011,5,RENT,1,Low,1,2250, 36 months,1,major_purchase,8,Low,1,Good Loan,0,12.69,B,2,2.25,2715.649845,2250,0,75.48,409000006487,26-Oct-18,TRF TO  Indiaforensic SERVICES I,"15,000,000.00",,-547572712.56,Padovano,580,France,64014.24,0,1,0
6489,2011,2,MORTGAGE,3,Low,1,12000, 60 months,2,home_improvement,7,Low,1,Good Loan,0,11.71,B,2,13.42,14696.48359,12000,0,265.18,409000006488,26-Oct-18,TRF TO  Indiaforensic SERVICES I,"700,000.00",,-548272712.56,Johnstone,550,France,26257.01,0,1,0
6490,2011,10,MORTGAGE,3,Low,1,11000, 36 months,1,debt_consolidation,6,Low,1,Good Loan,0,10.65,B,2,15.19,12326.74,11000,0,358.31,409000006489,29-Oct-18,Indiaforensic VISA ACQ DOM271018,,6115541.06,-542157171.50,Endrizzi,841,France,126794.56,0,1,0
6491,2011,4,MORTGAGE,3,Low,1,7000, 36 months,1,credit_card,1,High,2,Good Loan,0,13.49,C,3,11.3,7303.41,7000,0,237.52,409000006490,29-Oct-18,Indiaforensic RUPAY POS ACQ27101,,2489916.33,-539667255.17,Secombe,760,France,164162.44,0,1,0
6492,2011,2,RENT,1,Medium,2,15000, 60 months,2,medical,9,Low,1,Good Loan,0,12.69,B,2,2.79,17267.79,12094.73,0,338.93,409000006491,29-Oct-18,Indiaforensic RUPAY POS ACQ28101,,2866433.54,-536800821.63,Elewechi,687,France,179206.92,0,1,0
6493,2011,0.5,RENT,1,Low,1,1000, 36 months,1,medical,9,High,2,Bad Loan,1,13.49,C,3,17.6,703.21,502.9,28.41,33.94,409000006492,29-Oct-18,Indiaforensic MASTER ACQ DOM2910,,12939624.30,-523861197.33,Chu,753,Germany,18254.75,0,1,0
6494,2011,10,MORTGAGE,3,Low,1,15700, 36 months,1,credit_card,1,Low,1,Good Loan,0,7.9,A,1,11.42,17683.75247,15700,0,491.26,409000006493,29-Oct-18,Indiaforensic VISA ACQ DOM291018,,11271551.45,-512589645.88,Lucciano,661,France,83949.68,0,1,0
6495,2011,1,MORTGAGE,3,Low,1,10000, 60 months,2,other,4,Low,1,Good Loan,0,8.9,A,1,19.39,10532.7,8182.59,0,207.1,409000006494,29-Oct-18,Indiaforensic RUPAY POS ACQ29101,,2714946.91,-509874698.97,Pinto,699,France,22684.78,0,1,0
6496,2011,3,MORTGAGE,3,Medium,2,8800, 36 months,1,credit_card,1,Low,1,Good Loan,0,12.69,B,2,7.98,10617.6381,8800,0,295.2,409000006495,29-Oct-18,Indiaforensic RUPAY POS C2 ACQ29,,808434.95,-509066264.02,McGregor,617,Germany,7953.62,0,1,0
6497,2011,3,RENT,1,Low,1,19750, 36 months,1,debt_consolidation,6,Low,1,Good Loan,0,7.51,A,1,20.59,22117.96231,19750,0,614.44,409000006496,29-Oct-18,Indiaforensic VISA ACQ INT 25101,,5231.66,-509061032.36,Ugorji,595,Germany,143952.24,0,1,0
6498,2011,10,MORTGAGE,3,Low,1,11200, 36 months,1,credit_card,1,Low,1,Good Loan,0,6.03,A,1,16.91,12271.03632,11200,0,340.88,409000006497,29-Oct-18,TRF TO  Indiaforensic SERVICES I,"500,000.00",,-509561032.36,Bancks,669,France,158032.50,0,1,0
6499,2011,0.5,MORTGAGE,3,Low,1,6350, 60 months,2,credit_card,1,High,2,Bad Loan,1,19.03,E,5,24.72,2773.45,1067.61,321.25,164.83,409000006498,29-Oct-18,TRF TO  Indiaforensic SERVICES I,"1,000,000.00",,-510561032.36,Warlow-Davies,613,France,199104.52,0,1,0
6500,2011,3,MORTGAGE,3,Medium,2,15000, 60 months,2,home_improvement,7,High,2,Good Loan,0,18.64,E,5,17.65,21060.95271,15000,0,386.15,409000006499,29-Oct-18,TRF TO  Indiaforensic SERVICES I,"1,000,000.00",,-511561032.36,Dale,782,France,87566.97,0,1,0
6501,2011,10,RENT,1,Low,1,6775, 36 months,1,small_business,3,Low,1,Bad Loan,1,7.9,A,1,24.49,4821.51,4163.13,0,212,409000006500,29-Oct-18,TRF TO  Indiaforensic SERVICES I,"15,000,000.00",,-526561032.36,Buckley,582,France,170563.73,0,1,0
6502,2011,10,MORTGAGE,3,Low,1,6000, 36 months,1,debt_consolidation,6,High,2,Bad Loan,1,13.49,C,3,12.3,4529.16,3021.65,474.16,203.59,409000006501,29-Oct-18,TRF TO  Indiaforensic SERVICES I,"15,000,000.00",,-541561032.36,Nkemjika,679,France,157871.55,0,1,0
6503,2011,10,OWN,2,Low,1,3500, 36 months,1,other,4,Low,1,Good Loan,0,6.62,A,1,20.94,3856.036185,3500,0,107.47,409000006502,29-Oct-18,TRF TO  Indiaforensic SERVICES I,"2,000,000.00",,-543561032.36,Fairley,611,France,93203.43,0,1,0
6504,2011,4,RENT,1,Low,1,4000, 36 months,1,vacation,11,Low,1,Good Loan,0,7.9,A,1,6.29,4101.92,4000,0,125.17,409000006503,29-Oct-18,TRF TO  Indiaforensic SERVICES I,"4,000,000.00",,-547561032.36,Boothby,455,Germany,54398.56,0,1,0
6505,2011,2,MORTGAGE,3,Low,1,7200, 60 months,2,car,2,Low,1,Good Loan,0,12.42,B,2,12.53,7968.32,7200,0,161.7,409000006504,30-Oct-18,TRF TO  Indiaforensic SERVICES I,"500,000.00",,-548061032.36,Chukwuhaenye,621,France,168779.47,0,1,0
6506,2011,4,MORTGAGE,3,Low,1,35000, 60 months,2,debt_consolidation,6,High,2,Good Loan,0,22.35,F,6,9.65,48722.18,35000,0,973.64,409000006505,30-Oct-18,Indiaforensic MASTER ACQ DOM3010,,4000006.36,-544061026.00,Lock,596,Germany,1140.02,0,1,0
6507,2011,10,OWN,2,Medium,2,16000, 60 months,2,other,4,High,2,Bad Loan,1,13.49,C,3,9.17,9193.25,5393.2,0,368.08,409000006506,30-Oct-18,Indiaforensic VISA ACQ DOM301018,,5702269.15,-538358756.85,Clarke,585,Spain,186476.91,0,1,0
6508,2011,10,MORTGAGE,3,Low,1,14000, 60 months,2,debt_consolidation,6,Low,1,Bad Loan,1,12.69,B,2,3.91,15221.49,9623.81,1002.6,316.33,409000006507,30-Oct-18,Indiaforensic RUPAY POS ACQ30101,,2212981.27,-536145775.58,Ramsey,742,France,29023.03,0,1,0
6509,2011,1,MORTGAGE,3,Medium,2,20000, 60 months,2,debt_consolidation,6,High,2,Good Loan,0,13.49,C,3,7.98,25547.18638,20000,0,460.1,409000006508,30-Oct-18,Indiaforensic RUPAY POS C2 ACQ30,,768501.76,-535377273.82,Eipper,850,Germany,60021.34,0,1,0
6510,2011,0.5,RENT,1,Low,1,6000, 36 months,1,other,4,High,2,Good Loan,0,13.49,C,3,9.68,7325.297288,6000,0,203.59,409000006509,30-Oct-18,TRF TO  Indiaforensic SERVICES I,"10,000,000.00",,-545377273.82,Ko,738,Germany,180456.80,0,1,0
6511,2011,5,RENT,1,Low,1,2500, 36 months,1,debt_consolidation,6,High,2,Good Loan,0,16.29,D,4,18.01,2658.08,2500,0,88.26,409000006510,30-Oct-18,Indiaforensic MASTER INT27-29101,,10252.41,-545367021.41,Munro,619,Spain,132498.39,0,1,0
6512,2011,5,RENT,1,Low,1,4400, 36 months,1,small_business,3,Low,1,Good Loan,0,12.42,B,2,19,5290.043765,4400,0,147.03,409000006511,30-Oct-18,TRF TO  Indiaforensic SERVICES I,"2,800,000.00",,-548167021.41,McGregor,628,France,109608.81,0,1,0
6513,2011,2,RENT,1,Low,1,13250, 36 months,1,credit_card,1,Low,1,Good Loan,0,7.9,A,1,28.4,14908.32293,13250,0,414.6,409000006512,31-Oct-18,Indiaforensic VISA ACQ DOM311018,,6193971.18,-541973050.23,Henderson,487,France,98570.01,0,1,0
6514,2011,9,RENT,1,Low,1,7925, 60 months,2,debt_consolidation,6,Low,1,Bad Loan,1,12.42,B,2,28.2,888.85,489.24,0,177.98,409000006513,31-Oct-18,Indiaforensic RUPAY POS ACQ31101,,2760485.22,-539212565.01,Fernandez,513,Spain,160546.58,0,1,0
6515,2011,3,MORTGAGE,3,Medium,2,22400, 60 months,2,debt_consolidation,6,High,2,Bad Loan,1,21.67,F,6,18.65,16644.35,5210.46,2406.36,614.47,409000006514,31-Oct-18,Indiaforensic VISA ACQ INT 27101,,3509.00,-539209056.01,Porter,563,Spain,6139.74,0,1,0
6516,2011,10,MORTGAGE,3,Low,1,25200, 60 months,2,debt_consolidation,6,High,2,Good Loan,0,18.64,E,5,4.81,32183.23,25200,0,648.73,409000006515,31-Oct-18,Indiaforensic VISA ACQ INT 28101,,229.25,-539208826.76,Pan,803,France,6930.17,0,1,0
6517,2011,3,RENT,1,Low,1,6000, 36 months,1,major_purchase,8,Low,1,Good Loan,0,12.69,B,2,0.15,6109.23,6000,0,201.27,409000006516,31-Oct-18,Indiaforensic VISA ACQ INT 29101,,2599.67,-539206227.09,Esposito,607,Spain,10674.62,0,1,0
6518,2011,3,RENT,1,Low,1,2400, 36 months,1,other,4,High,2,Good Loan,0,16.77,D,4,17,3067.849695,2400,0,85.3,409000006517,31-Oct-18,Indiaforensic MASTER ACQ DOM3110,,4238903.89,-534967323.20,Kaeppel,628,Germany,71159.84,0,1,0
6519,2011,10,OWN,2,Low,1,16000, 36 months,1,debt_consolidation,6,Low,1,Good Loan,0,6.03,A,1,16.79,17530.38714,16000,0,486.97,409000006518,31-Oct-18,Indiaforensic RUPAY POS C2 ACQ31,,803011.10,-534164312.10,Lamb,521,Spain,62413.01,0,1,0
6520,2011,7,RENT,1,Medium,2,4800, 36 months,1,wedding,5,Low,1,Good Loan,0,8.9,A,1,4.15,5000.12,4800,0,152.42,409000006519,31-Oct-18,TRF TO  Indiaforensic SERVICES I,"13,300,000.00",,-547464312.10,Lei,669,Germany,166386.22,0,1,0
6521,2011,10,MORTGAGE,3,Low,1,7000, 36 months,1,home_improvement,7,Low,1,Good Loan,0,6.62,A,1,7.77,7407.94,7000,0,214.93,409000006520,31-Oct-18,TRF TO  Indiaforensic SERVICES I,"800,000.00",,-548264312.10,Conti,686,France,133086.45,0,1,0
6522,2011,7,MORTGAGE,3,Low,1,16100, 36 months,1,debt_consolidation,6,Low,1,Good Loan,0,7.9,A,1,10.59,18134.58135,16100,0,503.78,409000006521,1-Nov-18,Indiaforensic VISA ACQ DOM011118,,6214061.08,-542050251.02,Hargreaves,700,Germany,192933.37,0,1,0
6523,2011,3,OWN,2,Low,1,4500, 36 months,1,debt_consolidation,6,High,2,Bad Loan,1,13.49,C,3,21.4,3206.49,2393.81,12.6,152.69,409000006522,1-Nov-18,Indiaforensic RUPAY POS ACQ01111,,2545483.39,-539504767.63,Yermolayev,663,France,71359.78,0,1,0
6524,2011,3,RENT,1,Low,1,6800, 36 months,1,debt_consolidation,6,Low,1,Bad Loan,1,10.65,B,2,6.79,4429.36,3498.2,13.96,221.5,409000006523,1-Nov-18,TRF TO  Indiaforensic SERVICES I,"8,700,000.00",,-548204767.63,Kerr,671,Spain,79270.02,0,1,0
6525,2011,0.5,MORTGAGE,3,Low,1,30000, 60 months,2,debt_consolidation,6,Low,1,Good Loan,0,11.71,B,2,15.31,36880.80639,30000,0,662.95,409000006524,1-Nov-18,Indiaforensic MASTER ACQ DOM0111,,4744407.86,-543460359.77,Waters,651,Germany,29583.48,0,1,0
6526,2011,2,RENT,1,Low,1,10000, 36 months,1,debt_consolidation,6,Low,1,Good Loan,0,6.03,A,1,16.76,10956.36077,10000,0,304.36,409000006525,1-Nov-18,Indiaforensic VISA ACQ INT 30101,,5079.97,-543455279.80,Onyeorulu,728,France,88680.65,0,1,0
6527,2011,8,RENT,1,Low,1,6000, 36 months,1,debt_consolidation,6,Low,1,Good Loan,0,6.62,A,1,20.42,6552.44,6000,0,184.23,409000006526,1-Nov-18,Indiaforensic RUPAY POS C2 ACQ01,,790551.54,-542664728.26,Kolesnikova,574,France,134691.20,0,1,0
6528,2011,0.5,MORTGAGE,3,Low,1,25475, 60 months,2,small_business,3,High,2,Good Loan,0,21.28,F,6,18.31,32308.75,25475,0,693.21,409000006527,1-Nov-18,TRF TO  Indiaforensic SERVICES I,"5,600,000.00",,-548264728.26,Kazakova,464,France,75574.48,0,1,0
6529,2011,6,MORTGAGE,3,Low,1,19450, 36 months,1,debt_consolidation,6,Low,1,Good Loan,0,9.91,B,2,12.17,20214.48,19450,0,626.78,409000006528,1-Nov-18,Indiaforensic MASTER INT311018,,1019.55,-548263708.71,MacDonald,604,Spain,30252.30,0,1,0
6530,2011,7,RENT,1,Low,1,9000, 60 months,2,car,2,High,2,Good Loan,0,14.27,C,3,5.69,10288.26,9000,0,210.68,409000006529,2-Nov-18,Indiaforensic MASTER ACQ DOM0211,,5505148.23,-542758560.48,Sharwood,836,Spain,111324.41,0,1,0
6531,2011,6.05,RENT,1,Low,1,27000, 60 months,2,debt_consolidation,6,Low,1,Good Loan,0,10.65,B,2,24.06,29668.41,21954.26,0,582.35,409000006530,2-Nov-18,Indiaforensic VISA ACQ DOM021118,,5798359.10,-536960201.38,Bufkin,511,Germany,105425.18,0,1,0
6532,2011,4,RENT,1,Low,1,2400, 36 months,1,debt_consolidation,6,Low,1,Good Loan,0,10.65,B,2,19.15,2813.201995,2400,0,78.18,409000006531,2-Nov-18,Indiaforensic RUPAY POS ACQ02111,,2793512.18,-534166689.20,Nwankwo,518,France,36193.07,0,1,0
6533,2011,10,MORTGAGE,3,Medium,2,30000, 60 months,2,debt_consolidation,6,Low,1,Good Loan,0,12.42,B,2,18.05,39564.14273,30000,0,673.72,409000006532,2-Nov-18,Indiaforensic RUPAY POS C2 ACQ02,,768530.11,-533398159.09,Boniwell,756,France,93081.87,0,1,0
6534,2011,1,MORTGAGE,3,Medium,2,14000, 36 months,1,debt_consolidation,6,Low,1,Good Loan,0,6.62,A,1,12.41,15263.63,14000,0,429.86,409000006533,2-Nov-18,Indiaforensic VISA ACQ INT 31101,,36711.34,-533361447.75,Willis,489,France,107625.46,0,1,0
6535,2011,10,MORTGAGE,3,Medium,2,10000, 36 months,1,small_business,3,Low,1,Good Loan,0,7.9,A,1,3.83,10960.67,10000,0,312.91,409000006534,2-Nov-18,TRF TO  Indiaforensic SERVICES I,"10,000,000.00",,-543361447.75,Burns,622,Spain,152733.89,0,1,0
6536,2011,6,RENT,1,Low,1,1950, 36 months,1,debt_consolidation,6,Low,1,Good Loan,0,12.42,B,2,8.77,2335.245336,1950,0,65.16,409000006535,2-Nov-18,TRF TO  Indiaforensic SERVICES I,"4,900,000.00",,-548261447.75,Kung,652,France,110421.31,0,1,0
6537,2011,0.5,RENT,1,Low,1,2900, 36 months,1,credit_card,1,Low,1,Good Loan,0,9.91,B,2,13.58,3362.322863,2900,0,93.46,409000006536,2-Nov-18,Indiaforensic MASTER INT011118,,1000.73,-548260447.02,Howells,625,France,48486.25,0,1,0
6538,2011,5,MORTGAGE,3,Low,1,6000, 36 months,1,debt_consolidation,6,Low,1,Good Loan,0,9.91,B,2,0.75,6735.95,6000,0,193.35,409000006537,3-Nov-18,Indiaforensic VISA ACQ DOM031118,,7645892.11,-540614554.91,Bevan,521,Spain,72993.67,0,1,0
6539,2011,1,RENT,1,Low,1,12800, 60 months,2,medical,9,High,2,Good Loan,0,14.65,C,3,21.25,17703.84009,12800,0,302.17,409000006538,3-Nov-18,Indiaforensic RUPAY POS ACQ03111,,3379685.55,-537234869.36,Neitenstein,546,France,25744.13,0,1,0
6540,2011,2,RENT,1,Low,1,9000, 36 months,1,debt_consolidation,6,Low,1,Good Loan,0,9.91,B,2,17.64,9919.81,9000,0,290.03,409000006539,3-Nov-18,TRF TO  Indiaforensic SERVICES I,"10,000,000.00",,-547234869.36,Johnson,697,France,46807.62,0,1,0
6541,2011,3,MORTGAGE,3,Low,1,12000, 60 months,2,debt_consolidation,6,Low,1,Good Loan,0,10.65,B,2,14.12,14666.16615,12000,0,258.82,409000006540,3-Nov-18,TRF TO  Indiaforensic SERVICES I,"1,000,000.00",,-548234869.36,Sandover,571,Germany,26772.04,0,1,0
6542,2011,2,MORTGAGE,3,Medium,2,30000, 60 months,2,debt_consolidation,6,High,2,Good Loan,0,19.42,E,5,11.16,44257.04637,30000,0,785.17,409000006541,3-Nov-18,Indiaforensic RUPAY POS C2 ACQ03,,883026.49,-547351842.87,Nnamutaezinwa,748,Spain,150057.20,0,1,0
6543,2011,0.5,RENT,1,Low,1,2450, 36 months,1,credit_card,1,Low,1,Good Loan,0,7.9,A,1,19.2,2466.47,2450,0,76.67,409000006542,5-Nov-18,Indiaforensic RUPAY POS ACQ04111,,2784015.69,-544567827.18,Sinclair,591,France,56028.79,0,1,0
6544,2011,10,MORTGAGE,3,Low,1,12000, 60 months,2,debt_consolidation,6,High,2,Bad Loan,1,14.27,C,3,11.89,6179.14,3444.9,12.1,280.91,409000006543,5-Nov-18,Indiaforensic MASTER ACQ DOM0511,,15546792.38,-529021034.80,Wei,814,Germany,147693.92,0,1,0
6545,2011,0.5,RENT,1,Low,1,8850, 36 months,1,debt_consolidation,6,Low,1,Good Loan,0,12.69,B,2,23.2,10626.29736,8850,0,296.88,409000006544,5-Nov-18,Indiaforensic VISA ACQ DOM051118,,15859883.17,-513161151.63,Higgins,709,France,174032.00,0,1,0
6546,2011,10,OWN,2,Low,1,15000, 36 months,1,medical,9,Low,1,Good Loan,0,6.03,A,1,0.8,16432.37851,15000,0,456.54,409000006545,5-Nov-18,Indiaforensic RUPAY POS ACQ05111,,4346047.11,-508815104.52,Chang,433,Spain,153698.65,0,1,0
6547,2011,8,MORTGAGE,3,Low,1,5600, 36 months,1,debt_consolidation,6,Low,1,Bad Loan,1,11.71,B,2,19.54,2089.65,1360.57,242.95,185.23,409000006546,5-Nov-18,Indiaforensic RUPAY POS C2 ACQ05,,809760.06,-508005344.46,Henderson,781,France,108301.45,0,1,0
6548,2011,5,MORTGAGE,3,Low,1,20000, 60 months,2,debt_consolidation,6,High,2,Good Loan,0,16.77,D,4,21.12,25189.79,15828.45,0,494.59,409000006547,5-Nov-18,Indiaforensic VISA ACQ INT 01111,,2021.94,-508003322.52,Cox,656,France,22929.08,0,1,0
6549,2011,3,MORTGAGE,3,High,3,18750, 60 months,2,debt_consolidation,6,High,2,Good Loan,0,17.27,D,4,11.27,25571.11236,18750,0,468.72,409000006548,5-Nov-18,TRF TO  Indiaforensic SERVICES I,"15,000,000.00",,-523003322.52,Tsui,683,France,102665.92,0,1,0
6550,2011,8,RENT,1,Low,1,4800, 36 months,1,car,2,High,2,Good Loan,0,15.96,C,3,9.43,5936.03,4800,0,168.66,409000006549,5-Nov-18,TRF TO  Indiaforensic SERVICES I,"15,000,000.00",,-538003322.52,Lee,620,France,56139.09,0,1,0
6551,2011,5,MORTGAGE,3,Low,1,6075, 36 months,1,major_purchase,8,Low,1,Good Loan,0,6.03,A,1,12.16,6655.88116,6075,0,184.9,409000006550,5-Nov-18,TRF TO  Indiaforensic SERVICES I,"10,000,000.00",,-548003322.52,Sergeyeva,637,Germany,88391.29,0,1,0
6552,2011,10,MORTGAGE,3,Medium,2,27200, 60 months,2,debt_consolidation,6,High,2,Good Loan,0,19.03,E,5,13.36,35950.92,21294.51,0,706.04,409000006551,6-Nov-18,Indiaforensic VISA ACQ DOM061118,,7725533.42,-540277789.10,Napolitani,525,Spain,149195.44,0,1,0
6553,2011,2,MORTGAGE,3,Low,1,9500, 36 months,1,credit_card,1,High,2,Good Loan,0,16.77,D,4,22.36,11164.9,9500.01,0,337.62,409000006552,6-Nov-18,Indiaforensic RUPAY POS ACQ06111,,6363067.59,-533914721.51,Beatham,793,Germany,143357.03,0,1,0
6554,2011,10,MORTGAGE,3,Medium,2,4200, 36 months,1,other,4,Low,1,Good Loan,0,6.62,A,1,15.84,4640.918943,4200,0,128.96,409000006553,6-Nov-18,Indiaforensic VISA ACQ INT 02111,,4706.14,-533910015.37,Lu,638,Germany,168359.98,0,1,0
6555,2011,2,RENT,1,Low,1,6000, 36 months,1,small_business,3,High,2,Good Loan,0,16.29,D,4,9,7622.137689,6000,0,211.81,409000006554,6-Nov-18,TRF TO  Indiaforensic SERVICES I,"14,300,000.00",,-548210015.37,Yashina,520,France,77335.75,0,1,0
6556,2011,10,RENT,1,Low,1,6300, 36 months,1,debt_consolidation,6,Low,1,Good Loan,0,7.51,A,1,18.93,7009.692826,6300,0,196,409000006555,6-Nov-18,Indiaforensic MASTER ACQ DOM0611,,6292989.98,-541917025.39,Bales,641,France,93148.93,0,1,0
6557,2011,10,MORTGAGE,3,Low,1,21300, 60 months,2,debt_consolidation,6,High,2,Good Loan,0,18.25,D,4,24.1,29894.49199,21300,0,543.79,409000006556,6-Nov-18,Indiaforensic RUPAY POS C2 ACQ06,,1111346.39,-540805679.00,Hill,840,Germany,36687.11,0,1,0
6558,2011,4,RENT,1,Low,1,15000, 36 months,1,debt_consolidation,6,Low,1,Good Loan,0,9.91,B,2,20.8,17312.68477,15000,0,483.38,409000006557,6-Nov-18,TRF TO  Indiaforensic SERVICES I,"2,000,000.00",,-542805679.00,Ibeamaka,504,Spain,146703.36,0,1,0
6559,2011,6,RENT,1,Low,1,5000, 36 months,1,credit_card,1,Low,1,Good Loan,0,6.03,A,1,15.74,5477.943129,5000,0,152.18,409000006558,6-Nov-18,TRF TO  Indiaforensic SERVICES I,"5,000,000.00",,-547805679.00,Romilly,686,France,115927.85,0,1,0
6560,2011,4,RENT,1,Low,1,3000, 36 months,1,other,4,High,2,Good Loan,0,17.27,D,4,17.79,3862.589818,3000,0,107.37,409000006559,7-Nov-18,Indiaforensic RUPAY POS ACQ07111,,2893029.34,-544912649.66,Hayes,533,Germany,104189.46,0,1,0
6561,2011,7,MORTGAGE,3,Low,1,5500, 36 months,1,debt_consolidation,6,Low,1,Good Loan,0,11.71,B,2,22.68,6057.03,5500,0,181.92,409000006560,7-Nov-18,Indiaforensic RUPAY POS C2 ACQ07,,883587.82,-544029061.84,Chiu,577,France,9902.39,0,1,0
6562,2011,10,RENT,1,Low,1,16000, 60 months,2,major_purchase,8,High,2,Bad Loan,1,17.27,D,4,19.26,5249.02,1995.66,804.37,399.97,409000006561,8-Nov-18,TRF TO  Indiaforensic SERVICES I,"3,000,000.00",,-547029061.84,Sun,445,Germany,16645.77,0,1,0
6563,2011,7,MORTGAGE,3,Low,1,20125, 60 months,2,other,4,Low,1,Good Loan,0,10.65,B,2,12.65,22114.89,16371.76,0,434.07,409000006562,8-Nov-18,TRF TO  Indiaforensic SERVICES I,"1,000,000.00",,-548029061.84,Brennan,720,France,180134.88,0,1,0
6564,2011,10,RENT,1,Low,1,5500, 36 months,1,car,2,Low,1,Good Loan,0,7.51,A,1,9.1,5647.86,5500,0,171.11,409000006563,8-Nov-18,Indiaforensic RUPAY POS ACQ08111,,2726849.05,-545302212.79,Storey,643,Germany,148098.95,0,1,0
6565,2011,2,RENT,1,Low,1,4500, 36 months,1,small_business,3,Low,1,Good Loan,0,7.9,A,1,2.66,4961.08,4500,0,140.81,409000006564,8-Nov-18,Indiaforensic RUPAYPOSACQC208111,,800589.63,-544501623.16,Lawson,652,Germany,38798.79,0,1,0
6566,2011,6,MORTGAGE,3,Low,1,15000, 36 months,1,debt_consolidation,6,High,2,Bad Loan,1,15.27,C,3,14.8,10372.34,7031.46,456.03,521.97,409000006565,8-Nov-18,TRF TO  Indiaforensic SERVICES I,"3,000,000.00",,-547501623.16,T'ao,663,France,153295.00,0,1,0
6567,2011,3,RENT,1,Low,1,30000, 60 months,2,debt_consolidation,6,High,2,Good Loan,0,20.3,E,5,21.67,41819.59225,30000,0,799.84,409000006566,9-Nov-18,Indiaforensic VISA ACQ DOM071118,,7158935.89,-540342687.27,Yao,525,Germany,100687.67,0,1,0
6568,2011,6.05,MORTGAGE,3,Medium,2,25000, 36 months,1,credit_card,1,Low,1,Good Loan,0,9.91,B,2,4.19,28767.62,25000,0,805.63,409000006567,9-Nov-18,Indiaforensic VISA ACQ DOM081118,,6050299.48,-534292387.79,Bracewell,662,Spain,111442.71,0,1,0
6569,2011,4,MORTGAGE,3,Medium,2,12000, 60 months,2,credit_card,1,High,2,Good Loan,0,15.27,C,3,21.85,16874.0177,12000,0,287.19,409000006568,9-Nov-18,TRF TO  Indiaforensic SERVICES I,"3,000,000.00",,-537292387.79,Kerr,724,Germany,136902.01,0,1,0
6570,2011,10,RENT,1,Low,1,11625, 60 months,2,vacation,11,Low,1,Good Loan,0,9.91,B,2,9.03,12570.43,9495.65,0,246.49,409000006569,9-Nov-18,TRF TO  Indiaforensic SERVICES I,"10,000,000.00",,-547292387.79,Blake,581,Germany,105732.90,0,1,0
6571,2011,1,OWN,2,Low,1,13200, 36 months,1,house,12,Low,1,Good Loan,0,12.42,B,2,14.84,15861.37154,13200,0,441.09,409000006570,9-Nov-18,Indiaforensic MASTER ACQ DOM07-0,,14539365.82,-532753021.97,Sanders,685,Spain,35884.91,0,1,0
6572,2011,5,MORTGAGE,3,Low,1,5000, 36 months,1,credit_card,1,Low,1,Good Loan,0,6.62,A,1,17.08,5524.775394,5000,0,153.52,409000006571,9-Nov-18,Indiaforensic VISA ACQ DOM091118,,5522417.64,-527230604.33,Torkelson,595,France,73489.15,0,1,0
6573,2011,9,RENT,1,Low,1,12000, 36 months,1,debt_consolidation,6,Low,1,Good Loan,0,9.91,B,2,18.43,13916.07465,12000,0,386.7,409000006572,9-Nov-18,Indiaforensic RUPAY POS ACQ09111,,2714751.86,-524515852.47,Hsueh,588,France,110114.19,0,1,0
6574,2011,8,RENT,1,Low,1,8000, 36 months,1,debt_consolidation,6,High,2,Good Loan,0,16.29,D,4,20.42,10190.45081,8000,0,282.41,409000006573,9-Nov-18,TRF TO Indiaforensic SERVICES IN,"15,000,000.00",,-539515852.47,Wang,647,Germany,40145.28,0,1,0
6575,2011,0.5,RENT,1,Low,1,10000, 36 months,1,debt_consolidation,6,High,2,Bad Loan,1,15.96,C,3,18.98,4964.96,3066.21,407.94,351.38,409000006574,9-Nov-18,TRF TO Indiaforensic SERVICES IN,"5,000,000.00",,-544515852.47,Hightower,785,Germany,146398.51,0,1,0
6576,2011,0.5,RENT,1,Low,1,25000, 60 months,2,debt_consolidation,6,High,2,Good Loan,0,17.58,D,4,21.05,25726.69,25000,0,629.14,409000006575,9-Nov-18,TRF TO Indiaforensic SERVICES IN,"1,000,000.00",,-545515852.47,Genovesi,794,Germany,160526.36,0,1,0
6577,2011,2,OWN,2,Low,1,30000, 36 months,1,other,4,Low,1,Good Loan,0,9.91,B,2,3.85,34799.66125,30000,0,966.75,409000006576,9-Nov-18,TRF TO  Indiaforensic SERVICES I,"2,000,000.00",,-547515852.47,Levan,823,France,173516.71,0,1,0
6578,2011,0.5,MORTGAGE,3,High,3,35000, 36 months,1,house,12,High,2,Good Loan,0,17.58,D,4,12.15,43287.57,35000,0,1257.98,409000006577,9-Nov-18,TRF TO  Indiaforensic SERVICES I,"500,000.00",,-548015852.47,Lai,687,Germany,88396.60,0,1,0
6579,2011,10,RENT,1,Low,1,4700, 36 months,1,renewable_energy,13,Low,1,Good Loan,0,7.9,A,1,10.65,5266.531579,4700,0,147.07,409000006578,9-Nov-18,Indiaforensic RUPAY POS C2 ACQ09,,834435.72,-547181416.75,Loginov,850,France,185821.41,0,1,0
6580,2011,2,RENT,1,Low,1,1800, 36 months,1,other,4,Low,1,Good Loan,0,10.65,B,2,10.63,2053.25,1800,0,58.64,409000006579,9-Nov-18,Indiaforensic VISA ACQ INT 04111,,6357.44,-547175059.31,Lafleur,496,France,108098.28,0,1,0
6581,2011,10,MORTGAGE,3,Low,1,7425, 36 months,1,debt_consolidation,6,Low,1,Good Loan,0,6.03,A,1,19.4,8093.800179,7425,0,225.99,409000006580,9-Nov-18,Indiaforensic VISA ACQ INT 05111,,1010.97,-547174048.34,Obidimkpa,527,Germany,162267.91,0,1,0
6582,2011,10,MORTGAGE,3,Low,1,25600, 36 months,1,debt_consolidation,6,Low,1,Good Loan,0,12.69,B,2,18.69,30902.61506,25600,0,858.75,409000006581,9-Nov-18,Indiaforensic VISA ACQ INT 06111,,2036.35,-547172011.99,Ch'ang,576,Germany,193135.25,0,1,0
6583,2011,0.5,RENT,1,Low,1,4400, 36 months,1,credit_card,1,High,2,Good Loan,0,19.91,E,5,9.17,5877.217555,4400,0,163.32,409000006582,9-Nov-18,Indiaforensic VISA ACQ INT 07111,,110.57,-547171901.42,Mason,525,Spain,168034.90,0,1,0
6584,2011,4,RENT,1,Low,1,3600, 36 months,1,debt_consolidation,6,Low,1,Good Loan,0,12.69,B,2,11.26,4073.58,3600,0,120.77,409000006583,9-Nov-18,ICA 17825 Indiaforensic INT05111,,79707.87,-547092193.55,Miranda,727,Germany,163295.87,0,1,0
6585,2011,3,RENT,1,Low,1,16000, 36 months,1,debt_consolidation,6,Low,1,Good Loan,0,11.71,B,2,12.48,18629.79297,16000,0,529.22,409000006584,9-Nov-18,ICA 17825 Indiaforensic INT06111,,5122.95,-547087070.60,Simon,671,Germany,159553.27,0,1,0
6586,2011,6,MORTGAGE,3,Low,1,30750, 60 months,2,debt_consolidation,6,High,2,Good Loan,0,14.27,C,3,20.96,42152.36807,30750,0,719.82,409000006585,9-Nov-18,ICA 17825 Indiaforensic INT07111,,15729.12,-547071341.48,Golubeva,625,France,99800.87,0,1,0
6587,2011,5,MORTGAGE,3,Low,1,5000, 36 months,1,major_purchase,8,Low,1,Good Loan,0,7.9,A,1,26.54,5266.29,5000,0,156.46,409000006586,9-Nov-18,ICA 17825 Indiaforensic INT08111,,1019.80,-547070321.68,Manfrin,643,Germany,40250.82,0,1,0
6588,2011,10,RENT,1,Low,1,19575, 60 months,2,debt_consolidation,6,High,2,Good Loan,0,18.64,E,5,19.8,29137.07305,19575,0,503.92,409000006587,12-Nov-18,Indiaforensic VISA ACQ DOM101118,,6352472.57,-540717849.11,Stange,707,France,83335.78,0,1,0
6589,2011,2,RENT,1,Medium,2,2100, 36 months,1,debt_consolidation,6,Low,1,Bad Loan,1,9.91,B,2,19.63,472.01,359.88,0,67.68,409000006588,12-Nov-18,Indiaforensic RUPAY POS ACQ10111,,2762517.91,-537955331.20,Ferrari,539,Spain,48382.40,0,1,0
6590,2011,7,RENT,1,Low,1,15000, 36 months,1,debt_consolidation,6,High,2,Good Loan,0,13.49,C,3,10.77,18271.53753,15000,0,508.96,409000006589,12-Nov-18,Indiaforensic RUPAY POS ACQ11111,,4223595.48,-533731735.72,Taylor,498,Germany,165990.44,0,1,0
6591,2011,9,MORTGAGE,3,Medium,2,35000, 60 months,2,debt_consolidation,6,High,2,Good Loan,0,20.89,F,6,14.44,48152.49,27180.86,0,944.71,409000006590,12-Nov-18,Indiaforensic MASTER ACQ DOM10-1,,15264703.21,-518467032.51,Wei,696,Spain,9002.80,0,1,0
6592,2011,5,RENT,1,Low,1,9000, 36 months,1,debt_consolidation,6,High,2,Good Loan,0,16.29,D,4,12.74,11445.05526,9000,0,317.71,409000006591,12-Nov-18,Indiaforensic VISA ACQ DOM121118,,12901419.90,-505565612.61,Ch'eng,758,France,188156.34,0,1,0
6593,2011,10,RENT,1,Low,1,3000, 36 months,1,home_improvement,7,Low,1,Good Loan,0,10.65,B,2,10.98,3405.53,3000,0,97.72,409000006592,12-Nov-18,Indiaforensic RUPAY POS ACQ12111,,3736785.65,-501828826.96,Parsons,685,France,186785.01,0,1,0
6594,2011,10,RENT,1,Low,1,12000, 36 months,1,credit_card,1,Low,1,Good Loan,0,8.9,A,1,23.5,13715.76639,12000,0,381.04,409000006593,12-Nov-18,Indiaforensic RUPAY POS C2 ACQ12,,968967.68,-500859859.28,Pan,655,Germany,184259.60,0,1,0
6595,2011,3,RENT,1,Low,1,1800, 36 months,1,debt_consolidation,6,High,2,Good Loan,0,14.27,C,3,15.76,2221.315695,1800,0,61.76,409000006594,12-Nov-18,Indiaforensic VISA ACQ INT 08111,,14207.86,-500845651.42,Cameron,747,France,57817.84,0,1,0
6596,2011,1,RENT,1,Low,1,10625, 36 months,1,debt_consolidation,6,Low,1,Good Loan,0,7.9,A,1,28.22,11967.90796,10625,0,332.46,409000006595,12-Nov-18,TRF TO  Indiaforensic SERVICES I,"15,000,000.00",,-515845651.42,Igwebuike,601,Spain,144660.42,0,1,0
6597,2011,10,MORTGAGE,3,Low,1,18000, 36 months,1,credit_card,1,High,2,Good Loan,0,20.89,F,6,16.82,24374.94076,18000,0,677.14,409000006596,12-Nov-18,TRF TO  Indiaforensic SERVICES I,"15,000,000.00",,-530845651.42,Tuan,477,France,163112.90,0,1,0
6598,2011,4,OWN,2,Low,1,6400, 36 months,1,debt_consolidation,6,Low,1,Good Loan,0,7.9,A,1,16.8,7207.511662,6400,0,200.26,409000006597,12-Nov-18,TRF TO  Indiaforensic SERVICES I,"10,000,000.00",,-540845651.42,Fraser,558,France,136301.10,0,1,0
6599,2011,10,RENT,1,Low,1,12000, 36 months,1,credit_card,1,High,2,Good Loan,0,13.49,C,3,19.57,14556.82334,12000,0,407.17,409000006598,12-Nov-18,ICA 17825 Indiaforensic INT09111,,10248.16,-540835403.26,Turnbull,586,Spain,36176.63,0,1,0
6600,2011,10,MORTGAGE,3,Low,1,18000, 60 months,2,credit_card,1,High,2,Good Loan,0,15.27,C,3,14.41,25364.72576,18000,0,430.78,409000006599,12-Nov-18,TRF TO  Indiaforensic SERVICES I,"5,000,000.00",,-545835403.26,Chiazagomekpere,850,France,65769.30,0,1,0
6601,2011,4,MORTGAGE,3,Low,1,2600, 60 months,2,debt_consolidation,6,High,2,Good Loan,0,17.27,D,4,5.36,3308.84,2052.21,0,65,409000006600,12-Nov-18,TRF TO  Indiaforensic SERVICES I,"2,000,000.00",,-547835403.26,Yudina,505,France,174123.16,0,1,0
6602,2011,10,MORTGAGE,3,Medium,2,25000, 60 months,2,debt_consolidation,6,High,2,Good Loan,0,14.27,C,3,18.62,29829.7,20024.08,0,585.22,409000006601,13-Nov-18,Indiaforensic VISA ACQ DOM131118,,7238266.06,-540597137.20,Udinese,591,Germany,161304.68,0,1,0
6603,2011,4,RENT,1,Low,1,17500, 36 months,1,debt_consolidation,6,Low,1,Good Loan,0,7.9,A,1,13.22,19712.32423,17500,0,547.58,409000006602,13-Nov-18,Indiaforensic RUPAY POS ACQ13111,,2984430.53,-537612706.67,Chinweike,761,Germany,109394.62,0,1,0
6604,2011,10,MORTGAGE,3,Low,1,9600, 36 months,1,debt_consolidation,6,Low,1,Good Loan,0,6.03,A,1,13.18,9785.95,9600,0,292.19,409000006603,13-Nov-18,Indiaforensic VISA ACQ INT 09111,,16290.81,-537596415.86,Bergamaschi,554,France,190155.13,0,1,0
6605,2011,9,RENT,1,Low,1,12000, 36 months,1,credit_card,1,Low,1,Good Loan,0,11.71,B,2,18.78,14281.87042,12000,0,396.92,409000006604,13-Nov-18,ICA 17825 Indiaforensic MC DOM 1,,5311712.60,-532284703.26,Milliner,774,France,61450.96,0,1,0
6606,2011,4,MORTGAGE,3,Low,1,8000, 36 months,1,debt_consolidation,6,Low,1,Good Loan,0,12.69,B,2,17.1,9654.613871,8000,0,268.36,409000006605,13-Nov-18,TRF TO  Indiaforensic SERVICES I,"10,600,000.00",,-542884703.26,Knowles,771,Spain,8673.43,0,1,0
6607,2011,2,RENT,1,Low,1,12000, 60 months,2,debt_consolidation,6,High,2,Good Loan,0,18.25,D,4,21.23,15595.52,9427.23,0,306.36,409000006606,13-Nov-18,TRF TO  Indiaforensic SERVICES I,"5,300,000.00",,-548184703.26,Swinton,792,France,125912.77,0,1,0
6608,2011,10,MORTGAGE,3,Low,1,4000, 36 months,1,car,2,Low,1,Good Loan,0,8.9,A,1,11.44,4530.16,4000,0,127.02,409000006607,13-Nov-18,Indiaforensic RUPAY POS C2 ACQ13,,935708.81,-547248994.45,Gregory,673,Germany,151349.35,0,1,0
6609,2011,9,MORTGAGE,3,Medium,2,24000, 60 months,2,home_improvement,7,High,2,Bad Loan,1,17.27,D,4,5.7,28759.72,17411.86,0,599.96,409000006608,13-Nov-18,TRF TO  Indiaforensic SERVICES I,"1,000,000.00",,-548248994.45,Chibueze,765,France,67972.45,0,1,0
6610,2011,2,RENT,1,Low,1,6400, 36 months,1,debt_consolidation,6,Low,1,Good Loan,0,10.65,B,2,7.09,6948.03,6400,0,208.47,409000006609,14-Nov-18,Indiaforensic VISA ACQ DOM141118,,5951423.18,-542297571.27,Sukhorukova,748,France,71139.31,0,1,0
6611,2011,10,MORTGAGE,3,Medium,2,31150, 60 months,2,debt_consolidation,6,High,2,Good Loan,0,13.49,C,3,10.64,41934.89903,31150,0,716.6,409000006610,14-Nov-18,Indiaforensic RUPAY POS ACQ14111,,2805849.78,-539491721.49,French,422,France,86350.97,0,1,0
6612,2011,2,RENT,1,Low,1,6700, 60 months,2,debt_consolidation,6,High,2,Good Loan,0,20.3,E,5,3.84,8636.96,6700,0,178.63,409000006611,14-Nov-18,ICA 17825 Indiaforensic MC DOM 1,,4063196.06,-535428525.43,Estrada,568,Spain,118648.12,0,1,0
6613,2011,10,RENT,1,Low,1,15000, 36 months,1,debt_consolidation,6,High,2,Good Loan,0,14.27,C,3,10.1,18515.12607,15000,0,514.64,409000006612,14-Nov-18,TRF TO  Indiaforensic SERVICES I,"8,700,000.00",,-544128525.43,Fleming,502,France,100995.11,0,1,0
6614,2011,5,RENT,1,Low,1,2200, 36 months,1,debt_consolidation,6,Low,1,Good Loan,0,12.69,B,2,9.63,2653.88781,2200,0,73.8,409000006613,14-Nov-18,TRF TO  Indiaforensic SERVICES I,"4,100,000.00",,-548228525.43,Kennedy,524,France,147100.72,0,1,0
6615,2011,2,MORTGAGE,3,Medium,2,8000, 36 months,1,small_business,3,Low,1,Good Loan,0,6.03,A,1,0.5,8441.47,8000,0,243.49,409000006614,14-Nov-18,ICA 17825 Indiaforensic MC INT10,,21692.29,-548206833.14,Combes,689,France,155495.63,0,1,0
6616,2011,5,RENT,1,Low,1,5600, 36 months,1,debt_consolidation,6,Low,1,Good Loan,0,6.62,A,1,4.39,6188.817875,5600,0,171.95,409000006615,14-Nov-18,Indiaforensic RUPAY POS C2 ACQ14,,877441.89,-547329391.25,Carruthers,661,France,196875.87,0,1,0
6617,2011,6,RENT,1,Low,1,5000, 36 months,1,debt_consolidation,6,High,2,Good Loan,0,17.27,D,4,17.58,6474.327125,5000,0,178.94,409000006616,14-Nov-18,Indiaforensic VISA ACQ INT 10111,,2451.66,-547326939.59,Andrejew,606,Spain,63176.77,0,1,0
6618,2011,10,MORTGAGE,3,Low,1,18225, 60 months,2,debt_consolidation,6,Low,1,Bad Loan,1,12.69,B,2,17.19,1647.01,706.13,0,411.79,409000006617,14-Nov-18,Indiaforensic VISA ACQ INT 11111,,3228.51,-547323711.08,Ko,678,Germany,105221.76,0,1,0
6619,2011,10,OWN,2,Low,1,14125, 60 months,2,debt_consolidation,6,Low,1,Good Loan,0,12.69,B,2,7.76,16732.94,14124.99,0,319.16,409000006618,14-Nov-18,Indiaforensic VISA ACQ INT 12111,,5701.38,-547318009.70,Daniels,636,Germany,131924.38,0,1,0
6620,2011,4,RENT,1,Low,1,5000, 36 months,1,wedding,5,Low,1,Good Loan,0,10.65,B,2,20.25,5860.660461,5000,0,162.87,409000006619,15-Nov-18,TRF TO  Indiaforensic SERVICES I,"500,000.00",,-547818009.70,Toscano,647,France,23132.73,0,1,0
6621,2011,10,MORTGAGE,3,Low,1,6000, 60 months,2,car,2,Low,1,Good Loan,0,8.9,A,1,18.18,7233.004013,6000,0,124.26,409000006620,15-Nov-18,Indiaforensic VISA ACQ DOM151118,,5186503.19,-542631506.51,Wilson,732,France,161428.25,0,1,0
6622,2011,0.5,MORTGAGE,3,Low,1,12000, 60 months,2,debt_consolidation,6,High,2,Good Loan,0,14.65,C,3,10.13,14446.44,9598.96,0,283.28,409000006621,15-Nov-18,Indiaforensic RUPAY POS ACQ15111,,2695708.37,-539935798.14,Thomson,646,France,181794.86,0,1,0
6623,2011,8,OWN,2,Low,1,6000, 36 months,1,small_business,3,Low,1,Bad Loan,1,12.42,B,2,10.11,2069.3,1290.38,269.82,200.5,409000006622,15-Nov-18,ICA 17825 Indiaforensic MC DOM 1,,5143647.04,-534792151.10,Kazantseva,559,France,86634.30,0,1,0
6624,2011,4,MORTGAGE,3,Low,1,5000, 36 months,1,debt_consolidation,6,Low,1,Good Loan,0,11.71,B,2,12.86,5951.774424,5000,0,165.38,409000006623,15-Nov-18,TRF TO  Indiaforensic SERVICES I,"8,300,000.00",,-543092151.10,Cremonesi,581,France,29937.75,0,1,0
6625,2011,10,RENT,1,Low,1,5000, 36 months,1,debt_consolidation,6,Low,1,Good Loan,0,10.65,B,2,15.22,5861.895263,5000,0,162.87,409000006624,15-Nov-18,Indiaforensic RUPAY POS C2 ACQ15,,785816.50,-542306334.60,Ferri,565,France,140130.22,0,1,0
6626,2011,6.05,RENT,1,Low,1,3000, 36 months,1,credit_card,1,High,2,Good Loan,0,17.27,D,4,16.62,3166.91,3000,0,107.37,409000006625,15-Nov-18,Indiaforensic VISA ACQ INT 13111,,13386.28,-542292948.32,Ferri,657,Spain,17536.82,0,1,0
6627,2011,10,MORTGAGE,3,Low,1,7200, 36 months,1,debt_consolidation,6,High,2,Good Loan,0,16.29,D,4,19.16,8550.9,7200,0,254.17,409000006626,15-Nov-18,TRF TO  Indiaforensic SERVICES I,"5,100,000.00",,-547392948.32,Lombardi,847,France,53157.16,0,1,0
6628,2011,1,RENT,1,Low,1,9000, 36 months,1,credit_card,1,Low,1,Good Loan,0,9.91,B,2,16.41,9822.26,9000,0,290.03,409000006627,15-Nov-18,TRF TO  Indiaforensic SERVICES I,"800,000.00",,-548192948.32,Eluemuno,558,France,143585.29,0,1,0
6629,2011,8,RENT,1,Low,1,6200, 36 months,1,other,4,Low,1,Good Loan,0,6.03,A,1,0.65,6320.25,6200,0,188.71,409000006628,16-Nov-18,Indiaforensic VISA ACQ DOM161118,,6603560.59,-541589387.73,Chiganu,596,Spain,72402.00,0,1,0
6630,2011,1,RENT,1,Low,1,4000, 36 months,1,debt_consolidation,6,High,2,Good Loan,0,17.58,D,4,10.78,5016.5,4000,0,143.77,409000006629,16-Nov-18,Indiaforensic RUPAY POS ACQ16111,,1540910.37,-540048477.36,Hsueh,579,France,39891.84,0,1,0
6631,2011,4,OWN,2,Low,1,26000, 60 months,2,debt_consolidation,6,Low,1,Good Loan,0,10.65,B,2,9.01,33415.38002,26000,0,560.78,409000006630,16-Nov-18,ICA 17825 Indiaforensic MC DOM 1,,5120387.97,-534928089.39,O'Brien,741,France,89804.83,0,1,0
6632,2011,0.5,MORTGAGE,3,Medium,2,14000, 36 months,1,credit_card,1,High,2,Good Loan,0,16.77,D,4,9.67,16048.69,14000.01,0,497.54,409000006631,16-Nov-18,ICA 17825 Indiaforensic MC INT15,,3545.59,-534924543.80,Booth,613,France,136491.72,0,1,0
6633,2011,10,MORTGAGE,3,Low,1,15000, 36 months,1,debt_consolidation,6,Low,1,Good Loan,0,11.71,B,2,16.76,17852.04312,15000,0,496.14,409000006632,16-Nov-18,TRF TO  Indiaforensic SERVICES I,"13,300,000.00",,-548224543.80,O'Loghlin,694,Spain,35593.18,0,1,0
6634,2011,1,RENT,1,Low,1,2700, 36 months,1,debt_consolidation,6,Low,1,Good Loan,0,7.9,A,1,23.18,2876.98,2700,0,84.49,409000006633,16-Nov-18,Indiaforensic RUPAY POS C2 ACQ16,,2268346.44,-545956197.36,Lavrov,729,Spain,58268.20,0,1,0
6635,2011,10,RENT,1,Medium,2,21600, 36 months,1,debt_consolidation,6,Low,1,Good Loan,0,7.9,A,1,5.72,24330.34688,21600,0,675.87,409000006634,16-Nov-18,Indiaforensic VISA ACQ INT 14111,,5056.20,-545951141.16,Somadina,480,France,101778.90,0,1,0
6636,2011,1,RENT,1,Low,1,13225, 36 months,1,credit_card,1,Low,1,Good Loan,0,12.42,B,2,10.4,15877.72787,13225,0,441.92,409000006635,16-Nov-18,TRF TO  Indiaforensic SERVICES I,"2,300,000.00",,-548251141.16,Colombo,666,France,185123.09,0,1,0
6637,2011,10,MORTGAGE,3,Medium,2,28000, 60 months,2,credit_card,1,Low,1,Bad Loan,1,12.69,B,2,25.37,31668.63,21979.15,0,632.66,409000006636,17-Nov-18,Indiaforensic VISA ACQ DOM171118,,5276439.10,-542974702.06,Troupe,575,France,119927.81,0,1,0
6638,2011,9,OWN,2,Low,1,20000, 36 months,1,debt_consolidation,6,Low,1,Good Loan,0,11.71,B,2,11.7,23809.26892,20000,0,661.52,409000006637,17-Nov-18,Indiaforensic RUPAY POS ACQ17111,,783728.36,-542190973.70,Kenenna,850,France,195033.07,0,1,0
6639,2011,6,OWN,2,Low,1,3000, 36 months,1,wedding,5,Low,1,Bad Loan,1,9.91,B,2,4.75,1059.96,821.71,0,96.68,409000006638,17-Nov-18,Indiaforensic RUPAY POS C2 ACQ17,,2150244.52,-540040729.18,Franklin,740,France,86480.29,0,1,0
6640,2011,5,RENT,1,Low,1,12000, 60 months,2,small_business,3,Low,1,Good Loan,0,9.91,B,2,0,15025.77288,12000,0,254.44,409000006639,17-Nov-18,TRF TO  Indiaforensic SERVICES I,"2,000,000.00",,-542040729.18,Deleon,588,Germany,198766.61,0,1,0
6641,2011,10,MORTGAGE,3,Low,1,16000, 36 months,1,debt_consolidation,6,Low,1,Good Loan,0,6.03,A,1,1.36,16434.48,16000,0,486.97,409000006640,19-Nov-18,TRF TO  Indiaforensic SERVICES I,"3,000,000.00",,-545040729.18,Kung,681,France,185144.08,0,1,0
6642,2011,5,MORTGAGE,3,Low,1,5000, 36 months,1,debt_consolidation,6,High,2,Good Loan,0,16.77,D,4,23.82,6323.939045,5000,0,177.7,409000006641,19-Nov-18,TRF TO  Indiaforensic SERVICES I,"3,000,000.00",,-548040729.18,Zito,611,Spain,3729.89,0,1,0
6643,2011,9,RENT,1,Low,1,2600, 60 months,2,debt_consolidation,6,High,2,Good Loan,0,19.91,E,5,16.69,3519.8,2028.18,0,68.76,409000006642,19-Nov-18,ICA 17825 Indiaforensic MC INT 1,,3041.42,-548037687.76,Giordano,589,France,18988.58,0,1,0
6644,2011,10,MORTGAGE,3,Medium,2,20000, 60 months,2,home_improvement,7,Low,1,Good Loan,0,12.69,B,2,15.18,23023.1,16125.68,0,451.9,409000006643,19-Nov-18,ICA 17825 Indiaforensic MC DOM 1,,12671255.85,-535366431.91,Davide,717,Spain,119313.74,0,1,0
6645,2011,8,MORTGAGE,3,Medium,2,32000, 36 months,1,debt_consolidation,6,Low,1,Good Loan,0,7.9,A,1,10.65,35980.58219,32000,0,1001.29,409000006644,19-Nov-18,TRF TO  Indiaforensic SERVICES I,"10,000,000.00",,-545366431.91,Lei,556,Germany,62627.55,0,1,0
6646,2011,2,MORTGAGE,3,Low,1,7000, 36 months,1,debt_consolidation,6,Low,1,Good Loan,0,6.03,A,1,8.52,7588.09,7000,0,213.05,409000006645,19-Nov-18,Indiaforensic VISA ACQ DOM191118,,12121648.00,-533244783.91,Moss,850,France,197266.58,0,1,0
6647,2011,0.5,RENT,1,Low,1,4200, 60 months,2,car,2,Low,1,Good Loan,0,12.42,B,2,16.1,4685.39,4200,0,94.33,409000006646,19-Nov-18,Indiaforensic RUPAY POS ACQ18111,,2300668.87,-530944115.04,Lucciano,685,Spain,199992.48,0,1,0
6648,2011,6.05,MORTGAGE,3,Medium,2,19100, 60 months,2,other,4,High,2,Good Loan,0,22.06,F,6,3.93,26922.62,14749.75,0,528.18,409000006647,19-Nov-18,Indiaforensic RUPAY POS ACQ19111,,3084878.46,-527859236.58,Tai,713,France,16403.41,0,1,0
6649,2011,6,MORTGAGE,3,Low,1,30100, 60 months,2,home_improvement,7,High,2,Good Loan,0,19.42,E,5,3.31,33143.47,30100,0,787.79,409000006648,19-Nov-18,Indiaforensic RUPAY POS C2 ACQ19,,702017.72,-527157218.86,Osinachi,437,France,78854.57,0,1,0
6650,2011,10,RENT,1,Low,1,8000, 36 months,1,debt_consolidation,6,Low,1,Bad Loan,1,7.9,A,1,18.62,5503.3,4659.45,0,250.33,409000006649,19-Nov-18,TRF TO  Indiaforensic SERVICES I,"15,000,000.00",,-542157218.86,Coates,605,Spain,189310.27,0,1,0
6651,2011,0.5,RENT,1,Low,1,20000, 60 months,2,debt_consolidation,6,High,2,Good Loan,0,19.42,E,5,19.79,27416.5,20000,0,523.45,409000006650,19-Nov-18,TRF T  Indiaforensic SERVICES IN,"4,000,000.00",,-546157218.86,Larionova,758,Germany,78088.17,0,1,0
6652,2011,6.05,RENT,1,Low,1,2200, 36 months,1,major_purchase,8,Low,1,Good Loan,0,9.91,B,2,4.17,2565.834231,2200,0,70.9,409000006651,19-Nov-18,TRF T0  Indiaforensic SERVICES I,"2,000,000.00",,-548157218.86,Seleznev,600,France,19842.18,0,1,0
6653,2011,6,RENT,1,Medium,2,6000, 36 months,1,debt_consolidation,6,Low,1,Good Loan,0,10.65,B,2,14.44,6996.789684,6000,0,195.44,409000006652,20-Nov-18,ICA 17825 Indiaforensic MC INT 1,,39799.19,-548117419.67,Butcher,827,France,103305.01,0,1,0
6654,2011,9,MORTGAGE,3,Medium,2,14000, 60 months,2,credit_card,1,High,2,Good Loan,0,16.77,D,4,13.5,17320.54,14000,0,346.21,409000006653,20-Nov-18,Indiaforensic VISA ACQ DOM201118,,6627773.93,-541489645.74,Gould,608,Germany,116124.28,0,1,0
6655,2011,3,OWN,2,Low,1,3000, 36 months,1,major_purchase,8,Low,1,Good Loan,0,7.9,A,1,4.67,3378.315848,3000,0,93.88,409000006654,20-Nov-18,Indiaforensic RUPAY POS ACQ20111,,2486465.85,-539003179.89,Cunningham,608,France,142730.27,0,1,0
6656,2011,1,RENT,1,Low,1,1000, 36 months,1,credit_card,1,High,2,Good Loan,0,14.65,C,3,19.1,1241.211901,1000,0,34.5,409000006655,20-Nov-18,Indiaforensic VISA ACQ INT 16111,,5573.10,-538997606.79,Sanderson,554,France,58076.52,0,1,0
6657,2011,8,MORTGAGE,3,Low,1,35000, 60 months,2,debt_consolidation,6,High,2,Good Loan,0,20.3,E,5,19.05,47531.26,27243.66,0,933.14,409000006656,20-Nov-18,Indiaforensic RUPAY POS C2 ACQ20,,766268.52,-538231338.27,Mai,683,Germany,186123.57,0,1,0
6658,2011,10,OWN,2,Low,1,19000, 60 months,2,debt_consolidation,6,High,2,Good Loan,0,19.91,E,5,19.2,23637.66,19000,0,502.44,409000006657,20-Nov-18,TRF TO  Indiaforensic SERVICES I,"5,000,000.00",,-543231338.27,Reid,660,Spain,29664.45,0,1,0
6659,2011,2,RENT,1,Low,1,15000, 60 months,2,debt_consolidation,6,High,2,Good Loan,0,15.96,C,3,12.62,18563.1,11915.14,0,364.46,409000006658,20-Nov-18,TRF TO  Indiaforensic SERVICES I,"2,000,000.00",,-545231338.27,Downer,628,France,147963.07,0,1,0
6660,2011,10,OWN,2,Low,1,12000, 60 months,2,house,12,High,2,Bad Loan,1,19.42,E,5,7.67,4366.1,1568.93,608.54,314.07,409000006659,20-Nov-18,TRF TO  Indiaforensic SERVICES I,"2,000,000.00",,-547231338.27,Humphries,668,Germany,38466.39,0,1,0
6661,2011,1,OWN,2,Low,1,1500, 60 months,2,debt_consolidation,6,High,2,Good Loan,0,15.96,C,3,13.75,1868.37,1189.72,0,36.45,409000006660,21-Nov-18,FUND TRF TO  Indiaforensic SERVI,"1,000,000.00",,-548231338.27,Bochsa,776,France,143301.49,0,1,0
6662,2011,6.05,RENT,1,Medium,2,4000, 36 months,1,other,4,High,2,Good Loan,0,16.29,D,4,0.29,5015.24,4000,0,141.21,409000006661,21-Nov-18,Indiaforensic RUPAY POS ACQ21111,,3078833.91,-545152504.36,Czajkowski,820,France,31422.69,0,1,0
6663,2011,3,MORTGAGE,3,Low,1,11000, 36 months,1,home_improvement,7,High,2,Good Loan,0,16.77,D,4,14.86,14036.36684,11000,0,390.93,409000006662,21-Nov-18,Indiaforensic RUPAY POS C2 ACQ21,,732121.39,-544420382.97,Pankhurst,665,France,121505.61,0,1,0
6664,2011,4,RENT,1,Medium,2,20000, 36 months,1,credit_card,1,Low,1,Good Loan,0,7.9,A,1,10.18,22527.05624,20000,0,625.81,409000006663,21-Nov-18,FUND TRF TO  Indiaforensic SERVI,"2,000,000.00",,-546420382.97,She,850,Germany,89874.82,0,1,0
6665,2011,6.05,MORTGAGE,3,Medium,2,35000, 60 months,2,home_improvement,7,High,2,Good Loan,0,19.03,E,5,13.37,50114.88887,35000,0,908.5,409000006664,21-Nov-18,FUND TRF TO  Indiaforensic SERVI,"1,000,000.00",,-547420382.97,Birdseye,703,France,72500.68,0,1,0
6666,2011,2,MORTGAGE,3,Low,1,6000, 36 months,1,wedding,5,Low,1,Good Loan,0,7.51,A,1,19.34,6685.598172,6000,0,186.67,409000006665,21-Nov-18,FUND TRF TO  Indiaforensic SERVI,"500,000.00",,-547920382.97,Hope,506,Spain,182692.80,0,1,0
6667,2011,7,RENT,1,Low,1,6300, 36 months,1,debt_consolidation,6,High,2,Good Loan,0,15.96,C,3,21.6,7962.359646,6300,0,221.37,409000006666,22-Nov-18,ICA 17825 Indiaforensic MC INT 2,,19279.39,-547901103.58,Gill,588,Spain,4993.94,0,1,0
6668,2011,2,MORTGAGE,3,Low,1,14000, 60 months,2,debt_consolidation,6,High,2,Bad Loan,1,19.03,E,5,13.52,10134.63,4081.15,1432.71,363.4,409000006667,22-Nov-18,ICA 17825 Indiaforensic MC INT 2,,7152.14,-547893951.44,Moon,622,Spain,124964.82,0,1,0
6669,2011,4,RENT,1,Low,1,6000, 36 months,1,vacation,11,Low,1,Good Loan,0,8.9,A,1,18.05,6857.883194,6000,0,190.52,409000006668,22-Nov-18,ICA 17825 Indiaforensic MC DOM 2,,15140655.54,-532753295.90,Watt,606,France,161971.42,0,1,0
6670,2011,10,MORTGAGE,3,Low,1,10000, 36 months,1,debt_consolidation,6,High,2,Good Loan,0,18.25,D,4,15.81,10588.4,10000,0,362.78,409000006669,22-Nov-18,TRF TO  Indiaforensic SERVICES I,"15,000,000.00",,-547753295.90,Chinomso,517,France,39488.04,0,1,0
6671,2011,10,RENT,1,Low,1,20000, 60 months,2,other,4,Low,1,Good Loan,0,12.42,B,2,8.02,24218.52,20000,0,449.15,409000006670,22-Nov-18,Indiaforensic VISA ACQ DOM211118,,6233273.22,-541520022.68,Bellucci,758,Spain,55313.44,0,1,0
6672,2011,5,OWN,2,Low,1,9200, 36 months,1,debt_consolidation,6,Low,1,Good Loan,0,6.03,A,1,25.29,9847.46,9200,0,280.01,409000006671,22-Nov-18,Indiaforensic VISA ACQ DOM221118,,5883662.68,-535636360.00,Barese,677,France,187811.71,0,1,0
6673,2011,2,RENT,1,Low,1,9975, 36 months,1,debt_consolidation,6,High,2,Good Loan,0,16.29,D,4,23.79,12672.6025,9975,0,352.13,409000006672,22-Nov-18,Indiaforensic RUPAY POS ACQ22111,,3065036.47,-532571323.53,Fleming,827,Spain,184514.01,0,1,0
6674,2011,0.5,MORTGAGE,3,Low,1,20000, 60 months,2,debt_consolidation,6,High,2,Good Loan,0,17.58,D,4,13.86,27907.61697,20000,0,503.32,409000006673,22-Nov-18,Indiaforensic RUPAY POS C2 ACQ22,,756809.82,-531814513.71,Bell,729,France,121311.12,0,1,0
6675,2011,4,MORTGAGE,3,Low,1,35000, 60 months,2,small_business,3,Low,1,Bad Loan,1,11.71,B,2,0.35,3090.6,1751.26,0,773.44,409000006674,22-Nov-18,Indiaforensic VISA ACQ INT 19111,,3542.00,-531810971.71,Li Fonti,654,France,12873.39,0,1,0
6676,2011,1,RENT,1,Low,1,30000, 60 months,2,debt_consolidation,6,High,2,Bad Loan,1,13.49,C,3,10.34,12413.88,6992.19,0,690.15,409000006675,22-Nov-18,TRF TO  Indiaforensic SERVICES I,"1,000,000.00",,-532810971.71,Christmas,654,Spain,157238.05,0,1,0
6677,2011,10,MORTGAGE,3,Low,1,34000, 60 months,2,debt_consolidation,6,High,2,Good Loan,0,18.64,E,5,19.58,46433.41,34000,0,875.26,409000006676,22-Nov-18,TRF TO  Indiaforensic SERVICES I,"15,000,000.00",,-547810971.71,Chuter,619,Spain,123242.11,0,1,0
6678,2011,10,MORTGAGE,3,Low,1,22750, 60 months,2,debt_consolidation,6,Low,1,Bad Loan,1,12.69,B,2,25.26,10241.21,5385.24,997.67,514.03,409000006677,23-Nov-18,Indiaforensic RUPAY POS ACQ23111,,965541.18,-546845430.53,Johnson,642,Spain,184399.76,0,1,0
6679,2011,6.05,OWN,2,Low,1,7750, 36 months,1,debt_consolidation,6,Low,1,Good Loan,0,7.51,A,1,25.73,8672.658932,7750,0,241.11,409000006678,23-Nov-18,Indiaforensic RUPAY POS C2 ACQ23,,1562155.14,-545283275.39,Scott,472,Spain,57323.18,0,1,0
6680,2011,10,MORTGAGE,3,Medium,2,22400, 36 months,1,debt_consolidation,6,Low,1,Good Loan,0,12.42,B,2,11.89,26941.32747,22400,0,748.51,409000006679,26-Nov-18,TRF TO  Indiaforensic SERVICES I,"2,900,000.00",,-548183275.39,Byrne,470,Spain,68293.93,0,1,0
6681,2011,3,MORTGAGE,3,Medium,2,12000, 60 months,2,home_improvement,7,Low,1,Good Loan,0,10.65,B,2,5.87,14607.18784,12000,0,258.82,409000006680,26-Nov-18,ICA 17825 Indiaforensic MC DOM 2,,16419259.12,-531764016.27,Chukwudi,633,France,10288.24,0,1,0
6682,2011,10,MORTGAGE,3,Low,1,24600, 60 months,2,debt_consolidation,6,Low,1,Good Loan,0,12.69,B,2,11.38,28324.09,19837.83,0,555.83,409000006681,26-Nov-18,TRF TO  Indiaforensic SERVICES I,"10,000,000.00",,-541764016.27,Ma,602,France,179446.31,0,1,0
6683,2011,10,MORTGAGE,3,Low,1,1500, 60 months,2,other,4,High,2,Bad Loan,1,15.96,C,3,24.77,1286.67,651.61,124.55,36.45,409000006682,26-Nov-18,TRF TO  Indiaforensic SERVICES I,"5,000,000.00",,-546764016.27,Simmons,640,Spain,141453.62,0,1,0
6684,2011,1,MORTGAGE,3,Low,1,17000, 36 months,1,debt_consolidation,6,High,2,Bad Loan,1,15.27,C,3,13.6,16158.25,11441.81,778.97,591.57,409000006683,26-Nov-18,Indiaforensic VISA ACQ DOM231118,,4993123.72,-541770892.55,Fang,454,Spain,93151.77,0,1,0
6685,2011,5,MORTGAGE,3,Low,1,15000, 60 months,2,debt_consolidation,6,High,2,Good Loan,0,18.64,E,5,22.21,22805.84002,15000,0,386.15,409000006684,26-Nov-18,Indiaforensic RUPAY POS ACQ24111,,2556219.48,-539214673.07,Blake,562,France,6554.97,0,1,0
6686,2011,10,MORTGAGE,3,Low,1,9600, 36 months,1,debt_consolidation,6,Low,1,Good Loan,0,7.51,A,1,15.53,10750.30648,9600,0,298.67,409000006685,26-Nov-18,Indiaforensic RUPAY POS ACQ25111,,3393970.41,-535820702.66,Tien,636,France,38570.13,0,1,0
6687,2011,7,MORTGAGE,3,Low,1,8600, 36 months,1,debt_consolidation,6,Low,1,Good Loan,0,6.03,A,1,13.89,9418.581889,8600,0,261.75,409000006686,26-Nov-18,Indiaforensic VISA ACQ DOM241118,,4522443.03,-531298259.63,Yusupova,621,Spain,131048.36,0,1,0
6688,2011,10,MORTGAGE,3,Low,1,12025, 60 months,2,small_business,3,Low,1,Good Loan,0,9.91,B,2,19.57,13002.91,9822.31,0,254.97,409000006687,26-Nov-18,Indiaforensic VISA ACQ DOM261118,,11708902.02,-519589357.61,Davidson,795,Germany,127068.92,0,1,0
6689,2011,10,MORTGAGE,3,Low,1,6400, 36 months,1,debt_consolidation,6,High,2,Good Loan,0,16.29,D,4,9.14,7651.93,6400,0,225.93,409000006688,26-Nov-18,Indiaforensic RUPAY POS ACQ26111,,1506380.84,-518082976.77,Zhdanova,550,France,51721.52,0,1,0
6690,2011,0.5,RENT,1,Low,1,12800, 36 months,1,car,2,Low,1,Good Loan,0,8.9,A,1,12.51,14631.19779,12800,0,406.45,409000006689,26-Nov-18,Indiaforensic RUPAY POS C2 ACQ26,,1798748.08,-516284228.69,Nielson,630,Spain,46156.87,0,1,0
6691,2011,2,MORTGAGE,3,Low,1,5400, 36 months,1,other,4,Low,1,Good Loan,0,8.9,A,1,15.63,6171.494448,5400,0,171.47,409000006690,26-Nov-18,ICA 17825 Indiaforensic MC INT 2,,31944.43,-516252284.26,Niu,573,Germany,192950.60,0,1,0
6692,2011,10,RENT,1,Low,1,5000, 36 months,1,moving,10,High,2,Good Loan,0,15.96,C,3,14.36,6353.774244,5000,0,175.69,409000006691,26-Nov-18,TRF TO  Indiaforensic SERVICES I,"1,900,000.00",,-518152284.26,Kay,561,Spain,180932.46,0,1,0
6693,2011,7,MORTGAGE,3,Low,1,9600, 36 months,1,home_improvement,7,Low,1,Good Loan,0,7.9,A,1,11.69,10812.90545,9600,0,300.39,409000006692,26-Nov-18,TRF TO  Indiaforensic SERVICES I,"15,000,000.00",,-533152284.26,Green,662,France,19596.73,0,1,0
6694,2011,6.05,MORTGAGE,3,Low,1,8000, 36 months,1,credit_card,1,Low,1,Bad Loan,1,6.62,A,1,4.9,6140.75,5371.18,16.25,245.63,409000006693,26-Nov-18,TRF TO  Indiaforensic SERVICES I,"15,000,000.00",,-548152284.26,She,637,France,46786.92,0,1,0
6695,2011,4,OWN,2,Low,1,10000, 36 months,1,credit_card,1,High,2,Bad Loan,1,16.29,D,4,23.03,7701.32,5230.16,299.87,353.01,409000006694,27-Nov-18,ICA 17825 Indiaforensic MC INT 2,,42079.28,-548110204.98,Ajuluchukwu,651,Germany,175820.91,0,1,0
6696,2011,0.5,RENT,1,Medium,2,7500, 36 months,1,wedding,5,High,2,Good Loan,0,16.77,D,4,11.92,7604.99,7500,0,266.54,409000006695,27-Nov-18,Indiaforensic VISA ACQ DOM271118,,2553252.82,-545556952.16,Sabbatini,646,France,198208.00,0,1,0
6697,2011,1,RENT,1,Low,1,14000, 60 months,2,credit_card,1,High,2,Good Loan,0,16.77,D,4,18.77,20000.50154,14000,0,346.21,409000006696,27-Nov-18,Indiaforensic RUPAY POS ACQ27111,,2553252.82,-543003699.34,Board,567,France,55362.45,0,1,0
6698,2011,10,MORTGAGE,3,Low,1,18000, 36 months,1,debt_consolidation,6,Low,1,Good Loan,0,8.9,A,1,20.04,20574.33068,18000,0,571.56,409000006697,27-Nov-18,ICA 17825 Indiaforensic MC DOM 2,,4504947.47,-538498751.87,Leckie,638,France,47675.29,0,1,0
6699,2011,1,RENT,1,Low,1,8325, 36 months,1,debt_consolidation,6,Low,1,Good Loan,0,7.51,A,1,25.2,9322.372329,8325,0,259,409000006698,27-Nov-18,TRF TO  Indiaforensic SERVICES I,"9,700,000.00",,-548198751.87,Ho,725,France,61326.43,0,1,0
6700,2011,0.5,RENT,1,Medium,2,25000, 60 months,2,credit_card,1,Low,1,Bad Loan,1,11.71,B,2,13.77,20572.41,12355.32,1774.31,552.46,409000006699,27-Nov-18,Indiaforensic RUPAY POS C2 ACQ27,,752477.31,-547446274.56,Gordon,709,France,71672.86,0,1,0
6701,2011,0.5,RENT,1,Low,1,7000, 36 months,1,debt_consolidation,6,Low,1,Good Loan,0,7.51,A,1,13.35,7257.94,7000,0,217.78,409000006700,27-Nov-18,Indiaforensic VISA ACQ INT 22111,,3690.04,-547442584.52,Iroawuchi,787,Spain,101168.30,0,1,0
6702,2011,0.5,RENT,1,Low,1,9200, 60 months,2,small_business,3,High,2,Good Loan,0,15.27,C,3,13.93,12929.26263,9200,0,220.18,409000006701,27-Nov-18,Indiaforensic VISA ACQ INT 23111,,9346.56,-547433237.96,Liao,653,France,144880.81,0,1,0
6703,2011,6.05,RENT,1,Low,1,6000, 36 months,1,debt_consolidation,6,Low,1,Good Loan,0,7.9,A,1,28.41,6757.704688,6000,0,187.75,409000006702,27-Nov-18,TRF TO  Indiaforensic SERVICES I,"800,000.00",,-548233237.96,Hamilton,661,Germany,115037.67,0,1,0
6704,2011,10,MORTGAGE,3,Low,1,18825, 36 months,1,debt_consolidation,6,Low,1,Good Loan,0,8.9,A,1,26.69,21066.45313,18825,0,597.76,409000006703,27-Nov-18,Indiaforensic VISA ACQ DOM271118,,6216646.03,-542016591.93,Chimaobim,681,Germany,187280.51,0,1,0
6705,2011,10,MORTGAGE,3,Medium,2,35000, 60 months,2,debt_consolidation,6,Low,1,Good Loan,0,12.42,B,2,26.05,43097.15,35000,0,786.01,409000006704,27-Nov-18,Indiaforensic RUPAY POS ACQ27111,"2,553,252.82",,-544569844.75,Fan,436,Germany,183540.22,0,1,0
6706,2011,10,MORTGAGE,3,Low,1,5000, 36 months,1,home_improvement,7,Low,1,Good Loan,0,9.91,B,2,15.38,5812.83636,5000,0,161.13,409000006705,28-Nov-18,TRF TO  Indiaforensic SERVICES I,"3,000,000.00",,-547569844.75,Cayley,663,France,28531.81,0,1,0
6707,2011,4,RENT,1,Low,1,8400, 36 months,1,medical,9,High,2,Good Loan,0,17.27,D,4,20.06,10811.52536,8400,0,300.62,409000006706,28-Nov-18,TRF TO  Indiaforensic SERVICES I,"500,000.00",,-548069844.75,Kuykendall,662,France,42730.12,0,1,0
6708,2011,4,MORTGAGE,3,Low,1,2500, 36 months,1,other,4,Low,1,Bad Loan,1,11.71,B,2,1.31,822.6,606.05,0,82.69,409000006707,28-Nov-18,ICA 17825 Indiaforensic MC INT 2,,1876.39,-548067968.36,McDonald,607,Germany,104721.50,0,1,0
6709,2011,10,RENT,1,Low,1,5000, 36 months,1,debt_consolidation,6,Low,1,Good Loan,0,7.9,A,1,23.12,5625.643449,5000,0,156.46,409000006708,28-Nov-18,ICA 17825 Indiaforensic MC DOM 2,,4168767.81,-543899200.55,Duncan,754,France,65219.85,0,1,0
6710,2011,9,MORTGAGE,3,Low,1,4200, 36 months,1,debt_consolidation,6,High,2,Good Loan,0,15.27,C,3,22.91,4813.05,4200,0,146.16,409000006709,28-Nov-18,Indiaforensic VISA ACQ DOM281118,,5619451.48,-538279749.07,Browne,850,Germany,118929.64,0,1,0
6711,2011,2,OWN,2,Low,1,8500, 36 months,1,debt_consolidation,6,Low,1,Good Loan,0,7.51,A,1,8.02,9512.133431,8500,0,264.45,409000006710,28-Nov-18,Indiaforensic RUPAY POS ACQ28111,,2475503.03,-535804246.04,Barton,578,France,70563.90,0,1,0
6712,2011,4,MORTGAGE,3,Low,1,6000, 36 months,1,debt_consolidation,6,Low,1,Bad Loan,1,8.9,A,1,13.81,3619.6,2957.46,12.07,190.52,409000006711,28-Nov-18,Indiaforensic VISA ACQ INT 24111,,108844.68,-535695401.36,Boyle,666,Germany,139435.12,0,1,0
6713,2011,6,MORTGAGE,3,Low,1,15350, 36 months,1,debt_consolidation,6,Low,1,Good Loan,0,8.9,A,1,12.68,17180.69,15350,0,487.42,409000006712,28-Nov-18,Indiaforensic VISA ACQ INT 25111,,56310.97,-535639090.39,Moretti,599,France,170347.10,0,1,0
6714,2011,6,RENT,1,Low,1,12000, 36 months,1,debt_consolidation,6,High,2,Good Loan,0,13.49,C,3,19.09,14649.0326,12000,0,407.17,409000006713,28-Nov-18,Indiaforensic VISA ACQ INT 26111,,3144.12,-535635946.27,Ukaegbulam,586,France,131553.82,0,1,0
6715,2011,10,MORTGAGE,3,Low,1,4200, 60 months,2,credit_card,1,Low,1,Good Loan,0,12.69,B,2,24.58,5625.080006,4200,0,94.9,409000006714,28-Nov-18,Indiaforensic RUPAY POS C2 ACQ28,,576674.12,-535059272.15,Nwankwo,825,France,138344.70,0,1,0
6716,2011,3,MORTGAGE,3,Low,1,32350, 60 months,2,debt_consolidation,6,High,2,Bad Loan,1,18.64,E,5,22.9,5228.04,1701.05,1070.19,832.79,409000006715,28-Nov-18,TRF TO  Indiaforensic SERVICES I,"12,600,000.00",,-547659272.15,Niu,808,Spain,169894.40,0,1,0
6717,2011,5,MORTGAGE,3,Low,1,5000, 36 months,1,other,4,Low,1,Good Loan,0,11.71,B,2,23.89,5950.417826,5000,0,165.38,409000006716,28-Nov-18,TRF TO  Indiaforensic SERVICES I,"600,000.00",,-548259272.15,Hsu,515,Spain,9770.97,0,1,0
6718,2011,8,MORTGAGE,3,Medium,2,35000, 60 months,2,debt_consolidation,6,Low,1,Good Loan,0,12.69,B,2,12.79,38814.83,35000,0,790.82,409000006717,29-Nov-18,ICA 17825 Indiaforensic MC INT 2,,36134.95,-548223137.20,Shaw,663,Spain,74176.71,0,1,0
6719,2011,0.5,RENT,1,Low,1,7000, 36 months,1,wedding,5,Low,1,Good Loan,0,7.9,A,1,20.72,7218.76,7000,0,219.04,409000006718,29-Nov-18,Indiaforensic VISA ACQ DOM291118,,6463189.36,-541759947.84,Ho,444,France,112668.06,0,1,0
6720,2011,6,RENT,1,Low,1,2000, 36 months,1,debt_consolidation,6,High,2,Good Loan,0,13.49,C,3,3.47,2371.98,2000,0,67.87,409000006719,29-Nov-18,Indiaforensic RUPAY POS ACQ29111,,2381269.09,-539378678.75,Christie,650,France,186275.70,0,1,0
6721,2011,4,MORTGAGE,3,Medium,2,12000, 36 months,1,medical,9,Low,1,Good Loan,0,6.03,A,1,7.84,12338.83,12000,0,365.23,409000006720,29-Nov-18,Indiaforensic VISA ACQ INT 27111,,1433.83,-539377244.92,Onwuemelie,609,France,98463.99,0,1,0
6722,2011,3,RENT,1,Medium,2,10200, 36 months,1,debt_consolidation,6,Low,1,Good Loan,0,7.51,A,1,7.56,11420.16846,10200,0,317.34,409000006721,29-Nov-18,ICA 17825 Indiaforensic MC DOM 2,,4851716.63,-534525528.29,Ch'ang,824,Germany,2746.41,0,1,0
6723,2011,10,OWN,2,Low,1,15000, 36 months,1,debt_consolidation,6,Low,1,Good Loan,0,7.9,A,1,11.87,16896.09998,15000,0,469.36,409000006722,29-Nov-18,TRF TO  Indiaforensic SERVICES I,"13,700,000.00",,-548225528.29,Clendinnen,662,France,10928.30,0,1,0
6724,2011,10,RENT,1,Low,1,3000, 36 months,1,credit_card,1,Low,1,Bad Loan,1,6.62,A,1,3.67,2000.89,1669.28,76.03,92.12,409000006723,29-Nov-18,Indiaforensic RUPAY POS C2 ACQ29,,596990.04,-547628538.25,Onyemauchechi,699,Germany,91346.03,0,1,0
6725,2011,10,MORTGAGE,3,Low,1,15850, 60 months,2,debt_consolidation,6,Low,1,Good Loan,0,11.71,B,2,28.98,20765.4835,15850,0,350.26,409000006724,29-Nov-18,TRF TO  Indiaforensic SERVICES I,"600,000.00",,-548228538.25,Crawford,752,France,139844.04,0,1,0
6726,2011,10,MORTGAGE,3,Medium,2,16000, 36 months,1,debt_consolidation,6,Low,1,Good Loan,0,6.62,A,1,15.79,17326.97,16000,0,491.26,409000006725,30-Nov-18,Indiaforensic VISA ACQ DOM301118,,5115401.70,-543113136.55,Mellor,603,Germany,105052.90,0,1,0
6727,2011,6,RENT,1,Low,1,24000, 36 months,1,debt_consolidation,6,Low,1,Good Loan,0,7.9,A,1,21.31,25846.85,24000,0,750.97,409000006726,30-Nov-18,Indiaforensic RUPAY POS ACQ30111,,2392021.27,-540721115.28,Rizzo,628,Spain,144366.83,0,1,0
6728,2011,10,MORTGAGE,3,Medium,2,14000, 36 months,1,debt_consolidation,6,Low,1,Good Loan,0,6.62,A,1,0.18,15423.8609,14000,0,429.86,409000006727,30-Nov-18,Indiaforensic VISA ACQ INT 28111,,3552.80,-540717562.48,Christie,745,France,19605.18,0,1,0
6729,2011,10,MORTGAGE,3,High,3,7000, 36 months,1,other,4,Low,1,Good Loan,0,11.71,B,2,11.25,8309.14231,7000,0,231.54,409000006728,30-Nov-18,ICA 17825 Indiaforensic MC DOM 3,,3332083.27,-537385479.21,Watkins,804,Germany,80483.76,0,1,0
6730,2011,0.5,RENT,1,Low,1,5000, 60 months,2,debt_consolidation,6,High,2,Good Loan,0,16.77,D,4,15.38,6231.61,5000,0,123.65,409000006729,30-Nov-18,TRF TO  Indiaforensic SERVICES I,"10,000,000.00",,-547385479.21,Ojiofor,454,Germany,154344.00,0,1,0
6731,2011,10,RENT,1,Low,1,5000, 60 months,2,other,4,High,2,Good Loan,0,13.49,C,3,17.3,6543.346668,5000,0,115.03,409000006730,30-Nov-18,ICA 17825 Indiaforensic MC INT 2,,30956.87,-547354522.34,Tung,631,Spain,93503.02,0,1,0
6732,2011,3,MORTGAGE,3,Low,1,2200, 36 months,1,home_improvement,7,Low,1,Good Loan,0,11.71,B,2,1.02,2304.21,2200,0,72.77,409000006731,30-Nov-18,Indiaforensic RUPAY POS C2 ACQ30,,677021.33,-546677501.01,McKay,503,France,153036.97,0,1,0
6733,2011,10,RENT,1,Low,1,7000, 36 months,1,vacation,11,Low,1,Bad Loan,1,6.03,A,1,13.99,2064.78,1785.47,0,213.05,409000006732,30-Nov-18,TRF TO  Indiaforensic SERVICES I,"800,000.00",,-547477501.01,Meng,548,France,98029.58,0,1,0
6734,2011,5,RENT,1,Low,1,11000, 60 months,2,car,2,High,2,Good Loan,0,19.42,E,5,23.12,14655.46,8594.09,0,287.9,409000006733,1-Dec-18,Indiaforensic VISA ACQ DOM011218,,5296020.90,-542181480.11,Hussain,668,France,193018.71,0,1,0
6735,2011,10,MORTGAGE,3,Medium,2,7200, 36 months,1,credit_card,1,Low,1,Good Loan,0,9.91,B,2,5.6,8344.821416,7200,0,232.02,409000006734,1-Dec-18,TRF TO  Indiaforensic SERVICES I,"3,000,000.00",,-545181480.11,Mactier,619,France,60810.64,0,1,0
6736,2011,0.5,MORTGAGE,3,Low,1,8400, 60 months,2,home_improvement,7,High,2,Good Loan,0,14.27,C,3,10.03,10645.15,8400,0,196.64,409000006735,1-Dec-18,TRF TO  Indiaforensic SERVICES I,"3,000,000.00",,-548181480.11,Hsueh,842,France,87071.18,0,1,0
6737,2011,10,MORTGAGE,3,Low,1,1900, 36 months,1,debt_consolidation,6,Low,1,Good Loan,0,7.51,A,1,19.27,2127.68,1900,0,59.12,409000006736,1-Dec-18,Indiaforensic RUPAY POS ACQ01121,,2655105.43,-545526374.68,Nnachetam,707,France,164064.44,0,1,0
6738,2011,7,RENT,1,Low,1,35000, 60 months,2,small_business,3,High,2,Good Loan,0,14.65,C,3,10.08,36818.91,35000,0,826.24,409000006737,1-Dec-18,TRF TO  Indiaforensic SERVICES I,"2,000,000.00",,-547526374.68,Barnes,715,Spain,4554.67,0,1,0
6739,2011,0.5,RENT,1,Low,1,10000, 36 months,1,other,4,Low,1,Good Loan,0,7.9,A,1,5.34,10337.3,10000,0,312.91,409000006738,1-Dec-18,Indiaforensic RUPAY POS C2 ACQ01,,574648.18,-546951726.50,Christie,573,Germany,119924.80,0,1,0
6740,2011,10,MORTGAGE,3,Medium,2,14500, 36 months,1,debt_consolidation,6,Low,1,Good Loan,0,8.9,A,1,12.58,16017.48,14500,0,460.43,409000006739,3-Dec-18,TRF TO  Indiaforensic SERVICES I,"1,300,000.00",,-548251726.50,Lipton,509,France,170360.11,0,1,0
6741,2011,10,MORTGAGE,3,Low,1,9100, 36 months,1,house,12,Low,1,Good Loan,0,6.03,A,1,14.66,9970.331856,9100,0,276.97,409000006740,3-Dec-18,Indiaforensic RUPAY POS ACQ02121,,1223406.70,-547028319.80,Yu,670,Germany,69850.04,0,1,0
6742,2011,0.5,MORTGAGE,3,Low,1,3500, 60 months,2,other,4,Low,1,Good Loan,0,11.71,B,2,10.23,3936.45,2831.74,0,77.35,409000006741,3-Dec-18,ICA 17825 Indiaforensic MC DOM 0,,13683158.10,-533345161.70,Storey,613,Spain,47298.95,0,1,0
6743,2011,3,RENT,1,Low,1,17000, 36 months,1,debt_consolidation,6,Low,1,Good Loan,0,7.51,A,1,21.19,19037.93564,17000,0,528.89,409000006742,3-Dec-18,TRF TO  Indiaforensic SERVICES I,"14,900,000.00",,-548245161.70,Read,678,France,45443.68,0,1,0
6744,2011,2,RENT,1,Low,1,3000, 36 months,1,other,4,Low,1,Good Loan,0,8.9,A,1,16.6,3427.773792,3000,0,95.26,409000006743,3-Dec-18,Indiaforensic VISA ACQ DOM031218,,11949030.72,-536296130.98,Levy,555,Germany,198715.27,0,1,0
6745,2011,0.5,RENT,1,Low,1,12600, 60 months,2,debt_consolidation,6,High,2,Bad Loan,1,18.64,E,5,9.29,14965.93,8404.23,0,324.37,409000006744,3-Dec-18,Indiaforensic RUPAY POS ACQ03121,,4440936.91,-531855194.07,Chiu,777,France,115611.97,0,1,0
6746,2011,10,RENT,1,Medium,2,30000, 60 months,2,other,4,Low,1,Good Loan,0,9.91,B,2,1.88,32440.03,24504.67,0,636.09,409000006745,3-Dec-18,Indiaforensic RUPAY POS C2 ACQ03,,712882.36,-531142311.71,Moore,552,Spain,40333.94,0,1,0
6747,2011,4,RENT,1,Low,1,2200, 36 months,1,major_purchase,8,Low,1,Good Loan,0,5.99,A,1,11,2397.12,2200,0,66.92,409000006746,3-Dec-18,Indiaforensic VISA ACQ INT 29111,,53600.51,-531088711.20,Amies,640,Spain,105997.25,0,1,0
6748,2011,10,MORTGAGE,3,Low,1,26375, 60 months,2,debt_consolidation,6,High,2,Good Loan,0,14.65,C,3,16.54,27645.13,26375,0,622.63,409000006747,3-Dec-18,TRF TO  Indiaforensic SERVICES I,"15,000,000.00",,-546088711.20,Tsao,541,France,134851.12,0,1,0
6749,2011,1,RENT,1,Medium,2,25600, 36 months,1,credit_card,1,Low,1,Good Loan,0,12.69,B,2,15.72,26913.95,25600,0,858.75,409000006748,3-Dec-18,TRF TO  Indiaforensic SERVICES I,"1,400,000.00",,-547488711.20,Rowley,756,France,61666.87,0,1,0
6750,2011,1,RENT,1,Low,1,9600, 36 months,1,debt_consolidation,6,Low,1,Good Loan,0,11.71,B,2,20.4,9961.27,9600,0,317.53,409000006749,3-Dec-18,ICA 17825 Indiaforensic MC INT 3,,1011.62,-547487699.58,Aliyev,684,Spain,196574.48,0,1,0
6751,2011,5,RENT,1,Low,1,35000, 60 months,2,major_purchase,8,Low,1,Good Loan,0,12.42,B,2,14.2,46364.40682,35000,0,786.01,409000006750,4-Dec-18,TRF TO  Indiaforensic SERVICES I,"700,000.00",,-548187699.58,Riley,618,France,111097.39,0,1,0
6752,2011,7,MORTGAGE,3,Low,1,7200, 36 months,1,debt_consolidation,6,Low,1,Good Loan,0,6.62,A,1,8.11,7939.086655,7200,0,221.07,409000006751,4-Dec-18,Indiaforensic VISA ACQ DOM041218,,4492757.27,-543694942.31,Toscano,604,France,48201.64,0,1,0
6753,2011,0.5,RENT,1,Low,1,12000, 36 months,1,other,4,Low,1,Good Loan,0,6.62,A,1,13.92,12804.76,12000,0,368.45,409000006752,4-Dec-18,Indiaforensic RUPAY POS ACQ04121,,1904177.82,-541790764.49,Oluchukwu,624,Spain,135096.78,0,1,0
6754,2011,2,RENT,1,Medium,2,15000, 36 months,1,wedding,5,Low,1,Good Loan,0,12.42,B,2,8.79,17958.743,15000,0,501.23,409000006753,4-Dec-18,TRF TO  Indiaforensic SERVICES I,"6,400,000.00",,-548190764.49,Fu,661,Spain,15650.89,0,1,0
6755,2011,1,RENT,1,Low,1,10000, 36 months,1,credit_card,1,Low,1,Good Loan,0,11.71,B,2,21.46,11039.27,10000,0,330.76,409000006754,4-Dec-18,ICA 17825 Indiaforensic MC DOM 0,,3198798.74,-544991965.75,Warner,627,Spain,34097.22,0,1,0
6756,2011,7,MORTGAGE,3,Low,1,7600, 36 months,1,debt_consolidation,6,Low,1,Good Loan,0,6.03,A,1,19.84,7638.62,7600,0,231.32,409000006755,4-Dec-18,TRF TO  Indiaforensic SERVICES I,"3,200,000.00",,-548191965.75,Fleming,812,Spain,174822.74,0,1,0
6757,2011,3,MORTGAGE,3,Low,1,29300, 60 months,2,major_purchase,8,Low,1,Good Loan,0,12.42,B,2,2.05,32687.59,29300,0,658,409000006756,4-Dec-18,ICA 17825 Indiaforensic MC INT 0,,36068.76,-548155896.99,Ch'iu,473,France,85937.52,0,1,0
6758,2011,0.5,RENT,1,Low,1,19600, 60 months,2,debt_consolidation,6,Low,1,Good Loan,0,12.42,B,2,22.99,25624.43362,19600,0,440.17,409000006757,4-Dec-18,Indiaforensic RUPAY POS C2 ACQ04,,315809.94,-547840087.05,Langler,717,Spain,49185.57,0,1,0
6759,2011,1,RENT,1,Low,1,15000, 36 months,1,small_business,3,Low,1,Bad Loan,1,11.71,B,2,10.71,9398.35,6824.81,484.25,496.14,409000006758,4-Dec-18,Indiaforensic VISA ACQ INT 30111,,4893.02,-547835194.03,Angelo,693,Spain,77742.38,0,1,0
6760,2011,7,OWN,2,Low,1,14800, 60 months,2,debt_consolidation,6,High,2,Good Loan,0,13.49,C,3,8.82,17004.46,11585.35,0,340.47,409000006759,4-Dec-18,Indiaforensic RUPAY POS C2 ACQ03,,712882.35,-547122311.68,T'ien,705,France,34436.83,0,1,0
6761,2011,2,MORTGAGE,3,Low,1,3000, 36 months,1,debt_consolidation,6,Low,1,Good Loan,0,7.9,A,1,22.58,3378.544367,3000,0,93.88,409000006760,4-Dec-18,Indiaforensic RUPAY POS C2 ACQ03,"712,882.36",,-547835194.04,Milani,661,France,88279.60,0,1,0
6762,2011,1,RENT,1,Low,1,4000, 36 months,1,debt_consolidation,6,Low,1,Good Loan,0,12.42,B,2,11.53,4590.22,4000,0,133.67,409000006761,5-Dec-18,Indiaforensic VISA ACQ DOM051218,,5712862.99,-542122331.05,Pye,573,France,157549.60,0,1,0
6763,2011,1,RENT,1,Low,1,15000, 36 months,1,debt_consolidation,6,High,2,Good Loan,0,14.65,C,3,9.88,18616.79935,15000,0,517.42,409000006762,5-Dec-18,Indiaforensic RUPAY POS ACQ05121,,2305327.72,-539817003.33,Asher,639,France,173386.95,0,1,0
6764,2011,2,MORTGAGE,3,Low,1,6000, 36 months,1,credit_card,1,Low,1,Good Loan,0,8.9,A,1,3.97,6324.6,6000,0,190.52,409000006763,5-Dec-18,ICA 17825 Indiaforensic MC DOM 0,,4436153.72,-535380849.61,Chung,718,France,82782.08,0,1,0
6765,2011,10,MORTGAGE,3,Medium,2,25600, 60 months,2,debt_consolidation,6,Low,1,Good Loan,0,12.42,B,2,18.04,34124.75,25600,0,574.91,409000006764,5-Dec-18,TRF TO  Indiaforensic SERVICES I,"12,800,000.00",,-548180849.61,Yudin,570,France,187758.50,0,1,0
6766,2011,3,MORTGAGE,3,Low,1,15000, 36 months,1,debt_consolidation,6,Low,1,Good Loan,0,8.9,A,1,19.1,17143.96484,15000,0,476.3,409000006765,5-Dec-18,ICA 17825 Indiaforensic MC INT 0,,20392.14,-548160457.47,Arcuri,461,France,176547.80,0,1,0
6767,2011,4,OWN,2,Low,1,15000, 36 months,1,credit_card,1,Low,1,Good Loan,0,6.03,A,1,13.3,16167.84,15000,0,456.54,409000006766,5-Dec-18,Indiaforensic VISA ACQ INT 01121,,157021.85,-548003435.62,Capon,638,Germany,56585.20,0,1,0
6768,2011,5,RENT,1,Low,1,20000, 60 months,2,debt_consolidation,6,High,2,Good Loan,0,13.49,C,3,13.5,23421.84,16058.61,0,460.1,409000006767,5-Dec-18,Indiaforensic VISA ACQ INT 02121,,124116.27,-547879319.35,Piccio,608,Spain,125762.95,0,1,0
6769,2011,2,MORTGAGE,3,Low,1,4000, 36 months,1,debt_consolidation,6,High,2,Good Loan,0,15.27,C,3,20.29,5010.79,4000,0,139.2,409000006768,5-Dec-18,Indiaforensic RUPAY POS C2 ACQ05,,651814.48,-547227504.87,Lung,599,Spain,113868.40,0,1,0
6770,2011,9,MORTGAGE,3,Low,1,3000, 36 months,1,wedding,5,Low,1,Good Loan,0,10.65,B,2,20.6,3478.59,3000,0,97.72,409000006769,5-Dec-18,Indiaforensic RUPAY POS ACQ05121,,2305327.73,-544922177.14,Trevisan,762,France,24780.13,0,1,0
6771,2011,2,RENT,1,Low,1,17000, 60 months,2,debt_consolidation,6,Low,1,Good Loan,0,10.99,B,2,15.41,21150.75562,17000,0,369.54,409000006770,5-Dec-18,Indiaforensic RUPAY POS ACQ05121,"2,305,327.72",,-547227504.86,John,662,France,120259.41,0,1,0
6772,2011,4,RENT,1,Low,1,18000, 36 months,1,debt_consolidation,6,High,2,Good Loan,0,14.65,C,3,21.88,21789.45,18000,0,620.9,409000006771,6-Dec-18,ICA 17825 Indiaforensic MC DOM 0,,4358449.18,-542869055.68,Anayolisa,747,Germany,175398.34,0,1,0
6773,2011,1,RENT,1,Low,1,9000, 36 months,1,debt_consolidation,6,Low,1,Good Loan,0,12.69,B,2,10.67,10759.22076,9000,0,301.91,409000006772,6-Dec-18,TRF TO  Indiaforensic SERVICES I,"5,000,000.00",,-547869055.68,Ritchie,539,France,86767.48,0,1,0
6774,2011,4,RENT,1,Low,1,3825, 36 months,1,debt_consolidation,6,High,2,Good Loan,0,14.27,C,3,24.68,4652.99,3825,0,131.24,409000006773,6-Dec-18,Indiaforensic VISA ACQ DOM061218,,6318103.53,-541550952.15,Ch'eng,625,France,71216.60,0,1,0
6775,2011,4,RENT,1,Low,1,14000, 36 months,1,debt_consolidation,6,Low,1,Good Loan,0,7.9,A,1,4.17,15768.69741,14000,0,438.07,409000006774,6-Dec-18,Indiaforensic RUPAY POS ACQ06121,,2860987.12,-538689965.03,Macleod,656,France,85240.61,0,1,0
6776,2011,3,MORTGAGE,3,Low,1,4000, 60 months,2,other,4,High,2,Good Loan,0,16.77,D,4,10.74,5022.8,3157.5,0,98.92,409000006775,6-Dec-18,Indiaforensic VISA ACQ INT 04121,,2036.35,-538687928.68,Boyle,469,France,160529.71,0,1,0
6777,2011,3,RENT,1,Low,1,6000, 36 months,1,small_business,3,Low,1,Good Loan,0,7.9,A,1,18.86,6757.704688,6000,0,187.75,409000006776,6-Dec-18,TRF TO  Indiaforensic SERVICES I,"9,500,000.00",,-548187928.68,Chukwuemeka,621,Spain,102806.60,0,1,0
6778,2011,6.05,RENT,1,Low,1,2350, 36 months,1,moving,10,Low,1,Good Loan,0,9.91,B,2,6.75,2635.1,2350,0,75.73,409000006777,6-Dec-18,ICA 17825 Indiaforensic MC INT 0,,34076.18,-548153852.50,Bryant,754,France,144134.64,0,1,0
6779,2011,0.5,MORTGAGE,3,Low,1,3500, 36 months,1,other,4,Low,1,Bad Loan,1,7.9,A,1,22.04,1857.08,1546.2,0,109.52,409000006778,6-Dec-18,Indiaforensic RUPAY POS C2 ACQ06,,601594.35,-547552258.15,Hackett,679,Germany,184017.98,0,1,0
6780,2011,2,MORTGAGE,3,Low,1,8000, 36 months,1,debt_consolidation,6,High,2,Good Loan,0,17.27,D,4,9.32,10018.95,8000,0,286.3,409000006779,7-Dec-18,ICA 17825 Indiaforensic MC DOM 0,,4802557.18,-542749700.97,Kovaleva,535,France,195896.59,0,1,0
6781,2011,10,OWN,2,Low,1,1000, 36 months,1,medical,9,Low,1,Good Loan,0,9.91,B,2,7.46,1157.036769,1000,0,32.23,409000006780,7-Dec-18,Indiaforensic VISA ACQ DOM071218,,5952941.04,-536796759.93,Reed,487,France,126722.57,0,1,0
6782,2011,0.5,RENT,1,Low,1,12000, 36 months,1,debt_consolidation,6,Low,1,Good Loan,0,9.91,B,2,5.23,13917.90482,12000,0,386.7,409000006781,7-Dec-18,Indiaforensic RUPAY POS ACQ07121,,2381605.31,-534415154.62,Major,850,France,176883.42,0,1,0
6783,2011,5,MORTGAGE,3,Low,1,2400, 36 months,1,home_improvement,7,Low,1,Good Loan,0,12.69,B,2,20.4,2895.868551,2400,0,80.51,409000006782,7-Dec-18,TRF TO  Indiaforensic SERVICES I,"13,800,000.00",,-548215154.62,Lo,585,France,122960.98,0,1,0
6784,2011,0.5,MORTGAGE,3,Low,1,6100, 36 months,1,medical,9,Low,1,Bad Loan,1,8.9,A,1,22.2,5306.83,4234.48,260.56,193.7,409000006783,7-Dec-18,ICA 17825 Indiaforensic MC INT 0,,4838.59,-548210316.03,Hanson,603,France,9607.10,0,1,0
6785,2011,10,MORTGAGE,3,Low,1,6000, 36 months,1,debt_consolidation,6,Low,1,Good Loan,0,12.69,B,2,22.94,7242.008262,6000,0,201.27,409000006784,7-Dec-18,Indiaforensic RUPAY POS C2 ACQ07,,795570.20,-547414745.83,Ogbonnaya,728,Germany,152643.48,0,1,0
6786,2011,10,MORTGAGE,3,Low,1,15000, 36 months,1,debt_consolidation,6,High,2,Good Loan,0,13.49,C,3,17.87,18310.67547,15000,0,508.96,409000006785,10-Dec-18,Indiaforensic VISA ACQ DOM081218,,6164581.32,-541250164.51,Windsor,621,Spain,95551.22,0,1,0
6787,2011,3,RENT,1,Low,1,12000, 36 months,1,car,2,Low,1,Good Loan,0,6.62,A,1,14.25,13262.98399,12000,0,368.45,409000006786,10-Dec-18,Indiaforensic RUPAY POS ACQ08121,,3195098.96,-538055065.55,Calabrese,833,France,141860.62,0,1,0
6788,2011,4,MORTGAGE,3,Low,1,15950, 60 months,2,car,2,Low,1,Good Loan,0,8.9,A,1,2.7,16152.9,15950,0,330.33,409000006787,10-Dec-18,Indiaforensic RUPAY POS ACQ09121,,3140022.67,-534915042.88,Keating,502,France,76642.68,0,1,0
6789,2011,8,MORTGAGE,3,Low,1,8000, 36 months,1,debt_consolidation,6,Low,1,Bad Loan,1,6.62,A,1,21.51,1715.91,1431.12,0,245.63,409000006788,10-Dec-18,ICA 17825 Indiaforensic MC DOM 1,,14926188.87,-519988854.01,Costa,825,Germany,52301.15,0,1,0
6790,2011,0.5,RENT,1,Low,1,4000, 60 months,2,debt_consolidation,6,High,2,Bad Loan,1,19.03,E,5,12.75,179.57,0,179.57,103.83,409000006789,10-Dec-18,TRF TO  Indiaforensic SERVICES I,"10,000,000.00",,-529988854.01,Tan,668,France,29388.02,0,1,0
6791,2011,10,MORTGAGE,3,Low,1,25000, 60 months,2,house,12,High,2,Good Loan,0,17.58,D,4,0.94,34087.28968,25000,0,629.14,409000006790,10-Dec-18,TRF TO  Indiaforensic SERVICES I,"3,000,000.00",,-532988854.01,Ma,487,Spain,193408.43,0,1,0
6792,2011,8,RENT,1,Low,1,7000, 36 months,1,debt_consolidation,6,High,2,Good Loan,0,13.49,C,3,19.63,8123.83,7000,0,237.52,409000006791,10-Dec-18,TRF TO  Indiaforensic SERVICES I,"15,000,000.00",,-547988854.01,Martin,600,Germany,58632.37,0,1,0
6793,2011,5,MORTGAGE,3,Medium,2,25000, 36 months,1,major_purchase,8,Low,1,Good Loan,0,7.9,A,1,10.77,26825.68,25000,0,782.26,409000006792,10-Dec-18,Indiaforensic VISA ACQ DOM101218,,12098346.17,-535890507.84,Halpern,606,Spain,191076.22,0,1,0
6794,2011,2,RENT,1,Low,1,7000, 36 months,1,medical,9,High,2,Bad Loan,1,14.65,C,3,12.13,1855.39,794.55,649.29,241.46,409000006793,10-Dec-18,TRF TO  Indiaforensic SERVICES I,"10,000,000.00",,-545890507.84,Nyhan,623,Germany,645.61,0,1,0
6795,2011,10,MORTGAGE,3,High,3,20000, 60 months,2,debt_consolidation,6,High,2,Good Loan,0,17.27,D,4,4.81,25447.66,15783.02,0,499.96,409000006794,10-Dec-18,ICA 17825 Indiaforensic MC INT 0,,18060.13,-545872447.71,Jackson,575,France,144390.75,0,1,0
6796,2011,1,RENT,1,Low,1,3000, 36 months,1,wedding,5,High,2,Good Loan,0,14.27,C,3,18.19,3702.242811,3000,0,102.93,409000006795,10-Dec-18,Indiaforensic RUPAY POS ACQ10121,,3148757.68,-542723690.03,Reynolds,577,Spain,193580.32,0,1,0
6797,2011,6,RENT,1,Medium,2,14000, 36 months,1,house,12,Low,1,Good Loan,0,6.03,A,1,7.35,14882.52,14000,0,426.1,409000006796,10-Dec-18,Indiaforensic RUPAY POS C2 ACQ10,,736858.78,-541986831.25,Tai,651,France,126761.20,0,1,0
6798,2011,10,RENT,1,Medium,2,8000, 36 months,1,other,4,Low,1,Good Loan,0,6.62,A,1,4.4,8285.2,8000,0,245.63,409000006797,11-Dec-18,TRF TO  Indiaforensic SERVICES I,"5,000,000.00",,-546986831.25,Trevisani,693,Germany,62368.33,0,1,0
6799,2011,10,RENT,1,Low,1,35000, 60 months,2,small_business,3,High,2,Good Loan,0,17.27,D,4,26.32,47410.84157,35000,0,874.93,409000006798,11-Dec-18,TRF TO  Indiaforensic SERVICES I,"1,000,000.00",,-547986831.25,Uwakwe,800,France,131718.12,0,1,0
6800,2011,6.05,RENT,1,Low,1,5000, 36 months,1,other,4,Low,1,Good Loan,0,8.9,A,1,7.89,5651.79,5000,0,158.77,409000006799,11-Dec-18,ICA 17825 Indiaforensic MC DOM 1,,4708779.92,-543278051.33,Kerr,760,France,91098.76,0,1,0
6801,2011,8,MORTGAGE,3,Medium,2,18000, 60 months,2,debt_consolidation,6,Low,1,Good Loan,0,11.71,B,2,8.24,20394.17,17999.99,0,397.77,409000006800,11-Dec-18,TRF TO  Indiaforensic SERVICES I,"4,900,000.00",,-548178051.33,Findlay,711,France,67508.01,0,1,0
6802,2011,7,RENT,1,Low,1,10000, 36 months,1,debt_consolidation,6,High,2,Good Loan,0,14.27,C,3,10.97,12349.41741,10000,0,343.09,409000006801,11-Dec-18,Indiaforensic VISA ACQ DOM111218,,6243888.06,-541934163.27,Ugorji,637,Spain,12156.93,0,1,0
6803,2011,4,MORTGAGE,3,Low,1,11000, 36 months,1,debt_consolidation,6,Low,1,Good Loan,0,6.62,A,1,0.81,12105.91251,11000,0,337.75,409000006802,11-Dec-18,Indiaforensic RUPAY POS ACQ11121,,1402223.24,-540531940.03,Balashova,662,France,65089.38,0,1,0
6804,2011,5,OWN,2,Low,1,8000, 36 months,1,debt_consolidation,6,Low,1,Good Loan,0,10.65,B,2,24.5,9231.77,8000,0,260.59,409000006803,11-Dec-18,Indiaforensic VISA ACQ INT 07121,,11716.72,-540520223.31,Cheng,568,France,62370.67,0,1,0
6805,2011,2,OWN,2,Low,1,11000, 36 months,1,debt_consolidation,6,Low,1,Good Loan,0,11.71,B,2,7.8,13090.53384,11000,0,363.84,409000006804,11-Dec-18,TRF TO  Indiaforensic SERVICES I,"4,000,000.00",,-544520223.31,Martin,692,France,18826.34,0,1,0
6806,2011,4,MORTGAGE,3,Low,1,9000, 36 months,1,home_improvement,7,Low,1,Good Loan,0,7.51,A,1,13.09,9691.06,9000,0,280,409000006805,11-Dec-18,TRF TO  Indiaforensic SERVICES I,"3,000,000.00",,-547520223.31,Skinner,614,France,3342.62,0,1,0
6807,2011,6.05,RENT,1,Low,1,12000, 60 months,2,major_purchase,8,High,2,Good Loan,0,17.27,D,4,4.25,15722.58,12000,0,299.98,409000006806,11-Dec-18,Indiaforensic RUPAY POS C2 ACQ11,,2571313.35,-544948909.96,McDonald,478,France,178626.07,0,1,0
6808,2011,4,MORTGAGE,3,Medium,2,2500, 36 months,1,debt_consolidation,6,High,2,Bad Loan,1,15.27,C,3,9.57,1062,664.25,0,87,409000006807,11-Dec-18,ICA 17825 Indiaforensic MC INT 0,,64308.53,-544884601.43,Dellucci,562,France,32845.32,0,1,0
6809,2011,4,RENT,1,Low,1,12000, 36 months,1,credit_card,1,Low,1,Good Loan,0,6.03,A,1,11.3,12811.29,12000,0,365.23,409000006808,12-Dec-18,TRF TO  Indiaforensic SERVICES I,"3,300,000.00",,-548184601.43,Reynolds,709,Germany,134732.99,0,1,0
6810,2011,4,RENT,1,Low,1,10000, 36 months,1,debt_consolidation,6,Low,1,Good Loan,0,11.99,B,2,24.84,11111.53,10000,0,332.1,409000006809,12-Dec-18,ICA 17825 Indiaforensic MC DOM 1,,5524227.49,-542660373.94,Birdsall,684,France,106095.82,0,1,0
6811,2011,7,MORTGAGE,3,Low,1,10000, 36 months,1,home_improvement,7,Low,1,Good Loan,0,9.91,B,2,8.12,10882.97,10000.01,0,322.25,409000006810,12-Dec-18,Indiaforensic VISA ACQ DOM121218,,6493784.36,-536166589.58,Tsai,546,Germany,57380.13,0,1,0
6812,2011,4,RENT,1,Low,1,15000, 36 months,1,debt_consolidation,6,Low,1,Good Loan,0,8.9,A,1,1.92,16863.85,15000,0,476.3,409000006811,12-Dec-18,Indiaforensic RUPAY POS ACQ12121,,2716816.87,-533449772.71,Oguejiofor,779,France,25951.91,0,1,0
6813,2011,3,RENT,1,Low,1,3000, 36 months,1,debt_consolidation,6,Low,1,Good Loan,0,12.69,B,2,3.12,3467.18,3000,0,100.64,409000006812,12-Dec-18,Indiaforensic VISA ACQ INT 08121,,123739.63,-533326033.08,Mackie,576,Germany,69414.13,0,1,0
6814,2011,7,OWN,2,Low,1,1200, 36 months,1,vacation,11,Low,1,Good Loan,0,6.62,A,1,7.51,1326.118168,1200,0,36.85,409000006813,12-Dec-18,Indiaforensic VISA ACQ INT 09121,,1530.35,-533324502.73,Jamieson,481,Germany,96123.72,0,1,0
6815,2011,6.05,MORTGAGE,3,Low,1,20000, 60 months,2,debt_consolidation,6,Low,1,Good Loan,0,12.42,B,2,7.46,24880.88567,20000,0,449.15,409000006814,12-Dec-18,Indiaforensic VISA ACQ INT 10121,,100825.03,-533223677.70,Mai,445,France,119425.94,0,1,0
6816,2011,0.5,RENT,1,Low,1,14400, 36 months,1,debt_consolidation,6,Low,1,Good Loan,0,9.91,B,2,15.17,16459.02,14400,0,464.04,409000006815,12-Dec-18,TRF TO  Indiaforensic SERVICES I,"5,000,000.00",,-538223677.70,Patterson,606,Spain,120138.27,0,1,0
6817,2011,3,RENT,1,Low,1,15000, 36 months,1,wedding,5,Low,1,Good Loan,0,6.62,A,1,10.73,15953.08,15000,0,460.56,409000006816,12-Dec-18,TRF TO  Indiaforensic SERVICES I,"5,000,000.00",,-543223677.70,Taylor,559,France,150548.50,0,1,0
6818,2011,8,MORTGAGE,3,Low,1,10000, 36 months,1,small_business,3,Low,1,Good Loan,0,6.03,A,1,5.14,10951.83458,10000,0,304.36,409000006817,12-Dec-18,TRF TO  Indiaforensic SERVICES I,"4,000,000.00",,-547223677.70,Vinogradoff,608,France,142492.04,0,1,0
6819,2011,0.5,MORTGAGE,3,Low,1,30750, 60 months,2,credit_card,1,Low,1,Good Loan,0,11.71,B,2,24.21,34642.36,24914.01,0,679.52,409000006818,12-Dec-18,Indiaforensic RUPAY POS C2 ACQ12,,637958.84,-546585718.86,North,698,France,14357.00,0,1,0
6820,2011,4,MORTGAGE,3,Low,1,13300, 60 months,2,credit_card,1,High,2,Good Loan,0,19.91,E,5,15.18,16176.25,13300,0,351.71,409000006819,12-Dec-18,ICA 17825 Indiaforensic MC INT 1,,2513.95,-546583204.91,Carter,568,Spain,129569.92,0,1,0
6821,2011,6,MORTGAGE,3,Low,1,12800, 36 months,1,debt_consolidation,6,Low,1,Good Loan,0,6.62,A,1,11.77,14131.44049,12800,0,393.01,409000006820,13-Dec-18,TRF TO  Indiaforensic SERVICES I,"1,600,000.00",,-548183204.91,Graham,528,France,55972.56,0,1,0
6822,2011,7,MORTGAGE,3,Low,1,9000, 60 months,2,debt_consolidation,6,High,2,Good Loan,0,14.27,C,3,17.96,9107.72,9000,0,210.68,409000006821,13-Dec-18,ICA 17825 Indiaforensic MC DOM 1,,4753047.52,-543430157.39,Noble,802,France,59497.01,0,1,0
6823,2011,10,MORTGAGE,3,Medium,2,14000, 60 months,2,debt_consolidation,6,High,2,Bad Loan,1,16.77,D,4,9.5,4153.76,1943.64,17.6,346.21,409000006822,13-Dec-18,TRF TO  Indiaforensic SERVICES I,"4,800,000.00",,-548230157.39,Walker,669,Germany,181928.25,0,1,0
6824,2011,10,RENT,1,Low,1,8000, 36 months,1,debt_consolidation,6,High,2,Good Loan,0,13.49,C,3,14.79,9764.74634,8000,0,271.45,409000006823,13-Dec-18,Indiaforensic VISA ACQ DOM131218,,5223193.70,-543006963.69,Chibugo,581,Spain,102517.83,0,1,0
6825,2011,5,MORTGAGE,3,Low,1,9350, 36 months,1,other,4,Low,1,Good Loan,0,6.62,A,1,4.97,10333.42233,9350,0,287.08,409000006824,13-Dec-18,Indiaforensic RUPAY POS ACQ13121,,2503052.32,-540503911.37,Yobachi,640,France,88827.67,0,1,0
6826,2011,10,OWN,2,Low,1,7500, 36 months,1,credit_card,1,Low,1,Good Loan,0,12.69,B,2,12.11,8583.63,7500,0,251.59,409000006825,13-Dec-18,Indiaforensic RUPAY POS C2 ACQ13,,512063.58,-539991847.79,Ignatyeva,529,Spain,14161.30,0,1,0
6827,2011,10,MORTGAGE,3,Low,1,11200, 36 months,1,debt_consolidation,6,Low,1,Good Loan,0,12.42,B,2,14.54,13464.28329,11200,0,374.26,409000006826,13-Dec-18,Indiaforensic VISA ACQ INT 11121,,105619.60,-539886228.19,Chiemela,547,France,56908.41,0,1,0
6828,2011,6,RENT,1,Low,1,2975, 36 months,1,debt_consolidation,6,Low,1,Good Loan,0,7.9,A,1,3.54,3218.62,2975,0,93.09,409000006827,13-Dec-18,TRF TO  Indiaforensic SERVICES I,"8,300,000.00",,-548186228.19,Pokrovskaya,718,France,184474.72,0,1,0
6829,2011,7,MORTGAGE,3,Low,1,5000, 36 months,1,medical,9,Low,1,Bad Loan,1,11.71,B,2,6.19,4500.77,3322.11,240.15,165.38,409000006828,13-Dec-18,ICA 17825 Indiaforensic MC INT 1,,1007.64,-548185220.55,Storey,707,Germany,94912.78,0,1,0
6830,2011,0.5,MORTGAGE,3,Low,1,9000, 36 months,1,credit_card,1,Low,1,Good Loan,0,12.69,B,2,17.76,10057.37,9000,0,301.91,409000006829,14-Dec-18,ICA 17825 Indiaforensic MC DOM 1,,5113900.31,-543071320.24,Moroney,735,France,73069.59,0,1,0
6831,2011,3,RENT,1,Low,1,11000, 60 months,2,debt_consolidation,6,High,2,Bad Loan,1,17.58,D,4,20.46,2481.75,1099.95,0,276.83,409000006830,14-Dec-18,Indiaforensic VISA ACQ DOM141218,,6045909.33,-537025410.91,Maslov,765,France,136602.80,0,1,0
6832,2011,7,MORTGAGE,3,Low,1,16000, 60 months,2,debt_consolidation,6,High,2,Good Loan,0,13.49,C,3,11.1,18743.24,12849.22,0,368.08,409000006831,14-Dec-18,Indiaforensic RUPAY POS ACQ14121,,1472903.16,-535552507.75,Chukwueloka,469,Germany,150093.32,0,1,0
6833,2011,3,MORTGAGE,3,Low,1,21000, 60 months,2,credit_card,1,High,2,Bad Loan,1,18.64,E,5,13.81,10682.85,4407.53,965.55,540.61,409000006832,14-Dec-18,Indiaforensic RUPAY POS C2 ACQ14,,2114789.95,-533437717.80,Chu,594,Germany,168186.11,0,1,0
6834,2011,1,MORTGAGE,3,Low,1,18000, 60 months,2,debt_consolidation,6,High,2,Bad Loan,1,19.91,E,5,23.28,17604.91,8957.28,0,475.99,409000006833,14-Dec-18,Indiaforensic VISA ACQ INT 12121,,710.42,-533437007.38,Spence,675,France,146230.63,0,1,0
6835,2011,7,OWN,2,Medium,2,5000, 36 months,1,car,2,Low,1,Good Loan,0,10.65,B,2,5.04,5861.159406,5000,0,162.87,409000006834,14-Dec-18,TRF T  Indiaforensic SERVICES IN,"5,000,000.00",,-538437007.38,Mills,703,France,79314.10,0,1,0
6836,2011,2,MORTGAGE,3,Medium,2,35000, 60 months,2,debt_consolidation,6,High,2,Good Loan,0,18.64,E,5,10.53,44272.45,35000,0,901.01,409000006835,14-Dec-18,TRF TO  Indiaforensic SERVICES I,"9,800,000.00",,-548237007.38,Doyle,810,France,77965.67,0,1,0
6837,2011,2,RENT,1,Low,1,5000, 36 months,1,debt_consolidation,6,Low,1,Good Loan,0,8.9,A,1,12.71,5713.859502,5000,0,158.77,409000006836,14-Dec-18,ICA 17825 Indiaforensic MC DOM 1,700.9,,-548237708.28,Donnelly,715,Spain,128745.69,0,1,0
6838,2011,2,MORTGAGE,3,Low,1,20125, 60 months,2,debt_consolidation,6,Low,1,Good Loan,0,10.65,B,2,27.29,25120.22137,20125,0,434.07,409000006837,14-Dec-18,ICA 17825 Indiaforensic MC INT 1,,2723.15,-548234985.13,Tai,664,France,194767.30,0,1,0
6839,2011,10,RENT,1,Low,1,4200, 36 months,1,moving,10,Low,1,Good Loan,0,9.91,B,2,18.26,4859.007793,4200,0,135.35,409000006838,15-Dec-18,Indiaforensic VISA ACQ DOM151218,,6091213.26,-542143771.87,Abbott,850,France,10672.54,0,1,0
6840,2011,0.5,RENT,1,Low,1,4800, 36 months,1,debt_consolidation,6,Low,1,Good Loan,0,7.9,A,1,16.17,5402.921987,4800,0,150.2,409000006839,15-Dec-18,Indiaforensic RUPAY POS ACQ15121,,2863225.36,-539280546.51,Perez,724,Germany,10627.21,0,1,0
6841,2011,4,MORTGAGE,3,Medium,2,28000, 60 months,2,debt_consolidation,6,High,2,Good Loan,0,14.27,C,3,14.25,33867.44,28000,0,655.44,409000006840,15-Dec-18,TRF TO  Indiaforensic SERVICES I,"2,000,000.00",,-541280546.51,Hsiung,563,France,122268.75,0,1,0
6842,2011,10,MORTGAGE,3,Low,1,25000, 60 months,2,debt_consolidation,6,Low,1,Good Loan,0,10.65,B,2,6.88,29332.18,25000,0,539.21,409000006841,15-Dec-18,TRF TO  Indiaforensic SERVICES I,"3,000,000.00",,-544280546.51,Cherkasova,714,Germany,65482.94,0,1,0
6843,2011,3,MORTGAGE,3,Low,1,5100, 36 months,1,car,2,Low,1,Good Loan,0,7.9,A,1,9.2,5733.764111,5100,0,159.59,409000006842,15-Dec-18,TRF TO  Indiaforensic SERVICES I,"3,000,000.00",,-547280546.51,Denisov,614,France,146134.68,0,1,0
6844,2011,5,RENT,1,Medium,2,15600, 60 months,2,home_improvement,7,High,2,Good Loan,0,19.91,E,5,7.69,21025.87,12171.76,0,412.53,409000006843,15-Dec-18,Indiaforensic RUPAY POS C2 ACQ15,,766128.04,-546514418.47,Fowler,740,France,123300.38,0,1,0
6845,2011,2,RENT,1,Low,1,20000, 36 months,1,debt_consolidation,6,Low,1,Good Loan,0,7.9,A,1,16.53,21990.16,20000,0,625.81,409000006844,17-Dec-18,TRF TO  Indiaforensic SERVICES I,"1,000,000.00",,-547514418.47,Siciliano,587,France,122925.40,0,1,0
6846,2011,10,MORTGAGE,3,Low,1,30000, 36 months,1,debt_consolidation,6,Low,1,Good Loan,0,7.9,A,1,5.94,32595.9,30000,0,938.71,409000006845,17-Dec-18,TRF TO  Indiaforensic SERVICES I,"500,000.00",,-548014418.47,Crocker,465,Germany,127744.02,0,1,0
6847,2011,6,MORTGAGE,3,Low,1,12000, 60 months,2,debt_consolidation,6,Low,1,Good Loan,0,9.91,B,2,15.08,14909.91432,12000,0,254.44,409000006846,17-Dec-18,Indiaforensic VISA ACQ DOM171218,,9768546.91,-538245871.56,Longo,689,Spain,118319.50,0,1,0
6848,2011,0.5,RENT,1,Low,1,12000, 36 months,1,debt_consolidation,6,Low,1,Good Loan,0,7.9,A,1,8.86,13514.14281,12000,0,375.49,409000006847,17-Dec-18,Indiaforensic RUPAY POS ACQ16121,,2029086.36,-536216785.20,Polyakova,656,France,17104.00,0,1,0
6849,2011,8,OWN,2,Low,1,35000, 60 months,2,debt_consolidation,6,High,2,Good Loan,0,13.49,C,3,19.09,44781.31691,35000,0,805.17,409000006848,17-Dec-18,Indiaforensic RUPAY POS ACQ17121,,2452224.36,-533764560.84,Brown,579,France,164608.98,0,1,0
6850,2011,7,MORTGAGE,3,Low,1,16000, 36 months,1,debt_consolidation,6,Low,1,Good Loan,0,6.03,A,1,15.05,17530.23886,16000,0,486.97,409000006849,17-Dec-18,Indiaforensic VISA ACQ INT 13121,,53166.18,-533711394.66,Uspensky,716,France,152108.47,0,1,0
6851,2011,7,MORTGAGE,3,Medium,2,28250, 36 months,1,debt_consolidation,6,High,2,Good Loan,0,16.77,D,4,6.19,36129.79021,28250,0,1003.96,409000006850,17-Dec-18,ICA 17825 Indiaforensic MC DOM 1,,12202546.59,-521508848.07,O'Meara,551,France,23399.58,0,1,0
6852,2011,8,RENT,1,Low,1,20000, 60 months,2,debt_consolidation,6,High,2,Good Loan,0,18.25,D,4,23.14,23686.2,19999.99,0,510.6,409000006851,17-Dec-18,TRF TO  Indiaforensic SERVICES I,"5,000,000.00",,-526508848.07,Cantamessa,527,Germany,94711.43,0,1,0
6853,2011,3,MORTGAGE,3,Low,1,16000, 36 months,1,house,12,Low,1,Good Loan,0,6.62,A,1,5.55,17682.93558,16000,0,491.26,409000006852,17-Dec-18,TRF TO  Indiaforensic SERVICES I,"5,000,000.00",,-531508848.07,Alexander,600,France,7312.25,0,1,0
6854,2011,10,MORTGAGE,3,Medium,2,5000, 36 months,1,medical,9,Low,1,Good Loan,0,6.03,A,1,7.07,5477.972786,5000,0,152.18,409000006853,17-Dec-18,TRF TO  Indiaforensic SERVICES I,"14,500,000.00",,-546008848.07,Chinagorom,685,France,41876.98,0,1,0
6855,2011,7,RENT,1,Low,1,18950, 36 months,1,debt_consolidation,6,High,2,Good Loan,0,15.96,C,3,18,23712.26202,18950,0,665.86,409000006854,17-Dec-18,TRF TO  Indiaforensic SERVICES I,"2,000,000.00",,-548008848.07,Tomlinson,738,Spain,96881.32,0,1,0
6856,2011,0.5,MORTGAGE,3,Low,1,12000, 36 months,1,home_improvement,7,High,2,Bad Loan,1,16.77,D,4,14.29,10150.19,6593.9,768.31,426.47,409000006855,17-Dec-18,Indiaforensic RUPAY POS C2 ACQ17,,401144.87,-547607703.20,Lo,622,France,102402.91,0,1,0
6857,2011,0.5,RENT,1,Low,1,1800, 36 months,1,major_purchase,8,High,2,Good Loan,0,14.27,C,3,7.22,1935.53,1800,0,61.76,409000006856,17-Dec-18,ICA 17825 Indiaforensic MC INT 1,,3067.68,-547604635.52,Nwachukwu,528,France,176763.27,0,1,0
6858,2011,0.5,RENT,1,Medium,2,30000, 60 months,2,debt_consolidation,6,High,2,Good Loan,0,16.77,D,4,21.69,41276.56832,30000,0,741.88,409000006857,18-Dec-18,TRF TO  Indiaforensic SERVICES I,"500,000.00",,-548104635.52,Yang,546,Germany,23548.45,0,1,0
6859,2011,6.05,RENT,1,Low,1,2500, 36 months,1,debt_consolidation,6,Low,1,Good Loan,0,6.62,A,1,19.86,2761.837087,2500,0,76.76,409000006858,18-Dec-18,Indiaforensic VISA ACQ DOM181218,,4231262.18,-543873373.34,Bage,576,Germany,33450.11,0,1,0
6860,2011,7,MORTGAGE,3,Low,1,25000, 60 months,2,debt_consolidation,6,Low,1,Bad Loan,1,10.65,B,2,13.97,13204.71,6495.34,2587.36,539.21,409000006859,18-Dec-18,Indiaforensic RUPAY POS ACQ18121,,1912891.07,-541960482.27,Marcelo,733,France,19658.43,0,1,0
6861,2011,9,MORTGAGE,3,Low,1,8000, 60 months,2,debt_consolidation,6,High,2,Good Loan,0,22.74,G,7,4.28,11434.06,6157.49,0,224.34,409000006860,18-Dec-18,Indiaforensic VISA ACQ INT 14121,,4325.64,-541956156.63,Ofodile,727,Germany,104678.78,0,1,0
6862,2011,1,RENT,1,Low,1,28000, 60 months,2,credit_card,1,Low,1,Good Loan,0,10.65,B,2,14.05,31957.26,28000,0,603.92,409000006861,18-Dec-18,TRF TO  Indiaforensic SERVICES I,"3,000,000.00",,-544956156.63,Savage,605,Spain,143203.78,0,1,0
6863,2011,9,MORTGAGE,3,Low,1,5000, 36 months,1,home_improvement,7,Low,1,Bad Loan,1,7.51,A,1,13.28,1686.82,373.6,1222.06,155.56,409000006862,18-Dec-18,TRF TO  Indiaforensic SERVICES I,"3,000,000.00",,-547956156.63,Piccio,586,France,6975.02,0,1,0
6864,2011,10,MORTGAGE,3,High,3,35000, 60 months,2,home_improvement,7,Low,1,Good Loan,0,12.69,B,2,10.59,46763.18715,35000,0,790.82,409000006863,18-Dec-18,ICA 17825 Indiaforensic MC DOM 1,,2917130.39,-545039026.24,Simmons,564,Spain,153771.80,0,1,0
6865,2011,2,MORTGAGE,3,Medium,2,4200, 36 months,1,home_improvement,7,Low,1,Good Loan,0,12.69,B,2,6.35,4411.03,4200,0,140.89,409000006864,18-Dec-18,ICA 17825 Indiaforensic MC INT 1,,9648.88,-545029377.36,DeRose,593,Germany,85902.39,0,1,0
6866,2011,10,RENT,1,Low,1,25875, 60 months,2,debt_consolidation,6,High,2,Bad Loan,1,22.06,F,6,15.18,18535.18,6427.44,2804.74,715.53,409000006865,18-Dec-18,TRF TO  Indiaforensic SERVICES I,"3,000,000.00",,-548029377.36,Onuchukwu,736,Germany,188037.76,0,1,0
6867,2011,2,RENT,1,Low,1,1500, 36 months,1,debt_consolidation,6,High,2,Good Loan,0,19.03,E,5,16.76,1977.793495,1500,0,55.01,409000006866,18-Dec-18,Indiaforensic RUPAY POS C2 ACQ18,,406733.51,-547622643.85,Goodwin,675,Spain,52710.70,0,1,0
6868,2011,7,RENT,1,Low,1,15250, 60 months,2,debt_consolidation,6,Low,1,Bad Loan,1,12.69,B,2,22.83,5855.91,3377.76,0,344.57,409000006867,19-Dec-18,TRF TO  Indiaforensic SERVICES I,"600,000.00",,-548222643.85,Teakle,656,Spain,17034.37,0,1,0
6869,2011,5,RENT,1,Low,1,4000, 36 months,1,debt_consolidation,6,High,2,Good Loan,0,16.29,D,4,6.42,5082.304217,4000,0,141.21,409000006868,19-Dec-18,Indiaforensic VISA ACQ DOM191218,,4092845.05,-544129798.80,Thomson,462,France,131304.45,0,1,0
6870,2011,10,MORTGAGE,3,Medium,2,15000, 60 months,2,medical,9,High,2,Good Loan,0,17.58,D,4,14.55,18834.07,11477.88,0,377.49,409000006869,19-Dec-18,Indiaforensic RUPAY POS ACQ19121,,1826756.70,-542303042.10,Cross,685,Spain,172576.43,0,1,0
6871,2011,0.5,RENT,1,Low,1,15000, 60 months,2,major_purchase,8,Low,1,Good Loan,0,11.71,B,2,11.88,19392.39522,15000,0,331.48,409000006870,19-Dec-18,Indiaforensic VISA ACQ INT 15121,,93198.65,-542209843.45,Jones,850,Germany,99019.65,0,1,0
6872,2011,3,RENT,1,Low,1,6000, 60 months,2,other,4,Low,1,Good Loan,0,9.91,B,2,9.52,6487.66,4900.75,0,127.22,409000006871,19-Dec-18,Indiaforensic VISA ACQ INT 17121,,610.91,-542209232.54,Walker,636,Germany,190160.04,0,1,0
6873,2011,8,RENT,1,Low,1,12000, 36 months,1,credit_card,1,Low,1,Good Loan,0,6.03,A,1,14.22,13147.78198,12000,0,365.23,409000006872,19-Dec-18,ICA 17825 Indiaforensic MC DOM 1,,3115189.54,-539094043.00,De Salis,850,France,3025.49,0,1,0
6874,2011,0.5,MORTGAGE,3,Low,1,10625, 36 months,1,small_business,3,Low,1,Good Loan,0,6.62,A,1,16.89,11742.67708,10625,0,326.23,409000006873,19-Dec-18,TRF TO  Indiaforensic SERVICES I,"4,000,000.00",,-543094043.00,Oliver,628,France,34689.77,0,1,0
6875,2011,5,MORTGAGE,3,Low,1,10000, 36 months,1,debt_consolidation,6,Low,1,Good Loan,0,12.69,B,2,5.83,11380.6,10000,0,335.45,409000006874,19-Dec-18,TRF TO  Indiaforensic SERVICES I,"4,000,000.00",,-547094043.00,Lo Duca,798,France,2305.27,0,1,0
6876,2011,0.5,RENT,1,Low,1,5500, 36 months,1,debt_consolidation,6,High,2,Good Loan,0,14.65,C,3,12.98,6826.667297,5500,0,189.72,409000006875,19-Dec-18,TRF TO  Indiaforensic SERVICES I,"1,000,000.00",,-548094043.00,Brookes,610,France,113228.82,0,1,0
6877,2011,4,RENT,1,Low,1,3500, 36 months,1,debt_consolidation,6,High,2,Good Loan,0,13.49,C,3,22.97,4217.725103,3500,0,118.76,409000006876,19-Dec-18,Indiaforensic RUPAY POS C2 ACQ19,,542293.70,-547551749.30,Challis,591,France,171099.22,0,1,0
6878,2011,10,MORTGAGE,3,Low,1,5000, 36 months,1,home_improvement,7,Low,1,Good Loan,0,6.62,A,1,21.03,5525.000737,5000,0,153.52,409000006877,19-Dec-18,ICA 17825 Indiaforensic MC DOM 1,120.89,,-547551870.19,Ibeabuchi,614,Spain,62023.10,0,1,0
6879,2011,5,RENT,1,Low,1,6200, 36 months,1,other,4,Low,1,Good Loan,0,12.42,B,2,7.9,7363.81,6200,0,207.18,409000006878,20-Dec-18,TRF TO  Indiaforensic SERVICES I,"500,000.00",,-548051870.19,Iroawuchi,651,France,36923.67,0,1,0
6880,2011,0.5,RENT,1,Low,1,3000, 36 months,1,small_business,3,Low,1,Good Loan,0,7.9,A,1,14.86,3378.353935,3000,0,93.88,409000006879,20-Dec-18,ICA 17825 Indiaforensic MC DOM 2,,4163409.55,-543888460.64,Tyler,665,France,112256.57,0,1,0
6881,2011,0.5,OWN,2,Low,1,5000, 60 months,2,debt_consolidation,6,High,2,Good Loan,0,18.25,D,4,4.18,6488.59,3923.25,0,127.65,409000006880,20-Dec-18,TRF TO  Indiaforensic SERVICES I,"4,000,000.00",,-547888460.64,Fan,570,France,198830.98,0,1,0
6882,2011,1,RENT,1,Low,1,16000, 60 months,2,debt_consolidation,6,High,2,Good Loan,0,18.64,E,5,20.31,24315.42,16000,0,411.89,409000006881,20-Dec-18,Indiaforensic VISA ACQ DOM201218,,4899447.75,-542989012.89,Bates,631,Spain,197963.46,0,1,0
6883,2011,1,RENT,1,Low,1,6000, 36 months,1,medical,9,Low,1,Good Loan,0,11.71,B,2,17.33,6171.22,6000,0,198.46,409000006882,20-Dec-18,Indiaforensic RUPAY POS ACQ20121,,1704722.12,-541284290.77,Marsden,586,France,31635.99,0,1,0
6884,2011,5,MORTGAGE,3,Medium,2,30000, 60 months,2,other,4,High,2,Good Loan,0,15.96,C,3,0,38208.96,30000,0,728.91,409000006883,20-Dec-18,Indiaforensic RUPAY POS C2 ACQ20,,873351.90,-540410938.87,Dodgshun,691,France,49594.02,0,1,0
6885,2011,10,MORTGAGE,3,Medium,2,6000, 36 months,1,home_improvement,7,Low,1,Good Loan,0,11.71,B,2,21.49,7140.311199,6000,0,198.46,409000006884,20-Dec-18,Indiaforensic VISA ACQ INT 18121,,2819.35,-540408119.52,Maclean,639,France,170483.90,0,1,0
6886,2011,3,MORTGAGE,3,Medium,2,15000, 36 months,1,debt_consolidation,6,High,2,Bad Loan,1,14.27,C,3,17.43,2052.84,1365.44,0,514.64,409000006885,20-Dec-18,TRF TO  Indiaforensic SERVICES I,"7,800,000.00",,-548208119.52,Blackall,698,France,40339.90,0,1,0
6887,2011,10,MORTGAGE,3,Low,1,6800, 60 months,2,debt_consolidation,6,High,2,Bad Loan,1,15.27,C,3,20.27,7160.56,4441.34,29.4,162.74,409000006886,20-Dec-18,ICA 17825 Indiaforensic MC INT 1,,21903.41,-548186216.11,Mazzanti,733,Germany,3218.71,0,1,0
6888,2011,5,RENT,1,High,3,15000, 60 months,2,debt_consolidation,6,High,2,Good Loan,0,20.3,E,5,8.62,21624.60303,15000,0,399.92,409000006887,21-Dec-18,Indiaforensic VISA ACQ DOM211218,,3850979.79,-544335236.32,Amadi,850,France,68569.89,0,1,0
6889,2011,10,MORTGAGE,3,Low,1,19500, 60 months,2,home_improvement,7,High,2,Bad Loan,1,13.49,C,3,16.9,1343.97,694.98,0,448.6,409000006888,21-Dec-18,Indiaforensic RUPAY POS ACQ21121,,1498692.61,-542836543.71,Schoenheimer,618,France,29176.04,0,1,0
6890,2011,10,MORTGAGE,3,Low,1,25000, 60 months,2,debt_consolidation,6,Low,1,Good Loan,0,10.65,B,2,19.18,30784.57526,25000,0,539.21,409000006889,21-Dec-18,Indiaforensic VISA ACQ INT 19121,,49031.83,-542787511.88,Fiorentino,473,France,46758.42,0,1,0
6891,2011,10,MORTGAGE,3,Low,1,13800, 36 months,1,other,4,High,2,Good Loan,0,13.49,C,3,6.6,16847.42375,13800,0,468.25,409000006890,21-Dec-18,TRF TO  Indiaforensic SERVICES I,"5,000,000.00",,-547787511.88,Murray,490,France,171060.01,0,1,0
6892,2011,0.5,MORTGAGE,3,Low,1,2400, 36 months,1,home_improvement,7,Low,1,Good Loan,0,11.71,B,2,3.55,2856.788691,2400,0,79.39,409000006891,21-Dec-18,Indiaforensic RUPAY POS C2 ACQ21,,555897.26,-547231614.62,Fan,754,Germany,93550.53,0,1,0
6893,2011,10,RENT,1,Low,1,12500, 60 months,2,debt_consolidation,6,High,2,Bad Loan,1,13.49,C,3,22.58,4018.7,2212.02,0,287.56,409000006892,21-Dec-18,ICA 17825 Indiaforensic MC INT 2,,22689.02,-547208925.60,Cartwright,649,France,89405.26,0,1,0
6894,2011,1,RENT,1,Low,1,1400, 36 months,1,medical,9,High,2,Good Loan,0,14.27,C,3,3.05,1727.816531,1400,0,48.04,409000006893,21-Dec-18,TRF TO  Indiaforensic SERVICES I,"1,000,000.00",,-548208925.60,Cremonesi,578,France,169804.40,0,1,0
6895,2011,5,RENT,1,Low,1,14125, 60 months,2,medical,9,High,2,Good Loan,0,14.27,C,3,22.62,16844.95,11308.51,0,330.65,409000006894,24-Dec-18,ICA 17825 Indiaforensic MC DOM 2,,3326102.65,-544882822.95,White,690,Spain,83253.05,0,1,0
6896,2011,9,MORTGAGE,3,Low,1,12000, 36 months,1,debt_consolidation,6,Low,1,Good Loan,0,6.03,A,1,8.8,12571.93,12000,0,365.23,409000006895,24-Dec-18,ICA 17825 Indiaforensic MC DOM 2,,7999198.35,-536883624.60,Sabbatini,610,Germany,195813.81,0,1,0
6897,2011,10,OWN,2,Low,1,17000, 60 months,2,small_business,3,Low,1,Good Loan,0,10.65,B,2,13.02,18650.61,13809.49,0,366.67,409000006896,24-Dec-18,TRF TO  Indiaforensic SERVICES I,"2,000,000.00",,-538883624.60,Patterson,596,France,121568.37,0,1,0
6898,2011,3,OWN,2,Low,1,24000, 60 months,2,other,4,High,2,Good Loan,0,18.64,E,5,14.6,36534.54007,24000,0,617.83,409000006897,24-Dec-18,Indiaforensic POS VIS SETTL22121,,3387670.54,-535495954.06,Bromley,492,France,92144.09,0,1,0
6899,2011,4,RENT,1,Low,1,7000, 60 months,2,other,4,High,2,Good Loan,0,15.27,C,3,22.75,9323.787351,7000,0,167.53,409000006898,24-Dec-18,Indiaforensic POS VIS SETTL24121,,6547693.55,-528948260.51,Doherty,575,Spain,126307.25,0,1,0
6900,2011,5,MORTGAGE,3,Medium,2,12000, 60 months,2,debt_consolidation,6,High,2,Good Loan,0,17.58,D,4,19.46,16847.05148,12000,0,301.99,409000006899,24-Dec-18,Indiaforensic RUP ACQ SETL 22121,,1984011.06,-526964249.45,Ifeatu,569,France,130784.20,0,1,0
6901,2011,1,RENT,1,Low,1,4000, 36 months,1,wedding,5,Low,1,Good Loan,0,10.65,B,2,7.44,4482.21,4000,0,130.3,409000006900,24-Dec-18,Indiaforensic RUP ACQ SETL 23121,,2383057.01,-524581192.44,Bergamaschi,674,Spain,166694.93,0,1,0
6902,2011,6,RENT,1,Low,1,6000, 36 months,1,debt_consolidation,6,Low,1,Good Loan,0,11.71,B,2,19.73,6620.84,6000,0,198.46,409000006901,24-Dec-18,Indiaforensic RUP ACQ SETL 24121,,1849183.91,-522732008.53,Shubina,507,France,44001.11,0,1,0
6903,2011,3,MORTGAGE,3,Low,1,7400, 36 months,1,debt_consolidation,6,Low,1,Good Loan,0,7.51,A,1,14.17,7774,7400,0,230.23,409000006902,24-Dec-18,Indiaforensic POS INTL SETL 2012,,71980.99,-522660027.54,Lung,457,Spain,185992.36,0,1,0
6904,2011,4,RENT,1,Low,1,10000, 60 months,2,debt_consolidation,6,High,2,Good Loan,0,18.25,D,4,20.73,14982.86588,10000,0,255.3,409000006903,24-Dec-18,TRF TO  Indiaforensic SERVICES I,"1,000,000.00",,-523660027.54,Kinder,584,Germany,178997.89,0,1,0
6905,2011,10,MORTGAGE,3,Low,1,12000, 36 months,1,debt_consolidation,6,Low,1,Good Loan,0,6.03,A,1,5.91,12844.5,12000,0,365.23,409000006904,24-Dec-18,TRF TO  Indiaforensic SERVICES I,"15,000,000.00",,-538660027.54,Terry,744,Germany,141558.04,0,1,0
6906,2011,2,RENT,1,Low,1,14000, 36 months,1,house,12,Low,1,Good Loan,0,10.65,B,2,25.8,15794.52,14000,0,456.03,409000006905,24-Dec-18,TRF TO  Indiaforensic SERVICES I,"2,000,000.00",,-540660027.54,Shepherdson,687,France,47921.22,0,1,0
6907,2011,4,MORTGAGE,3,Low,1,20000, 36 months,1,debt_consolidation,6,Low,1,Good Loan,0,7.9,A,1,14.33,22528.16092,20000,0,625.81,409000006906,24-Dec-18,TRF TO  Indiaforensic SERVICES I,"5,000,000.00",,-545660027.54,Short,688,Spain,104902.68,0,1,0
6908,2011,10,RENT,1,Low,1,23000, 60 months,2,debt_consolidation,6,High,2,Good Loan,0,18.64,E,5,20.51,26089.22,23000,0,592.09,409000006907,24-Dec-18,TRF TO  Indiaforensic SERVICES I,"2,000,000.00",,-547660027.54,Zetticci,519,France,68479.60,0,1,0
6909,2011,4,RENT,1,Low,1,7400, 36 months,1,debt_consolidation,6,Low,1,Good Loan,0,10.65,B,2,5.43,8674.01214,7400,0,241.05,409000006908,24-Dec-18,TRF TO  Indiaforensic SERVICES I,"500,000.00",,-548160027.54,Belov,733,Spain,1271.51,0,1,0
6910,2011,10,MORTGAGE,3,Medium,2,30000, 60 months,2,debt_consolidation,6,Low,1,Good Loan,0,11.71,B,2,16.4,33789.17,24301.2,0,662.95,409000006909,24-Dec-18,ICA 17825 Indiaforensic MC INT 2,,2022.35,-548158005.19,Knight,666,Spain,29346.10,0,1,0
6911,2011,6,MORTGAGE,3,Low,1,7000, 36 months,1,medical,9,High,2,Good Loan,0,18.64,E,5,6.51,9207.920651,7000,0,255.32,409000006910,24-Dec-18,Indiaforensic RUP ACQ C2 SETL 24,,452738.16,-547705267.03,Burson,511,Spain,184118.73,0,1,0
6912,2011,6,MORTGAGE,3,Medium,2,6000, 36 months,1,major_purchase,8,Low,1,Good Loan,0,7.51,A,1,4.74,6710.25325,6000,0,186.67,409000006911,26-Dec-18,Indiaforensic POS VIS SETTL25121,,3004995.21,-544700271.82,Nicholls,705,Germany,96013.50,0,1,0
6913,2011,6,MORTGAGE,3,Low,1,3600, 36 months,1,other,4,High,2,Good Loan,0,13.49,C,3,14.48,4393.946133,3600,0,122.15,409000006912,26-Dec-18,Indiaforensic POS VIS SETTL26121,,2736730.19,-541963541.63,Hs?eh,544,France,103713.93,0,1,0
6914,2011,10,MORTGAGE,3,Low,1,18200, 60 months,2,debt_consolidation,6,High,2,Good Loan,0,20.3,E,5,16.36,24713.08,14165.36,0,485.24,409000006913,26-Dec-18,Indiaforensic RUP ACQ SETL 25121,,757283.45,-541206258.18,Ku,564,France,46632.87,0,1,0
6915,2011,3,RENT,1,Low,1,2500, 60 months,2,debt_consolidation,6,High,2,Good Loan,0,16.77,D,4,20.28,2535,2500,0,61.83,409000006914,26-Dec-18,Indiaforensic RUP ACQ SETL 26121,,2367856.66,-538838401.52,T'ien,702,France,135334.24,0,1,0
6916,2011,2,RENT,1,Low,1,5000, 36 months,1,debt_consolidation,6,Low,1,Good Loan,0,11.71,B,2,14.19,5950.580618,5000,0,165.38,409000006915,26-Dec-18,Indiaforensic RUP ACQ C2 SETL 26,,344005.99,-538494395.53,H?,658,Germany,13482.28,0,1,0
6917,2011,10,RENT,1,Medium,2,6000, 36 months,1,other,4,Low,1,Good Loan,0,7.51,A,1,13.15,6665.99,6000,0,186.67,409000006916,26-Dec-18,Indiaforensic POS INTL SETL 2112,,30632.36,-538463763.17,Vasilieva,654,France,130075.07,0,1,0
6918,2011,2,OWN,2,Low,1,22800, 36 months,1,car,2,Low,1,Good Loan,0,12.69,B,2,4.6,27524.10713,22800,0,764.83,409000006917,26-Dec-18,TRF TO  Indiaforensic SERVICES I,"5,000,000.00",,-543463763.17,Omeokachie,649,Germany,143544.48,0,1,0
6919,2011,3,OWN,2,High,3,32000, 36 months,1,home_improvement,7,Low,1,Good Loan,0,6.62,A,1,3.71,35369.30085,32000,0,982.52,409000006918,26-Dec-18,TRF TO  Indiaforensic SERVICES I,"4,000,000.00",,-547463763.17,Napolitano,597,Spain,187826.11,0,1,0
6920,2011,2,RENT,1,Low,1,20000, 36 months,1,debt_consolidation,6,Low,1,Good Loan,0,7.51,A,1,10.03,22397.69536,20000,0,622.22,409000006919,26-Dec-18,TRF TO  Indiaforensic SERVICES I,"500,000.00",,-547963763.17,Hopwood,782,France,167058.75,0,1,0
6921,2011,5,OWN,2,Low,1,12800, 60 months,2,home_improvement,7,High,2,Good Loan,0,16.77,D,4,19.12,17398.83,12800,0,316.54,409000006920,26-Dec-18,ICA 17825 Indiaforensic MC INT 2,,17447.74,-547946315.43,Bergamaschi,644,France,79928.41,0,1,0
6922,2011,6.05,MORTGAGE,3,Low,1,3600, 36 months,1,other,4,Low,1,Good Loan,0,9.91,B,2,1.77,4174.387262,3600,0,116.01,409000006921,27-Dec-18,Indiaforensic POS VIS SETTL27121,,3356693.91,-544589621.52,Lindeman,679,Spain,6075.36,0,1,0
6923,2011,1,RENT,1,Low,1,20000, 60 months,2,credit_card,1,High,2,Good Loan,0,19.03,E,5,18.14,25817.58,20000,0,519.15,409000006922,27-Dec-18,Indiaforensic RUP ACQ SETL 27121,,1341668.87,-543247952.65,McKinley,678,France,43821.56,0,1,0
6924,2011,4,RENT,1,Low,1,14000, 36 months,1,other,4,Low,1,Good Loan,0,6.03,A,1,27.66,14906.09,14000,0,426.1,409000006923,27-Dec-18,Indiaforensic POS INTL SETL 2312,,3726.64,-543244226.01,Sergeyev,806,France,32125.98,0,1,0
6925,2011,0.5,RENT,1,Low,1,6000, 36 months,1,debt_consolidation,6,High,2,Bad Loan,1,13.49,C,3,23.68,6514.88,5206.06,0,203.59,409000006924,27-Dec-18,Indiaforensic POS INTL SETL 2412,,10487.67,-543233738.34,Sanchez,668,Spain,141679.73,0,1,0
6926,2011,4,MORTGAGE,3,Medium,2,28000, 36 months,1,credit_card,1,Low,1,Good Loan,0,9.99,B,2,15.65,30577.78,28000,0,903.35,409000006925,27-Dec-18,ICA 17825 Indiaforensic MC DOM 2,,5067750.89,-538165987.45,Muomelu,659,Germany,84133.48,0,1,0
6927,2011,10,RENT,1,Medium,2,14000, 36 months,1,house,12,Low,1,Good Loan,0,6.03,A,1,2.37,15120.31,14000,0,426.1,409000006926,27-Dec-18,ICA 17825 Indiaforensic MC INT 2,,5810.29,-538160177.16,Murray,660,France,9692.58,0,1,0
6928,2011,6,RENT,1,Low,1,16000, 60 months,2,debt_consolidation,6,High,2,Good Loan,0,19.03,E,5,16.99,22090.35413,16000,0,415.32,409000006927,27-Dec-18,ICA 17825 Indiaforensic MC DOM 2,,2308212.13,-535851965.03,Ibekwe,601,France,20708.60,0,1,0
6929,2011,7,RENT,1,Low,1,18800, 60 months,2,debt_consolidation,6,High,2,Good Loan,0,14.27,C,3,20.25,23681.97,18800,0,440.08,409000006928,27-Dec-18,TRF TO  Indiaforensic SERVICES I,"10,000,000.00",,-545851965.03,McVey,781,France,85644.06,0,1,0
6930,2011,10,MORTGAGE,3,Low,1,35000, 60 months,2,debt_consolidation,6,High,2,Good Loan,0,13.49,C,3,19.04,45830.48632,35000,0,805.17,409000006929,27-Dec-18,TRF TO  Indiaforensic SERVICES I,"2,400,000.00",,-548251965.03,White,628,Germany,107674.30,0,1,0
6931,2011,10,MORTGAGE,3,Low,1,14000, 36 months,1,credit_card,1,Low,1,Good Loan,0,6.03,A,1,8.02,14724.87,13999.99,0,426.1,409000006930,27-Dec-18,Indiaforensic RUP ACQ C2 SETL 27,,434047.30,-547817917.73,Patterson,751,France,134822.05,0,1,0
6932,2011,0.5,RENT,1,Low,1,4000, 36 months,1,debt_consolidation,6,Low,1,Good Loan,0,7.9,A,1,16.21,4504.689907,4000,0,125.17,409000006931,27-Dec-18,ICA 17825 Indiaforensic MC DOM 2,"42,665.53",,-547860583.26,Mai,531,France,4606.97,0,1,0
6933,2011,0.5,RENT,1,Low,1,5000, 36 months,1,other,4,Low,1,Good Loan,0,10.65,B,2,9.84,5861.059617,5000,0,162.87,409000006932,28-Dec-18,ICA 17825 Indiaforensic MC DOM 2,,2196351.65,-545664231.61,Han,647,France,51362.82,0,1,0
6934,2011,4,MORTGAGE,3,Low,1,4000, 36 months,1,medical,9,Low,1,Good Loan,0,7.9,A,1,7.78,4101.94,4000,0,125.17,409000006933,28-Dec-18,FDRL/INTERNAL FUND TRANSFE,"1,000,000.00",,-546664231.61,Davidson,708,Spain,39704.14,0,1,0
6935,2011,10,RENT,1,Medium,2,5000, 36 months,1,other,4,Low,1,Good Loan,0,12.69,B,2,12.19,5997.568902,5000,0,167.73,409000006934,28-Dec-18,FDRL/INTERNAL FUND TRANSFE,"500,000.00",,-547164231.61,Parkin,550,Spain,195638.13,0,1,0
6936,2011,4,MORTGAGE,3,Low,1,20000, 60 months,2,debt_consolidation,6,High,2,Good Loan,0,20.3,E,5,21.08,28836.83373,20000,0,533.23,409000006935,28-Dec-18,FDRL/INTERNAL FUND TRANSFE,"1,000,000.00",,-548164231.61,McKissick,670,France,86413.11,0,1,0
6937,2011,5,OWN,2,Low,1,12000, 60 months,2,wedding,5,Low,1,Good Loan,0,11.71,B,2,9.72,13510.46,9717.16,0,265.18,409000006936,28-Dec-18,Indiaforensic POS VIS SETTL28121,"18,786.10",,-548183017.71,Horsfall,592,France,116385.24,0,1,0
6938,2011,5,RENT,1,Low,1,5000, 36 months,1,major_purchase,8,Low,1,Good Loan,0,10.65,B,2,16.76,5840.274877,5000,0,162.87,409000006937,28-Dec-18,Indiaforensic RUP ACQ SETL 28121,,1203089.30,-546979928.41,Clapp,589,France,182076.97,0,1,0
6939,2011,6,OWN,2,Low,1,5300, 60 months,2,house,12,High,2,Good Loan,0,16.77,D,4,18.1,6655.45,4183.86,0,131.07,409000006938,28-Dec-18,Indiaforensic RUP ACQ C2 SETL 28,,307124.32,-546672804.09,Azikiwe,725,France,67879.80,0,1,0
6940,2011,10,RENT,1,Low,1,20000, 60 months,2,debt_consolidation,6,High,2,Good Loan,0,13.49,C,3,8.88,23436.88,19999.99,0,460.1,409000006939,28-Dec-18,Indiaforensic POS INTL SETL 2512,,325.83,-546672478.26,Zubarev,570,France,11417.26,0,1,0
6941,2011,1,MORTGAGE,3,Medium,2,12000, 36 months,1,debt_consolidation,6,Low,1,Good Loan,0,12.69,B,2,4.34,12979.06,12000,0,402.54,409000006940,28-Dec-18,Indiaforensic POS INTL SETL 2612,,1059.68,-546671418.58,Pisano,575,France,65998.26,0,1,0
6942,2011,1,RENT,1,Low,1,6000, 36 months,1,debt_consolidation,6,Low,1,Good Loan,0,6.03,A,1,10.28,6195.48,6000,0,182.62,409000006941,28-Dec-18,FDRL/INTERNAL FUND TRANSFE,"500,000.00",,-547171418.58,Coates,501,Germany,114774.35,0,1,0
6943,2011,10,MORTGAGE,3,Low,1,3000, 36 months,1,debt_consolidation,6,Low,1,Bad Loan,1,7.51,A,1,25.01,1204.84,999.47,0,93.34,409000006942,28-Dec-18,FDRL/INTERNAL FUND TRANSFE,"1,000,000.00",,-548171418.58,Trentino,431,Germany,126153.24,0,1,0
6944,2011,4,RENT,1,Low,1,5000, 36 months,1,debt_consolidation,6,High,2,Bad Loan,1,16.29,D,4,16.74,3835.75,2609.67,137.11,176.51,409000006943,28-Dec-18,ICA 17825 Indiaforensic MC INT 2,,18610.44,-548152808.14,MacDonnell,719,Spain,176091.31,0,1,0
6945,2011,0.5,RENT,1,Low,1,3500, 36 months,1,debt_consolidation,6,Low,1,Good Loan,0,12.42,B,2,10.6,4208.90427,3500,0,116.96,409000006944,29-Dec-18,Indiaforensic POS VIS SETTL29121,,6604502.51,-541548305.63,Ermakov,850,Germany,87352.43,0,1,0
6946,2011,3,MORTGAGE,3,Medium,2,5150, 36 months,1,house,12,Low,1,Good Loan,0,6.62,A,1,0.94,5356.88,5150,0,158.13,409000006945,29-Dec-18,Indiaforensic RUP ACQ SETL 29121,,669731.46,-540878574.17,K?,554,Germany,107074.81,0,1,0
6947,2011,4,MORTGAGE,3,Low,1,4800, 36 months,1,credit_card,1,Low,1,Bad Loan,1,10.65,B,2,12.73,3456.62,2718.5,12.38,156.36,409000006946,29-Dec-18,FDRL/INTERNAL FUND TRANSFE,"1,000,000.00",,-541878574.17,Hammonds,418,France,69157.93,0,1,0
6948,2011,0.5,RENT,1,Low,1,13500, 60 months,2,debt_consolidation,6,High,2,Good Loan,0,18.64,E,5,10.85,16221.82,13500,0,347.53,409000006947,29-Dec-18,FDRL/INTERNAL FUND TRANSFE,"1,000,000.00",,-542878574.17,Peppin,715,Spain,149970.59,0,1,0
6949,2011,6.05,MORTGAGE,3,Low,1,7600, 36 months,1,debt_consolidation,6,High,2,Bad Loan,1,16.29,D,4,21.2,2648.95,1451.93,353.05,268.29,409000006948,29-Dec-18,FDRL/INTERNAL FUND TRANSFE,"1,000,000.00",,-543878574.17,Ball,750,Spain,153288.97,0,1,0
6950,2011,6.05,MORTGAGE,3,Medium,2,20000, 36 months,1,home_improvement,7,Low,1,Good Loan,0,7.51,A,1,12.41,22398.16806,20000,0,622.22,409000006949,29-Dec-18,FDRL/INTERNAL FUND TRANSFE,"1,000,000.00",,-544878574.17,Yeh,766,Germany,147700.78,0,1,0
6951,2011,6,RENT,1,Low,1,11875, 36 months,1,medical,9,Low,1,Good Loan,0,10.65,B,2,19.13,13854.45674,11875,0,386.81,409000006950,29-Dec-18,FDRL/INTERNAL FUND TRANSFE,"1,000,000.00",,-545878574.17,L?,652,Spain,188657.97,0,1,0
6952,2011,10,RENT,1,Low,1,21725, 60 months,2,debt_consolidation,6,High,2,Bad Loan,1,18.79,E,5,21.07,4069.48,1375.45,710.02,561.06,409000006951,29-Dec-18,FDRL/INTERNAL FUND TRANSFE,"1,000,000.00",,-546878574.17,Shih,658,France,103764.55,0,1,0
6953,2011,3,RENT,1,Low,1,1400, 36 months,1,wedding,5,High,2,Good Loan,0,15.27,C,3,22.61,1751.95,1400,0,48.72,409000006952,29-Dec-18,FDRL/INTERNAL FUND TRANSFE,"1,000,000.00",,-547878574.17,Greco,659,France,140934.57,0,1,0
6954,2011,2,MORTGAGE,3,Low,1,24625, 60 months,2,debt_consolidation,6,High,2,Good Loan,0,14.65,C,3,25.25,32713.6158,24625,0,581.32,409000006953,29-Dec-18,Indiaforensic RUP ACQ C2 SETL 29,,1272855.20,-546605718.97,Napolitano,574,Germany,15118.20,0,1,0
6955,2011,10,MORTGAGE,3,Low,1,2400, 36 months,1,other,4,Low,1,Good Loan,0,6.03,A,1,14.18,2524.49,2400,0,73.05,409000006954,31-Dec-18,FDRL/INTERNAL FUND TRANSFE,"1,000,000.00",,-547605718.97,Zaytseva,611,France,63202.00,0,1,0
6956,2011,6,MORTGAGE,3,Low,1,20000, 36 months,1,debt_consolidation,6,High,2,Bad Loan,1,15.27,C,3,13.6,19940.36,11722.31,3343.83,695.96,409000006955,31-Dec-18,FDRL/INTERNAL FUND TRANSFE,"500,000.00",,-548105718.97,Genovesi,738,Spain,16081.62,0,1,0
6957,2011,1,RENT,1,Medium,2,10000, 36 months,1,debt_consolidation,6,Low,1,Good Loan,0,12.69,B,2,16.24,11561.53,10000,0,335.45,409000006956,31-Dec-18,ICA 17825 Indiaforensic MC DOM 2,,6378574.93,-541727144.04,Angelo,571,France,523.00,0,1,0
6958,2011,1,RENT,1,Low,1,12000, 36 months,1,credit_card,1,Low,1,Good Loan,0,6.62,A,1,21.07,13262.78986,12000,0,368.45,409000006957,31-Dec-18,Indiaforensic POS VIS SETTL31121,,5371589.67,-536355554.37,Waters,686,France,181757.19,0,1,0
6959,2011,2,RENT,1,Low,1,4800, 36 months,1,car,2,High,2,Good Loan,0,14.65,C,3,2.08,5310.33,4800,0,165.58,409000006958,31-Dec-18,Indiaforensic RUP ACQ SETL 30121,,1526611.51,-534828942.86,Maclean,679,Spain,1173.23,0,1,0
6960,2011,4,RENT,1,Low,1,12000, 36 months,1,debt_consolidation,6,Low,1,Good Loan,0,8.9,A,1,7.52,13706.69275,12000,0,381.04,409000006959,31-Dec-18,Indiaforensic RUP ACQ SETL 31121,,1417714.74,-533411228.12,Seleznyova,617,Spain,86587.37,0,1,0
6961,2011,7,MORTGAGE,3,Medium,2,15000, 36 months,1,debt_consolidation,6,Low,1,Good Loan,0,7.9,A,1,5.29,16810.51172,15000,0,469.36,409000006960,31-Dec-18,Indiaforensic POS INTL SETL 2712,,47423.75,-533363804.37,Fontenot,673,France,109545.56,0,1,0
6962,2011,1,MORTGAGE,3,Low,1,25000, 60 months,2,debt_consolidation,6,Low,1,Good Loan,0,12.42,B,2,19.66,29345.91,25000,0,561.44,409000006961,31-Dec-18,FDRL/INTERNAL FUND TRANSFE,"5,000,000.00",,-538363804.37,Reid,745,France,174431.01,0,1,0
6963,2011,10,RENT,1,Low,1,12000, 36 months,1,debt_consolidation,6,Low,1,Good Loan,0,6.62,A,1,5.47,13271.81686,12000,0,368.45,409000006962,31-Dec-18,FDRL/INTERNAL FUND TRANSFE,"1,000,000.00",,-539363804.37,Fraser,677,Germany,119368.99,0,1,0
6964,2011,10,OWN,2,Low,1,5100, 36 months,1,credit_card,1,Low,1,Good Loan,0,6.03,A,1,12.69,5364.33,5100,0,155.23,409000006963,31-Dec-18,FDRL/INTERNAL FUND TRANSFE,"5,000,000.00",,-544363804.37,Tuan,613,Spain,23315.59,0,1,0
6965,2011,2,RENT,1,Low,1,4800, 36 months,1,debt_consolidation,6,High,2,Bad Loan,1,14.27,C,3,21.88,215.58,0,215.58,164.69,409000006964,31-Dec-18,FDRL/INTERNAL FUND TRANSFE,"500,000.00",,-544863804.37,Howarth,576,France,67539.85,0,1,0
6966,2011,5,RENT,1,Medium,2,10000, 36 months,1,moving,10,High,2,Bad Loan,1,13.49,C,3,7.75,6785.52,5037.87,0,339.31,409000006965,31-Dec-18,FDRL/INTERNAL FUND TRANSFE,"1,000,000.00",,-545863804.37,Davis,584,Spain,185201.58,0,1,0
6967,2011,0.5,MORTGAGE,3,Low,1,10000, 36 months,1,home_improvement,7,Low,1,Good Loan,0,6.62,A,1,6.37,10158.65,10000,0,307.04,409000006966,31-Dec-18,FDRL/INTERNAL FUND TRANSFE,"1,000,000.00",,-546863804.37,Gorbunov,663,France,131827.15,0,1,0
6968,2011,6,MORTGAGE,3,Low,1,12000, 36 months,1,credit_card,1,Low,1,Good Loan,0,7.51,A,1,4.49,13437.54211,12000,0,373.33,409000006967,31-Dec-18,FDRL/INTERNAL FUND TRANSFE,"1,000,000.00",,-547863804.37,Gentry,466,France,10842.46,0,1,0
6969,2011,0.5,MORTGAGE,3,Medium,2,22000, 60 months,2,debt_consolidation,6,High,2,Good Loan,0,17.27,D,4,7.06,30876.6232,22000,0,549.96,409000006968,31-Dec-18,Indiaforensic RUP ACQ C2 SETL 31,,402262.70,-547461541.67,Chiu,510,Germany,23768.01,0,1,0
6970,2011,10,RENT,1,Low,1,7000, 36 months,1,debt_consolidation,6,Low,1,Good Loan,0,9.91,B,2,7.39,7816.99,7000,0,225.58,409000006969,31-Dec-18,FDRL/INTERNAL FUND TRANSFE,"500,000.00",,-547961541.67,Sunderland,619,Spain,117616.29,0,1,0
6971,2011,2,MORTGAGE,3,Low,1,24000, 60 months,2,small_business,3,High,2,Bad Loan,1,13.49,C,3,19.68,28252.75,19327.92,0,552.12,409000006970,1-Jan-19,ICA 17825 Indiaforensic MC INT 2,,77716.07,-547883825.60,Fan,696,Germany,174027.30,0,1,0
6972,2011,3,MORTGAGE,3,Low,1,25000, 60 months,2,debt_consolidation,6,Low,1,Good Loan,0,12.42,B,2,15.89,28615.8,20188.56,0,561.44,409000006971,1-Jan-19,Indiaforensic VISA ACQ DOM010119,,3142999.01,-544740826.59,Parry,554,France,115091.38,0,1,0
6973,2011,0.5,RENT,1,Low,1,24000, 36 months,1,credit_card,1,Low,1,Good Loan,0,7.9,A,1,10.16,26639.23238,24000,0,750.97,409000006972,1-Jan-19,Indiaforensic RUPAY POS ACQ01011,,1364940.69,-543375885.90,Niu,595,France,106340.66,0,1,0
6974,2011,3,MORTGAGE,3,Low,1,3000, 36 months,1,credit_card,1,Low,1,Good Loan,0,7.9,A,1,9.09,3148.57,3000,0,93.88,409000006973,1-Jan-19,FDRL/INTERNAL FUND TRANSFE,"1,000,000.00",,-544375885.90,Zuyev,659,Germany,198103.32,0,1,0
6975,2011,9,RENT,1,Low,1,2000, 36 months,1,vacation,11,High,2,Good Loan,0,14.65,C,3,22.44,2482.512246,2000,0,68.99,409000006974,1-Jan-19,FDRL/INTERNAL FUND TRANSFE,"1,000,000.00",,-545375885.90,Ijendu,662,France,175314.87,0,1,0
6976,2011,3,RENT,1,Low,1,4000, 36 months,1,debt_consolidation,6,Low,1,Good Loan,0,6.62,A,1,7.92,4256.47,4000,0,122.82,409000006975,1-Jan-19,FDRL/INTERNAL FUND TRANSFE,"500,000.00",,-545875885.90,Bird,556,Spain,150679.65,0,1,0
6977,2011,0.5,RENT,1,Low,1,10000, 36 months,1,debt_consolidation,6,Low,1,Good Loan,0,6.62,A,1,13.64,11052.10456,10000,0,307.04,409000006976,1-Jan-19,FDRL/INTERNAL FUND TRANSFE,"1,000,000.00",,-546875885.90,Palmer,701,Spain,110043.88,0,1,0
6978,2011,1,MORTGAGE,3,Low,1,21200, 36 months,1,debt_consolidation,6,Low,1,Good Loan,0,9.91,B,2,25.23,24535.20787,21200,0,683.17,409000006977,1-Jan-19,FDRL/INTERNAL FUND TRANSFE,"1,000,000.00",,-547875885.90,Y?,587,Spain,194890.33,0,1,0
6979,2011,10,RENT,1,Low,1,5600, 36 months,1,credit_card,1,Low,1,Good Loan,0,6.62,A,1,7.71,6154.24,5600,0,171.95,409000006978,1-Jan-19,Indiaforensic RUPAY POS C2 ACQ01,,265417.43,-547610468.47,Nicholson,571,France,112366.98,0,1,0
6980,2011,3,MORTGAGE,3,Medium,2,9800, 36 months,1,other,4,High,2,Good Loan,0,21.28,F,6,24.2,10939.66,9800,0,370.63,409000006979,2-Jan-19,FDRL/INTERNAL FUND TRANSFE,"500,000.00",,-548110468.47,Adams,539,France,167289.82,0,1,0
6981,2011,10,RENT,1,Low,1,1500, 36 months,1,other,4,Low,1,Good Loan,0,6.03,A,1,12.33,1641.39,1500,0,45.66,409000006980,2-Jan-19,ICA 17825 Indiaforensic MC DOM 0,,3898799.15,-544211669.32,Cocci,644,Germany,182099.71,0,1,0
6982,2011,3,MORTGAGE,3,Low,1,28000, 36 months,1,home_improvement,7,High,2,Good Loan,0,15.96,C,3,15.35,35456.32742,28000,0,983.85,409000006981,2-Jan-19,FDRL/INTERNAL FUND TRANSFE,"1,000,000.00",,-545211669.32,Kuo,572,Germany,49373.97,0,1,0
6983,2011,6,OWN,2,Low,1,3600, 60 months,2,other,4,High,2,Bad Loan,1,19.42,E,5,4.14,299.15,35.8,205.35,94.22,409000006982,2-Jan-19,FDRL/INTERNAL FUND TRANSFE,"1,000,000.00",,-546211669.32,Trevisani,753,France,861.40,0,1,0
6984,2011,6.05,RENT,1,Low,1,13275, 36 months,1,debt_consolidation,6,High,2,Bad Loan,1,15.27,C,3,11.64,7855,5140.52,464.97,461.94,409000006983,2-Jan-19,FDRL/INTERNAL FUND TRANSFE,"1,000,000.00",,-547211669.32,Kuo,706,France,81718.37,0,1,0
6985,2011,4,RENT,1,Low,1,30000, 36 months,1,debt_consolidation,6,Low,1,Bad Loan,1,12.69,B,2,18.33,30240.82,24190.82,0,1006.35,409000006984,2-Jan-19,FDRL/INTERNAL FUND TRANSFE,"1,000,000.00",,-548211669.32,H?,588,France,49324.03,0,1,0
6986,2011,4,RENT,1,Low,1,4000, 60 months,2,car,2,High,2,Bad Loan,1,14.27,C,3,2.6,3080.86,1402.66,397.74,93.64,409000006985,2-Jan-19,Indiaforensic VISA ACQ DOM020119,,2202046.44,-546009622.88,Thomson,825,France,9751.03,0,1,0
6987,2011,10,MORTGAGE,3,Low,1,12000, 60 months,2,debt_consolidation,6,Low,1,Good Loan,0,9.91,B,2,10.43,12844.82,12000,0,254.44,409000006986,2-Jan-19,Indiaforensic RUPAY POS ACQ02011,,544263.45,-545465359.43,Knorr,627,Spain,78899.22,0,1,0
6988,2011,1,MORTGAGE,3,Low,1,2400, 36 months,1,credit_card,1,High,2,Good Loan,0,14.27,C,3,21.09,2961.768678,2400,0,82.35,409000006987,2-Jan-19,FDRL/INTERNAL FUND TRANSFE,"1,000,000.00",,-546465359.43,Manfrin,532,France,13889.73,0,1,0
6989,2011,0.5,RENT,1,Low,1,2200, 60 months,2,debt_consolidation,6,High,2,Bad Loan,1,19.42,E,5,11.9,0,0,0,57.58,409000006988,2-Jan-19,FDRL/INTERNAL FUND TRANSFE,"500,000.00",,-546965359.43,Hayes,764,France,11467.38,0,1,0
6990,2011,0.5,RENT,1,Low,1,3500, 36 months,1,medical,9,Low,1,Good Loan,0,11.71,B,2,19.96,4125.9,3500,0,115.77,409000006989,2-Jan-19,FDRL/INTERNAL FUND TRANSFE,"1,000,000.00",,-547965359.43,Shao,700,France,130789.15,0,1,0
6991,2011,10,MORTGAGE,3,Low,1,35000, 60 months,2,debt_consolidation,6,Low,1,Good Loan,0,10.99,B,2,20.79,38775.78,28439.55,0,760.82,409000006990,2-Jan-19,Indiaforensic RUPAY POS C2 ACQ02,,999329.52,-546966029.91,Sinclair,660,France,108665.89,0,1,0
6992,2011,10,MORTGAGE,3,Medium,2,28000, 36 months,1,home_improvement,7,Low,1,Good Loan,0,7.9,A,1,11.69,31538.23945,28000,0,876.13,409000006991,2-Jan-19,Indiaforensic VISA ACQ INT 29121,,428286.17,-546537743.74,Bradshaw,518,Germany,160303.08,0,1,0
6993,2011,7,RENT,1,Low,1,7200, 36 months,1,medical,9,Low,1,Good Loan,0,6.03,A,1,5.26,7850.15,7200,0,219.14,409000006992,2-Jan-19,Indiaforensic VISA ACQ INT 30121,,123176.79,-546414566.95,Castiglione,557,France,115287.99,0,1,0
6994,2011,6,RENT,1,Low,1,8100, 36 months,1,small_business,3,Low,1,Good Loan,0,7.51,A,1,16.4,8151.27,8100,0,252,409000006993,2-Jan-19,Indiaforensic VISA ACQ INT 31121,,3235.10,-546411331.85,Hurst,639,France,139094.12,0,1,0
6995,2011,5,MORTGAGE,3,Low,1,35000, 60 months,2,debt_consolidation,6,High,2,Bad Loan,1,17.27,D,4,20.92,39445.6,23213.09,50.93,874.93,409000006994,3-Jan-19,FDRL/INTERNAL FUND TRANSFE,"500,000.00",,-546911331.85,Adamson,557,France,20515.72,0,1,0
6996,2011,3,MORTGAGE,3,Low,1,15000, 36 months,1,credit_card,1,Low,1,Good Loan,0,6.62,A,1,7.16,16441.93,15000,0,460.56,409000006995,3-Jan-19,FDRL/INTERNAL FUND TRANSFE,"500,000.00",,-547411331.85,James,633,France,36642.65,0,1,0
6997,2011,0.5,RENT,1,Low,1,4500, 36 months,1,medical,9,Low,1,Good Loan,0,7.9,A,1,1.58,4974.91,4500,0,140.81,409000006996,3-Jan-19,ICA 17825 Indiaforensic MC INT 0,,4546.30,-547406785.55,Pavlova,623,Spain,104382.11,0,1,0
6998,2011,3,RENT,1,Low,1,8000, 36 months,1,debt_consolidation,6,Low,1,Good Loan,0,7.9,A,1,14.35,8506.1,8000,0,250.33,409000006997,3-Jan-19,Indiaforensic VISA ACQ DOM030119,,3188045.09,-544218740.46,Davey,611,France,146448.01,0,1,0
6999,2011,3,RENT,1,Low,1,2600, 36 months,1,debt_consolidation,6,Low,1,Good Loan,0,7.9,A,1,7.63,2842.08,2600,0,81.36,409000006998,3-Jan-19,Indiaforensic VISA ACQ INT 01011,,3744.47,-544214995.99,Barrett,666,Spain,166650.90,0,1,0
7000,2011,1,RENT,1,Medium,2,10000, 36 months,1,debt_consolidation,6,Low,1,Good Loan,0,6.03,A,1,15.64,10956.00489,10000,0,304.36,409000006999,3-Jan-19,Indiaforensic RUPAY POS ACQ03011,,1042699.95,-543172296.04,Dolgorukova,521,France,164223.70,0,1,0
7001,2011,10,RENT,1,Low,1,16600, 60 months,2,car,2,High,2,Good Loan,0,17.58,D,4,13.36,23420.41397,16600,0,417.75,409000007000,3-Jan-19,ICA 17825 Indiaforensic MC DOM 0,,2874900.96,-540297395.08,Johnson,775,France,149331.01,0,1,0
7002,2011,5,MORTGAGE,3,Low,1,9000, 36 months,1,major_purchase,8,Low,1,Good Loan,0,6.62,A,1,19.68,9350.57,9000,0,276.34,409000007001,3-Jan-19,FDRL/INTERNAL FUND TRANSFE,"2,000,000.00",,-542297395.08,Manna,681,Germany,73066.72,0,1,0
7003,2011,10,MORTGAGE,3,Low,1,9600, 36 months,1,debt_consolidation,6,High,2,Good Loan,0,15.27,C,3,11.76,12017.94398,9600,0,334.06,409000007002,3-Jan-19,FDRL/INTERNAL FUND TRANSFE,"2,000,000.00",,-544297395.08,Hou,564,Germany,15378.23,0,1,0
7004,2011,8,RENT,1,Low,1,35000, 60 months,2,debt_consolidation,6,Low,1,Good Loan,0,11.49,B,2,8.26,35335.37,35000,0,769.57,409000007003,3-Jan-19,FDRL/INTERNAL FUND TRANSFE,"3,000,000.00",,-547297395.08,Okeke,646,Germany,53072.49,0,1,0
7005,2011,2,RENT,1,Low,1,5375, 36 months,1,debt_consolidation,6,Low,1,Good Loan,0,12.69,B,2,23.38,5645.12,5375,0,180.31,409000007004,3-Jan-19,Indiaforensic RUPAY POS C2 ACQ03,,382738.61,-546914656.47,Kodilinyechukwu,670,France,3159.15,0,1,0
7006,2011,4,OWN,2,Low,1,14000, 60 months,2,debt_consolidation,6,Low,1,Good Loan,0,8.9,A,1,14.91,17291.06,14000,0,289.94,409000007005,4-Jan-19,FDRL/INTERNAL FUND TRANSFE,"1,000,000.00",,-547914656.47,Esposito,751,France,125920.54,0,1,0
7007,2011,10,MORTGAGE,3,Medium,2,15000, 60 months,2,debt_consolidation,6,Low,1,Good Loan,0,10.65,B,2,13.95,18576.20977,15000,0,323.53,409000007006,4-Jan-19,ICA 17825 Indiaforensic MC INT 0,,6214.41,-547908442.06,Boyle,544,France,124113.04,0,1,0
7008,2011,6,RENT,1,Low,1,7000, 36 months,1,wedding,5,Low,1,Good Loan,0,9.91,B,2,17.07,8118.176857,7000,0,225.58,409000007007,4-Jan-19,ICA 17825 Indiaforensic MC DOM 0,,1830147.12,-546078294.94,Hsiung,639,France,93716.38,0,1,0
7009,2011,0.5,RENT,1,Low,1,15000, 60 months,2,major_purchase,8,Low,1,Bad Loan,1,12.42,B,2,0.6,12454.02,8130.75,0,336.86,409000007008,4-Jan-19,FDRL/INTERNAL FUND TRANSFE,"1,000,000.00",,-547078294.94,Kennedy,635,Germany,155799.86,0,1,0
7010,2011,2,MORTGAGE,3,Low,1,16000, 60 months,2,car,2,Low,1,Good Loan,0,12.42,B,2,22.18,16678.68,16000,0,359.32,409000007009,4-Jan-19,FDRL/INTERNAL FUND TRANSFE,"1,000,000.00",,-548078294.94,Norton,672,France,8814.69,0,1,0
7011,2011,8,RENT,1,Low,1,3350, 36 months,1,debt_consolidation,6,Low,1,Good Loan,0,7.9,A,1,25.57,3621.83,3350,0,104.83,409000007010,4-Jan-19,Indiaforensic VISA ACQ DOM040119,,2730292.95,-545348001.99,Zakharov,639,France,164453.98,0,1,0
7012,2011,4,MORTGAGE,3,Low,1,9000, 36 months,1,debt_consolidation,6,High,2,Bad Loan,1,15.96,C,3,5.89,7756.99,5177.48,536.64,316.24,409000007011,4-Jan-19,Indiaforensic RUPAY POS ACQ04011,,1104356.48,-544243645.51,Chimaraoke,697,France,87803.32,0,1,0
7013,2011,4,RENT,1,Low,1,12800, 36 months,1,debt_consolidation,6,Low,1,Good Loan,0,7.9,A,1,15.26,13294.85,12800,0,400.52,409000007012,4-Jan-19,Indiaforensic VISA ACQ INT 02011,,74423.46,-544169222.05,Small,850,Spain,183617.32,0,1,0
7014,2011,2,MORTGAGE,3,Low,1,14825, 36 months,1,debt_consolidation,6,Low,1,Good Loan,0,6.03,A,1,13.08,16240.94016,14825,0,451.21,409000007013,4-Jan-19,FDRL/INTERNAL FUND TRANSFE,"1,000,000.00",,-545169222.05,McGregor,748,France,53584.03,0,1,0
7015,2011,10,MORTGAGE,3,Low,1,28600, 60 months,2,credit_card,1,High,2,Good Loan,0,22.06,F,6,12.83,38880.43,28600,0,790.88,409000007014,4-Jan-19,FDRL/INTERNAL FUND TRANSFE,"1,000,000.00",,-546169222.05,Brown,463,Spain,1950.93,0,1,0
7016,2011,0.5,RENT,1,Low,1,14400, 60 months,2,debt_consolidation,6,Low,1,Bad Loan,1,8.9,A,1,3.12,9997.94,6171.18,1132.5,298.23,409000007015,4-Jan-19,FDRL/INTERNAL FUND TRANSFE,"1,000,000.00",,-547169222.05,Frederickson,572,France,175025.27,0,1,0
7017,2011,7,OWN,2,Medium,2,12000, 60 months,2,renewable_energy,13,High,2,Good Loan,0,17.58,D,4,14.34,13827.46,12000,0,301.99,409000007016,4-Jan-19,FDRL/INTERNAL FUND TRANSFE,"1,000,000.00",,-548169222.05,Wood,741,Spain,13018.96,0,1,0
7018,2011,5,MORTGAGE,3,Medium,2,6425, 36 months,1,major_purchase,8,Low,1,Good Loan,0,6.03,A,1,4.09,7039.258401,6425,0,195.55,409000007017,4-Jan-19,Indiaforensic RUPAY POS C2 ACQ04,,425206.72,-547744015.33,Smith,646,Spain,42537.59,0,1,0
7019,2011,1,RENT,1,Low,1,9375, 36 months,1,debt_consolidation,6,Low,1,Bad Loan,1,11.71,B,2,19.88,3826.69,2518.9,393.79,310.09,409000007018,4-Jan-19,ICA 17825 Indiaforensic MC DOM 0,321.18,,-547744336.51,Harris,805,Germany,62989.82,0,1,0
7020,2011,4,OWN,2,Low,1,4150, 60 months,2,home_improvement,7,High,2,Good Loan,0,17.58,D,4,15.93,5608.976496,4150,0,104.44,409000007019,4-Jan-19,FDRL/INTERNAL FUND TRANSFE,"500,000.00",,-548244336.51,Hall,637,France,71692.80,0,1,0
7021,2011,10,RENT,1,Low,1,7500, 36 months,1,credit_card,1,Low,1,Good Loan,0,6.03,A,1,11.85,8122.68,7500,0,228.27,409000007020,5-Jan-19,Indiaforensic VISA ACQ DOM050119,,2452248.51,-545792088.00,Pickworth,651,France,823.96,0,1,0
7022,2011,10,MORTGAGE,3,Medium,2,13225, 60 months,2,debt_consolidation,6,Low,1,Good Loan,0,12.42,B,2,22.43,13892.22,13225,0,297,409000007021,5-Jan-19,Indiaforensic RUPAY POS ACQ05011,,1284206.05,-544507881.95,Porter,672,France,169469.30,0,1,0
7023,2011,4,MORTGAGE,3,Low,1,15000, 36 months,1,credit_card,1,Low,1,Good Loan,0,7.51,A,1,10.28,16797.22318,15000,0,466.67,409000007022,5-Jan-19,FDRL/INTERNAL FUND TRANSFE,"3,000,000.00",,-547507881.95,Storey,493,France,150159.95,0,1,0
7024,2011,4,MORTGAGE,3,Low,1,7875, 36 months,1,credit_card,1,Low,1,Good Loan,0,10.65,B,2,6.81,8648.13,7875,0,256.52,409000007023,5-Jan-19,FDRL/INTERNAL FUND TRANSFE,"500,000.00",,-548007881.95,Li,524,Germany,32063.30,0,1,0
7025,2011,10,MORTGAGE,3,Low,1,4050, 36 months,1,credit_card,1,Low,1,Bad Loan,1,7.51,A,1,19.09,3772.04,3171.69,138.76,126,409000007024,5-Jan-19,Indiaforensic RUPAY POS C2 ACQ05,,256251.12,-547751630.83,McGill,624,Germany,68794.15,0,1,0
7026,2011,6,MORTGAGE,3,Low,1,1500, 36 months,1,small_business,3,Low,1,Good Loan,0,6.03,A,1,6.25,1619.97,1500,0,45.66,409000007025,5-Jan-19,FDRL/INTERNAL FUND TRANSFE,"500,000.00",,-548251630.83,Sinclair,569,Spain,75084.96,0,1,0
7027,2011,10,RENT,1,Low,1,5500, 36 months,1,debt_consolidation,6,Low,1,Good Loan,0,9.91,B,2,18.86,6189.58,5500,0,177.24,409000007026,7-Jan-19,Indiaforensic VISA ACQ DOM060119,"1,997.00",,-548253627.83,Horton,677,France,114685.92,0,1,0
7028,2011,10,MORTGAGE,3,Medium,2,18000, 36 months,1,other,4,Low,1,Good Loan,0,9.91,B,2,6.47,20744.66986,18000,0,580.05,409000007027,7-Jan-19,Indiaforensic RUPAY POS ACQ06011,,1089965.21,-547163662.62,Sal,464,Germany,143665.44,0,1,0
7029,2011,8,MORTGAGE,3,Medium,2,35000, 36 months,1,debt_consolidation,6,Low,1,Good Loan,0,8.9,A,1,5.75,40007.39459,35000,0,1111.37,409000007028,7-Jan-19,Indiaforensic VISA ACQ INT 03011,,97976.70,-547065685.92,Murray,718,Germany,51099.56,0,1,0
7030,2011,10,RENT,1,Low,1,25000, 36 months,1,debt_consolidation,6,Low,1,Good Loan,0,7.51,A,1,12.15,27991.8359,25000,0,777.78,409000007029,7-Jan-19,ICA 17825 Indiaforensic MC INT 0,,1001.23,-547064684.69,Giles,594,France,5408.74,0,1,0
7031,2011,10,OWN,2,Low,1,10000, 36 months,1,other,4,Low,1,Good Loan,0,8.9,A,1,16.2,11429.67235,10000,0,317.54,409000007030,7-Jan-19,ICA 17825 Indiaforensic MC DOM 0,,5157678.93,-541907005.76,Brown,574,France,103006.27,0,1,0
7032,2011,10,MORTGAGE,3,Low,1,25000, 36 months,1,debt_consolidation,6,Low,1,Good Loan,0,12.69,B,2,16.15,30176.94707,25000,0,838.63,409000007031,7-Jan-19,FDRL/INTERNAL FUND TRANSFE,"3,000,000.00",,-544907005.76,Okechukwu,478,Spain,44147.95,0,1,0
7033,2011,0.5,RENT,1,Low,1,4200, 36 months,1,car,2,Low,1,Good Loan,0,7.51,A,1,5.07,4702.153557,4200,0,130.67,409000007032,7-Jan-19,FDRL/INTERNAL FUND TRANSFE,"3,000,000.00",,-547907005.76,White,615,Spain,149278.96,0,1,0
7034,2011,5,MORTGAGE,3,Medium,2,30000, 36 months,1,home_improvement,7,Low,1,Good Loan,0,11.71,B,2,19.79,35716.28999,30000,0,992.28,409000007033,7-Jan-19,Indiaforensic VISA ACQ DOM070119,,4772125.41,-543134880.35,Kirillova,651,Spain,193009.21,0,1,0
7035,2011,5,MORTGAGE,3,Low,1,23450, 36 months,1,debt_consolidation,6,Low,1,Good Loan,0,7.9,A,1,13.47,26314.92514,23450,0,733.76,409000007034,7-Jan-19,Indiaforensic RUPAY POS ACQ07011,,1317107.63,-541817772.72,Lawson,465,Germany,74898.80,0,1,0
7036,2011,10,RENT,1,Low,1,10000, 36 months,1,vacation,11,Low,1,Good Loan,0,10.65,B,2,4.79,11721.91966,10000,0,325.74,409000007035,7-Jan-19,Indiaforensic RUPAY POS C2 ACQ07,,219866.73,-541597905.99,Sarratt,558,France,116253.10,0,1,0
7037,2011,2,RENT,1,Low,1,6500, 60 months,2,debt_consolidation,6,High,2,Good Loan,0,15.96,C,3,15.91,8088.16,6500,0,157.93,409000007036,8-Jan-19,FDRL/INTERNAL FUND TRANSFE,"3,000,000.00",,-544597905.99,Hay,540,Germany,19374.08,0,1,0
7038,2011,0.5,RENT,1,Low,1,26000, 36 months,1,debt_consolidation,6,High,2,Good Loan,0,14.27,C,3,22.79,31882.60535,26000,0,892.04,409000007037,8-Jan-19,FDRL/INTERNAL FUND TRANSFE,"3,000,000.00",,-547597905.99,Lin,568,Germany,64516.80,0,1,0
7039,2011,10,MORTGAGE,3,Low,1,7125, 36 months,1,credit_card,1,Low,1,Good Loan,0,7.51,A,1,27.02,7977.936411,7125,0,221.67,409000007038,8-Jan-19,FDRL/INTERNAL FUND TRANSFE,"500,000.00",,-548097905.99,Ozerova,630,France,34475.14,0,1,0
7040,2011,1,RENT,1,Medium,2,3600, 36 months,1,vacation,11,High,2,Good Loan,0,16.77,D,4,13.45,3969.86,3600,0,127.94,409000007039,8-Jan-19,ICA 17825 Indiaforensic MC DOM 0,,2377129.04,-545720776.95,Lambert,523,Germany,57061.71,0,1,0
7041,2011,3,OWN,2,Low,1,5000, 36 months,1,major_purchase,8,Low,1,Good Loan,0,9.91,B,2,11.45,5799.150778,5000,0,161.13,409000007040,8-Jan-19,Indiaforensic VISA ACQ DOM080119,,2659050.68,-543061726.27,Bulgakov,678,France,32301.88,0,1,0
7042,2011,2,OWN,2,Low,1,12000, 36 months,1,debt_consolidation,6,Low,1,Good Loan,0,11.71,B,2,8.11,12866.29,12000,0,396.92,409000007041,8-Jan-19,Indiaforensic RUPAY POS ACQ08011,,1136553.40,-541925172.87,He,438,France,136859.55,0,1,0
7043,2011,5,OWN,2,Low,1,15000, 60 months,2,debt_consolidation,6,High,2,Good Loan,0,19.42,E,5,10.06,23265.66005,15000,0,392.59,409000007042,8-Jan-19,Indiaforensic RUPAY POS C2 ACQ08,,252123.95,-541673048.92,Uchechukwu,544,France,69244.24,0,1,0
7044,2011,10,OWN,2,Low,1,5000, 36 months,1,debt_consolidation,6,Low,1,Good Loan,0,7.51,A,1,4.15,5438.4,5000,0,155.56,409000007043,8-Jan-19,Indiaforensic VISA ACQ INT 04011,,624.45,-541672424.47,Robertson,595,Germany,156309.52,0,1,0
7045,2011,3,MORTGAGE,3,Medium,2,24000, 36 months,1,debt_consolidation,6,Low,1,Good Loan,0,7.9,A,1,7.4,25846.75,24000,0,750.97,409000007044,8-Jan-19,FDRL/INTERNAL FUND TRANSFE,"3,000,000.00",,-544672424.47,Leworthy,678,France,4989.33,0,1,0
7046,2011,10,RENT,1,Medium,2,35000, 60 months,2,debt_consolidation,6,High,2,Bad Loan,1,20.89,F,6,18.24,38091.15,16720.06,2521.71,944.71,409000007045,8-Jan-19,FDRL/INTERNAL FUND TRANSFE,"500,000.00",,-545172424.47,Onyemachukwu,850,France,190194.95,0,1,0
7047,2011,10,MORTGAGE,3,Low,1,11325, 36 months,1,debt_consolidation,6,Low,1,Good Loan,0,7.51,A,1,7.35,12604.13,11325,0,352.33,409000007046,8-Jan-19,FDRL/INTERNAL FUND TRANSFE,"3,000,000.00",,-548172424.47,Rivero,589,Germany,3529.72,0,1,0
7048,2011,3,RENT,1,Low,1,13500, 60 months,2,credit_card,1,Low,1,Good Loan,0,11.71,B,2,21.82,15202.79,10934.13,0,298.33,409000007047,8-Jan-19,ICA 17825 Indiaforensic MC DOM 0,510.89,,-548172935.36,Lai,785,Spain,81778.72,0,1,0
7049,2011,4,MORTGAGE,3,Medium,2,9150, 36 months,1,debt_consolidation,6,Low,1,Good Loan,0,6.03,A,1,16.57,9882.19,9150,0,278.49,409000007048,9-Jan-19,ICA 17825 Indiaforensic MC DOM 0,,1883604.47,-546289330.89,Feng,563,Spain,39297.48,0,1,0
7050,2011,6.05,RENT,1,Low,1,5400, 36 months,1,small_business,3,Low,1,Good Loan,0,8.9,A,1,6.27,6166.656603,5400,0,171.47,409000007049,9-Jan-19,FDRL/INTERNAL FUND TRANSFE,"500,000.00",,-546789330.89,Hornung,602,France,176614.86,0,1,0
7051,2011,8,MORTGAGE,3,High,3,28000, 36 months,1,small_business,3,Low,1,Good Loan,0,7.9,A,1,0.56,29904.55,28000,0,876.13,409000007050,9-Jan-19,FDRL/INTERNAL FUND TRANSFE,"1,000,000.00",,-547789330.89,Schiavone,591,France,108684.65,0,1,0
7052,2011,10,MORTGAGE,3,Low,1,22000, 60 months,2,credit_card,1,Low,1,Good Loan,0,11.99,B,2,26.55,24930.37,17794.83,0,489.27,409000007051,9-Jan-19,Indiaforensic VISA ACQ DOM090119,,2273947.75,-545515383.14,Barnet,643,Spain,145764.40,0,1,0
7053,2011,2,RENT,1,Low,1,4000, 60 months,2,debt_consolidation,6,High,2,Bad Loan,1,20.89,F,6,4.39,3996.02,1751.48,339.04,107.97,409000007052,9-Jan-19,Indiaforensic RUPAY POS ACQ09011,,537997.85,-544977385.29,Dennys,605,France,42135.28,0,1,0
7054,2011,3,RENT,1,Medium,2,16000, 60 months,2,credit_card,1,High,2,Good Loan,0,17.27,D,4,13.13,20358.31,12626.29,0,399.97,409000007053,9-Jan-19,Indiaforensic RUPAY POS C2 ACQ09,,1011653.48,-543965731.81,Ritchie,755,Germany,16929.41,0,1,0
7055,2011,10,RENT,1,Low,1,15000, 36 months,1,debt_consolidation,6,Low,1,Good Loan,0,7.51,A,1,26.68,16540.24,15000,0,466.67,409000007054,9-Jan-19,Indiaforensic VISA ACQ INT 05011,,152048.51,-543813683.30,Lo,769,Spain,104393.78,0,1,0
7056,2011,10,MORTGAGE,3,Low,1,5200, 36 months,1,car,2,Low,1,Good Loan,0,6.62,A,1,9.08,5228.95,5200,0,159.66,409000007055,9-Jan-19,Indiaforensic VISA ACQ INT 06011,,2718.11,-543810965.19,Yuriev,620,France,192717.57,0,1,0
7057,2011,9,OWN,2,Low,1,3500, 36 months,1,major_purchase,8,High,2,Good Loan,0,15.27,C,3,5.85,4342.68,3500,0,121.8,409000007056,9-Jan-19,Indiaforensic VISA ACQ INT 07011,,5883.98,-543805081.21,Howarth,725,France,59650.42,0,1,0
7058,2011,8,RENT,1,Low,1,4500, 36 months,1,debt_consolidation,6,Low,1,Good Loan,0,6.62,A,1,10.09,4719,4500,0,138.17,409000007057,9-Jan-19,FDRL/INTERNAL FUND TRANSFE,"1,000,000.00",,-544805081.21,Gibson,818,Germany,63729.72,0,1,0
7059,2011,2,RENT,1,Low,1,12000, 36 months,1,credit_card,1,Low,1,Bad Loan,1,8.9,A,1,19.7,7941.8,6264.33,329.4,381.04,409000007058,9-Jan-19,FDRL/INTERNAL FUND TRANSFE,"1,000,000.00",,-545805081.21,Zikoranachidimma,624,France,73679.59,0,1,0
7060,2011,10,MORTGAGE,3,Low,1,24000, 60 months,2,medical,9,High,2,Bad Loan,1,21.67,F,6,11.69,14949.75,5478.93,1141.54,658.36,409000007059,9-Jan-19,FDRL/INTERNAL FUND TRANSFE,"1,000,000.00",,-546805081.21,Mason,669,Germany,174969.92,0,1,0
7061,2011,2,RENT,1,Low,1,7000, 36 months,1,credit_card,1,Low,1,Good Loan,0,7.9,A,1,17.64,7884.497769,7000,0,219.04,409000007060,9-Jan-19,FDRL/INTERNAL FUND TRANSFE,"1,000,000.00",,-547805081.21,Rizzo,712,France,1703.58,0,1,0
7062,2011,8,MORTGAGE,3,Low,1,35000, 60 months,2,small_business,3,High,2,Good Loan,0,13.49,C,3,2.05,41028.67,28124.09,0,805.17,409000007061,10-Jan-19,ICA 17825 Indiaforensic MC DOM 1,,1855733.07,-545949348.14,Thomson,603,Germany,163181.62,0,1,0
7063,2011,6,RENT,1,Low,1,1200, 36 months,1,major_purchase,8,High,2,Good Loan,0,16.29,D,4,13.49,1382.44,1200,0,42.37,409000007062,10-Jan-19,FDRL/INTERNAL FUND TRANSFE,"1,000,000.00",,-546949348.14,Ignatyev,597,France,52319.26,0,1,0
7064,2011,7,MORTGAGE,3,Low,1,12250, 36 months,1,debt_consolidation,6,Low,1,Good Loan,0,6.62,A,1,23.87,13538.07685,12250,0,376.12,409000007063,10-Jan-19,FDRL/INTERNAL FUND TRANSFE,"1,000,000.00",,-547949348.14,Ferguson,580,Germany,51672.08,0,1,0
7065,2011,4,MORTGAGE,3,Low,1,7200, 36 months,1,credit_card,1,Low,1,Good Loan,0,11.71,B,2,11.77,7405.56,7200,0,238.15,409000007064,10-Jan-19,Indiaforensic VISA ACQ DOM100119,,2187174.40,-545762173.74,Woods,718,France,145355.11,0,1,0
7066,2011,10,OWN,2,Low,1,2000, 36 months,1,vacation,11,High,2,Good Loan,0,16.29,D,4,12.15,2540.52581,2000,0,70.61,409000007065,10-Jan-19,Indiaforensic RUPAY POS ACQ10011,,324551.09,-545437622.65,Sung,527,Spain,51711.57,0,1,0
7067,2011,3,MORTGAGE,3,Low,1,24000, 60 months,2,debt_consolidation,6,Low,1,Good Loan,0,10.65,B,2,14.39,27922.50729,24000.01,0,517.64,409000007066,10-Jan-19,Indiaforensic VISA ACQ INT 08011,,55635.27,-545381987.38,Lo,729,Spain,149535.97,0,1,0
7068,2011,6,MORTGAGE,3,Medium,2,20000, 60 months,2,debt_consolidation,6,High,2,Good Loan,0,15.27,C,3,12.76,25568.68,20000,0,478.64,409000007067,10-Jan-19,FDRL/INTERNAL FUND TRANSFE,"1,000,000.00",,-546381987.38,Burn,746,France,94105.00,0,1,0
7069,2011,5,MORTGAGE,3,Low,1,4000, 36 months,1,car,2,Low,1,Good Loan,0,6.03,A,1,17.53,4382.393719,4000,0,121.75,409000007068,10-Jan-19,FDRL/INTERNAL FUND TRANSFE,"500,000.00",,-546881987.38,Russell,699,Germany,155905.79,0,1,0
7070,2011,5,MORTGAGE,3,Low,1,12000, 60 months,2,small_business,3,Low,1,Good Loan,0,7.9,A,1,9.48,12364.85,9874.59,0,242.75,409000007069,10-Jan-19,FDRL/INTERNAL FUND TRANSFE,"1,000,000.00",,-547881987.38,Jen,759,France,138380.11,0,1,0
7071,2011,10,RENT,1,Low,1,10000, 36 months,1,other,4,Low,1,Good Loan,0,12.42,B,2,21.71,12025.84291,10000,0,334.16,409000007070,10-Jan-19,Indiaforensic RUPAY POS C2 ACQ10,,978029.55,-546903957.83,Lo Duca,748,France,97734.30,0,1,0
7072,2011,10,MORTGAGE,3,Low,1,32000, 60 months,2,home_improvement,7,High,2,Good Loan,0,21.67,F,6,19.81,50152.22812,32000,0,877.82,409000007071,10-Jan-19,FDRL/INTERNAL FUND TRANSFE,"1,000,000.00",,-547903957.83,Oluchi,698,Spain,173576.71,0,1,0
7073,2011,7,MORTGAGE,3,Low,1,6500, 36 months,1,car,2,Low,1,Good Loan,0,6.03,A,1,1.27,7115.559094,6500,0,197.84,409000007072,11-Jan-19,ICA 17825 Indiaforensic MC DOM 1,,1711607.46,-546192350.37,Yao,686,France,27596.39,0,1,0
7074,2011,4,MORTGAGE,3,Low,1,8650, 36 months,1,home_improvement,7,Low,1,Good Loan,0,7.51,A,1,11.14,9220.9,8650,0,269.11,409000007073,11-Jan-19,FDRL/INTERNAL FUND TRANSFE,"2,000,000.00",,-548192350.37,Gould,679,France,16897.19,0,1,0
7075,2011,0.5,RENT,1,Low,1,15000, 60 months,2,small_business,3,High,2,Good Loan,0,13.49,C,3,13.08,17582.84,12052.93,0,345.08,409000007074,11-Jan-19,Indiaforensic VISA ACQ DOM110119,,2850099.24,-545342251.13,Salter,682,Germany,36895.99,0,1,0
7076,2011,5,MORTGAGE,3,Medium,2,30000, 60 months,2,house,12,High,2,Good Loan,0,15.96,C,3,13.37,42463.00841,30000,0,728.91,409000007075,11-Jan-19,Indiaforensic RUPAY POS ACQ11011,,1187947.21,-544154303.92,Warner,778,France,113046.81,0,1,0
7077,2011,3,RENT,1,Low,1,25000, 36 months,1,home_improvement,7,Low,1,Good Loan,0,7.9,A,1,0.84,27604.76,25000,0,782.26,409000007076,11-Jan-19,Indiaforensic RUPAY POS C2 ACQ11,,270270.85,-543884033.07,Salier,742,France,129933.50,0,1,0
7078,2011,4,RENT,1,Low,1,8000, 36 months,1,debt_consolidation,6,Low,1,Good Loan,0,6.03,A,1,27.48,8517.47,8000,0,243.49,409000007077,11-Jan-19,Indiaforensic VISA ACQ INT 09011,,5186.57,-543878846.50,Lazar,649,Germany,133091.32,0,1,0
7079,2011,10,RENT,1,Low,1,32400, 36 months,1,debt_consolidation,6,Low,1,Good Loan,0,7.9,A,1,11.27,36203.19,32400,0,1013.81,409000007078,11-Jan-19,FDRL/INTERNAL FUND TRANSFE,"2,000,000.00",,-545878846.50,Onyenachiya,763,France,106282.74,0,1,0
7080,2011,4,MORTGAGE,3,Low,1,10000, 36 months,1,debt_consolidation,6,Low,1,Good Loan,0,6.03,A,1,13.3,10956.39042,10000,0,304.36,409000007079,11-Jan-19,FDRL/INTERNAL FUND TRANSFE,"2,000,000.00",,-547878846.50,Findlay,595,Germany,57862.88,0,1,0
7081,2011,10,MORTGAGE,3,Low,1,13675, 60 months,2,debt_consolidation,6,Low,1,Good Loan,0,11.71,B,2,24.22,15397.08,11074.18,0,302.2,409000007080,14-Jan-19,ICA 17825 Indiaforensic MC INT 1,,2563.96,-547876282.54,Gibbons,628,Germany,12628.61,0,1,0
7082,2011,10,MORTGAGE,3,Low,1,21350, 60 months,2,debt_consolidation,6,High,2,Good Loan,0,13.49,C,3,13.64,27706.5885,21350,0,491.16,409000007081,14-Jan-19,Indiaforensic VISA ACQ DOM120119,,1956387.03,-545919895.51,McCawley,625,France,198914.80,0,1,0
7083,2011,2,MORTGAGE,3,Low,1,23675, 60 months,2,debt_consolidation,6,High,2,Good Loan,0,16.77,D,4,14.25,32374.93769,23675,0,585.47,409000007082,14-Jan-19,Indiaforensic RUPAY POS ACQ12011,,878171.97,-545041723.54,Taylor,733,France,109127.54,0,1,0
7084,2011,10,MORTGAGE,3,Low,1,8000, 36 months,1,debt_consolidation,6,Low,1,Good Loan,0,9.91,B,2,6.15,8314.15,8000,0,257.8,409000007083,14-Jan-19,Indiaforensic RUPAY POS ACQ13011,,1379062.95,-543662660.59,Yang,665,Spain,22487.45,0,1,0
7085,2011,2,MORTGAGE,3,Low,1,9050, 36 months,1,medical,9,Low,1,Good Loan,0,6.62,A,1,6.05,9845.23,9050,0,277.87,409000007084,14-Jan-19,Indiaforensic VISA ACQ INT 10011,,68052.64,-543594607.95,Okwudiliolisa,805,Germany,46791.09,0,1,0
7086,2011,10,RENT,1,Medium,2,16000, 36 months,1,car,2,Low,1,Good Loan,0,12.69,B,2,2.5,17762.87,16000,0,536.72,409000007085,14-Jan-19,FDRL/INTERNAL FUND TRANSFE,"2,000,000.00",,-545594607.95,Napolitano,725,France,158697.28,0,1,0
7087,2011,7,MORTGAGE,3,Medium,2,20000, 36 months,1,credit_card,1,Low,1,Good Loan,0,12.42,B,2,12.47,23863.50143,20000,0,668.31,409000007086,14-Jan-19,FDRL/INTERNAL FUND TRANSFE,"2,000,000.00",,-547594607.95,Vavilov,554,France,194138.36,0,1,0
7088,2011,0.5,MORTGAGE,3,Medium,2,5300, 36 months,1,debt_consolidation,6,Low,1,Good Loan,0,12.69,B,2,23.91,6425.636952,5300,0,177.79,409000007087,14-Jan-19,ICA 17825 Indiaforensic MC DOM 1,,4065323.28,-543529284.67,Teague,675,Spain,35177.31,0,1,0
7089,2011,2,RENT,1,Low,1,17325, 60 months,2,debt_consolidation,6,High,2,Bad Loan,1,19.42,E,5,22.77,11799.04,4513.88,1842.61,453.44,409000007088,14-Jan-19,FDRL/INTERNAL FUND TRANSFE,"2,000,000.00",,-545529284.67,Chiemenam,556,France,157015.50,0,1,0
7090,2011,2,MORTGAGE,3,Low,1,13000, 36 months,1,debt_consolidation,6,Low,1,Good Loan,0,6.03,A,1,16.06,14243.41651,13000,0,395.67,409000007089,14-Jan-19,FDRL/INTERNAL FUND TRANSFE,"2,000,000.00",,-547529284.67,Hughes,635,Spain,136551.25,0,1,0
7091,2011,10,MORTGAGE,3,Low,1,26000, 60 months,2,debt_consolidation,6,Low,1,Good Loan,0,10.65,B,2,7.95,32230.52274,26000,0,560.78,409000007090,14-Jan-19,FDRL/INTERNAL FUND TRANSFE,"500,000.00",,-548029284.67,Cattaneo,601,France,96517.97,0,1,0
7092,2011,2,RENT,1,Low,1,8400, 36 months,1,other,4,Low,1,Good Loan,0,11.71,B,2,18.06,9650.84,8400,0,277.84,409000007091,14-Jan-19,Indiaforensic VISA ACQ DOM140119,,4713034.13,-543316250.54,Davis,600,Germany,93629.66,0,1,0
7093,2011,10,MORTGAGE,3,High,3,25000, 60 months,2,wedding,5,Low,1,Good Loan,0,12.69,B,2,3.83,28610.46,25000,0,564.87,409000007092,14-Jan-19,Indiaforensic RUPAY POS ACQ14011,,1051053.66,-542265196.88,Nekrasova,758,Spain,96097.65,0,1,0
7094,2011,10,MORTGAGE,3,Low,1,1200, 36 months,1,home_improvement,7,Low,1,Good Loan,0,12.69,B,2,8.06,1447.925958,1200,0,40.26,409000007093,14-Jan-19,Indiaforensic RUPAY POS C2 ACQ14,,276641.90,-541988554.98,Loggia,606,Germany,156476.36,0,1,0
7095,2011,10,RENT,1,Low,1,20000, 60 months,2,debt_consolidation,6,High,2,Bad Loan,1,17.58,D,4,12.8,8556,4007.61,0,503.32,409000007094,14-Jan-19,FDRL/INTERNAL FUND TRANSFE,"3,000,000.00",,-544988554.98,Combes,640,France,42964.63,0,1,0
7096,2011,8,RENT,1,Medium,2,14400, 36 months,1,debt_consolidation,6,Low,1,Bad Loan,1,11.71,B,2,8.57,6191,4622.41,9.37,476.3,409000007095,14-Jan-19,FDRL/INTERNAL FUND TRANSFE,"3,000,000.00",,-547988554.98,Onwuka,753,Germany,122021.33,0,1,0
7097,2011,9,RENT,1,Low,1,7000, 36 months,1,debt_consolidation,6,Low,1,Good Loan,0,6.62,A,1,3.75,7734.877185,7000,0,214.93,409000007096,15-Jan-19,Indiaforensic VISA ACQ DOM150119,,2173973.08,-545814581.90,Kharlamov,559,Spain,56311.39,0,1,0
7098,2011,4,MORTGAGE,3,Low,1,10000, 36 months,1,credit_card,1,Low,1,Good Loan,0,11.71,B,2,21.54,11903.00621,10000,0,330.76,409000007097,15-Jan-19,Indiaforensic RUPAY POS ACQ15011,,436017.93,-545378563.97,Scott,754,Spain,150685.52,0,1,0
7099,2011,7,MORTGAGE,3,Low,1,7200, 36 months,1,debt_consolidation,6,Low,1,Good Loan,0,6.62,A,1,11.02,7938.148363,7200,0,221.07,409000007098,15-Jan-19,Indiaforensic VISA ACQ INT 11011,,3942.78,-545374621.19,Lettiere,621,Germany,177740.58,0,1,0
7100,2011,7,RENT,1,Low,1,8800, 36 months,1,debt_consolidation,6,Low,1,Good Loan,0,6.62,A,1,22.55,9348.57,8800,0,270.2,409000007099,15-Jan-19,FDRL/INTERNAL FUND TRANSFE,"1,000,000.00",,-546374621.19,Osonduagwuike,654,France,71492.28,0,1,0
7101,2011,10,MORTGAGE,3,Low,1,10800, 36 months,1,credit_card,1,Low,1,Good Loan,0,7.51,A,1,24.41,12093.68795,10800,0,336,409000007100,15-Jan-19,FDRL/INTERNAL FUND TRANSFE,"1,000,000.00",,-547374621.19,Wan,650,Spain,104492.83,0,1,0
7102,2011,2,MORTGAGE,3,Low,1,25500, 36 months,1,small_business,3,High,2,Bad Loan,1,17.27,D,4,8.93,12884.24,7731.29,1032.01,912.58,409000007101,15-Jan-19,FDRL/INTERNAL FUND TRANSFE,"500,000.00",,-547874621.19,Donaldson,831,Spain,47729.33,0,1,0
7103,2011,5,RENT,1,Low,1,5600, 36 months,1,debt_consolidation,6,High,2,Good Loan,0,13.49,C,3,18.33,6815.195383,5600,0,190.02,409000007102,15-Jan-19,ICA 17825 Indiaforensic MC DOM 1,,1411208.56,-546463412.63,Chukwufumnanya,519,France,97593.16,0,1,0
7104,2011,6,MORTGAGE,3,Low,1,7000, 36 months,1,debt_consolidation,6,High,2,Bad Loan,1,14.65,C,3,23.52,482.18,313.43,0,241.46,409000007103,16-Jan-19,FDRL/INTERNAL FUND TRANSFE,"500,000.00",,-546963412.63,Ma,552,Germany,186869.58,0,1,0
7105,2011,5,RENT,1,Low,1,12500, 36 months,1,debt_consolidation,6,Low,1,Good Loan,0,10.65,B,2,21.02,14653.42835,12500,0,407.17,409000007104,16-Jan-19,FDRL/INTERNAL FUND TRANSFE,"500,000.00",,-547463412.63,Alexander,577,Spain,135227.23,0,1,0
7106,2011,10,MORTGAGE,3,Low,1,28200, 60 months,2,debt_consolidation,6,High,2,Good Loan,0,18.64,E,5,5.59,37624.86,28200,0,725.95,409000007105,16-Jan-19,FDRL/INTERNAL FUND TRANSFE,"500,000.00",,-547963412.63,Nkemjika,576,Spain,135244.87,0,1,0
7107,2011,4,MORTGAGE,3,Medium,2,9000, 36 months,1,vacation,11,Low,1,Good Loan,0,6.03,A,1,0.97,9582.65,9000,0,273.92,409000007106,16-Jan-19,Indiaforensic RUPAY POS C2 ACQ15,,835673.88,-547127738.75,Carroll,646,France,179473.26,0,1,0
7108,2011,3,RENT,1,Low,1,7500, 60 months,2,other,4,Low,1,Good Loan,0,11.71,B,2,13.95,8433.7,6066.7,0,165.74,409000007107,16-Jan-19,ICA 17825 Indiaforensic MC INT 1,,3655.79,-547124082.96,Obioma,711,Germany,50610.62,0,1,0
7109,2011,5,MORTGAGE,3,Medium,2,15000, 60 months,2,major_purchase,8,Low,1,Good Loan,0,11.71,B,2,0.45,18842.27727,15000,0,331.48,409000007108,16-Jan-19,FDRL/INTERNAL FUND TRANSFE,"1,000,000.00",,-548124082.96,Campbell,806,Spain,75232.02,0,1,0
7110,2011,6,RENT,1,Low,1,13000, 60 months,2,debt_consolidation,6,High,2,Good Loan,0,13.49,C,3,10.19,15221.77,10435.93,0,299.07,409000007109,16-Jan-19,ICA 17825 Indiaforensic MC DOM 1,,1784054.46,-546340028.50,Sims,670,France,89205.54,0,1,0
7111,2011,4,RENT,1,Low,1,1000, 36 months,1,wedding,5,High,2,Good Loan,0,13.49,C,3,9.78,1222.254552,1000,0,33.94,409000007110,16-Jan-19,FDRL/INTERNAL FUND TRANSFE,"1,000,000.00",,-547340028.50,McKay,679,Spain,61761.77,0,1,0
7112,2011,9,MORTGAGE,3,Medium,2,15000, 36 months,1,medical,9,Low,1,Good Loan,0,6.03,A,1,3.8,16231.93,15000,0,456.54,409000007111,16-Jan-19,FDRL/INTERNAL FUND TRANSFE,"500,000.00",,-547840028.50,Huang,850,Spain,103921.43,0,1,0
7113,2011,5,MORTGAGE,3,Medium,2,30000, 60 months,2,other,4,Low,1,Good Loan,0,12.69,B,2,5.27,34521.91,24180.68,0,677.85,409000007112,16-Jan-19,Indiaforensic VISA ACQ DOM160119,,2348875.98,-545491152.52,Campbell,670,Germany,198802.90,0,1,0
7114,2011,6.05,MORTGAGE,3,Low,1,4500, 36 months,1,credit_card,1,Low,1,Good Loan,0,8.49,A,1,6.04,5095.937918,4500,0,142.04,409000007113,16-Jan-19,Indiaforensic RUPAY POS ACQ16011,,920914.66,-544570237.86,Boni,733,France,9617.24,0,1,0
7115,2011,4,OWN,2,Low,1,2500, 36 months,1,other,4,Low,1,Good Loan,0,12.69,B,2,4,2844.36,2500,0,83.87,409000007114,16-Jan-19,Indiaforensic VISA ACQ INT 12011,,5281.17,-544564956.69,Gorbunova,764,France,187905.12,0,1,0
7116,2011,10,MORTGAGE,3,Medium,2,8000, 60 months,2,car,2,Low,1,Good Loan,0,11.71,B,2,0.96,8211.36,8000,0,176.79,409000007115,16-Jan-19,Indiaforensic VISA ACQ INT 14011,,2021.94,-544562934.75,Genovese,673,France,121440.80,0,1,0
7117,2011,1,RENT,1,Low,1,12000, 36 months,1,house,12,Low,1,Good Loan,0,6.62,A,1,9.69,13262.43396,12000,0,368.45,409000007116,16-Jan-19,Indiaforensic VISA ACQ INT 15011,,2018.44,-544560916.31,Landor,588,Germany,36292.94,0,1,0
7118,2011,10,MORTGAGE,3,Low,1,35000, 60 months,2,debt_consolidation,6,Low,1,Good Loan,0,11.71,B,2,13.91,38545.78,35000,0,773.44,409000007117,16-Jan-19,FDRL/INTERNAL FUND TRANSFE,"3,000,000.00",,-547560916.31,Meng,564,Spain,20432.09,0,1,0
7119,2011,4,MORTGAGE,3,Low,1,12000, 60 months,2,car,2,Low,1,Good Loan,0,9.91,B,2,7.99,14002.16,12000,0,254.44,409000007118,16-Jan-19,FDRL/INTERNAL FUND TRANSFE,"300,000.00",,-547860916.31,Wardell,715,France,187051.23,0,1,0
7120,2011,10,OWN,2,Low,1,35000, 60 months,2,home_improvement,7,Low,1,Good Loan,0,12.42,B,2,11.43,40072.79,28270.41,0,786.01,409000007119,16-Jan-19,FDRL/INTERNAL FUND TRANSFE,"400,000.00",,-548260916.31,Williams,621,France,148689.13,0,1,0
7121,2011,10,MORTGAGE,3,Low,1,16000, 60 months,2,debt_consolidation,6,High,2,Good Loan,0,19.42,E,5,1.44,20213.94,16000,0,418.76,409000007120,16-Jan-19,Indiaforensic RUPAY POS C2 ACQ16,,280290.18,-547980626.13,Ofodile,796,Spain,125445.80,0,1,0
7122,2011,9,MORTGAGE,3,Low,1,11300, 36 months,1,debt_consolidation,6,Low,1,Good Loan,0,10.65,B,2,17.93,13246.57788,11300,0,368.08,409000007121,16-Jan-19,ICA 17825 Indiaforensic MC DOM 1,792.66,,-547981418.79,Clark,672,France,22736.06,0,1,0
7123,2011,1,RENT,1,Low,1,4000, 36 months,1,debt_consolidation,6,Low,1,Good Loan,0,12.69,B,2,18.83,4805.432362,4000,0,134.18,409000007122,17-Jan-19,ICA 17825 Indiaforensic MC INT 1,,3652.27,-547977766.52,Lo,527,Spain,54947.51,0,1,0
7124,2011,10,RENT,1,Low,1,18000, 60 months,2,debt_consolidation,6,High,2,Good Loan,0,19.03,E,5,12.45,26495.7977,18000,0,467.23,409000007123,17-Jan-19,ICA 17825 Indiaforensic MC DOM 1,,2077448.54,-545900317.98,Chukwuemeka,722,France,167984.72,0,1,0
7125,2011,3,MORTGAGE,3,High,3,35000, 36 months,1,debt_consolidation,6,High,2,Good Loan,0,16.77,D,4,5.38,44343.61228,35000,0,1243.85,409000007124,17-Jan-19,FDRL/INTERNAL FUND TRANSFE,"500,000.00",,-546400317.98,Lai,596,Germany,4802.27,0,1,0
7126,2011,6.05,OWN,2,Low,1,10500, 36 months,1,medical,9,Low,1,Good Loan,0,6.62,A,1,21.04,11586.50818,10500,0,322.39,409000007125,17-Jan-19,FDRL/INTERNAL FUND TRANSFE,"1,000,000.00",,-547400317.98,Arcuri,746,France,72909.75,0,1,0
7127,2011,7,MORTGAGE,3,Low,1,8400, 36 months,1,debt_consolidation,6,Low,1,Good Loan,0,11.71,B,2,13.1,9997.92819,8400,0,277.84,409000007126,17-Jan-19,FDRL/INTERNAL FUND TRANSFE,"500,000.00",,-547900317.98,Graham,523,France,185488.81,0,1,0
7128,2011,4,MORTGAGE,3,Low,1,5000, 36 months,1,car,2,Low,1,Good Loan,0,12.69,B,2,9.07,6033.892458,5000,0,167.73,409000007127,17-Jan-19,Indiaforensic VISA ACQ DOM170119,,3209202.61,-544691115.37,Krylov,624,France,88407.51,0,1,0
7129,2011,10,RENT,1,Medium,2,12000, 60 months,2,debt_consolidation,6,High,2,Good Loan,0,18.25,D,4,12.47,17733.04883,12000,0,306.36,409000007128,17-Jan-19,Indiaforensic RUPAY POS ACQ17011,,1228914.07,-543462201.30,Henry,553,Spain,184544.59,0,1,0
7130,2011,10,MORTGAGE,3,Low,1,4800, 36 months,1,credit_card,1,Low,1,Good Loan,0,10.65,B,2,10.22,5506.39,4800,0,156.36,409000007129,17-Jan-19,FDRL/INTERNAL FUND TRANSFE,"2,000,000.00",,-545462201.30,Jamieson,850,Spain,136539.13,0,1,0
7131,2011,8,MORTGAGE,3,Low,1,10500, 36 months,1,debt_consolidation,6,Low,1,Good Loan,0,7.51,A,1,5.88,11521.26,10500,0,326.67,409000007130,17-Jan-19,FDRL/INTERNAL FUND TRANSFE,"500,000.00",,-545962201.30,Moore,599,Germany,85045.92,0,1,0
7132,2011,6.05,RENT,1,Low,1,3000, 60 months,2,other,4,High,2,Good Loan,0,14.27,C,3,4.25,3907.311588,3000,0,70.23,409000007131,17-Jan-19,FDRL/INTERNAL FUND TRANSFE,"500,000.00",,-546462201.30,Tan,492,France,85421.48,0,1,0
7133,2011,3,RENT,1,Medium,2,5000, 36 months,1,major_purchase,8,Low,1,Good Loan,0,11.71,B,2,10.12,5944.77046,5000,0,165.38,409000007132,17-Jan-19,FDRL/INTERNAL FUND TRANSFE,"500,000.00",,-546962201.30,Thornton,707,Spain,119903.20,0,1,0
7134,2011,1,MORTGAGE,3,Low,1,5000, 36 months,1,debt_consolidation,6,High,2,Bad Loan,1,14.65,C,3,12.05,1548.63,1050.84,0,172.48,409000007133,17-Jan-19,FDRL/INTERNAL FUND TRANSFE,"500,000.00",,-547462201.30,Macleod,743,France,138780.89,0,1,0
7135,2011,1,RENT,1,Low,1,6500, 36 months,1,other,4,Low,1,Good Loan,0,9.91,B,2,17.25,7147.36,6500,0,209.47,409000007134,17-Jan-19,FDRL/INTERNAL FUND TRANSFE,"300,000.00",,-547762201.30,Rizzo,522,France,14789.90,0,1,0
7136,2011,8,RENT,1,Medium,2,20000, 36 months,1,debt_consolidation,6,High,2,Good Loan,0,18.64,E,5,4.72,25868.52,20000,0,729.49,409000007135,17-Jan-19,FDRL/INTERNAL FUND TRANSFE,"500,000.00",,-548262201.30,Chukwukadibia,681,Spain,131964.66,0,1,0
7137,2011,3,MORTGAGE,3,High,3,20000, 36 months,1,debt_consolidation,6,High,2,Good Loan,0,14.27,C,3,8.74,24690.42126,20000,0,686.18,409000007136,17-Jan-19,Indiaforensic RUPAY POS C2 ACQ17,,287553.22,-547974648.08,Ts'ai,826,France,178709.98,0,1,0
7138,2011,3,MORTGAGE,3,Low,1,7000, 36 months,1,medical,9,Low,1,Good Loan,0,7.9,A,1,12.37,7883.697872,7000,0,219.04,409000007137,18-Jan-19,FDRL/INTERNAL FUND TRANSFE,"300,000.00",,-548274648.08,Lu,630,Germany,20344.84,0,1,0
7139,2011,3,MORTGAGE,3,Low,1,13750, 36 months,1,debt_consolidation,6,Low,1,Good Loan,0,11.71,B,2,11.77,16035.11,13750,0,454.8,409000007138,18-Jan-19,ICA 17825 Indiaforensic MC DOM 1,,1498354.08,-546776294.00,Kent,430,Germany,172852.06,0,1,0
7140,2011,10,RENT,1,Low,1,5000, 36 months,1,debt_consolidation,6,High,2,Good Loan,0,15.96,C,3,13.29,6274.352386,5000,0,175.69,409000007139,18-Jan-19,Indiaforensic VISA ACQ DOM180119,,2437830.25,-544338463.75,Black,806,France,103945.58,0,1,0
7141,2011,10,OWN,2,Low,1,14000, 60 months,2,debt_consolidation,6,Low,1,Good Loan,0,12.69,B,2,14.34,18412.58098,14000,0,316.33,409000007140,18-Jan-19,Indiaforensic RUPAY POS ACQ18011,,1198595.05,-543139868.70,Chukwubuikem,703,Spain,183656.12,0,1,0
7142,2011,9,MORTGAGE,3,Low,1,4000, 36 months,1,car,2,Low,1,Good Loan,0,9.91,B,2,18.7,4501.3,4000,0,128.9,409000007141,18-Jan-19,ICA 17825 Indiaforensic MC INT 1,,504.70,-543139364.00,McMillan,755,Germany,10333.78,0,1,0
7143,2011,5,MORTGAGE,3,Low,1,17000, 36 months,1,major_purchase,8,Low,1,Good Loan,0,6.03,A,1,6.3,18626.22927,17000,0,517.41,409000007142,18-Jan-19,FDRL/INTERNAL FUND TRANSFE,"2,000,000.00",,-545139364.00,Ngozichukwuka,612,Spain,122109.58,0,1,0
7144,2011,9,RENT,1,Low,1,22400, 60 months,2,debt_consolidation,6,High,2,Good Loan,0,18.64,E,5,18.67,18818.02,11259.21,0,369.42,409000007143,18-Jan-19,FDRL/INTERNAL FUND TRANSFE,"3,000,000.00",,-548139364.00,Y?an,719,France,125041.52,0,1,0
7145,2011,6,MORTGAGE,3,Medium,2,10625, 60 months,2,debt_consolidation,6,High,2,Good Loan,0,14.27,C,3,14.45,11590.59,10625,0,248.72,409000007144,18-Jan-19,Indiaforensic RUPAY POS C2 ACQ18,,369581.71,-547769782.29,Sung,554,Germany,140003.00,0,1,0
7146,2011,5,MORTGAGE,3,Low,1,12000, 36 months,1,debt_consolidation,6,Low,1,Good Loan,0,6.03,A,1,23.63,13067.32,12000,0,365.23,409000007145,19-Jan-19,FDRL/INTERNAL FUND TRANSFE,"500,000.00",,-548269782.29,Macartney,683,France,183171.47,0,1,0
7147,2011,4,RENT,1,Low,1,9600, 36 months,1,debt_consolidation,6,High,2,Bad Loan,1,14.27,C,3,14.6,8130.27,5634.99,556.01,329.37,409000007146,19-Jan-19,Indiaforensic VISA ACQ DOM190119,,2164040.17,-546105742.12,Ali,749,France,61128.29,0,1,0
7148,2011,5,RENT,1,Low,1,12000, 36 months,1,debt_consolidation,6,Low,1,Good Loan,0,9.91,B,2,12.18,13916.87005,12000,0,386.7,409000007147,19-Jan-19,Indiaforensic RUPAY POS ACQ19011,,1116656.90,-544989085.22,Morley,724,Spain,52462.25,0,1,0
7149,2011,6,MORTGAGE,3,Low,1,12000, 36 months,1,credit_card,1,Low,1,Good Loan,0,6.62,A,1,9.4,12512.44,12000,0,368.45,409000007148,19-Jan-19,Indiaforensic RUPAY POS C2 ACQ19,,441402.89,-544547682.33,Martin,770,Spain,50839.85,0,1,0
7150,2011,3,MORTGAGE,3,Low,1,2000, 36 months,1,other,4,Low,1,Good Loan,0,7.9,A,1,25.36,2198.7,2000,0,62.59,409000007149,19-Jan-19,FDRL/INTERNAL FUND TRANSFE,"500,000.00",,-545047682.33,Okorie,680,France,61240.87,0,1,0
7151,2011,10,MORTGAGE,3,Low,1,18400, 60 months,2,debt_consolidation,6,High,2,Good Loan,0,19.42,E,5,22.53,27778.25908,18400,0,481.57,409000007150,19-Jan-19,FDRL/INTERNAL FUND TRANSFE,"2,000,000.00",,-547047682.33,Ku,699,France,127429.56,0,1,0
7152,2011,5,MORTGAGE,3,Low,1,8000, 36 months,1,debt_consolidation,6,Low,1,Good Loan,0,6.03,A,1,7.84,8744.593246,8000,0,243.49,409000007151,19-Jan-19,FDRL/INTERNAL FUND TRANSFE,"500,000.00",,-547547682.33,Andreyeva,442,France,68343.08,0,1,0
7153,2011,10,MORTGAGE,3,Medium,2,21000, 60 months,2,debt_consolidation,6,High,2,Good Loan,0,18.64,E,5,10.59,22595.8,21000,0,540.61,409000007152,19-Jan-19,FDRL/INTERNAL FUND TRANSFE,"400,000.00",,-547947682.33,Cheng,529,France,126511.94,0,1,0
7154,2011,4,RENT,1,Low,1,9500, 60 months,2,wedding,5,High,2,Good Loan,0,19.03,E,5,7.71,13582.05895,9500,0,246.6,409000007153,19-Jan-19,FDRL/INTERNAL FUND TRANSFE,"300,000.00",,-548247682.33,Hsia,574,Spain,8559.66,0,1,0
7155,2011,1,MORTGAGE,3,Low,1,26000, 36 months,1,credit_card,1,High,2,Good Loan,0,15.96,C,3,9.75,32876.66999,26000,0,913.57,409000007154,21-Jan-19,Indiaforensic RUPAY POS ACQ20011,,1075964.31,-547171718.02,Lane,605,France,147822.81,0,1,0
7156,2011,10,RENT,1,Low,1,5000, 36 months,1,debt_consolidation,6,Low,1,Good Loan,0,6.62,A,1,12.7,5524.871316,5000,0,153.52,409000007155,21-Jan-19,FDRL/INTERNAL FUND TRANSFE,"400,000.00",,-547571718.02,Findlay,515,Germany,39288.11,0,1,0
7157,2011,10,OWN,2,Low,1,28000, 60 months,2,home_improvement,7,Low,1,Good Loan,0,10.65,B,2,9.47,35924.84992,28000,0,603.92,409000007156,21-Jan-19,FDRL/INTERNAL FUND TRANSFE,"300,000.00",,-547871718.02,Okonkwo,632,Germany,85179.48,0,1,0
7158,2011,7,RENT,1,Low,1,9600, 36 months,1,debt_consolidation,6,Low,1,Good Loan,0,10.65,B,2,22.28,11253.01939,9600,0,312.71,409000007157,21-Jan-19,FDRL/INTERNAL FUND TRANSFE,"300,000.00",,-548171718.02,Pirogova,558,France,190019.61,0,1,0
7159,2011,10,RENT,1,Low,1,10400, 60 months,2,small_business,3,High,2,Bad Loan,1,17.58,D,4,8.93,466.98,0,466.98,261.73,409000007158,21-Jan-19,ICA 17825 Indiaforensic MC DOM 2,,5002149.12,-543169568.90,McDonald,434,Germany,96405.88,0,1,0
7160,2011,7,MORTGAGE,3,Low,1,18000, 60 months,2,medical,9,High,2,Bad Loan,1,19.42,E,5,14.29,6122.76,2570.56,17.05,471.1,409000007159,21-Jan-19,FDRL/INTERNAL FUND TRANSFE,"3,000,000.00",,-546169568.90,Okonkwo,525,France,83342.73,0,1,0
7161,2011,10,MORTGAGE,3,Low,1,5000, 36 months,1,car,2,Low,1,Good Loan,0,6.03,A,1,18.72,5478.002443,5000,0,152.18,409000007160,21-Jan-19,FDRL/INTERNAL FUND TRANSFE,"2,000,000.00",,-548169568.90,Nnanna,640,Germany,161333.13,0,1,0
7162,2011,3,RENT,1,Low,1,16000, 60 months,2,debt_consolidation,6,Low,1,Good Loan,0,11.71,B,2,11.36,18012.14,12955.27,0,353.58,409000007161,21-Jan-19,Indiaforensic VISA ACQ DOM210119,,4192974.87,-543976594.03,Ku,690,France,81292.33,0,1,0
7163,2011,8,MORTGAGE,3,Medium,2,19200, 60 months,2,debt_consolidation,6,High,2,Good Loan,0,18.64,E,5,9.71,25603.39,19200,0,494.27,409000007162,21-Jan-19,Indiaforensic RUPAY POS ACQ21011,,1299002.84,-542677591.19,Porter,607,Spain,177747.72,0,1,0
7164,2011,10,MORTGAGE,3,Low,1,30000, 36 months,1,debt_consolidation,6,High,2,Good Loan,0,17.58,D,4,11.09,31288.96,30000,0,1078.27,409000007163,21-Jan-19,Indiaforensic RUPAY POS C2 ACQ21,,307309.41,-542370281.78,Somayina,850,France,187980.21,0,1,0
7165,2011,1,RENT,1,Low,1,7200, 36 months,1,wedding,5,Low,1,Good Loan,0,8.9,A,1,12.66,8229.166059,7200,0,228.63,409000007164,21-Jan-19,Indiaforensic VISA ACQ INT 17011,,21821.93,-542348459.85,Mao,780,Germany,177235.21,0,1,0
7166,2011,2,MORTGAGE,3,Medium,2,15000, 36 months,1,home_improvement,7,Low,1,Good Loan,0,6.03,A,1,0.25,16434.71909,15000,0,456.54,409000007165,21-Jan-19,FDRL/INTERNAL FUND TRANSFE,"500,000.00",,-542848459.85,Fuller,616,Germany,29835.37,0,1,0
7167,2011,3,MORTGAGE,3,Medium,2,10200, 36 months,1,home_improvement,7,Low,1,Good Loan,0,7.9,A,1,9.55,11276.45,10200,0,319.17,409000007166,21-Jan-19,FDRL/INTERNAL FUND TRANSFE,"3,000,000.00",,-545848459.85,Craig,618,Spain,80204.38,0,1,0
7168,2011,7,MORTGAGE,3,Low,1,6350, 36 months,1,other,4,Low,1,Good Loan,0,7.51,A,1,9.94,7108.413983,6350,0,197.56,409000007167,21-Jan-19,FDRL/INTERNAL FUND TRANSFE,"2,000,000.00",,-547848459.85,Trevisano,676,France,189268.81,0,1,0
7169,2011,9,RENT,1,Medium,2,13000, 36 months,1,debt_consolidation,6,Low,1,Good Loan,0,7.9,A,1,19.87,13169.87,13000,0,406.78,409000007168,21-Jan-19,FDRL/INTERNAL FUND TRANSFE,"400,000.00",,-548248459.85,Ruiz,507,France,85411.01,0,1,0
7170,2011,7,RENT,1,Low,1,4000, 36 months,1,debt_consolidation,6,Low,1,Good Loan,0,10.65,B,2,5.88,4587.91,4000,0,130.3,409000007169,22-Jan-19,ICA 17825 Indiaforensic MC DOM 2,,1901143.95,-546347315.90,Fraser,490,France,154360.97,0,1,0
7171,2011,2,RENT,1,Low,1,1500, 36 months,1,other,4,Low,1,Good Loan,0,11.71,B,2,1.13,1784.758723,1500,0,49.62,409000007170,22-Jan-19,FDRL/INTERNAL FUND TRANSFE,"400,000.00",,-546747315.90,Gallo,678,France,84460.18,0,1,0
7172,2011,10,RENT,1,Low,1,28000, 36 months,1,debt_consolidation,6,Low,1,Good Loan,0,9.91,B,2,13.27,32474.24595,28000,0,902.3,409000007171,22-Jan-19,FDRL/INTERNAL FUND TRANSFE,"400,000.00",,-547147315.90,Waterhouse,637,Germany,65618.01,0,1,0
7173,2011,10,RENT,1,Low,1,4000, 36 months,1,other,4,High,2,Bad Loan,1,14.65,C,3,17.73,2064.75,1454.26,0,137.98,409000007172,22-Jan-19,FDRL/INTERNAL FUND TRANSFE,"400,000.00",,-547547315.90,Cremonesi,602,France,112928.74,0,1,0
7174,2011,10,RENT,1,Low,1,12000, 60 months,2,moving,10,Low,1,Good Loan,0,11.71,B,2,15.11,15620.412,12000,0,265.18,409000007173,22-Jan-19,FDRL/INTERNAL FUND TRANSFE,"300,000.00",,-547847315.90,Feng,744,Spain,142210.94,0,1,0
7175,2011,10,MORTGAGE,3,Medium,2,20000, 36 months,1,home_improvement,7,Low,1,Good Loan,0,10.65,B,2,17.35,23285.64136,20000,0,651.47,409000007174,22-Jan-19,FDRL/INTERNAL FUND TRANSFE,"400,000.00",,-548247315.90,H?,640,France,82559.77,0,1,0
7176,2011,2,MORTGAGE,3,Low,1,6350, 36 months,1,debt_consolidation,6,Low,1,Good Loan,0,7.51,A,1,25.78,7108.813938,6350,0,197.56,409000007175,22-Jan-19,Indiaforensic VISA ACQ DOM220119,,2236242.93,-546011072.97,Jara,684,France,127388.06,0,1,0
7177,2011,9,RENT,1,Low,1,20000, 36 months,1,credit_card,1,Low,1,Good Loan,0,12.69,B,2,8.18,24142.42022,20000,0,670.9,409000007176,22-Jan-19,Indiaforensic RUPAY POS ACQ22011,,1103571.19,-544907501.78,Wilson,495,Germany,10160.23,0,1,0
7178,2011,10,RENT,1,Low,1,10000, 60 months,2,debt_consolidation,6,High,2,Good Loan,0,17.58,D,4,2.26,12811.35,10000,0,251.66,409000007177,22-Jan-19,FDRL/INTERNAL FUND TRANSFE,"300,000.00",,-545207501.78,O'Callaghan,559,Germany,64242.31,0,1,0
7179,2011,5,MORTGAGE,3,Low,1,9100, 36 months,1,debt_consolidation,6,Low,1,Good Loan,0,12.42,B,2,16.89,10943.51985,9100,0,304.08,409000007178,22-Jan-19,FDRL/INTERNAL FUND TRANSFE,"3,000,000.00",,-548207501.78,Robson,684,France,198355.28,0,1,0
7180,2011,10,MORTGAGE,3,Low,1,25000, 60 months,2,debt_consolidation,6,High,2,Good Loan,0,17.27,D,4,23.12,29959.3,25000,0,624.95,409000007179,23-Jan-19,Indiaforensic RUPAY POS C2 ACQ22,,283081.02,-547924420.76,Pease,613,France,79323.61,0,1,0
7181,2011,2,OWN,2,Low,1,9200, 36 months,1,debt_consolidation,6,Low,1,Good Loan,0,12.42,B,2,10.92,11063.46699,9200,0,307.43,409000007180,23-Jan-19,Indiaforensic VISA ACQ DOM230119,,2595319.14,-545329101.62,Maclean,794,France,24113.91,0,1,0
7182,2011,4,RENT,1,Low,1,17000, 36 months,1,debt_consolidation,6,Low,1,Good Loan,0,11.71,B,2,17.97,20220.98343,17000,0,562.3,409000007181,23-Jan-19,Indiaforensic RUPAY POS ACQ23011,,1067847.72,-544261253.90,Lavrentyev,736,France,41921.06,0,1,0
7183,2011,4,RENT,1,Low,1,12000, 60 months,2,home_improvement,7,Low,1,Bad Loan,1,10.65,B,2,0.38,5176.81,2933.11,518.88,258.82,409000007182,23-Jan-19,Indiaforensic VISA ACQ INT 18011,,1010.97,-544260242.93,Rhodes,692,Germany,107472.99,0,1,0
7184,2011,10,RENT,1,Low,1,15000, 36 months,1,debt_consolidation,6,Low,1,Good Loan,0,12.42,B,2,5.52,17897.60901,15000,0,501.23,409000007183,23-Jan-19,Indiaforensic VISA ACQ INT 19011,,23509.13,-544236733.80,Murphy,703,Spain,143859.66,0,1,0
7185,2011,6.05,MORTGAGE,3,Low,1,10000, 36 months,1,debt_consolidation,6,Low,1,Good Loan,0,10.65,B,2,8.63,11722.71797,10000,0,325.74,409000007184,23-Jan-19,Indiaforensic VISA ACQ INT 20011,,505.48,-544236228.32,Alexander,720,Germany,104120.17,0,1,0
7186,2011,6,RENT,1,Low,1,17000, 36 months,1,small_business,3,Low,1,Good Loan,0,7.9,A,1,6.43,19148.7339,17000,0,531.94,409000007185,23-Jan-19,Indiaforensic VISA ACQ INT 21011,,3893.22,-544232335.10,Nekrasov,777,Germany,79792.30,0,1,0
7187,2011,2,RENT,1,Low,1,2000, 36 months,1,debt_consolidation,6,Low,1,Good Loan,0,6.62,A,1,9.52,2197.336379,2000,0,61.41,409000007186,23-Jan-19,FDRL/INTERNAL FUND TRANSFE,"2,000,000.00",,-546232335.10,Arnold,653,France,154639.72,0,1,0
7188,2011,9,OWN,2,Low,1,16000, 60 months,2,debt_consolidation,6,High,2,Good Loan,0,14.27,C,3,13.17,21621.63449,16000,0,374.54,409000007187,23-Jan-19,FDRL/INTERNAL FUND TRANSFE,"2,000,000.00",,-548232335.10,Trevisan,552,France,57850.10,0,1,0
7189,2011,5,MORTGAGE,3,Medium,2,30000, 60 months,2,debt_consolidation,6,High,2,Good Loan,0,14.27,C,3,18.21,35788.94,24024.85,0,702.26,409000007188,23-Jan-19,ICA 17825 Indiaforensic MC DOM 2,,1547887.86,-546684447.24,Mason,708,France,62868.33,0,1,0
7190,2011,10,MORTGAGE,3,Medium,2,30000, 60 months,2,small_business,3,High,2,Good Loan,0,20.89,F,6,12.76,39780.75,30000.01,0,809.75,409000007189,23-Jan-19,ICA 17825 Indiaforensic MC INT 1,,3267.92,-546681179.32,Tucker,647,France,92357.21,0,1,0
7191,2011,10,MORTGAGE,3,Low,1,29700, 60 months,2,credit_card,1,Low,1,Bad Loan,1,12.69,B,2,19.72,23749.81,13484.94,2275.57,671.07,409000007190,23-Jan-19,FDRL/INTERNAL FUND TRANSFE,"400,000.00",,-547081179.32,Hobson,597,Germany,161083.53,0,1,0
7192,2011,10,MORTGAGE,3,Low,1,8400, 36 months,1,debt_consolidation,6,Low,1,Good Loan,0,6.03,A,1,7.54,9203.195684,8400,0,255.66,409000007191,23-Jan-19,FDRL/INTERNAL FUND TRANSFE,"300,000.00",,-547381179.32,Gordon,501,France,91429.74,0,1,0
7193,2011,10,RENT,1,Low,1,30000, 60 months,2,debt_consolidation,6,Low,1,Bad Loan,1,11.71,B,2,13.5,30471.62,21348.99,0,662.95,409000007192,23-Jan-19,FDRL/INTERNAL FUND TRANSFE,"400,000.00",,-547781179.32,Anderson,709,France,117031.20,0,1,0
7194,2011,7,RENT,1,Low,1,2000, 36 months,1,wedding,5,Low,1,Good Loan,0,12.42,B,2,1.99,2404.687199,2000,0,66.84,409000007193,23-Jan-19,FDRL/INTERNAL FUND TRANSFE,"400,000.00",,-548181179.32,Terry,621,Germany,44857.40,0,1,0
7195,2011,0.5,MORTGAGE,3,Low,1,6000, 36 months,1,credit_card,1,High,2,Good Loan,0,13.49,C,3,2,6602.12,6000,0,203.59,409000007194,23-Jan-19,Indiaforensic RUPAY POS C2 ACQ23,,353737.79,-547827441.53,Lappin,799,France,36483.52,0,1,0
7196,2011,2,RENT,1,Low,1,2675, 36 months,1,credit_card,1,Low,1,Good Loan,0,9.91,B,2,12.17,3035.4,2675,0,86.21,409000007195,23-Jan-19,ICA 17825 Indiaforensic MC DOM 2,"2,182.65",,-547829624.18,Santiago,675,France,34045.61,0,1,0
7197,2011,10,MORTGAGE,3,Low,1,12000, 60 months,2,other,4,Low,1,Bad Loan,1,11.71,B,2,27.26,3245.33,1543.52,600.43,265.18,409000007196,23-Jan-19,FDRL/INTERNAL FUND TRANSFE,"400,000.00",,-548229624.18,Wallace,561,France,59981.62,0,1,0
7198,2011,8,MORTGAGE,3,Low,1,10000, 36 months,1,debt_consolidation,6,Low,1,Good Loan,0,10.65,B,2,15.7,11598.28753,10000,0,325.74,409000007197,24-Jan-19,Indiaforensic VISA ACQ DOM240119,,2634271.82,-545595352.36,King,707,France,152944.39,0,1,0
7199,2011,0.5,RENT,1,Low,1,3400, 36 months,1,debt_consolidation,6,Low,1,Good Loan,0,7.51,A,1,7.71,3806.386069,3400,0,105.78,409000007198,24-Jan-19,Indiaforensic RUPAY POS ACQ24011,,1273216.50,-544322135.86,Fang,670,France,66979.06,0,1,0
7200,2011,2,RENT,1,Low,1,4000, 36 months,1,wedding,5,Low,1,Good Loan,0,7.51,A,1,22.52,4478.00118,4000,0,124.45,409000007199,24-Jan-19,Indiaforensic VISA ACQ INT 22011,,328.15,-544321807.71,May,649,Spain,28797.32,0,1,0
7201,2011,2,RENT,1,Low,1,20000, 60 months,2,debt_consolidation,6,High,2,Good Loan,0,14.27,C,3,16.86,23837.74,16004.87,0,468.17,409000007200,24-Jan-19,FDRL/INTERNAL FUND TRANSFE,"400,000.00",,-544721807.71,Travis,524,France,51670.82,0,1,0
7202,2011,2,RENT,1,Low,1,2000, 36 months,1,other,4,Low,1,Good Loan,0,9.91,B,2,20.28,2319.166419,2000,0,64.45,409000007201,24-Jan-19,FDRL/INTERNAL FUND TRANSFE,"500,000.00",,-545221807.71,Nnachetam,689,Germany,41865.72,0,1,0
7203,2011,10,RENT,1,Low,1,12800, 60 months,2,wedding,5,Low,1,Good Loan,0,8.9,A,1,6.71,15811.46,12800,0,265.09,409000007202,24-Jan-19,FDRL/INTERNAL FUND TRANSFE,"3,000,000.00",,-548221807.71,Zhdanova,573,Spain,96015.53,0,1,0
7204,2011,0.5,MORTGAGE,3,Low,1,12000, 36 months,1,home_improvement,7,High,2,Good Loan,0,14.27,C,3,8.15,14815.88457,12000,0,411.71,409000007203,24-Jan-19,ICA 17825 Indiaforensic MC DOM 2,,1890120.56,-546331687.15,Jefferson,657,France,103914.40,0,1,0
7205,2011,4,RENT,1,Low,1,35000, 60 months,2,debt_consolidation,6,Low,1,Good Loan,0,11.49,B,2,19.23,43789.53142,35000,0,769.57,409000007204,24-Jan-19,FDRL/INTERNAL FUND TRANSFE,"500,000.00",,-546831687.15,Cremonesi,686,Spain,89199.51,0,1,0
7206,2011,10,RENT,1,Low,1,30000, 60 months,2,debt_consolidation,6,High,2,Bad Loan,1,19.03,E,5,15.16,9788.81,3711.73,1151.4,617.13,409000007205,24-Jan-19,FDRL/INTERNAL FUND TRANSFE,"500,000.00",,-547331687.15,Fang,683,France,48849.89,0,1,0
7207,2011,3,MORTGAGE,3,Low,1,35000, 60 months,2,small_business,3,Low,1,Good Loan,0,11.71,B,2,5.15,30863.14,22196.8,0,605.5,409000007206,24-Jan-19,FDRL/INTERNAL FUND TRANSFE,"400,000.00",,-547731687.15,Sinclair,753,Germany,197444.69,0,1,0
7208,2011,6,MORTGAGE,3,Medium,2,22250, 36 months,1,debt_consolidation,6,Low,1,Good Loan,0,12.42,B,2,17.08,23747.99,22250,0,743.49,409000007207,24-Jan-19,FDRL/INTERNAL FUND TRANSFE,"500,000.00",,-548231687.15,Begley,520,Spain,145160.96,0,1,0
7209,2011,4,MORTGAGE,3,Low,1,5025, 36 months,1,debt_consolidation,6,Low,1,Good Loan,0,8.9,A,1,20.18,5718.93829,5025,0,159.56,409000007208,24-Jan-19,ICA 17825 Indiaforensic MC DOM 2,"1,167.88",,-548232855.03,Degtyarev,547,Germany,52309.80,0,1,0
7210,2011,5,MORTGAGE,3,Low,1,22800, 36 months,1,house,12,High,2,Good Loan,0,17.27,D,4,1.7,29004.56195,22800,0,815.95,409000007209,24-Jan-19,Indiaforensic RUPAY POS C2 ACQ24,,248018.43,-547984836.60,Atkins,653,France,50695.93,0,1,0
7211,2011,0.5,MORTGAGE,3,Low,1,11300, 36 months,1,credit_card,1,Low,1,Good Loan,0,9.91,B,2,16.03,13102.15316,11300,0,364.15,409000007210,25-Jan-19,Indiaforensic VISA ACQ DOM250119,,3441693.88,-544543142.72,Ikenna,648,Spain,157891.11,0,1,0
7212,2011,4,RENT,1,Low,1,5000, 36 months,1,debt_consolidation,6,Low,1,Good Loan,0,10.65,B,2,7.92,5820.60267,5000,0,162.87,409000007211,25-Jan-19,ICA 17825 Indiaforensic MC DOM 2,,1779575.98,-542763566.74,Sun,639,France,181850.74,0,1,0
7213,2011,10,RENT,1,Low,1,5600, 36 months,1,debt_consolidation,6,Low,1,Good Loan,0,6.03,A,1,14.94,6135.41436,5600,0,170.44,409000007212,25-Jan-19,Indiaforensic RUPAY POS ACQ25011,,1055734.79,-541707831.95,Lettiere,711,France,51345.39,0,1,0
7214,2011,4,RENT,1,Low,1,15000, 36 months,1,debt_consolidation,6,Low,1,Good Loan,0,12.42,B,2,17.28,18039.09483,15000,0,501.23,409000007213,25-Jan-19,ICA 17825 Indiaforensic MC INT 2,,2221.49,-541705610.46,Smith,484,Germany,137519.92,0,1,0
7215,2011,3,OWN,2,Low,1,7075, 36 months,1,debt_consolidation,6,High,2,Bad Loan,1,17.58,D,4,15.6,6302.38,4049.64,437.89,254.3,409000007214,25-Jan-19,FDRL/INTERNAL FUND TRANSFE,"500,000.00",,-542205610.46,Finch,721,France,49653.37,0,1,0
7216,2011,3,RENT,1,Low,1,3700, 36 months,1,debt_consolidation,6,Low,1,Good Loan,0,7.9,A,1,6.01,4015.06,3700,0,115.78,409000007215,25-Jan-19,FDRL/INTERNAL FUND TRANSFE,"3,000,000.00",,-545205610.46,Monaldo,548,Germany,55867.38,0,1,0
7217,2011,0.5,RENT,1,Low,1,2000, 36 months,1,debt_consolidation,6,Low,1,Good Loan,0,8.9,A,1,5.83,2108.06,2000,0,63.51,409000007216,25-Jan-19,FDRL/INTERNAL FUND TRANSFE,"3,000,000.00",,-548205610.46,Ugonna,679,France,172749.40,0,1,0
7218,2011,10,RENT,1,Low,1,25000, 60 months,2,debt_consolidation,6,High,2,Bad Loan,1,14.65,C,3,14.49,5511.08,2378.99,790.76,590.17,409000007217,25-Jan-19,Indiaforensic RUPAY POS C2 ACQ25,,433831.57,-547771778.89,Chiang,553,France,90607.31,0,1,0
7219,2011,4,RENT,1,Low,1,10000, 36 months,1,small_business,3,Low,1,Bad Loan,1,6.62,A,1,7.05,7320.4,5851.59,565.83,307.04,409000007218,25-Jan-19,FDRL/INTERNAL FUND TRANSFE,"500,000.00",,-548271778.89,Sun,757,France,130861.95,0,1,0
7220,2011,0.5,MORTGAGE,3,Low,1,9800, 60 months,2,major_purchase,8,Low,1,Good Loan,0,12.42,B,2,2.52,12906.5211,9800,0,220.09,409000007219,25-Jan-19,ICA 17825 Indiaforensic MC DOM 2,259.84,,-548272038.73,Blackburn,581,France,5558.47,0,1,0
7221,2011,3,RENT,1,Low,1,7000, 36 months,1,credit_card,1,Low,1,Good Loan,0,8.9,A,1,24.39,7999.741754,7000,0,222.28,409000007220,28-Jan-19,ICA 17825 Indiaforensic MC DOM 2,,5283854.68,-542988184.05,Chang,718,Spain,121537.91,0,1,0
7222,2011,10,RENT,1,Low,1,4000, 36 months,1,debt_consolidation,6,Low,1,Good Loan,0,9.91,B,2,15.53,4648.276163,4000,0,128.9,409000007221,28-Jan-19,FDRL/INTERNAL FUND TRANSFE,"5,000,000.00",,-547988184.05,Palermo,625,France,57128.78,0,1,0
7223,2011,3,MORTGAGE,3,Low,1,17000, 36 months,1,credit_card,1,Low,1,Good Loan,0,7.9,A,1,22.33,19148.96245,17000,0,531.94,409000007222,28-Jan-19,Indiaforensic VISA ACQ DOM260119,,2851043.55,-545137140.50,McEwan,744,Spain,19409.77,0,1,0
7224,2011,2,RENT,1,Low,1,3600, 36 months,1,credit_card,1,Low,1,Good Loan,0,6.03,A,1,11.52,3843.37,3600,0,109.57,409000007223,28-Jan-19,Indiaforensic VISA ACQ DOM280119,,4117544.07,-541019596.43,Davide,799,Germany,88604.89,0,1,0
7225,2011,10,OWN,2,Low,1,7200, 36 months,1,other,4,Low,1,Good Loan,0,6.03,A,1,7.26,7888.6091,7200,0,219.14,409000007224,28-Jan-19,Indiaforensic RUPAY POS ACQ26011,,1329254.61,-539690341.82,Chieloka,751,Spain,479.54,0,1,0
7226,2011,1,MORTGAGE,3,Low,1,4000, 36 months,1,debt_consolidation,6,Low,1,Good Loan,0,6.03,A,1,14.04,4349.98,4000,0,121.75,409000007225,28-Jan-19,Indiaforensic RUPAY POS ACQ27011,,1193394.53,-538496947.29,Humphreys,781,Germany,173837.54,0,1,0
7227,2011,10,RENT,1,Low,1,30000, 36 months,1,debt_consolidation,6,Low,1,Good Loan,0,11.71,B,2,19.61,35006.47,30000,0,992.28,409000007226,28-Jan-19,Indiaforensic RUPAY POS ACQ28011,,1296419.42,-537200527.87,Cocci,777,Germany,487.30,0,1,0
7228,2011,10,MORTGAGE,3,Low,1,20000, 36 months,1,debt_consolidation,6,Low,1,Good Loan,0,7.9,A,1,13.48,22527.52249,20000,0,625.81,409000007227,28-Jan-19,Indiaforensic RUPAY POS C2 ACQ28,,304222.16,-536896305.71,Hanson,704,Spain,35600.25,0,1,0
7229,2011,1,MORTGAGE,3,Low,1,35000, 60 months,2,debt_consolidation,6,High,2,Good Loan,0,17.27,D,4,9.75,32458.6,20128.71,0,637.45,409000007228,28-Jan-19,Indiaforensic VISA ACQ INT 24011,,12823.27,-536883482.44,Macleod,539,France,166929.43,0,1,0
7230,2011,10,RENT,1,Low,1,10200, 36 months,1,wedding,5,Low,1,Good Loan,0,11.71,B,2,16.15,12141.72588,10200,0,337.38,409000007229,28-Jan-19,FDRL/INTERNAL FUND TRANSFE,"5,000,000.00",,-541883482.44,Ritchie,716,France,98998.61,0,1,0
7231,2011,6.05,RENT,1,Low,1,5000, 36 months,1,debt_consolidation,6,Low,1,Bad Loan,1,7.9,A,1,12,1562.3,1270.81,0,156.46,409000007230,28-Jan-19,FDRL/INTERNAL FUND TRANSFE,"2,000,000.00",,-543883482.44,Nebechukwu,670,France,54229.74,0,1,0
7232,2011,9,MORTGAGE,3,Low,1,10000, 36 months,1,debt_consolidation,6,Low,1,Good Loan,0,6.03,A,1,21.86,10794.63,10000,0,304.36,409000007231,28-Jan-19,FDRL/INTERNAL FUND TRANSFE,"2,000,000.00",,-545883482.44,Nnamutaezinwa,555,France,105720.09,0,1,0
7233,2011,10,OWN,2,Low,1,35000, 36 months,1,debt_consolidation,6,Low,1,Good Loan,0,8.9,A,1,13.79,40006.37714,35000,0,1111.37,409000007232,28-Jan-19,FDRL/INTERNAL FUND TRANSFE,"2,000,000.00",,-547883482.44,Ikemefuna,679,Germany,121151.46,0,1,0
7234,2011,2,RENT,1,Low,1,8600, 36 months,1,small_business,3,Low,1,Good Loan,0,7.51,A,1,11.56,9630.171084,8600,0,267.56,409000007233,28-Jan-19,FDRL/INTERNAL FUND TRANSFE,"300,000.00",,-548183482.44,Scott,571,France,154844.22,0,1,0
7235,2011,4,MORTGAGE,3,Low,1,9000, 36 months,1,home_improvement,7,Low,1,Good Loan,0,6.03,A,1,4.7,9720.22,9000,0,273.92,409000007234,28-Jan-19,ICA 17825 Indiaforensic MC INT 2,,1515.78,-548181966.66,Chiang,512,Spain,18785.48,0,1,0
7236,2011,6,MORTGAGE,3,Low,1,21600, 36 months,1,credit_card,1,Low,1,Good Loan,0,12.42,B,2,11.9,24906.62,21600,0,721.77,409000007235,29-Jan-19,ICA 17825 Indiaforensic MC DOM 2,,2269130.02,-545912836.64,Artyomova,697,France,64771.61,0,1,0
7237,2011,2,RENT,1,Medium,2,30000, 60 months,2,debt_consolidation,6,Low,1,Good Loan,0,12.42,B,2,18.58,25500.48,17990.27,0,500.24,409000007236,29-Jan-19,FDRL/INTERNAL FUND TRANSFE,"2,000,000.00",,-547912836.64,Hsieh,424,Spain,16250.61,0,1,0
7238,2011,2,RENT,1,Low,1,14750, 60 months,2,other,4,Low,1,Bad Loan,1,11.71,B,2,25.72,3383.94,1700.41,455.79,325.95,409000007237,29-Jan-19,FDRL/INTERNAL FUND TRANSFE,"300,000.00",,-548212836.64,Levien,684,France,131093.99,0,1,0
7239,2011,10,RENT,1,Low,1,12000, 60 months,2,debt_consolidation,6,High,2,Good Loan,0,15.96,C,3,16.5,17284.55998,12000,0,291.57,409000007238,29-Jan-19,Indiaforensic VISA ACQ DOM290119,,3380726.31,-544832110.33,Erskine,697,Spain,129188.18,0,1,0
7240,2011,3,RENT,1,Low,1,24600, 60 months,2,debt_consolidation,6,High,2,Good Loan,0,17.58,D,4,14.94,30246.44,22700,0,571.26,409000007239,29-Jan-19,Indiaforensic RUPAY POS ACQ29011,,1139175.82,-543692934.51,Fiorentino,580,Germany,47428.73,0,1,0
7241,2011,10,MORTGAGE,3,Medium,2,5000, 36 months,1,vacation,11,Low,1,Good Loan,0,11.71,B,2,15.07,5927.45668,5000,0,165.38,409000007240,29-Jan-19,Indiaforensic RUPAY POS C2 ACQ29,,228530.07,-543464404.44,Okonkwo,600,France,132973.21,0,1,0
7242,2011,8,MORTGAGE,3,Low,1,14400, 36 months,1,credit_card,1,Low,1,Good Loan,0,11.71,B,2,17.5,16398.12,14400,0,476.3,409000007241,29-Jan-19,FDRL/INTERNAL FUND TRANSFE,"3,000,000.00",,-546464404.44,Monds,521,France,84908.20,0,1,0
7243,2011,0.5,MORTGAGE,3,Medium,2,21000, 36 months,1,debt_consolidation,6,Low,1,Good Loan,0,11.71,B,2,13.76,25001.49487,21000,0,694.6,409000007242,29-Jan-19,FDRL/INTERNAL FUND TRANSFE,"400,000.00",,-546864404.44,Campbell,664,Spain,57338.56,0,1,0
7244,2011,9,RENT,1,Low,1,11000, 36 months,1,credit_card,1,Low,1,Good Loan,0,8.9,A,1,15.11,12555.33187,11000,0,349.29,409000007243,29-Jan-19,FDRL/INTERNAL FUND TRANSFE,"500,000.00",,-547364404.44,Ibekwe,634,France,161579.85,0,1,0
7245,2011,7,RENT,1,Low,1,25000, 60 months,2,small_business,3,Low,1,Good Loan,0,10.65,B,2,0,23113.04,17115.48,0,454.56,409000007244,29-Jan-19,FDRL/INTERNAL FUND TRANSFE,"400,000.00",,-547764404.44,Marcelo,445,France,122625.68,0,1,0
7246,2011,2,OWN,2,Low,1,10000, 36 months,1,debt_consolidation,6,Low,1,Good Loan,0,6.62,A,1,16.8,11049.9127,10000,0,307.04,409000007245,29-Jan-19,FDRL/INTERNAL FUND TRANSFE,"500,000.00",,-548264404.44,Castro,702,Germany,52909.87,0,1,0
7247,2011,2,MORTGAGE,3,Low,1,5950, 36 months,1,small_business,3,High,2,Good Loan,0,13.49,C,3,14.02,6783.71,5950,0,201.89,409000007246,29-Jan-19,ICA 17825 Indiaforensic MC INT 2,,21618.35,-548242786.09,Capon,485,France,170226.47,0,1,0
7248,2011,5,MORTGAGE,3,Low,1,25000, 36 months,1,debt_consolidation,6,High,2,Bad Loan,1,13.49,C,3,24.56,12372.05,5328.14,4755.62,848.27,409000007247,29-Jan-19,ICA 17825 Indiaforensic MC DOM 2,789.43,,-548243575.52,Voronova,582,Germany,191757.65,0,1,0
7249,2011,6,RENT,1,Medium,2,4375, 36 months,1,major_purchase,8,Low,1,Good Loan,0,12.42,B,2,7.06,5149.03,4375,0,146.2,409000007248,30-Jan-19,ICA 17825 Indiaforensic MC DOM 3,,2223856.77,-546019718.75,Loggia,605,Spain,66652.75,0,1,0
7250,2011,0.5,MORTGAGE,3,Low,1,5000, 36 months,1,debt_consolidation,6,Low,1,Good Loan,0,6.62,A,1,18.75,5523.877453,5000,0,153.52,409000007249,30-Jan-19,FDRL/INTERNAL FUND TRANSFE,"2,000,000.00",,-548019718.75,Law,628,France,195977.75,0,1,0
7251,2011,10,MORTGAGE,3,Low,1,4300, 36 months,1,debt_consolidation,6,Low,1,Good Loan,0,7.9,A,1,24.54,4483.68,4300,0,134.55,409000007250,30-Jan-19,Indiaforensic VISA ACQ DOM300119,,3198722.56,-544820996.19,Grant,604,Spain,69056.26,0,1,0
7252,2011,4,RENT,1,Low,1,2500, 60 months,2,other,4,High,2,Bad Loan,1,15.96,C,3,15.75,2364.12,1252.91,188.88,60.75,409000007251,30-Jan-19,Indiaforensic RUPAY POS ACQ30011,,1128246.61,-543692749.58,Greco,724,Germany,12920.43,0,1,0
7253,2011,10,MORTGAGE,3,Low,1,10625, 36 months,1,credit_card,1,Low,1,Good Loan,0,6.03,A,1,22.52,11329.1,10625,0,323.38,409000007252,30-Jan-19,Indiaforensic VISA ACQ INT 27011,,1212.55,-543691537.03,Dietz,567,Germany,138552.74,0,1,0
7254,2011,9,RENT,1,Low,1,5000, 60 months,2,debt_consolidation,6,High,2,Bad Loan,1,17.58,D,4,13.87,5758.41,3403.26,0,125.83,409000007253,30-Jan-19,FDRL/INTERNAL FUND TRANSFE,"500,000.00",,-544191537.03,Martel,779,Spain,22832.71,0,1,0
7255,2011,4,RENT,1,Low,1,10700, 36 months,1,debt_consolidation,6,Low,1,Good Loan,0,6.03,A,1,18.68,11002.16,10700,0,325.67,409000007254,30-Jan-19,FDRL/INTERNAL FUND TRANSFE,"2,000,000.00",,-546191537.03,Jarvis,785,France,61811.10,0,1,0
7256,2011,10,MORTGAGE,3,Low,1,35000, 60 months,2,credit_card,1,Low,1,Good Loan,0,10.99,B,2,26.81,44392.45632,35000,0,760.82,409000007255,30-Jan-19,FDRL/INTERNAL FUND TRANSFE,"2,000,000.00",,-548191537.03,Meng,563,France,191604.27,0,1,0
7257,2011,10,MORTGAGE,3,Low,1,20000, 60 months,2,debt_consolidation,6,Low,1,Good Loan,0,12.69,B,2,18.84,25261.66804,19850,0,448.51,409000007256,30-Jan-19,ICA 17825 Indiaforensic MC INT 2,,387.33,-548191149.70,Hay,821,Germany,25445.00,0,1,0
7258,2011,2,MORTGAGE,3,Medium,2,11800, 36 months,1,debt_consolidation,6,Low,1,Good Loan,0,7.51,A,1,7.48,12708.5,11800,0,367.11,409000007257,30-Jan-19,Indiaforensic RUPAY POS C2 ACQ30,,278733.70,-547912416.00,Voronoff,747,France,129964.56,0,1,0
7259,2011,6,MORTGAGE,3,Low,1,7000, 36 months,1,debt_consolidation,6,Low,1,Good Loan,0,6.03,A,1,17.45,7669.512623,7000,0,213.05,409000007258,30-Jan-19,FDRL/INTERNAL FUND TRANSFE,"300,000.00",,-548212416.00,Trevascus,600,Germany,6209.51,0,1,0
7260,2011,6.05,MORTGAGE,3,Low,1,3000, 36 months,1,vacation,11,Low,1,Good Loan,0,6.03,A,1,11.08,3233.81,3000,0,91.31,409000007259,30-Jan-19,ICA 17825 Indiaforensic MC DOM 3,,3678.70,-548208737.30,Ho,625,Spain,134794.02,0,1,0
7261,2011,4,MORTGAGE,3,Medium,2,5000, 36 months,1,medical,9,Low,1,Good Loan,0,8.9,A,1,19.11,5176.16,5000,0,158.77,409000007260,31-Jan-19,Indiaforensic VISA ACQ DOM310119,,2568123.79,-545640613.51,Hansen,773,France,57549.65,0,1,0
7262,2011,1,RENT,1,Low,1,4000, 36 months,1,debt_consolidation,6,Low,1,Good Loan,0,12.69,B,2,5.67,4815.52,4000,0,134.18,409000007261,31-Jan-19,Indiaforensic RUPAY POS ACQ31011,,1319311.74,-544321301.77,Craig,726,France,28367.21,0,1,0
7263,2011,2,MORTGAGE,3,Low,1,4000, 60 months,2,home_improvement,7,High,2,Good Loan,0,14.27,C,3,13.25,4764.72,3199.39,0,93.64,409000007262,31-Jan-19,Indiaforensic VISA ACQ INT 29011,,31775.18,-544289526.59,Hall,641,Spain,51703.09,0,1,0
7264,2011,1,RENT,1,Low,1,6000, 36 months,1,debt_consolidation,6,Low,1,Good Loan,0,10.65,B,2,15.41,7033.973837,6000,0,195.44,409000007263,31-Jan-19,ICA 17825 Indiaforensic MC INT 3,,4438.57,-544285088.02,Sun,649,France,66602.70,0,1,0
7265,2011,10,MORTGAGE,3,Low,1,24000, 36 months,1,debt_consolidation,6,High,2,Good Loan,0,13.49,C,3,22.13,29301.30027,24000,0,814.34,409000007264,31-Jan-19,FDRL/INTERNAL FUND TRANSFE,"500,000.00",,-544785088.02,Durant,434,Spain,2739.71,0,1,0
7266,2011,6.05,RENT,1,Low,1,1200, 36 months,1,debt_consolidation,6,Low,1,Good Loan,0,9.91,B,2,18.64,1391.368844,1200,0,38.67,409000007265,31-Jan-19,FDRL/INTERNAL FUND TRANSFE,"3,000,000.00",,-547785088.02,Jackson,738,France,69227.42,0,1,0
7267,2011,3,MORTGAGE,3,Low,1,7700, 36 months,1,debt_consolidation,6,Low,1,Good Loan,0,11.71,B,2,16.43,8768.26,7700,0,254.69,409000007266,31-Jan-19,FDRL/INTERNAL FUND TRANSFE,"400,000.00",,-548185088.02,Chigozie,762,Spain,31445.03,0,1,0
7268,2011,5,MORTGAGE,3,Low,1,7000, 36 months,1,car,2,Low,1,Good Loan,0,6.03,A,1,11.3,7204.46,7000,0,213.05,409000007267,31-Jan-19,ICA 17825 Indiaforensic MC DOM 3,,1808500.89,-546376587.13,Farmer,507,Germany,150037.19,0,1,0
7269,2011,10,RENT,1,High,3,12025, 36 months,1,debt_consolidation,6,High,2,Good Loan,0,14.27,C,3,1.31,14840.6091,12025,0,412.57,409000007268,31-Jan-19,FDRL/INTERNAL FUND TRANSFE,"500,000.00",,-546876587.13,Douglas,606,Germany,111448.92,0,1,0
7270,2011,2,MORTGAGE,3,Low,1,5600, 36 months,1,wedding,5,Low,1,Good Loan,0,6.62,A,1,7.23,6031.97,5600,0,171.95,409000007269,31-Jan-19,FDRL/INTERNAL FUND TRANSFE,"500,000.00",,-547376587.13,Ardis,655,Germany,51226.32,0,1,0
7271,2011,8,MORTGAGE,3,Medium,2,28000, 60 months,2,other,4,Low,1,Good Loan,0,9.91,B,2,3.94,30276.84,22870.55,0,593.68,409000007270,31-Jan-19,FDRL/INTERNAL FUND TRANSFE,"300,000.00",,-547676587.13,Smith,697,Germany,53581.14,0,1,0
7272,2011,5,RENT,1,Low,1,20000, 36 months,1,debt_consolidation,6,High,2,Bad Loan,1,16.77,D,4,11.64,23783.45,17958.48,292.5,710.77,409000007271,31-Jan-19,FDRL/INTERNAL FUND TRANSFE,"500,000.00",,-548176587.13,Butler,504,Germany,149697.78,0,1,0
7273,2011,1,RENT,1,Low,1,25000, 60 months,2,debt_consolidation,6,High,2,Bad Loan,1,18.64,E,5,23.41,8982.97,3030.56,1261.83,643.58,409000007272,31-Jan-19,Indiaforensic RUPAY POS C2 ACQ31,,323202.79,-547853384.34,Pettry,653,France,160348.31,0,1,0
7274,2011,0.5,MORTGAGE,3,Low,1,5000, 36 months,1,home_improvement,7,Low,1,Good Loan,0,6.62,A,1,2.37,5406.87,5000,0,153.52,409000007273,31-Jan-19,FDRL/INTERNAL FUND TRANSFE,"400,000.00",,-548253384.34,John,660,Spain,154641.91,0,1,0
7275,2011,3,RENT,1,Low,1,6000, 60 months,2,debt_consolidation,6,High,2,Good Loan,0,14.27,C,3,17.83,8144.398242,6000,0,140.46,409000007274,1-Feb-19,ICA 17825 Indiaforensic MC DOM 0,,1647527.73,-546605856.61,Potter,652,France,104331.76,0,1,0
7276,2011,5,MORTGAGE,3,Medium,2,10700, 36 months,1,wedding,5,High,2,Good Loan,0,14.27,C,3,10.19,13122.15559,10700,0,367.11,409000007275,1-Feb-19,FDRL/INTERNAL FUND TRANSFE,"500,000.00",,-547105856.61,Shaw,669,France,135630.32,0,1,0
7277,2011,3,RENT,1,Low,1,14600, 36 months,1,debt_consolidation,6,Low,1,Good Loan,0,6.03,A,1,21.24,15736.63,14600,0,444.36,409000007276,1-Feb-19,FDRL/INTERNAL FUND TRANSFE,"500,000.00",,-547605856.61,Boyle,594,France,65361.66,0,1,0
7278,2011,0.5,MORTGAGE,3,Medium,2,7200, 36 months,1,debt_consolidation,6,Low,1,Good Loan,0,7.9,A,1,24.86,8105.489119,7200,0,225.29,409000007277,1-Feb-19,FDRL/INTERNAL FUND TRANSFE,"500,000.00",,-548105856.61,Elmore,756,Germany,56176.31,0,1,0
7279,2011,10,MORTGAGE,3,Low,1,12600, 60 months,2,debt_consolidation,6,Low,1,Good Loan,0,7.9,A,1,11.89,14972.47594,12600,0,254.88,409000007278,1-Feb-19,Indiaforensic VISA ACQ DOM010219,,2569844.30,-545536012.31,Udinesi,642,France,60059.47,0,1,0
7280,2011,6,MORTGAGE,3,Low,1,12600, 60 months,2,major_purchase,8,Low,1,Good Loan,0,12.69,B,2,24.17,14306.84,12600,0,284.7,409000007279,1-Feb-19,Indiaforensic RUPAY POS ACQ01021,,1157601.93,-544378410.38,Sun,486,Germany,51364.56,0,1,0
7281,2011,10,MORTGAGE,3,Low,1,3300, 36 months,1,major_purchase,8,Low,1,Good Loan,0,7.51,A,1,11.26,3620.1,3300,0,102.67,409000007280,1-Feb-19,Indiaforensic RUPAY POS C2 ACQ01,,318614.00,-544059796.38,Tuan,804,France,118752.60,0,1,0
7282,2011,9,RENT,1,Low,1,3500, 60 months,2,other,4,Low,1,Good Loan,0,12.69,B,2,17.44,4019.87,2816.62,0,79.09,409000007281,1-Feb-19,Indiaforensic VISA ACQ INT 30011,,10701.14,-544049095.24,Lawrence,629,France,116848.79,0,1,0
7283,2011,10,MORTGAGE,3,Low,1,6250, 36 months,1,debt_consolidation,6,Low,1,Bad Loan,1,7.51,A,1,26.94,3305.35,2768.14,10.41,194.45,409000007282,1-Feb-19,FDRL/INTERNAL FUND TRANSFE,"300,000.00",,-544349095.24,Burrows,581,Spain,45026.23,0,1,0
7284,2011,10,MORTGAGE,3,Low,1,13000, 60 months,2,debt_consolidation,6,Low,1,Bad Loan,1,8.9,A,1,24.06,9453.46,7201.51,0,206.07,409000007283,1-Feb-19,FDRL/INTERNAL FUND TRANSFE,"400,000.00",,-544749095.24,Shao,667,France,189657.26,0,1,0
7285,2011,0.5,OWN,2,Low,1,6000, 36 months,1,debt_consolidation,6,Low,1,Good Loan,0,10.65,B,2,22.45,7033.474874,6000,0,195.44,409000007284,1-Feb-19,FDRL/INTERNAL FUND TRANSFE,"500,000.00",,-545249095.24,White,667,Spain,57213.46,0,1,0
7286,2011,10,MORTGAGE,3,Low,1,12000, 36 months,1,house,12,Low,1,Good Loan,0,6.03,A,1,2.21,12232.86,12000,0,365.23,409000007285,1-Feb-19,FDRL/INTERNAL FUND TRANSFE,"3,000,000.00",,-548249095.24,Chialuka,679,France,63687.06,0,1,0
7287,2011,10,MORTGAGE,3,Low,1,6800, 36 months,1,debt_consolidation,6,Low,1,Good Loan,0,6.03,A,1,17.79,7240.09,6800,0,206.97,409000007286,2-Feb-19,Indiaforensic VISA ACQ DOM020219,,2878558.26,-545370536.98,Toscano,680,France,58761.33,0,1,0
7288,2011,10,MORTGAGE,3,Low,1,14000, 60 months,2,debt_consolidation,6,High,2,Good Loan,0,15.27,C,3,10.56,18221.938,14000,0,335.05,409000007287,2-Feb-19,Indiaforensic RUPAY POS ACQ02021,,1230734.29,-544139802.69,McKay,644,Spain,14187.78,0,1,0
7289,2011,10,MORTGAGE,3,Low,1,5000, 60 months,2,other,4,High,2,Good Loan,0,14.27,C,3,24.29,5952.19,3997.08,0,117.05,409000007288,2-Feb-19,FDRL/INTERNAL FUND TRANSFE,"3,000,000.00",,-547139802.69,Voronkov,571,France,145115.95,0,1,0
7290,2011,10,MORTGAGE,3,Low,1,9600, 60 months,2,major_purchase,8,Low,1,Bad Loan,1,11.71,B,2,13.08,1562.58,601.97,505.43,212.15,409000007289,2-Feb-19,FDRL/INTERNAL FUND TRANSFE,"300,000.00",,-547439802.69,Sal,627,Spain,187718.26,0,1,0
7291,2011,10,MORTGAGE,3,High,3,14400, 36 months,1,debt_consolidation,6,Low,1,Good Loan,0,8.9,A,1,8.6,16310.79,14400,0,457.25,409000007290,2-Feb-19,FDRL/INTERNAL FUND TRANSFE,"500,000.00",,-547939802.69,Ikechukwu,536,France,27150.35,0,1,0
7292,2011,8,OWN,2,Low,1,2000, 60 months,2,other,4,High,2,Good Loan,0,16.77,D,4,22.96,2509.3,1577.64,0,49.46,409000007291,2-Feb-19,FDRL/INTERNAL FUND TRANSFE,"300,000.00",,-548239802.69,Kruglova,599,Spain,111622.76,0,1,0
7293,2011,6,RENT,1,Low,1,5000, 36 months,1,debt_consolidation,6,High,2,Bad Loan,1,15.27,C,3,12.93,1305.18,635.86,250.27,173.99,409000007292,2-Feb-19,Indiaforensic RUPAY POS C2 ACQ02,,236953.53,-548002849.16,Clements,744,Spain,27244.35,0,1,0
7294,2011,6,MORTGAGE,3,Low,1,5000, 36 months,1,home_improvement,7,Low,1,Good Loan,0,6.03,A,1,6.98,5309.72,5000,0,152.18,409000007293,4-Feb-19,Indiaforensic RUPAY POS ACQ03021,,1358503.08,-546644346.08,Kennedy,709,France,57029.66,0,1,0
7295,2011,4,RENT,1,Low,1,8000, 36 months,1,debt_consolidation,6,High,2,Good Loan,0,16.77,D,4,17.02,10228.29611,8000,0,284.31,409000007294,4-Feb-19,Indiaforensic VISA ACQ INT 31011,,2243.25,-546642102.83,Johnson,653,Germany,25183.01,0,1,0
7296,2011,0.5,MORTGAGE,3,Low,1,6500, 36 months,1,debt_consolidation,6,Low,1,Good Loan,0,6.03,A,1,11.03,6813.56,6500,0,197.84,409000007295,4-Feb-19,FDRL/INTERNAL FUND TRANSFE,"500,000.00",,-547142102.83,Chung,648,Germany,129980.93,0,1,0
7297,2011,3,RENT,1,Low,1,5000, 36 months,1,debt_consolidation,6,Low,1,Good Loan,0,6.03,A,1,12.53,5478.239697,5000,0,152.18,409000007296,4-Feb-19,FDRL/INTERNAL FUND TRANSFE,"500,000.00",,-547642102.83,Garland,663,Germany,118716.63,0,1,0
7298,2011,0.5,RENT,1,Low,1,12000, 36 months,1,debt_consolidation,6,Low,1,Good Loan,0,11.71,B,2,19.48,14283.28954,12000,0,396.92,409000007297,4-Feb-19,FDRL/INTERNAL FUND TRANSFE,"300,000.00",,-547942102.83,Docherty,613,Germany,20134.07,0,1,0
7299,2011,6,RENT,1,Medium,2,4000, 36 months,1,debt_consolidation,6,Low,1,Bad Loan,1,7.51,A,1,22.07,2852.13,2109.3,349.09,124.45,409000007298,4-Feb-19,FDRL/INTERNAL FUND TRANSFE,"300,000.00",,-548242102.83,Nnaife,620,France,190208.23,0,1,0
7300,2011,3,MORTGAGE,3,Low,1,2000, 36 months,1,home_improvement,7,Low,1,Good Loan,0,6.03,A,1,5.15,2117.32,2000,0,60.88,409000007299,4-Feb-19,ICA 17825 Indiaforensic MC DOM 0,,5088853.78,-543153249.05,Lettiere,661,France,68021.90,0,1,0
7301,2011,0.5,RENT,1,Low,1,1200, 36 months,1,moving,10,Low,1,Bad Loan,1,9.91,B,2,9.18,952.3,722.94,65.65,38.67,409000007300,4-Feb-19,FDRL/INTERNAL FUND TRANSFE,"5,000,000.00",,-548153249.05,Sanderson,669,Germany,110881.56,0,1,0
7302,2011,1,OWN,2,Low,1,3000, 60 months,2,car,2,Low,1,Good Loan,0,12.42,B,2,9.98,3735.694779,3000,0,67.38,409000007301,4-Feb-19,ICA 17825 Indiaforensic MC INT 0,,180.22,-548153068.83,Fomin,767,Germany,132480.75,0,1,0
7303,2011,0.5,RENT,1,Low,1,6200, 36 months,1,wedding,5,Low,1,Good Loan,0,8.9,A,1,1.66,7086.130955,6200,0,196.87,409000007302,4-Feb-19,Indiaforensic VISA ACQ DOM040219,,5421008.52,-542732060.31,Wright,491,France,7032.95,0,1,0
7304,2011,10,MORTGAGE,3,Medium,2,35000, 60 months,2,debt_consolidation,6,High,2,Bad Loan,1,21.28,F,6,18.57,32231.49,11892.44,5570.17,952.39,409000007303,4-Feb-19,Indiaforensic RUPAY POS ACQ04021,,1315291.29,-541416769.02,Buckley,653,France,27862.58,0,1,0
7305,2011,6.05,MORTGAGE,3,Low,1,6025, 36 months,1,debt_consolidation,6,Low,1,Good Loan,0,6.03,A,1,19.71,6601.209873,6025,0,183.38,409000007304,4-Feb-19,Indiaforensic RUPAY POS C2 ACQ04,,292193.58,-541124575.44,Pan,679,Germany,87008.17,0,1,0
7306,2011,0.5,RENT,1,Low,1,20000, 60 months,2,major_purchase,8,Low,1,Good Loan,0,11.71,B,2,13.52,24222.46,20000,0,441.97,409000007305,4-Feb-19,FDRL/INTERNAL FUND TRANSFE,"2,000,000.00",,-543124575.44,Manna,687,France,27411.19,0,1,0
7307,2011,10,MORTGAGE,3,Low,1,13000, 60 months,2,credit_card,1,Low,1,Good Loan,0,12.42,B,2,18.92,13268.77,13000,0,291.95,409000007306,4-Feb-19,FDRL/INTERNAL FUND TRANSFE,"5,000,000.00",,-548124575.44,Chinwendu,837,France,46395.21,0,1,0
7308,2011,4,RENT,1,Low,1,3000, 36 months,1,wedding,5,Low,1,Good Loan,0,8.9,A,1,23.24,3347.12,3000,0,95.26,409000007307,5-Feb-19,ICA 17825 Indiaforensic MC INT 0,,6822.03,-548117753.41,Ndubuagha,850,France,194245.29,0,1,0
7309,2011,6,RENT,1,Low,1,18000, 36 months,1,credit_card,1,Low,1,Good Loan,0,7.9,A,1,17.23,19668.85,18000,0,563.23,409000007308,5-Feb-19,ICA 17825 Indiaforensic MC DOM 0,,2191043.04,-545926710.37,White,663,Spain,151317.27,0,1,0
7310,2011,2,OWN,2,Low,1,10000, 60 months,2,other,4,High,2,Good Loan,0,14.27,C,3,13.29,11912.82,7994.07,0,234.09,409000007309,5-Feb-19,FDRL/INTERNAL FUND TRANSFE,"2,000,000.00",,-547926710.37,Hale,547,Spain,118142.79,0,1,0
7311,2011,10,RENT,1,Low,1,2000, 36 months,1,vacation,11,Low,1,Good Loan,0,7.9,A,1,24.55,2230.53,2000,0,62.59,409000007310,5-Feb-19,FDRL/INTERNAL FUND TRANSFE,"300,000.00",,-548226710.37,Ross,627,France,138700.75,0,1,0
7312,2011,10,MORTGAGE,3,Low,1,12000, 60 months,2,home_improvement,7,Low,1,Good Loan,0,10.65,B,2,3.09,13266.71,12000,0,258.82,409000007311,5-Feb-19,Indiaforensic VISA ACQ DOM050219,,2263535.15,-545963175.22,Ikenna,707,France,6035.51,0,1,0
7313,2011,5,MORTGAGE,3,Medium,2,10000, 36 months,1,credit_card,1,Low,1,Good Loan,0,6.62,A,1,13.26,10677.09,10000,0,307.04,409000007312,5-Feb-19,Indiaforensic RUPAY POS ACQ05021,,1056799.79,-544906375.43,Nkemdilim,629,France,41263.69,0,1,0
7314,2011,10,RENT,1,Low,1,4800, 36 months,1,credit_card,1,Low,1,Good Loan,0,11.71,B,2,10.17,5712.732699,4800,0,158.77,409000007313,5-Feb-19,Indiaforensic VISA ACQ INT 01021,,2476.43,-544903899.00,McMillan,687,France,63185.05,0,1,0
7315,2011,7,RENT,1,Low,1,20500, 60 months,2,debt_consolidation,6,Low,1,Bad Loan,1,12.69,B,2,12.9,7103.65,3846.47,608.35,310.12,409000007314,5-Feb-19,FDRL/INTERNAL FUND TRANSFE,"300,000.00",,-545203899.00,Duke,588,France,92536.00,0,1,0
7316,2011,2,RENT,1,Low,1,9300, 36 months,1,debt_consolidation,6,High,2,Good Loan,0,15.99,D,4,4.43,11763.69223,9300,0,326.92,409000007315,5-Feb-19,FDRL/INTERNAL FUND TRANSFE,"3,000,000.00",,-548203899.00,Bradbury,502,Germany,158736.07,0,1,0
7317,2011,5,RENT,1,Low,1,15000, 36 months,1,debt_consolidation,6,Low,1,Good Loan,0,7.9,A,1,11.79,16335.25,15000,0,469.36,409000007316,5-Feb-19,Indiaforensic RUPAY POS C2 ACQ05,,316127.48,-547887771.52,Bayley,793,Germany,18633.40,0,1,0
7318,2011,1,RENT,1,Low,1,5000, 36 months,1,credit_card,1,Low,1,Good Loan,0,7.51,A,1,8.78,5597.057624,5000,0,155.56,409000007317,5-Feb-19,ICA 17825 Indiaforensic MC DOM 0,"2,525.42",,-547890296.94,Bartlett,727,Germany,71830.10,0,1,0
7319,2011,2,RENT,1,Low,1,2000, 36 months,1,car,2,High,2,Good Loan,0,13.49,C,3,7.63,2440.342668,2000,0,67.87,409000007318,6-Feb-19,Indiaforensic VISA ACQ DOM060219,,3126090.30,-544764206.64,Cremin,632,Spain,19525.65,0,1,0
7320,2011,6,OWN,2,Low,1,10800, 60 months,2,debt_consolidation,6,High,2,Good Loan,0,19.42,E,5,17.3,16213.34605,10800,0,282.66,409000007319,6-Feb-19,Indiaforensic RUPAY POS ACQ06021,,1417083.68,-543347122.96,Gilchrist,474,Germany,110953.33,0,1,0
7321,2011,4,MORTGAGE,3,Low,1,14000, 36 months,1,debt_consolidation,6,Low,1,Good Loan,0,12.42,B,2,15.02,16789.09808,14000,0,467.82,409000007320,6-Feb-19,Indiaforensic VISA ACQ INT 03021,,6052.03,-543341070.93,Shih,850,Germany,4466.21,0,1,0
7322,2011,1,MORTGAGE,3,Low,1,12625, 36 months,1,debt_consolidation,6,Low,1,Bad Loan,1,7.9,A,1,23.63,6713.64,5589.72,0,395.04,409000007321,6-Feb-19,Indiaforensic VISA ACQ INT 04021,,2021.94,-543339048.99,Fitzpatrick,584,France,105818.51,0,1,0
7323,2011,2,RENT,1,Low,1,5000, 36 months,1,debt_consolidation,6,High,2,Good Loan,0,13.49,C,3,24.72,6099.705734,5000,0,169.66,409000007322,6-Feb-19,FDRL/INTERNAL FUND TRANSFE,"500,000.00",,-543839048.99,Pagan,713,France,149558.83,0,1,0
7324,2011,3,RENT,1,Low,1,13800, 60 months,2,other,4,High,2,Good Loan,0,22.06,F,6,21.45,19498.58,13800,0,381.62,409000007323,6-Feb-19,FDRL/INTERNAL FUND TRANSFE,"3,000,000.00",,-546839048.99,Hendrick,742,Spain,4070.28,0,1,0
7325,2011,10,RENT,1,Low,1,5000, 36 months,1,major_purchase,8,Low,1,Good Loan,0,12.69,B,2,9.39,6033.664152,5000,0,167.73,409000007324,6-Feb-19,FDRL/INTERNAL FUND TRANSFE,"400,000.00",,-547239048.99,Sanderson,607,France,132741.13,0,1,0
7326,2011,0.5,MORTGAGE,3,Medium,2,35000, 60 months,2,debt_consolidation,6,High,2,Good Loan,0,19.42,E,5,15.71,36146.04003,24425,0,639.26,409000007325,6-Feb-19,ICA 17825 Indiaforensic MC INT 0,,14297.72,-547224751.27,Samsonova,761,Spain,61251.25,0,1,0
7327,2011,10,RENT,1,Low,1,10000, 36 months,1,car,2,Low,1,Good Loan,0,11.71,B,2,1.67,11893.44792,10000,0,330.76,409000007326,6-Feb-19,ICA 17825 Indiaforensic MC DOM 0,,2636452.58,-544588298.69,Azubuike,600,France,91347.76,0,1,0
7328,2011,10,MORTGAGE,3,Low,1,7300, 36 months,1,other,4,Low,1,Good Loan,0,7.51,A,1,23.43,7903.07,7300,0,227.11,409000007327,6-Feb-19,FDRL/INTERNAL FUND TRANSFE,"300,000.00",,-544888298.69,Pan,650,Spain,171045.31,0,1,0
7329,2011,2,MORTGAGE,3,Medium,2,18000, 36 months,1,debt_consolidation,6,Low,1,Good Loan,0,7.9,A,1,11.18,20275.51862,18000,0,563.23,409000007328,6-Feb-19,FDRL/INTERNAL FUND TRANSFE,"3,000,000.00",,-547888298.69,Massie,850,Germany,155850.40,0,1,0
7330,2011,10,MORTGAGE,3,Medium,2,10000, 36 months,1,debt_consolidation,6,Low,1,Good Loan,0,9.91,B,2,23.76,11331.94,10000,0,322.25,409000007329,6-Feb-19,FDRL/INTERNAL FUND TRANSFE,"300,000.00",,-548188298.69,Sandover,501,France,27380.99,0,1,0
7331,2011,2,RENT,1,Low,1,4000, 36 months,1,major_purchase,8,Low,1,Good Loan,0,10.65,B,2,2.1,4688.155082,4000,0,130.3,409000007330,6-Feb-19,Indiaforensic RUPAY POS C2 ACQ06,,336808.42,-547851490.27,Craig,418,France,154208.96,0,1,0
7332,2011,10,RENT,1,Low,1,22000, 36 months,1,debt_consolidation,6,Low,1,Good Loan,0,12.69,B,2,5.64,24074.21,22000,0,737.99,409000007331,6-Feb-19,ICA 17825 Indiaforensic MC DOM 0,724.92,,-547852215.19,Onwudiwe,797,Spain,93624.55,0,1,0
7333,2011,10,MORTGAGE,3,Low,1,3000, 36 months,1,other,4,High,2,Bad Loan,1,15.96,C,3,3.97,1180.71,692.14,132.11,105.42,409000007332,7-Feb-19,FDRL/INTERNAL FUND TRANSFE,"200,000.00",,-548052215.19,Chu,788,Germany,64746.07,0,1,0
7334,2011,0.5,RENT,1,Low,1,14400, 36 months,1,debt_consolidation,6,High,2,Good Loan,0,13.49,C,3,16.38,17039.38,14400,0,488.6,409000007333,7-Feb-19,FDRL/INTERNAL FUND TRANSFE,"200,000.00",,-548252215.19,Zetticci,699,Spain,82815.93,0,1,0
7335,2011,10,RENT,1,Low,1,3800, 36 months,1,car,2,Low,1,Good Loan,0,7.9,A,1,17.09,4298.845379,3800,0,118.91,409000007334,7-Feb-19,ICA 17825 Indiaforensic MC DOM 0,,2480544.35,-545771670.84,Vaguine,616,France,27308.58,0,1,0
7336,2011,4,RENT,1,Low,1,2000, 36 months,1,debt_consolidation,6,Low,1,Bad Loan,1,7.9,A,1,25.88,1596.93,1276.97,98.85,62.59,409000007335,7-Feb-19,FDRL/INTERNAL FUND TRANSFE,"2,000,000.00",,-547771670.84,Owen,651,France,104876.80,0,1,0
7337,2011,4,RENT,1,Low,1,10000, 36 months,1,debt_consolidation,6,High,2,Bad Loan,1,20.89,F,6,4.32,3664.78,1949.92,280.78,376.19,409000007336,7-Feb-19,FDRL/INTERNAL FUND TRANSFE,"500,000.00",,-548271670.84,Hurst,654,France,151316.37,0,1,0
7338,2011,1,RENT,1,Low,1,10000, 36 months,1,debt_consolidation,6,Low,1,Good Loan,0,12.69,B,2,14.14,12033.88244,10000,0,335.45,409000007337,7-Feb-19,Indiaforensic VISA ACQ DOM070219,,2686377.36,-545585293.48,Harding,676,France,91817.38,0,1,0
7339,2011,10,RENT,1,Low,1,12000, 36 months,1,debt_consolidation,6,Low,1,Good Loan,0,12.42,B,2,20.91,13011.58,12000,0,400.99,409000007338,7-Feb-19,Indiaforensic RUPAY POS ACQ07021,,1299138.16,-544286155.32,Smith,708,Germany,125311.17,0,1,0
7340,2011,6,MORTGAGE,3,Low,1,7500, 60 months,2,car,2,Low,1,Good Loan,0,9.91,B,2,27.73,8109.69,6126.16,0,159.03,409000007339,7-Feb-19,Indiaforensic VISA ACQ INT 05021,,525.70,-544285629.62,Moore,499,Spain,14868.94,0,1,0
7341,2011,0.5,OWN,2,Low,1,16450, 36 months,1,debt_consolidation,6,Low,1,Bad Loan,1,10.65,B,2,23.19,9614.18,6876.6,549.63,535.83,409000007340,7-Feb-19,FDRL/INTERNAL FUND TRANSFE,"2,000,000.00",,-546285629.62,Bradley,689,France,196112.45,0,1,0
7342,2011,3,MORTGAGE,3,Low,1,8500, 36 months,1,home_improvement,7,Low,1,Good Loan,0,7.51,A,1,2.86,9393.08,8500,0,264.45,409000007341,7-Feb-19,FDRL/INTERNAL FUND TRANSFE,"1,000,000.00",,-547285629.62,Burfitt,850,Spain,24093.40,0,1,0
7343,2011,10,MORTGAGE,3,Low,1,12000, 60 months,2,debt_consolidation,6,High,2,Good Loan,0,16.77,D,4,10.71,13435.33,12000,0,296.75,409000007342,7-Feb-19,FDRL/INTERNAL FUND TRANSFE,"300,000.00",,-547585629.62,Mackenzie,502,France,66263.87,0,1,0
7344,2011,10,MORTGAGE,3,Low,1,3600, 60 months,2,debt_consolidation,6,High,2,Good Loan,0,16.77,D,4,13.23,4670.14,3600,0,89.03,409000007343,7-Feb-19,FDRL/INTERNAL FUND TRANSFE,"300,000.00",,-547885629.62,Milanesi,643,France,100304.13,0,1,0
7345,2011,7,OWN,2,Low,1,29800, 36 months,1,debt_consolidation,6,Low,1,Good Loan,0,10.65,B,2,16.57,32909.6,29800,0,970.69,409000007344,7-Feb-19,FDRL/INTERNAL FUND TRANSFE,"300,000.00",,-548185629.62,Shubin,762,France,167909.52,0,1,0
7346,2011,1,MORTGAGE,3,Low,1,10000, 36 months,1,home_improvement,7,Low,1,Good Loan,0,7.9,A,1,9.08,11263.54581,10000,0,312.91,409000007345,7-Feb-19,ICA 17825 Indiaforensic MC DOM 0,551.24,,-548186180.86,Nieves,719,France,16246.59,0,1,0
7347,2011,1,RENT,1,Low,1,8000, 36 months,1,debt_consolidation,6,Low,1,Good Loan,0,6.03,A,1,9.51,8780.034427,8000,0,243.49,409000007346,7-Feb-19,Indiaforensic RUPAY POS C2 ACQ07,,292366.91,-547893813.95,Martin,789,France,103603.65,0,1,0
7348,2011,10,MORTGAGE,3,Low,1,5325, 36 months,1,home_improvement,7,Low,1,Good Loan,0,11.71,B,2,3.26,6336.817274,5325,0,176.13,409000007347,8-Feb-19,FDRL/INTERNAL FUND TRANSFE,"300,000.00",,-548193813.95,Jen,553,Spain,7680.23,0,1,0
7349,2011,6,MORTGAGE,3,Low,1,7500, 36 months,1,home_improvement,7,Low,1,Good Loan,0,7.9,A,1,19.02,7550.04,7500,0,234.68,409000007348,8-Feb-19,ICA 17825 Indiaforensic MC DOM 0,,1983841.68,-546209972.27,Woods,448,Spain,95215.73,0,1,0
7350,2011,8,MORTGAGE,3,Low,1,12000, 36 months,1,debt_consolidation,6,Low,1,Bad Loan,1,6.62,A,1,12.42,11053.5,9814.76,19.04,368.45,409000007349,8-Feb-19,FDRL/INTERNAL FUND TRANSFE,"1,000,000.00",,-547209972.27,Docherty,632,Germany,148172.94,0,1,0
7351,2011,10,RENT,1,Low,1,23000, 60 months,2,debt_consolidation,6,High,2,Good Loan,0,18.25,D,4,5.78,27238.54,23000,0,587.19,409000007350,8-Feb-19,FDRL/INTERNAL FUND TRANSFE,"1,000,000.00",,-548209972.27,Lin,669,Spain,124382.90,0,1,0
7352,2011,1,MORTGAGE,3,Low,1,2500, 36 months,1,home_improvement,7,Low,1,Good Loan,0,6.03,A,1,2.96,2536.93,2500,0,76.09,409000007351,8-Feb-19,Indiaforensic VISA ACQ DOM080219,,3175922.78,-545034049.49,Cheng,654,Spain,159311.46,0,1,0
7353,2011,5,OWN,2,Medium,2,5000, 36 months,1,other,4,Low,1,Good Loan,0,12.69,B,2,18.59,6033.023828,5000,0,167.73,409000007352,8-Feb-19,FDRL/INTERNAL FUND TRANSFE,"3,000,000.00",,-548034049.49,Korovina,726,France,6787.48,0,1,0
7354,2011,0.5,MORTGAGE,3,Low,1,24000, 60 months,2,debt_consolidation,6,High,2,Good Loan,0,16.77,D,4,22.12,24976.08,15695.22,0,490.88,409000007353,8-Feb-19,FDRL/INTERNAL FUND TRANSFE,"200,000.00",,-548234049.49,Macdonald,596,France,197297.77,0,1,0
7355,2011,10,MORTGAGE,3,Low,1,25000, 60 months,2,debt_consolidation,6,Low,1,Good Loan,0,12.42,B,2,6.53,28619.16,20190.65,0,561.44,409000007354,8-Feb-19,Indiaforensic VISA ACQ INT 06021,,1544.98,-548232504.51,Hardy,733,Germany,21556.95,0,1,0
7356,2011,10,RENT,1,Low,1,3000, 36 months,1,other,4,High,2,Good Loan,0,13.49,C,3,19.44,3660.529744,3000,0,101.8,409000007355,8-Feb-19,Indiaforensic RUPAY POS ACQ08021,,1231408.95,-547001095.56,Shaw,529,Spain,56518.00,0,1,0
7357,2011,2,RENT,1,Low,1,20000, 60 months,2,debt_consolidation,6,High,2,Bad Loan,1,18.25,D,4,22.72,11536.43,4776.39,874.07,510.6,409000007356,8-Feb-19,Indiaforensic RUPAY POS C2 ACQ08,,386359.57,-546614735.99,Knight,493,France,158840.99,0,1,0
7358,2011,10,MORTGAGE,3,Low,1,5000, 36 months,1,credit_card,1,Low,1,Good Loan,0,6.03,A,1,16.03,5293.19,5000,0,152.18,409000007357,11-Feb-19,FDRL/INTERNAL FUND TRANSFE,"1,000,000.00",,-547614735.99,Bruny,615,Spain,126396.01,0,1,0
7359,2011,10,MORTGAGE,3,High,3,30000, 36 months,1,debt_consolidation,6,Low,1,Good Loan,0,11.71,B,2,8.79,35713.583,30000,0,992.28,409000007358,11-Feb-19,FDRL/INTERNAL FUND TRANSFE,"300,000.00",,-547914735.99,Ikedinachukwu,600,France,148087.88,0,1,0
7360,2011,10,MORTGAGE,3,Low,1,12000, 60 months,2,credit_card,1,High,2,Bad Loan,1,18.64,E,5,12.93,11657.44,5439.06,920.24,308.92,409000007359,11-Feb-19,FDRL/INTERNAL FUND TRANSFE,"300,000.00",,-548214735.99,Moran,666,France,33701.50,0,1,0
7361,2011,8,MORTGAGE,3,Medium,2,4000, 36 months,1,home_improvement,7,Low,1,Good Loan,0,10.65,B,2,21.06,4572.92,4000,0,130.3,409000007360,11-Feb-19,ICA 17825 Indiaforensic MC DOM 1,,5829289.30,-542385446.69,Macleod,644,Spain,84622.37,0,1,0
7362,2011,3,RENT,1,Low,1,12000, 36 months,1,wedding,5,Low,1,Good Loan,0,9.91,B,2,9.44,13918.05311,12000,0,386.7,409000007361,11-Feb-19,FDRL/INTERNAL FUND TRANSFE,"500,000.00",,-542885446.69,Yin,692,France,185580.89,0,1,0
7363,2011,10,MORTGAGE,3,Low,1,1800, 36 months,1,home_improvement,7,Low,1,Good Loan,0,12.42,B,2,7.31,2162.365314,1800,0,60.15,409000007362,11-Feb-19,FDRL/INTERNAL FUND TRANSFE,"300,000.00",,-543185446.69,Felix,707,France,62768.80,0,1,0
7364,2011,10,OWN,2,Medium,2,16500, 60 months,2,car,2,High,2,Good Loan,0,14.65,C,3,4.35,19861.93,13197.48,0,389.51,409000007363,11-Feb-19,FDRL/INTERNAL FUND TRANSFE,"5,000,000.00",,-548185446.69,Rippey,603,France,38829.11,0,1,0
7365,2011,7,RENT,1,Low,1,4000, 60 months,2,small_business,3,High,2,Good Loan,0,13.49,C,3,18.17,5401.322979,4000,0,92.02,409000007364,11-Feb-19,Indiaforensic VISA ACQ DOM090219,,2559581.46,-545625865.23,Mishina,671,France,110748.88,0,1,0
7366,2011,2,MORTGAGE,3,Medium,2,35000, 60 months,2,debt_consolidation,6,High,2,Good Loan,0,13.49,C,3,20.47,29272.37,20065.99,0,574.55,409000007365,11-Feb-19,Indiaforensic VISA ACQ INT 07021,,308.37,-545625556.86,Graham,568,Spain,54083.80,0,1,0
7367,2011,0.5,MORTGAGE,3,Low,1,10000, 36 months,1,home_improvement,7,Low,1,Good Loan,0,6.03,A,1,5.28,10703.8,10000,0,304.36,409000007366,11-Feb-19,Indiaforensic RUPAY POS ACQ09021,,1058578.37,-544566978.49,Johnston,598,Spain,88658.73,0,1,0
7368,2011,3,RENT,1,Low,1,18000, 60 months,2,moving,10,Low,1,Bad Loan,1,10.65,B,2,16.52,1161.06,689.39,0,388.23,409000007367,11-Feb-19,Indiaforensic RUPAY POS ACQ10021,,1887208.55,-542679769.94,Korovin,606,Spain,177938.52,0,1,0
7369,2011,0.5,RENT,1,Low,1,6800, 60 months,2,debt_consolidation,6,High,2,Good Loan,0,13.49,C,3,13.64,7452.7,6800,0,156.44,409000007368,11-Feb-19,Indiaforensic VISA ACQ DOM110219,,5315327.98,-537364441.96,Lei,850,Germany,174235.06,0,1,0
7370,2011,0.5,RENT,1,Medium,2,7400, 36 months,1,moving,10,Low,1,Good Loan,0,6.03,A,1,0.15,8107.76489,7400,0,225.23,409000007369,11-Feb-19,Indiaforensic RUPAY POS ACQ11021,,1492207.60,-535872234.36,Chimaijem,644,Spain,82696.84,0,1,0
7371,2011,3,RENT,1,Low,1,10000, 36 months,1,credit_card,1,Low,1,Good Loan,0,6.62,A,1,17.11,10992.62,10000,0,307.04,409000007370,11-Feb-19,Indiaforensic RUPAY POS C2 ACQ11,,288784.96,-535583449.40,Scott,655,France,142415.97,0,1,0
7372,2011,0.5,RENT,1,Low,1,12000, 60 months,2,debt_consolidation,6,High,2,Bad Loan,1,13.49,C,3,7.12,5796.14,3310.42,20.09,276.06,409000007371,11-Feb-19,FDRL/INTERNAL FUND TRANSFE,"10,000,000.00",,-545583449.40,Grant,850,France,62811.03,0,1,0
7373,2011,10,RENT,1,Low,1,2000, 36 months,1,major_purchase,8,Low,1,Good Loan,0,10.65,B,2,13.95,2343.753244,2000,0,65.15,409000007372,11-Feb-19,FDRL/INTERNAL FUND TRANSFE,"300,000.00",,-545883449.40,McIntyre,683,Spain,25339.29,0,1,0
7374,2011,5,RENT,1,Low,1,5825, 36 months,1,debt_consolidation,6,High,2,Good Loan,0,14.27,C,3,23.72,6644.1,5825,0,199.85,409000007373,11-Feb-19,FDRL/INTERNAL FUND TRANSFE,"2,000,000.00",,-547883449.40,Griffin,663,Germany,176487.05,0,1,0
7375,2011,1,RENT,1,Low,1,8400, 36 months,1,debt_consolidation,6,Low,1,Good Loan,0,7.9,A,1,16.29,9461.532431,8400,0,262.84,409000007374,11-Feb-19,FDRL/INTERNAL FUND TRANSFE,"300,000.00",,-548183449.40,Converse,682,Germany,49833.50,0,1,0
7376,2011,10,MORTGAGE,3,Low,1,35000, 60 months,2,credit_card,1,High,2,Good Loan,0,16.49,D,4,21.38,22272.53,18225,0,447.96,409000007375,11-Feb-19,ICA 17825 Indiaforensic MC INT 0,,2918.98,-548180530.42,Ch'ang,639,France,55829.25,0,1,0
7377,2011,2,MORTGAGE,3,Low,1,15000, 60 months,2,debt_consolidation,6,High,2,Bad Loan,1,18.25,D,4,19.56,4938.05,1878.7,649.71,329.98,409000007376,12-Feb-19,ICA 17825 Indiaforensic MC DOM 1,,2176117.11,-546004413.31,Coates,704,France,155823.20,0,1,0
7378,2011,1,MORTGAGE,3,Low,1,16000, 36 months,1,debt_consolidation,6,High,2,Good Loan,0,13.49,C,3,16.76,19534.16074,16000,0,542.89,409000007377,12-Feb-19,FDRL/INTERNAL FUND TRANSFE,"1,000,000.00",,-547004413.31,Reid,691,France,60622.61,0,1,0
7379,2011,4,RENT,1,Low,1,16500, 36 months,1,debt_consolidation,6,Low,1,Good Loan,0,7.9,A,1,14.73,18087.01,16500,0,516.29,409000007378,12-Feb-19,FDRL/INTERNAL FUND TRANSFE,"1,000,000.00",,-548004413.31,Ts'ui,599,France,174196.68,0,1,0
7380,2011,0.5,MORTGAGE,3,Medium,2,35000, 36 months,1,debt_consolidation,6,High,2,Good Loan,0,17.58,D,4,18.54,44898.27898,35000,0,1257.98,409000007379,12-Feb-19,FDRL/INTERNAL FUND TRANSFE,"200,000.00",,-548204413.31,Belstead,573,France,56905.38,0,1,0
7381,2011,2,RENT,1,Low,1,8000, 36 months,1,debt_consolidation,6,High,2,Good Loan,0,13.49,C,3,18.85,9748.308843,8000,0,271.45,409000007380,12-Feb-19,ICA 17825 Indiaforensic MC INT 0,,7467.90,-548196945.41,Dickinson,589,Germany,101178.85,0,1,0
7382,2011,10,MORTGAGE,3,High,3,30000, 60 months,2,home_improvement,7,High,2,Good Loan,0,14.27,C,3,11.5,26808.01986,20275,0,474.61,409000007381,12-Feb-19,Indiaforensic VISA ACQ DOM120219,,2861311.35,-545335634.06,Nwora,620,Germany,73857.94,0,1,0
7383,2011,8,OWN,2,Low,1,12150, 36 months,1,debt_consolidation,6,Low,1,Good Loan,0,6.62,A,1,7.65,13428.77697,12150,0,373.05,409000007382,12-Feb-19,Indiaforensic RUPAY POS ACQ12021,,488946.20,-544846687.86,Bishop,647,Spain,102325.19,0,1,0
7384,2011,3,OWN,2,Low,1,7200, 36 months,1,credit_card,1,Low,1,Good Loan,0,7.51,A,1,9.95,7833.86,7200,0,224,409000007383,12-Feb-19,Indiaforensic VISA ACQ INT 08021,,2522.09,-544844165.77,Loggia,737,Spain,55356.39,0,1,0
7385,2011,7,MORTGAGE,3,Low,1,5500, 36 months,1,credit_card,1,High,2,Good Loan,0,13.49,C,3,4.18,6346.31,5500,0,186.62,409000007384,12-Feb-19,FDRL/INTERNAL FUND TRANSFE,"200,000.00",,-545044165.77,Rowe,634,France,131284.93,0,1,0
7386,2011,10,MORTGAGE,3,Medium,2,25000, 60 months,2,debt_consolidation,6,High,2,Good Loan,0,14.27,C,3,16.33,29794.42,20003.62,0,585.22,409000007385,12-Feb-19,FDRL/INTERNAL FUND TRANSFE,"1,000,000.00",,-546044165.77,Balashov,660,France,88080.43,0,1,0
7387,2011,10,MORTGAGE,3,Medium,2,14000, 60 months,2,home_improvement,7,High,2,Good Loan,0,19.42,E,5,4.44,21513.45356,14000,0,366.42,409000007386,12-Feb-19,FDRL/INTERNAL FUND TRANSFE,"2,000,000.00",,-548044165.77,Ulyanova,666,Germany,93266.01,0,1,0
7388,2011,0.5,MORTGAGE,3,Medium,2,7450, 36 months,1,debt_consolidation,6,Low,1,Good Loan,0,11.71,B,2,12.52,8866.554742,7450,0,246.42,409000007387,12-Feb-19,FDRL/INTERNAL FUND TRANSFE,"200,000.00",,-548244165.77,Bogolyubova,696,France,75562.47,0,1,0
7389,2011,2,RENT,1,Low,1,5000, 36 months,1,wedding,5,High,2,Good Loan,0,13.49,C,3,22.09,6103.614773,5000,0,169.66,409000007388,12-Feb-19,Indiaforensic RUPAY POS C2 ACQ12,,1150211.24,-547093954.53,Remington,836,France,153747.73,0,1,0
7390,2011,6.05,OWN,2,Low,1,6000, 36 months,1,house,12,Low,1,Good Loan,0,7.9,A,1,1.88,6757.707754,6000,0,187.75,409000007389,12-Feb-19,FDRL/INTERNAL FUND TRANSFE,"300,000.00",,-547393954.53,Mishin,667,Spain,163830.64,0,1,0
7391,2011,6.05,RENT,1,Low,1,12800, 36 months,1,credit_card,1,Low,1,Good Loan,0,12.69,B,2,20.46,15448.32227,12800,0,429.38,409000007390,12-Feb-19,FDRL/INTERNAL FUND TRANSFE,"500,000.00",,-547893954.53,Tu,596,Spain,103456.47,0,1,0
7392,2011,0.5,RENT,1,Low,1,14000, 36 months,1,debt_consolidation,6,Low,1,Good Loan,0,12.69,B,2,19.64,16895.34463,14000,0,469.63,409000007391,12-Feb-19,FDRL/INTERNAL FUND TRANSFE,"300,000.00",,-548193954.53,Castiglione,430,France,95655.16,0,1,0
7393,2011,10,RENT,1,Low,1,9950, 60 months,2,other,4,Low,1,Good Loan,0,10.65,B,2,1.72,11778.13,9950,0,214.61,409000007392,13-Feb-19,ICA 17825 Indiaforensic MC DOM 1,,2123357.05,-546070597.48,Nnaife,596,Spain,138350.74,0,1,0
7394,2011,5,RENT,1,Low,1,11200, 36 months,1,debt_consolidation,6,High,2,Good Loan,0,16.77,D,4,18.63,14321.2463,11200,0,398.03,409000007393,13-Feb-19,Indiaforensic VISA ACQ DOM130219,,2679669.27,-543390928.21,Yang,599,France,31190.42,0,1,0
7395,2011,5,MORTGAGE,3,Medium,2,21000, 60 months,2,home_improvement,7,Low,1,Good Loan,0,12.69,B,2,3.22,19567.36633,14725,0,332.71,409000007394,13-Feb-19,FDRL/INTERNAL FUND TRANSFE,"1,000,000.00",,-544390928.21,Ayers,519,France,167553.06,0,1,0
7396,2011,4,MORTGAGE,3,Medium,2,15000, 60 months,2,debt_consolidation,6,High,2,Good Loan,0,14.27,C,3,17.12,17440.92,15000.01,0,351.13,409000007395,13-Feb-19,FDRL/INTERNAL FUND TRANSFE,"1,000,000.00",,-545390928.21,Cocci,721,Germany,59604.45,0,1,0
7397,2011,0.5,RENT,1,Medium,2,6500, 36 months,1,debt_consolidation,6,Low,1,Good Loan,0,7.51,A,1,5.88,7071.54,6500,0,202.23,409000007396,13-Feb-19,FDRL/INTERNAL FUND TRANSFE,"200,000.00",,-545590928.21,Mackenzie,603,Spain,162223.67,0,1,0
7398,2011,6.05,OWN,2,Low,1,6000, 36 months,1,other,4,Low,1,Good Loan,0,6.03,A,1,27.95,6588.87861,6000,0,182.62,409000007397,13-Feb-19,Indiaforensic RUPAY POS ACQ13021,,398221.22,-545192706.99,Fiorentini,572,Germany,196549.85,0,1,0
7399,2011,10,MORTGAGE,3,Low,1,15000, 60 months,2,debt_consolidation,6,Low,1,Good Loan,0,7.9,A,1,7.79,18079.38001,15000,0,303.43,409000007398,13-Feb-19,Indiaforensic VISA ACQ INT 09021,,12616.08,-545180090.91,Akabueze,453,Germany,120373.84,0,1,0
7400,2011,4,RENT,1,Low,1,15000, 60 months,2,debt_consolidation,6,High,2,Good Loan,0,17.58,D,4,2.42,19987.41,15000,0,377.49,409000007399,13-Feb-19,Indiaforensic VISA ACQ INT 10021,,3054.53,-545177036.38,Hyde,668,France,92149.64,0,1,0
7401,2011,2,RENT,1,Low,1,2400, 36 months,1,renewable_energy,13,Low,1,Good Loan,0,10.65,B,2,20.47,2805.72,2400,0,78.18,409000007400,13-Feb-19,Indiaforensic VISA ACQ INT 11021,,2648.66,-545174387.72,Levi,762,Germany,178361.48,0,1,0
7402,2011,10,MORTGAGE,3,Low,1,30000, 60 months,2,debt_consolidation,6,Low,1,Good Loan,0,9.91,B,2,6.23,25913.40719,20900,0,443.14,409000007401,13-Feb-19,FDRL/INTERNAL FUND TRANSFE,"3,000,000.00",,-548174387.72,Nwabugwu,633,France,170998.83,0,1,0
7403,2011,2,MORTGAGE,3,Low,1,5000, 36 months,1,other,4,Low,1,Good Loan,0,7.51,A,1,15.61,5091.68,5000,0,155.56,409000007402,13-Feb-19,ICA 17825 Indiaforensic MC INT12,,109.24,-548174278.48,Chia,647,Spain,77216.48,0,1,0
7404,2011,8,MORTGAGE,3,Low,1,12375, 36 months,1,debt_consolidation,6,Low,1,Good Loan,0,9.91,B,2,24.85,14144.31,12375,0,398.79,409000007403,13-Feb-19,Indiaforensic RUPAY POS C2 ACQ13,,1223341.57,-546950936.91,Trevisano,796,Spain,121164.60,0,1,0
7405,2011,5,MORTGAGE,3,Medium,2,14650, 60 months,2,debt_consolidation,6,High,2,Good Loan,0,15.27,C,3,6.82,20837.29996,14650,0,350.61,409000007404,13-Feb-19,FDRL/INTERNAL FUND TRANSFE,"1,000,000.00",,-547950936.91,Bennetts,733,France,141841.31,0,1,0
7406,2011,2,OWN,2,Low,1,6000, 36 months,1,major_purchase,8,High,2,Good Loan,0,15.27,C,3,4.57,7510.739817,6000,0,208.79,409000007405,13-Feb-19,FDRL/INTERNAL FUND TRANSFE,"300,000.00",,-548250936.91,Teng,556,France,104000.06,0,1,0
7407,2011,10,MORTGAGE,3,Low,1,15875, 36 months,1,credit_card,1,Low,1,Good Loan,0,7.9,A,1,17.16,17881.66435,15875,0,496.74,409000007406,14-Feb-19,ICA 17825 Indiaforensic MC INT13,,1013.10,-548249923.81,Hsueh,489,Spain,191419.32,0,1,0
7408,2011,10,MORTGAGE,3,Low,1,20000, 36 months,1,debt_consolidation,6,Low,1,Good Loan,0,8.9,A,1,4,22762.03556,20000,0,635.07,409000007407,14-Feb-19,ICA 17825 Indiaforensic MC DOM 1,,2061913.07,-546188010.74,Mahmood,639,France,28188.96,0,1,0
7409,2011,10,MORTGAGE,3,Low,1,35000, 60 months,2,debt_consolidation,6,High,2,Bad Loan,1,22.06,F,6,10.99,15425.99,4712.62,1749.35,967.86,409000007408,14-Feb-19,FDRL/INTERNAL FUND TRANSFE,"2,000,000.00",,-548188010.74,Sinclair,715,France,60407.93,0,1,0
7410,2011,7,MORTGAGE,3,Low,1,4750, 36 months,1,debt_consolidation,6,High,2,Bad Loan,1,15.27,C,3,17.04,2335.95,1460.35,202.05,165.29,409000007409,14-Feb-19,Indiaforensic VISA ACQ DOM140219,,2492430.28,-545695580.46,Chin,807,Germany,130489.37,0,1,0
7411,2011,10,OWN,2,Low,1,13000, 60 months,2,debt_consolidation,6,Low,1,Good Loan,0,10.65,B,2,16.82,14242.49,10546.93,0,280.39,409000007410,14-Feb-19,Indiaforensic VISA ACQ INT 12021,,1192.94,-545694387.52,She,714,Spain,193040.32,0,1,0
7412,2011,1,RENT,1,Low,1,7000, 36 months,1,debt_consolidation,6,High,2,Good Loan,0,20.89,F,6,5.68,7956.8,7000,0,263.34,409000007411,14-Feb-19,Indiaforensic RUPAY POS ACQ14021,,1220794.77,-544473592.75,He,626,Germany,109742.80,0,1,0
7413,2011,6,RENT,1,Low,1,11200, 36 months,1,credit_card,1,Low,1,Good Loan,0,6.62,A,1,22.27,12128.53,11200,0,343.89,409000007412,14-Feb-19,Indiaforensic RUPAY POS C2 ACQ14,,234374.95,-544239217.80,Hill,697,France,74760.32,0,1,0
7414,2011,10,MORTGAGE,3,Low,1,16000, 36 months,1,credit_card,1,Low,1,Good Loan,0,10.65,B,2,17.61,18756.43418,16000,0,521.18,409000007413,14-Feb-19,FDRL/INTERNAL FUND TRANSFE,"3,000,000.00",,-547239217.80,Vachon,850,Germany,61936.10,0,1,0
7415,2011,2,MORTGAGE,3,Low,1,1750, 36 months,1,car,2,Low,1,Good Loan,0,10.65,B,2,21.28,2050.866362,1750,0,57.01,409000007414,14-Feb-19,FDRL/INTERNAL FUND TRANSFE,"500,000.00",,-547739217.80,Ball,737,Germany,78650.95,0,1,0
7416,2011,4,MORTGAGE,3,Low,1,4500, 36 months,1,debt_consolidation,6,High,2,Bad Loan,1,14.65,C,3,13.02,2598.24,201.33,2288.52,155.23,409000007415,14-Feb-19,FDRL/INTERNAL FUND TRANSFE,"300,000.00",,-548039217.80,Hsieh,812,France,168023.60,0,1,0
7417,2011,10,MORTGAGE,3,Low,1,20375, 60 months,2,debt_consolidation,6,High,2,Good Loan,0,20.3,E,5,24.04,26266.89,20375,0,543.22,409000007416,14-Feb-19,FDRL/INTERNAL FUND TRANSFE,"200,000.00",,-548239217.80,Baker,583,France,5571.59,0,1,0
7418,2011,4,RENT,1,Low,1,3600, 36 months,1,house,12,High,2,Good Loan,0,16.77,D,4,8.23,4658.178562,3600,0,127.94,409000007417,15-Feb-19,ICA 17825 Indiaforensic MC DOM 1,,1936494.87,-546302722.93,Monaldo,730,Germany,118591.67,0,1,0
7419,2011,3,RENT,1,Low,1,3000, 36 months,1,other,4,High,2,Bad Loan,1,19.03,E,5,13.25,1125.32,597.26,138.02,110.02,409000007418,15-Feb-19,ICA 17825 Indiaforensic MC INT14,,102797.95,-546199924.98,Lucchesi,677,France,7824.31,0,1,0
7420,2011,6,MORTGAGE,3,Low,1,35000, 60 months,2,house,12,Low,1,Good Loan,0,11.71,B,2,1.9,30035.71,21602.21,0,589.47,409000007419,15-Feb-19,FDRL/INTERNAL FUND TRANSFE,"2,000,000.00",,-548199924.98,Hamilton,748,Germany,38153.19,0,1,0
7421,2011,10,MORTGAGE,3,Low,1,15000, 36 months,1,debt_consolidation,6,High,2,Good Loan,0,15.96,C,3,18.53,17984.51,15000,0,527.06,409000007420,15-Feb-19,Indiaforensic VISA ACQ DOM150219,,2279691.01,-545920233.97,Kuo,753,Germany,180829.99,0,1,0
7422,2011,10,MORTGAGE,3,Medium,2,15000, 60 months,2,debt_consolidation,6,High,2,Good Loan,0,18.25,D,4,4.61,16956.52,15000,0,382.95,409000007421,15-Feb-19,Indiaforensic VISA ACQ INT 13021,,6859.18,-545913374.79,Fan,634,Spain,143960.72,0,1,0
7423,2011,10,MORTGAGE,3,Medium,2,24000, 60 months,2,debt_consolidation,6,Low,1,Good Loan,0,12.69,B,2,20.87,30692.0331,24000,0,542.28,409000007422,15-Feb-19,Indiaforensic RUPAY POS ACQ15021,,1160942.19,-544752432.60,Wright,622,France,8788.35,0,1,0
7424,2011,3,RENT,1,Low,1,6000, 36 months,1,other,4,Low,1,Good Loan,0,6.62,A,1,3.99,6630.648643,6000,0,184.23,409000007423,15-Feb-19,Indiaforensic RUPAY POS C2 ACQ15,,298115.90,-544454316.70,Milano,699,Germany,103557.85,0,1,0
7425,2011,10,MORTGAGE,3,Low,1,6000, 36 months,1,other,4,Low,1,Good Loan,0,8.9,A,1,17.28,6693.23,6000,0,190.52,409000007424,15-Feb-19,FDRL/INTERNAL FUND TRANSFE,"2,000,000.00",,-546454316.70,Wall,570,Germany,147168.28,0,1,0
7426,2011,4,RENT,1,Low,1,10825, 36 months,1,debt_consolidation,6,Low,1,Good Loan,0,10.65,B,2,11.55,12689.25858,10825,0,352.61,409000007425,15-Feb-19,FDRL/INTERNAL FUND TRANSFE,"300,000.00",,-546754316.70,Chidumaga,552,Germany,58844.84,0,1,0
7427,2011,1,RENT,1,Low,1,8500, 36 months,1,debt_consolidation,6,Low,1,Good Loan,0,7.9,A,1,16.95,8862.59,8500,0,265.97,409000007426,15-Feb-19,FDRL/INTERNAL FUND TRANSFE,"1,000,000.00",,-547754316.70,Olisaemeka,619,France,18094.96,0,1,0
7428,2011,0.5,RENT,1,Low,1,2000, 36 months,1,car,2,Low,1,Good Loan,0,12.42,B,2,15.68,2296.75,2000,0,66.84,409000007427,15-Feb-19,FDRL/INTERNAL FUND TRANSFE,"500,000.00",,-548254316.70,Kovalyova,714,Spain,162515.17,0,1,0
7429,2011,10,MORTGAGE,3,Low,1,16000, 60 months,2,home_improvement,7,Low,1,Good Loan,0,11.71,B,2,20.76,18014.31,12956.6,0,353.58,409000007428,16-Feb-19,Indiaforensic VISA ACQ DOM160219,,2537022.66,-545717294.04,Onio,503,Spain,157921.25,0,1,0
7430,2011,4,MORTGAGE,3,Low,1,1000, 36 months,1,debt_consolidation,6,Low,1,Bad Loan,1,6.62,A,1,24,301.12,230.07,26.8,30.71,409000007429,16-Feb-19,Indiaforensic RUPAY POS ACQ16021,,383102.14,-545334191.90,Hill,685,Spain,68701.73,0,1,0
7431,2011,1,MORTGAGE,3,Low,1,13000, 36 months,1,debt_consolidation,6,Low,1,Good Loan,0,6.03,A,1,11.73,14258.5709,13000,0,395.67,409000007430,16-Feb-19,FDRL/INTERNAL FUND TRANSFE,"500,000.00",,-545834191.90,Okeke,606,France,186778.89,0,1,0
7432,2011,0.5,RENT,1,Low,1,2000, 36 months,1,debt_consolidation,6,Low,1,Good Loan,0,10.65,B,2,21.23,2344.373136,2000,0,65.15,409000007431,16-Feb-19,FDRL/INTERNAL FUND TRANSFE,"2,000,000.00",,-547834191.90,Upjohn,678,France,66561.60,0,1,0
7433,2011,2,MORTGAGE,3,Low,1,9000, 36 months,1,debt_consolidation,6,Low,1,Good Loan,0,7.9,A,1,13.82,10018.8,9000,0,281.62,409000007432,16-Feb-19,FDRL/INTERNAL FUND TRANSFE,"200,000.00",,-548034191.90,H?,724,Germany,64831.36,0,1,0
7434,2011,3,RENT,1,Low,1,10000, 36 months,1,vacation,11,Low,1,Good Loan,0,6.62,A,1,8.8,10922.76,10000,0,307.04,409000007433,16-Feb-19,FDRL/INTERNAL FUND TRANSFE,"200,000.00",,-548234191.90,Marcus,779,Germany,6589.16,0,1,0
7435,2011,3,OWN,2,Low,1,15000, 36 months,1,home_improvement,7,Low,1,Good Loan,0,6.62,A,1,2.68,16144.67,15000,0,460.56,409000007434,16-Feb-19,Indiaforensic RUPAY POS C2 ACQ16,,1043910.03,-547190281.87,Yobachukwu,638,Spain,165370.66,0,1,0
7436,2011,10,RENT,1,Low,1,5600, 36 months,1,debt_consolidation,6,High,2,Good Loan,0,15.96,C,3,19.99,6677.16,5600,0,196.77,409000007435,18-Feb-19,FDRL/INTERNAL FUND TRANSFE,"1,000,000.00",,-548190281.87,Russell,610,Spain,184758.17,0,1,0
7437,2011,6,OWN,2,Low,1,22000, 60 months,2,major_purchase,8,Low,1,Good Loan,0,10.65,B,2,9.47,24003.32,22000,0,474.51,409000007436,18-Feb-19,ICA 17825 Indiaforensic MC DOM 1,,5028161.86,-543162120.01,Hovell,646,Germany,13911.27,0,1,0
7438,2011,10,MORTGAGE,3,Low,1,30000, 60 months,2,debt_consolidation,6,High,2,Good Loan,0,13.49,C,3,22.3,40615.90696,30000,0,690.15,409000007437,18-Feb-19,FDRL/INTERNAL FUND TRANSFE,"2,000,000.00",,-545162120.01,Chukwumaobim,628,France,34857.46,0,1,0
7439,2011,4,RENT,1,Low,1,4500, 36 months,1,credit_card,1,Low,1,Good Loan,0,6.62,A,1,24.36,4972.537463,4500,0,138.17,409000007438,18-Feb-19,FDRL/INTERNAL FUND TRANSFE,"3,000,000.00",,-548162120.01,Boyle,528,France,156192.43,0,1,0
7440,2011,9,OWN,2,Medium,2,11900, 60 months,2,car,2,Low,1,Good Loan,0,10.65,B,2,11.88,13246.76,11900,0,256.67,409000007439,18-Feb-19,Indiaforensic RUPAY POS ACQ17021,,397476.94,-547764643.07,Scott,432,France,53874.67,0,1,0
7441,2011,7,RENT,1,Low,1,11425, 36 months,1,debt_consolidation,6,Low,1,Good Loan,0,7.51,A,1,26,12794.91883,11425,0,355.45,409000007440,18-Feb-19,Indiaforensic VISA ACQ DOM180219,,4335861.86,-543428781.21,Johnstone,622,Spain,100183.05,0,1,0
7442,2011,1,MORTGAGE,3,Medium,2,10000, 60 months,2,debt_consolidation,6,High,2,Good Loan,0,15.96,C,3,7.01,12361.31,7935.5,0,242.97,409000007441,18-Feb-19,Indiaforensic RUPAY POS ACQ18021,,1562802.81,-541865978.40,Alvares,721,France,4493.12,0,1,0
7443,2011,10,RENT,1,Low,1,19750, 60 months,2,debt_consolidation,6,High,2,Good Loan,0,18.25,D,4,22.65,27164.86047,19750,0,504.22,409000007442,18-Feb-19,FDRL/INTERNAL FUND TRANSFE,"200,000.00",,-542065978.40,McDavid,614,Spain,130610.78,0,1,0
7444,2011,4,MORTGAGE,3,Low,1,7000, 36 months,1,debt_consolidation,6,Low,1,Good Loan,0,8.9,A,1,12.16,8000.574953,7000,0,222.28,409000007443,18-Feb-19,FDRL/INTERNAL FUND TRANSFE,"200,000.00",,-542265978.40,Dellucci,634,France,63340.65,0,1,0
7445,2011,10,MORTGAGE,3,Low,1,12000, 60 months,2,other,4,High,2,Good Loan,0,13.49,C,3,5.72,14047.16,9630.67,0,276.06,409000007444,18-Feb-19,FDRL/INTERNAL FUND TRANSFE,"2,000,000.00",,-544265978.40,Brothers,742,France,180066.59,0,1,0
7446,2011,10,RENT,1,Low,1,35000, 60 months,2,debt_consolidation,6,High,2,Good Loan,0,13.49,C,3,18.7,47589.60284,35000,0,805.17,409000007445,18-Feb-19,FDRL/INTERNAL FUND TRANSFE,"2,000,000.00",,-546265978.40,Sanders,516,France,95273.73,0,1,0
7447,2011,10,MORTGAGE,3,Low,1,10000, 36 months,1,major_purchase,8,High,2,Good Loan,0,14.65,C,3,19.25,10582.9,10000,0,344.95,409000007446,18-Feb-19,FDRL/INTERNAL FUND TRANSFE,"2,000,000.00",,-548265978.40,Morrison,718,France,53511.74,0,1,0
7448,2011,10,MORTGAGE,3,Low,1,7000, 36 months,1,other,4,Low,1,Good Loan,0,9.91,B,2,10.8,8080.49495,7000,0,225.58,409000007447,18-Feb-19,Indiaforensic RUPAY POS C2 ACQ18,,200649.95,-548065328.45,Molle,636,Germany,109685.61,0,1,0
7449,2011,6.05,RENT,1,Low,1,2000, 36 months,1,moving,10,Low,1,Bad Loan,1,9.91,B,2,19.92,1413.5,1147.64,0,64.45,409000007448,19-Feb-19,FDRL/INTERNAL FUND TRANSFE,"200,000.00",,-548265328.45,Genovese,691,Spain,75664.56,0,1,0
7450,2011,4,RENT,1,Low,1,4200, 36 months,1,debt_consolidation,6,Low,1,Good Loan,0,8.9,A,1,13.04,4798.64997,4200,0,133.37,409000007449,19-Feb-19,Indiaforensic RUPAY POS ACQ19021,,1012180.53,-547253147.92,Zetticci,698,France,71972.95,0,1,0
7451,2011,10,MORTGAGE,3,Low,1,12000, 60 months,2,medical,9,High,2,Bad Loan,1,16.77,D,4,10.88,2076.28,936.88,10.58,296.75,409000007450,19-Feb-19,FDRL/INTERNAL FUND TRANSFE,"500,000.00",,-547753147.92,Hsueh,712,Spain,23702.42,0,1,0
7452,2011,7,MORTGAGE,3,Low,1,22000, 36 months,1,debt_consolidation,6,Low,1,Good Loan,0,10.65,B,2,20.02,25791.66834,22000,0,716.62,409000007451,19-Feb-19,FDRL/INTERNAL FUND TRANSFE,"500,000.00",,-548253147.92,Alexander,659,France,112572.02,0,1,0
7453,2011,1,MORTGAGE,3,Low,1,8500, 36 months,1,debt_consolidation,6,High,2,Bad Loan,1,15.96,C,3,20.14,6271.53,4449.41,18.36,298.67,409000007452,19-Feb-19,Indiaforensic RUPAY POS C2 ACQ19,,314738.49,-547938409.43,Muravyova,573,Spain,62424.46,0,1,0
7454,2011,8,MORTGAGE,3,Low,1,4375, 36 months,1,credit_card,1,Low,1,Good Loan,0,6.62,A,1,27.95,4834.901999,4375,0,134.33,409000007453,19-Feb-19,FDRL/INTERNAL FUND TRANSFE,"300,000.00",,-548238409.43,Wright,778,Germany,131238.37,0,1,0
7455,2011,5,RENT,1,Low,1,7200, 36 months,1,credit_card,1,Low,1,Good Loan,0,10.65,B,2,20.95,8439.884744,7200,0,234.53,409000007454,20-Feb-19,ICA 17825 Indiaforensic MC DOM 2,,3133915.86,-545104493.57,Calabresi,732,France,184350.78,0,1,0
7456,2011,10,MORTGAGE,3,Low,1,1000, 36 months,1,other,4,High,2,Bad Loan,1,15.27,C,3,10.42,1072.26,799.1,28.26,34.8,409000007455,20-Feb-19,FDRL/INTERNAL FUND TRANSFE,"3,000,000.00",,-548104493.57,Johnson,550,Germany,13999.64,0,1,0
7457,2011,1,MORTGAGE,3,Low,1,20000, 60 months,2,debt_consolidation,6,High,2,Good Loan,0,14.65,C,3,27.64,26247.12126,20000,0,472.14,409000007456,20-Feb-19,ICA 17825 Indiaforensic MC INT16,,35524.13,-548068969.44,Lucchesi,790,Spain,168152.76,0,1,0
7458,2011,2,MORTGAGE,3,Low,1,1400, 36 months,1,renewable_energy,13,Low,1,Good Loan,0,6.03,A,1,1.92,1548.800713,1400,0,42.61,409000007457,20-Feb-19,Indiaforensic VISA ACQ DOM190219,,2403172.20,-545665797.24,Galgano,665,Germany,35640.12,0,1,0
7459,2011,10,MORTGAGE,3,Low,1,24700, 60 months,2,debt_consolidation,6,High,2,Good Loan,0,17.58,D,4,19.14,31911.01,19802.42,0,621.59,409000007458,20-Feb-19,Indiaforensic VISA ACQ DOM200219,,1786893.45,-543878903.79,Grigoryeva,728,Spain,120088.17,0,1,0
7460,2011,10,MORTGAGE,3,High,3,15000, 36 months,1,debt_consolidation,6,High,2,Good Loan,0,17.58,D,4,4.46,18297.51,15000,0,539.14,409000007459,20-Feb-19,Indiaforensic VISA ACQ INT 15021,,8421.38,-543870482.41,Raymond,645,Spain,74346.11,0,1,0
7461,2011,7,RENT,1,Medium,2,35000, 60 months,2,debt_consolidation,6,High,2,Good Loan,0,15.96,C,3,13.05,39817.03,35000.01,0,850.39,409000007460,20-Feb-19,FDRL/INTERNAL FUND TRANSFE,"2,000,000.00",,-545870482.41,Paterson,647,Germany,2955.46,0,1,0
7462,2011,5,MORTGAGE,3,Low,1,35000, 60 months,2,small_business,3,Low,1,Bad Loan,1,11.49,B,2,15.05,18209.55,10123.13,1470.62,769.57,409000007461,20-Feb-19,FDRL/INTERNAL FUND TRANSFE,"2,000,000.00",,-547870482.41,Genovese,596,Spain,146504.35,0,1,0
7463,2011,10,MORTGAGE,3,Low,1,13600, 36 months,1,debt_consolidation,6,Low,1,Bad Loan,1,12.42,B,2,12.46,1200.83,313.26,747,454.45,409000007462,20-Feb-19,FDRL/INTERNAL FUND TRANSFE,"200,000.00",,-548070482.41,Martin,610,France,149602.54,0,1,0
7464,2011,6,RENT,1,Low,1,4000, 36 months,1,other,4,High,2,Good Loan,0,19.03,E,5,10.56,5197.75,4000,0,146.69,409000007463,20-Feb-19,FDRL/INTERNAL FUND TRANSFE,"200,000.00",,-548270482.41,Moretti,512,France,53020.90,0,1,0
7465,2011,4,RENT,1,Low,1,13000, 36 months,1,debt_consolidation,6,Low,1,Good Loan,0,9.91,B,2,19.13,14858.12,13000,0,418.93,409000007464,20-Feb-19,Indiaforensic RUPAY POS ACQ20021,,941338.65,-547329143.76,Leckie,768,Germany,41788.25,0,1,0
7466,2011,10,MORTGAGE,3,Low,1,16425, 36 months,1,debt_consolidation,6,Low,1,Good Loan,0,7.9,A,1,20.81,18501.24571,16425,0,513.95,409000007465,20-Feb-19,Indiaforensic RUPAY POS C2 ACQ20,,229681.77,-547099461.99,Lane,666,Germany,74849.46,0,1,0
7467,2011,2,MORTGAGE,3,Low,1,7000, 36 months,1,home_improvement,7,Low,1,Good Loan,0,10.65,B,2,8.45,8200.033329,7000,0,228.02,409000007466,20-Feb-19,Indiaforensic RUPAY POS C2 ACQ15,"298,115.90",,-547397577.89,Brodney,700,Germany,134417.31,0,1,0
7468,2011,10,MORTGAGE,3,Low,1,32000, 60 months,2,debt_consolidation,6,High,2,Good Loan,0,23.52,G,7,17.65,46459.45,24530.36,0,911.69,409000007467,20-Feb-19,Indiaforensic RUPAY POS C2 ACQ15,,299173.31,-547098404.58,Angelo,651,Germany,75837.58,0,1,0
7469,2011,10,MORTGAGE,3,Low,1,15000, 36 months,1,credit_card,1,High,2,Good Loan,0,15.96,C,3,21.35,18448.52,15000,0,527.06,409000007468,21-Feb-19,FDRL/INTERNAL FUND TRANSFE,"300,000.00",,-547398404.58,Millar,542,Spain,54869.54,0,1,0
7470,2011,3,RENT,1,Medium,2,7000, 36 months,1,small_business,3,High,2,Bad Loan,1,16.29,D,4,2.43,1589.1,780.44,355,247.11,409000007469,21-Feb-19,FDRL/INTERNAL FUND TRANSFE,"500,000.00",,-547898404.58,Balashov,686,France,35356.46,0,1,0
7471,2011,6,MORTGAGE,3,Low,1,10000, 36 months,1,debt_consolidation,6,Low,1,Good Loan,0,7.51,A,1,4.04,11196.90531,10000,0,311.11,409000007470,21-Feb-19,FDRL/INTERNAL FUND TRANSFE,"300,000.00",,-548198404.58,Afanasyev,850,Germany,122141.13,0,1,0
7472,2011,2,RENT,1,Low,1,6000, 36 months,1,debt_consolidation,6,Low,1,Good Loan,0,11.71,B,2,2,7123.357551,6000,0,198.46,409000007471,21-Feb-19,Indiaforensic VISA ACQ DOM210219,,2097924.27,-546100480.31,Chialuka,658,Germany,119439.66,0,1,0
7473,2011,10,RENT,1,Low,1,4000, 36 months,1,car,2,Low,1,Good Loan,0,6.62,A,1,10.17,4375.88,4000,0,122.82,409000007472,21-Feb-19,Indiaforensic RUPAY POS ACQ21021,,370353.60,-545730126.71,Yermolayev,448,France,81999.53,0,1,0
7474,2011,6,MORTGAGE,3,Low,1,9800, 36 months,1,car,2,Low,1,Good Loan,0,6.62,A,1,19.07,10772.43,9800,0,300.9,409000007473,21-Feb-19,Indiaforensic VISA ACQ INT 16021,,85263.19,-545644863.52,Tien,609,Spain,120594.85,0,1,0
7475,2011,2,RENT,1,Low,1,2500, 36 months,1,car,2,High,2,Good Loan,0,16.29,D,4,12.59,3191.007981,2500,0,88.26,409000007474,21-Feb-19,Indiaforensic VISA ACQ INT 17021,,525.70,-545644337.82,Lucchesi,704,France,120770.75,0,1,0
7476,2011,10,MORTGAGE,3,Low,1,25000, 60 months,2,debt_consolidation,6,Low,1,Bad Loan,1,12.69,B,2,18.07,21437.34,3478.85,15236.31,564.87,409000007475,21-Feb-19,Indiaforensic VISA ACQ INT 18021,,420.32,-545643917.50,Lai,698,France,134790.74,0,1,0
7477,2011,4,MORTGAGE,3,Low,1,25200, 60 months,2,debt_consolidation,6,High,2,Bad Loan,1,20.3,E,5,14.9,8699.93,2931.96,1298.29,671.86,409000007476,21-Feb-19,FDRL/INTERNAL FUND TRANSFE,"500,000.00",,-546143917.50,Bates,759,France,100137.70,0,1,0
7478,2011,3,RENT,1,Low,1,7200, 36 months,1,credit_card,1,Low,1,Good Loan,0,12.69,B,2,5.65,8019.9,7200,0,241.53,409000007477,21-Feb-19,FDRL/INTERNAL FUND TRANSFE,"2,000,000.00",,-548143917.50,Saunders,677,France,158325.87,0,1,0
7479,2011,10,OWN,2,Medium,2,20000, 36 months,1,other,4,Low,1,Good Loan,0,6.62,A,1,11.81,22105.03628,20000,0,614.08,409000007478,21-Feb-19,ICA 17825 Indiaforensic MC DOM 2,,1701038.73,-546442878.77,Chukwuemeka,544,Spain,70007.67,0,1,0
7480,2011,0.5,MORTGAGE,3,Medium,2,18000, 60 months,2,home_improvement,7,High,2,Good Loan,0,23.91,G,7,9.46,26279.9,13746.8,0,516.89,409000007479,21-Feb-19,FDRL/INTERNAL FUND TRANSFE,"300,000.00",,-546742878.77,Meagher,567,Spain,88659.07,0,1,0
7481,2011,6,RENT,1,Low,1,4000, 36 months,1,car,2,Low,1,Good Loan,0,9.91,B,2,14.6,4635.715366,4000,0,128.9,409000007480,21-Feb-19,FDRL/INTERNAL FUND TRANSFE,"1,000,000.00",,-547742878.77,Golubeva,490,Spain,190889.13,0,1,0
7482,2011,10,MORTGAGE,3,Medium,2,30000, 36 months,1,debt_consolidation,6,High,2,Good Loan,0,18.64,E,5,18.09,39384.66549,30000,0,1094.23,409000007481,21-Feb-19,FDRL/INTERNAL FUND TRANSFE,"500,000.00",,-548242878.77,Collier,626,France,56646.28,0,1,0
7483,2011,8,MORTGAGE,3,Low,1,35000, 36 months,1,debt_consolidation,6,Low,1,Good Loan,0,7.9,A,1,20.22,39425.25815,35000,0,1095.16,409000007482,21-Feb-19,Indiaforensic RUPAY POS C2 ACQ21,,817093.75,-547425785.02,Chan,718,Germany,32999.10,0,1,0
7484,2011,0.5,OWN,2,Low,1,13250, 36 months,1,car,2,Low,1,Good Loan,0,7.9,A,1,1.66,14924.66793,13250,0,414.6,409000007483,21-Feb-19,FDRL/INTERNAL FUND TRANSFE,"200,000.00",,-547625785.02,Chen,616,France,178235.37,0,1,0
7485,2011,5,MORTGAGE,3,Low,1,6000, 36 months,1,debt_consolidation,6,Low,1,Good Loan,0,8.9,A,1,15.88,6856.935375,6000,0,190.52,409000007484,21-Feb-19,FDRL/INTERNAL FUND TRANSFE,"200,000.00",,-547825785.02,Wright,772,France,25448.31,0,1,0
7486,2011,6,MORTGAGE,3,Low,1,10000, 36 months,1,debt_consolidation,6,Low,1,Good Loan,0,9.91,B,2,7.02,11598.03964,10000,0,322.25,409000007485,21-Feb-19,FDRL/INTERNAL FUND TRANSFE,"200,000.00",,-548025785.02,Cocci,561,France,84871.99,0,1,0
7487,2011,0.5,RENT,1,Low,1,14500, 60 months,2,debt_consolidation,6,Low,1,Good Loan,0,11.71,B,2,9.98,15956.11,14500,0,320.43,409000007486,21-Feb-19,FDRL/INTERNAL FUND TRANSFE,"200,000.00",,-548225785.02,Williams,814,France,157822.54,0,1,0
7488,2011,5,RENT,1,Medium,2,30000, 60 months,2,debt_consolidation,6,High,2,Good Loan,0,23.13,G,7,7.01,34402.17,30000,0,847.96,409000007487,22-Feb-19,ICA 17825 Indiaforensic MC DOM 2,,1332982.89,-546892802.13,McGuffog,651,France,84383.22,0,1,0
7489,2011,0.5,RENT,1,Low,1,7500, 36 months,1,wedding,5,Low,1,Good Loan,0,7.51,A,1,5.37,7946.38,7500,0,233.34,409000007488,22-Feb-19,FDRL/INTERNAL FUND TRANSFE,"1,000,000.00",,-547892802.13,Chukwujamuike,538,Germany,119216.46,0,1,0
7490,2011,5,RENT,1,Low,1,9600, 36 months,1,debt_consolidation,6,High,2,Good Loan,0,16.29,D,4,17.82,12178.92273,9600,0,338.89,409000007489,22-Feb-19,Indiaforensic VISA ACQ DOM220219,,1631703.90,-546261098.23,Scott,600,France,82547.01,0,1,0
7491,2011,3,MORTGAGE,3,Low,1,2800, 36 months,1,car,2,Low,1,Good Loan,0,6.03,A,1,7.02,2814.39,2800,0,85.22,409000007490,22-Feb-19,Indiaforensic RUPAY POS ACQ22021,,903091.57,-545358006.66,Bell,654,France,86764.46,0,1,0
7492,2011,8,MORTGAGE,3,Medium,2,35000, 36 months,1,debt_consolidation,6,High,2,Good Loan,0,15.96,C,3,12.23,43238.42,35000,0,1229.81,409000007491,22-Feb-19,Indiaforensic VISA ACQ INT 20021,,3105.44,-545354901.22,Olisaemeka,622,France,197372.13,0,1,0
7493,2011,10,MORTGAGE,3,Low,1,9400, 60 months,2,small_business,3,Low,1,Good Loan,0,10.65,B,2,24.97,10313.28,7636.24,0,202.75,409000007492,22-Feb-19,FDRL/INTERNAL FUND TRANSFE,"2,000,000.00",,-547354901.22,Napolitani,682,France,82872.64,0,1,0
7494,2011,2,RENT,1,Low,1,5200, 36 months,1,credit_card,1,Low,1,Good Loan,0,6.62,A,1,4.53,5743.720205,5200,0,159.66,409000007493,22-Feb-19,FDRL/INTERNAL FUND TRANSFE,"500,000.00",,-547854901.22,Sargood,610,Spain,129563.86,0,1,0
7495,2011,3,MORTGAGE,3,Low,1,12800, 36 months,1,small_business,3,Low,1,Good Loan,0,6.62,A,1,8.23,14147.15806,12800,0,393.01,409000007494,22-Feb-19,Indiaforensic RUPAY POS C2 ACQ22,,209018.89,-547645882.33,Harrington,795,France,135388.89,0,1,0
7496,2011,4,MORTGAGE,3,Low,1,1700, 36 months,1,home_improvement,7,High,2,Good Loan,0,16.77,D,4,19.14,2173.637577,1700,0,60.42,409000007495,22-Feb-19,FDRL/INTERNAL FUND TRANSFE,"500,000.00",,-548145882.33,Sutherland,557,France,4497.55,0,1,0
7497,2011,10,MORTGAGE,3,Low,1,8000, 36 months,1,debt_consolidation,6,Low,1,Good Loan,0,7.51,A,1,12.54,8903.55,8000,0,248.89,409000007496,22-Feb-19,ICA 17825 Indiaforensic MC INT21,,2022.08,-548143860.25,Allan,824,Germany,67885.37,0,1,0
7498,2011,10,RENT,1,Medium,2,10300, 36 months,1,credit_card,1,Low,1,Good Loan,0,9.91,B,2,18.96,10990.35,10300,0,331.92,409000007497,25-Feb-19,ICA 17825 Indiaforensic MC DOM 2,,4042413.38,-544101446.87,Folliero,698,France,111471.55,0,1,0
7499,2011,4,RENT,1,Low,1,13125, 60 months,2,major_purchase,8,High,2,Good Loan,0,14.27,C,3,7.12,15647.49,10504.95,0,307.24,409000007498,25-Feb-19,FDRL/INTERNAL FUND TRANSFE,"2,000,000.00",,-546101446.87,Mordvinova,630,France,134407.93,0,1,0
7500,2011,4,RENT,1,Low,1,20000, 36 months,1,debt_consolidation,6,Low,1,Good Loan,0,7.9,A,1,4.83,21054.71,20000,0,625.81,409000007499,25-Feb-19,FDRL/INTERNAL FUND TRANSFE,"2,000,000.00",,-548101446.87,Schofield,609,Germany,108258.22,0,1,0
7501,2011,4,MORTGAGE,3,Low,1,12900, 60 months,2,debt_consolidation,6,High,2,Bad Loan,1,22.74,G,7,14.62,5692.74,1858.09,634.68,361.74,409000007500,25-Feb-19,Indiaforensic VISA ACQ DOM230219,,2124952.90,-545976493.97,Williams,694,France,197528.62,0,1,0
7502,2011,10,OWN,2,Low,1,6125, 36 months,1,debt_consolidation,6,High,2,Good Loan,0,14.65,C,3,21.13,7604.069675,6125,0,211.28,409000007501,25-Feb-19,Indiaforensic VISA ACQ DOM250219,,3865244.52,-542111249.45,Baird,681,France,139761.25,0,1,0
7503,2011,10,MORTGAGE,3,Low,1,26850, 60 months,2,credit_card,1,Low,1,Bad Loan,1,12.69,B,2,19.05,12199.91,7356.37,0,488.05,409000007502,25-Feb-19,Indiaforensic RUPAY POS ACQ23021,,783826.71,-541327422.74,Whitehouse,721,Spain,136119.96,0,1,0
7504,2011,0.5,MORTGAGE,3,Medium,2,5000, 36 months,1,home_improvement,7,Low,1,Good Loan,0,6.03,A,1,0.24,5287.99,5000,0,152.18,409000007503,25-Feb-19,Indiaforensic RUPAY POS ACQ24021,,964914.38,-540362508.36,Thompson,563,Germany,197812.16,0,1,0
7505,2011,10,OWN,2,Medium,2,5000, 36 months,1,home_improvement,7,High,2,Good Loan,0,14.27,C,3,8.99,5851.38,5000,0,171.55,409000007504,25-Feb-19,Indiaforensic RUPAY POS ACQ25021,,830616.69,-539531891.67,Ogochukwu,654,Spain,51972.92,0,1,0
7506,2011,3,MORTGAGE,3,Medium,2,3800, 60 months,2,other,4,Low,1,Good Loan,0,12.42,B,2,15,5014.224034,3800,0,85.34,409000007505,25-Feb-19,Indiaforensic RUPAY POS C2 ACQ25,,219455.98,-539312435.69,Niu,659,Spain,99341.87,0,1,0
7507,2011,10,RENT,1,Medium,2,20000, 60 months,2,debt_consolidation,6,High,2,Good Loan,0,15.27,C,3,10.86,20997.5,20000,0,478.64,409000007506,25-Feb-19,Indiaforensic VISA ACQ INT 21021,,2372.00,-539310063.69,Okoli,674,Germany,171345.02,0,1,0
7508,2011,10,RENT,1,Medium,2,5000, 36 months,1,credit_card,1,Low,1,Good Loan,0,12.69,B,2,8.36,6033.485593,5000,0,167.73,409000007507,25-Feb-19,FDRL/INTERNAL FUND TRANSFE,"500,000.00",,-539810063.69,Lorenzen,576,Germany,119056.68,0,1,0
7509,2011,1,RENT,1,Low,1,6000, 36 months,1,debt_consolidation,6,Low,1,Good Loan,0,6.03,A,1,27.83,6572.719742,6000,0,182.62,409000007508,25-Feb-19,FDRL/INTERNAL FUND TRANSFE,"5,000,000.00",,-544810063.69,Okechukwu,566,Germany,172601.62,0,1,0
7510,2011,10,RENT,1,Medium,2,24000, 60 months,2,debt_consolidation,6,High,2,Good Loan,0,13.49,C,3,4.61,28669.12,19775.11,0,552.12,409000007509,25-Feb-19,FDRL/INTERNAL FUND TRANSFE,"3,000,000.00",,-547810063.69,Anderson,545,Germany,104936.88,0,1,0
7511,2011,9,MORTGAGE,3,Low,1,5000, 36 months,1,other,4,Low,1,Good Loan,0,7.9,A,1,12.76,5649.489971,5000,0,156.46,409000007510,26-Feb-19,FDRL/INTERNAL FUND TRANSFE,"400,000.00",,-548210063.69,Ku,798,France,159044.10,0,1,0
7512,2011,7,MORTGAGE,3,Low,1,8000, 36 months,1,debt_consolidation,6,Low,1,Good Loan,0,6.03,A,1,14.4,8764.933272,8000,0,243.49,409000007511,26-Feb-19,Indiaforensic VISA ACQ DOM260219,,2015292.28,-546194771.41,Kung,757,France,83263.06,0,1,0
7513,2011,6,MORTGAGE,3,Low,1,2100, 36 months,1,home_improvement,7,Low,1,Good Loan,0,6.62,A,1,13.51,2318.752155,2100,0,64.48,409000007512,26-Feb-19,Indiaforensic RUPAY POS ACQ26021,,735875.03,-545458896.38,Lu,641,France,130910.78,0,1,0
7514,2011,4,RENT,1,Low,1,12600, 60 months,2,small_business,3,Low,1,Bad Loan,1,12.69,B,2,4.15,6832.26,4100.24,21.06,284.7,409000007513,26-Feb-19,Indiaforensic VISA ACQ INT 22021,,308.37,-545458588.01,Trevisano,718,France,126336.72,0,1,0
7515,2011,0.5,RENT,1,Low,1,1300, 36 months,1,credit_card,1,Low,1,Good Loan,0,9.91,B,2,9.07,1483.56,1300,0,41.9,409000007514,26-Feb-19,FDRL/INTERNAL FUND TRANSFE,"2,000,000.00",,-547458588.01,Onwubiko,699,France,27980.80,0,1,0
7516,2011,10,MORTGAGE,3,Low,1,25000, 36 months,1,small_business,3,Low,1,Good Loan,0,10.65,B,2,26.83,29313.00763,25000,0,814.34,409000007515,26-Feb-19,FDRL/INTERNAL FUND TRANSFE,"500,000.00",,-547958588.01,Vidler,623,France,47880.71,0,1,0
7517,2011,10,MORTGAGE,3,High,3,12800, 36 months,1,major_purchase,8,Low,1,Good Loan,0,9.91,B,2,0.74,12906.48,12800,0,412.48,409000007516,26-Feb-19,FDRL/INTERNAL FUND TRANSFE,"300,000.00",,-548258588.01,Shen,644,France,73882.49,0,1,0
7518,2011,10,MORTGAGE,3,Low,1,2500, 36 months,1,home_improvement,7,Low,1,Good Loan,0,6.62,A,1,10.96,2761.625835,2500,0,76.76,409000007517,26-Feb-19,ICA 17825 Indiaforensic MC DOM 2,,1773538.78,-546485049.23,McGregor,586,France,162960.05,0,1,0
7519,2011,8,MORTGAGE,3,Medium,2,28800, 60 months,2,debt_consolidation,6,High,2,Good Loan,0,18.25,D,4,9.59,35200.88,28800,0,735.26,409000007518,26-Feb-19,FDRL/INTERNAL FUND TRANSFE,"1,000,000.00",,-547485049.23,Nnamdi,500,Germany,68807.47,0,1,0
7520,2011,10,MORTGAGE,3,Medium,2,24000, 36 months,1,wedding,5,Low,1,Good Loan,0,6.62,A,1,7.61,26524.8681,24000,0,736.89,409000007519,26-Feb-19,FDRL/INTERNAL FUND TRANSFE,"400,000.00",,-547885049.23,Castiglione,583,France,144039.05,0,1,0
7521,2011,4,RENT,1,Low,1,4800, 36 months,1,other,4,Low,1,Good Loan,0,11.71,B,2,17.1,5438.35,4800,0,158.77,409000007520,26-Feb-19,FDRL/INTERNAL FUND TRANSFE,"300,000.00",,-548185049.23,Bergamaschi,595,Germany,151192.18,0,1,0
7522,2011,2,MORTGAGE,3,Medium,2,30000, 36 months,1,debt_consolidation,6,Low,1,Good Loan,0,7.9,A,1,16.15,33557.50397,30000,0,938.71,409000007521,26-Feb-19,Indiaforensic RUPAY POS C2 ACQ26,,139536.26,-548045512.97,Allingham,670,Spain,120225.62,0,1,0
7523,2011,6,MORTGAGE,3,Low,1,15000, 60 months,2,debt_consolidation,6,High,2,Bad Loan,1,17.58,D,4,13.51,9057.98,4471.47,0,377.49,409000007522,27-Feb-19,Indiaforensic VISA ACQ DOM270219,,1639862.91,-546405650.06,Stelzer,610,France,56118.81,0,1,0
7524,2011,10,OWN,2,Low,1,7000, 60 months,2,major_purchase,8,Low,1,Good Loan,0,10.65,B,2,22.18,7672.72,5681.51,0,150.98,409000007523,27-Feb-19,Indiaforensic RUPAY POS ACQ27021,,623019.86,-545782630.20,Rubin,814,Spain,130853.03,0,1,0
7525,2011,1,RENT,1,Low,1,16000, 36 months,1,credit_card,1,Low,1,Good Loan,0,7.9,A,1,11.47,17846.08,16000,0,500.65,409000007524,27-Feb-19,Indiaforensic VISA ACQ INT 23021,,2847.54,-545779782.66,Ho,660,France,185156.94,0,1,0
7526,2011,5,RENT,1,Low,1,20000, 60 months,2,credit_card,1,High,2,Good Loan,0,18.25,D,4,12.72,25956.79,15693.86,0,510.6,409000007525,27-Feb-19,Indiaforensic VISA ACQ INT 24021,,1221.81,-545778560.85,Watson,580,Germany,35671.45,0,1,0
7527,2011,10,MORTGAGE,3,Low,1,4000, 36 months,1,debt_consolidation,6,Low,1,Good Loan,0,7.51,A,1,23.91,4476.908716,4000,0,124.45,409000007526,27-Feb-19,Indiaforensic VISA ACQ INT 25021,,2545.44,-545776015.41,Perry,850,France,59568.24,0,1,0
7528,2011,5,MORTGAGE,3,Low,1,9000, 60 months,2,car,2,Low,1,Good Loan,0,10.65,B,2,13.1,9862.71,7303.4,0,194.12,409000007527,27-Feb-19,ICA 17825 Indiaforensic MC DOM 2,,1401515.64,-544374499.77,Sun,676,Spain,139911.58,0,1,0
7529,2011,3,MORTGAGE,3,Low,1,1500, 36 months,1,debt_consolidation,6,High,2,Good Loan,0,13.49,C,3,14.76,1830.156559,1500,0,50.9,409000007528,27-Feb-19,FDRL/INTERNAL FUND TRANSFE,"300,000.00",,-544674499.77,Harrell,578,France,56770.76,0,1,0
7530,2011,0.5,MORTGAGE,3,Low,1,6000, 36 months,1,debt_consolidation,6,High,2,Good Loan,0,14.65,C,3,11.18,7448.495724,6000,0,206.97,409000007529,27-Feb-19,FDRL/INTERNAL FUND TRANSFE,"300,000.00",,-544974499.77,Robson,579,France,157564.75,0,1,0
7531,2011,1,MORTGAGE,3,Low,1,2000, 36 months,1,debt_consolidation,6,High,2,Good Loan,0,14.27,C,3,6.29,2047.18,2000,0,68.62,409000007530,27-Feb-19,FDRL/INTERNAL FUND TRANSFE,"3,000,000.00",,-547974499.77,Wilson,711,Germany,131473.31,0,1,0
7532,2011,10,RENT,1,Low,1,2500, 60 months,2,car,2,Low,1,Good Loan,0,10.65,B,2,21.95,2682.91,2500,0,53.93,409000007531,27-Feb-19,FDRL/INTERNAL FUND TRANSFE,"300,000.00",,-548274499.77,Kelechi,692,France,90424.09,0,1,0
7533,2011,3,MORTGAGE,3,High,3,35000, 60 months,2,home_improvement,7,High,2,Good Loan,0,20.3,E,5,8.22,37330.6,35000,0,933.14,409000007532,27-Feb-19,Indiaforensic RUPAY POS C2 ACQ27,,178079.19,-548096420.58,Bates,760,Spain,156660.21,0,1,0
7534,2011,5,RENT,1,Low,1,3000, 36 months,1,other,4,High,2,Good Loan,0,15.27,C,3,5.27,3762.544546,3000,0,104.4,409000007533,27-Feb-19,ICA 17825 Indiaforensic MC DOM 2,"1,373.71",,-548097794.29,Eberegbulam,630,Germany,88372.69,0,1,0
7535,2011,5,MORTGAGE,3,Low,1,18000, 36 months,1,debt_consolidation,6,Low,1,Good Loan,0,11.71,B,2,19.21,21307.49649,18000,0,595.37,409000007534,28-Feb-19,Indiaforensic VISA ACQ DOM280219,,1789774.32,-546308019.97,Olisaemeka,808,France,46200.71,0,1,0
7536,2011,5,RENT,1,Low,1,6000, 36 months,1,debt_consolidation,6,Low,1,Good Loan,0,12.42,B,2,9.08,7216.232212,6000,0,200.5,409000007535,28-Feb-19,Indiaforensic RUPAY POS ACQ28021,,773906.47,-545534113.50,Davey,611,Germany,160548.12,0,1,0
7537,2011,3,RENT,1,Low,1,10000, 36 months,1,house,12,Low,1,Good Loan,0,6.62,A,1,9.24,11046.78347,10000,0,307.04,409000007536,28-Feb-19,FDRL/INTERNAL FUND TRANSFE,"400,000.00",,-545934113.50,De Luca,697,France,1262.83,0,1,0
7538,2011,6,MORTGAGE,3,Medium,2,14000, 36 months,1,debt_consolidation,6,Low,1,Good Loan,0,6.03,A,1,9,15332.72942,14000,0,426.1,409000007537,28-Feb-19,FDRL/INTERNAL FUND TRANSFE,"300,000.00",,-546234113.50,Ho,655,France,188639.28,0,1,0
7539,2011,1,MORTGAGE,3,Medium,2,35000, 60 months,2,debt_consolidation,6,Low,1,Good Loan,0,11.71,B,2,17.61,34505.6678,27000,0,596.66,409000007538,28-Feb-19,FDRL/INTERNAL FUND TRANSFE,"2,000,000.00",,-548234113.50,Vasiliev,601,Spain,14665.28,0,1,0
7540,2011,10,MORTGAGE,3,Low,1,6000, 36 months,1,major_purchase,8,Low,1,Good Loan,0,8.9,A,1,19.47,6807.52,6000,0,190.52,409000007539,28-Feb-19,ICA 17825 Indiaforensic MC DOM 2,,1510408.29,-546723705.21,Smith,755,France,156868.21,0,1,0
7541,2011,0.5,RENT,1,Low,1,14000, 36 months,1,debt_consolidation,6,Low,1,Good Loan,0,6.03,A,1,8.32,15339.22931,14000,0,426.1,409000007540,28-Feb-19,Indiaforensic RUPAY POS C2 ACQ28,,189244.22,-546534460.99,Sung,553,France,30461.55,0,1,0
7542,2011,4,MORTGAGE,3,Low,1,4300, 36 months,1,home_improvement,7,Low,1,Good Loan,0,7.9,A,1,2.92,4786.36,4300,0,134.55,409000007541,28-Feb-19,FDRL/INTERNAL FUND TRANSFE,"400,000.00",,-546934460.99,White,723,France,123885.88,0,1,0
7543,2011,6,OWN,2,Low,1,12000, 36 months,1,major_purchase,8,Low,1,Good Loan,0,6.03,A,1,7.69,13147.80731,12000,0,365.23,409000007542,28-Feb-19,FDRL/INTERNAL FUND TRANSFE,"1,000,000.00",,-547934460.99,Wang,507,Spain,60688.38,0,1,0
7544,2011,3,RENT,1,Low,1,8800, 36 months,1,debt_consolidation,6,Low,1,Good Loan,0,8.9,A,1,11.34,10057.90362,8800,0,279.43,409000007543,28-Feb-19,FDRL/INTERNAL FUND TRANSFE,"300,000.00",,-548234460.99,Davide,777,France,21785.91,0,1,0
7545,2011,10,MORTGAGE,3,Low,1,19500, 60 months,2,debt_consolidation,6,High,2,Good Loan,0,13.49,C,3,12.88,22849.11,15663.99,0,448.6,409000007544,1-Mar-19,ICA 17825 Indiaforensic MC DOM 0,,1508432.79,-546726028.20,Nnamdi,566,France,188135.69,0,1,0
7546,2011,6.05,MORTGAGE,3,Low,1,10000, 36 months,1,major_purchase,8,Low,1,Good Loan,0,6.03,A,1,1.56,10956.50551,10000,0,304.36,409000007545,1-Mar-19,Indiaforensic VISA ACQ DOM010319,,2239731.26,-544486296.94,Welsh,732,France,154364.66,0,1,0
7547,2011,5,OWN,2,Low,1,21600, 60 months,2,debt_consolidation,6,Low,1,Good Loan,0,12.69,B,2,21.34,26555.25,21600,0,488.05,409000007546,1-Mar-19,Indiaforensic VISA ACQ INT 27021,,2050.44,-544484246.50,Sousa,697,France,61312.15,0,1,0
7548,2011,2,MORTGAGE,3,Low,1,15000, 60 months,2,home_improvement,7,Low,1,Good Loan,0,12.69,B,2,24.17,17781.37,15000,0,338.93,409000007547,1-Mar-19,FDRL/INTERNAL FUND TRANSFE,"1,000,000.00",,-545484246.50,Andrews,555,France,47454.93,0,1,0
7549,2011,2,OWN,2,Low,1,4000, 36 months,1,debt_consolidation,6,High,2,Good Loan,0,14.65,C,3,10.71,4642.21,4000,0,137.98,409000007548,1-Mar-19,FDRL/INTERNAL FUND TRANSFE,"300,000.00",,-545784246.50,Chiawuotu,584,Germany,121102.90,0,1,0
7550,2011,2,RENT,1,Low,1,5000, 36 months,1,debt_consolidation,6,Low,1,Good Loan,0,7.9,A,1,10.31,5631.399391,5000,0,156.46,409000007549,1-Mar-19,FDRL/INTERNAL FUND TRANSFE,"1,000,000.00",,-546784246.50,Thomson,705,Germany,137419.87,0,1,0
7551,2011,2,RENT,1,Low,1,12800, 60 months,2,debt_consolidation,6,High,2,Good Loan,0,15.96,C,3,11.64,15546.3,12800.01,0,311,409000007550,1-Mar-19,FDRL/INTERNAL FUND TRANSFE,"1,000,000.00",,-547784246.50,Carpenter,688,France,157664.02,0,1,0
7552,2011,2,MORTGAGE,3,Medium,2,12000, 36 months,1,car,2,High,2,Bad Loan,1,16.29,D,4,12.03,6346.05,4299.55,0,423.61,409000007551,1-Mar-19,FDRL/INTERNAL FUND TRANSFE,"300,000.00",,-548084246.50,Yefimova,626,France,148689.65,0,1,0
7553,2011,10,MORTGAGE,3,High,3,30000, 36 months,1,home_improvement,7,Low,1,Good Loan,0,12.69,B,2,4.54,35166.43,30000,0,1006.35,409000007552,1-Mar-19,ICA 17825 Indiaforensic MC INT28,,1014.76,-548083231.74,Ma,636,Spain,39789.62,0,1,0
7554,2011,10,MORTGAGE,3,High,3,30000, 36 months,1,credit_card,1,Low,1,Good Loan,0,6.62,A,1,6.57,33158.10611,30000,0,921.11,409000007553,1-Mar-19,Indiaforensic RUPAY POS ACQ01031,,344579.79,-547738651.95,Black,719,Spain,165162.40,0,1,0
7555,2011,10,MORTGAGE,3,Low,1,15600, 36 months,1,debt_consolidation,6,High,2,Bad Loan,1,17.27,D,4,7.78,2787.75,1715.36,0,558.29,409000007554,1-Mar-19,Indiaforensic RUPAY POS C2 ACQ01,,739611.99,-546999039.96,Obijiaku,706,Spain,137674.55,0,1,0
7556,2011,9,MORTGAGE,3,Medium,2,30000, 36 months,1,major_purchase,8,Low,1,Good Loan,0,7.9,A,1,3.03,33791.73282,30000,0,938.71,409000007555,1-Mar-19,FDRL/INTERNAL FUND TRANSFE,"400,000.00",,-547399039.96,King,731,Spain,101371.72,0,1,0
7557,2011,10,MORTGAGE,3,Low,1,35000, 60 months,2,debt_consolidation,6,High,2,Bad Loan,1,22.35,F,6,18.41,20241.96,3115.69,11494.86,973.64,409000007556,1-Mar-19,FDRL/INTERNAL FUND TRANSFE,"400,000.00",,-547799039.96,Miller,738,Spain,65066.48,0,1,0
7558,2011,2,RENT,1,Low,1,3500, 36 months,1,credit_card,1,High,2,Good Loan,0,17.27,D,4,15.89,4165.35,3500,0,125.26,409000007557,1-Mar-19,FDRL/INTERNAL FUND TRANSFE,"400,000.00",,-548199039.96,Chin,426,France,107876.91,0,1,0
7559,2011,10,RENT,1,Low,1,4000, 60 months,2,other,4,High,2,Bad Loan,1,14.65,C,3,11.7,3928.98,2259.81,247.08,94.43,409000007558,2-Mar-19,Indiaforensic VISA ACQ DOM020319,,1802573.68,-546396466.28,Cox,622,Spain,111180.30,0,1,0
7560,2011,6.05,MORTGAGE,3,Low,1,7275, 36 months,1,credit_card,1,Low,1,Good Loan,0,6.03,A,1,17.87,7541.43,7275,0,221.42,409000007559,2-Mar-19,Indiaforensic RUPAY POS ACQ02031,,890081.57,-545506384.71,Wallace,701,Spain,115650.63,0,1,0
7561,2011,4,MORTGAGE,3,Low,1,6825, 36 months,1,debt_consolidation,6,Low,1,Good Loan,0,8.9,A,1,17.88,7797.823834,6825,0,216.72,409000007560,2-Mar-19,FDRL/INTERNAL FUND TRANSFE,"2,000,000.00",,-547506384.71,Price,512,France,165035.17,0,1,0
7562,2011,10,RENT,1,Low,1,28000, 60 months,2,other,4,High,2,Bad Loan,1,21.28,F,6,10.95,13516.46,4859.33,1328.62,761.92,409000007561,2-Mar-19,FDRL/INTERNAL FUND TRANSFE,"400,000.00",,-547906384.71,Yuan,635,France,193746.55,0,1,0
7563,2011,4,MORTGAGE,3,Low,1,5000, 36 months,1,debt_consolidation,6,Low,1,Good Loan,0,6.03,A,1,19.07,5261.44,5000,0,152.18,409000007562,2-Mar-19,FDRL/INTERNAL FUND TRANSFE,"300,000.00",,-548206384.71,Mullen,685,France,58458.26,0,1,0
7564,2011,6.05,MORTGAGE,3,Low,1,14775, 36 months,1,debt_consolidation,6,Low,1,Good Loan,0,6.62,A,1,9.23,16328.99777,14775,0,453.65,409000007563,2-Mar-19,Indiaforensic RUPAY POS C2 ACQ02,,220247.98,-547986136.73,Howell,609,France,52332.85,0,1,0
7565,2011,8,MORTGAGE,3,Low,1,12500, 36 months,1,credit_card,1,Low,1,Good Loan,0,6.03,A,1,8.33,13695.60935,12500,0,380.45,409000007564,4-Mar-19,Indiaforensic RUPAY POS ACQ03031,,525776.22,-547460360.51,McIntosh,598,Germany,75959.10,0,1,0
7566,2011,7,OWN,2,Low,1,6000, 36 months,1,car,2,Low,1,Good Loan,0,6.03,A,1,2.25,6422.19,6000,0,182.62,409000007565,4-Mar-19,Indiaforensic RUPAY POS ACQ04031,,1660490.06,-545799870.45,Clifton,708,France,123.07,0,1,0
7567,2011,10,MORTGAGE,3,Low,1,20000, 60 months,2,debt_consolidation,6,High,2,Good Loan,0,13.49,C,3,28.72,25955.0831,20000,0,460.1,409000007566,4-Mar-19,FDRL/INTERNAL FUND TRANSFE,"2,000,000.00",,-547799870.45,Okwuoma,574,Spain,167066.95,0,1,0
7568,2011,10,MORTGAGE,3,Low,1,21000, 36 months,1,debt_consolidation,6,Low,1,Good Loan,0,12.42,B,2,5.67,23563.93,21000,0,701.73,409000007567,4-Mar-19,FDRL/INTERNAL FUND TRANSFE,"400,000.00",,-548199870.45,Chidiebere,629,France,117572.59,0,1,0
7569,2011,10,MORTGAGE,3,Low,1,12000, 36 months,1,debt_consolidation,6,Low,1,Good Loan,0,6.62,A,1,6.14,13261.79616,12000,0,368.45,409000007568,4-Mar-19,Indiaforensic RUPAY POS C2 ACQ04,,208818.24,-547991052.21,Fan,422,Spain,7166.71,0,1,0
7570,2011,1,RENT,1,Low,1,1000, 36 months,1,debt_consolidation,6,Low,1,Good Loan,0,7.9,A,1,16.15,1104.03,1000,0,31.3,409000007569,5-Mar-19,ICA 17825 Indiaforensic MC DOM 0,,5644452.01,-542346600.20,Onyemauchechukwu,656,Spain,137173.39,0,1,0
7571,2011,2,MORTGAGE,3,High,3,30000, 36 months,1,home_improvement,7,Low,1,Good Loan,0,9.91,B,2,5.25,33473.22,30000,0,966.75,409000007570,5-Mar-19,Indiaforensic VISA ACQ DOM040319,,3743085.84,-538603514.36,Harker,697,France,116442.42,0,1,0
7572,2011,6.05,MORTGAGE,3,Low,1,6000, 36 months,1,other,4,Low,1,Good Loan,0,6.03,A,1,11.41,6573.601432,6000,0,182.62,409000007571,5-Mar-19,Indiaforensic VISA ACQ DOM050319,,2099441.11,-536504073.25,Bolton,718,France,32421.32,0,1,0
7573,2011,0.5,RENT,1,Low,1,4000, 36 months,1,debt_consolidation,6,Low,1,Good Loan,0,8.9,A,1,20.1,4379.22,4000,0,127.02,409000007572,5-Mar-19,Indiaforensic RUPAY POS ACQ05031,,789713.82,-535714359.43,Lazarev,586,Germany,104665.79,0,1,0
7574,2011,0.5,RENT,1,Low,1,20000, 36 months,1,debt_consolidation,6,High,2,Good Loan,0,13.49,C,3,10.35,22805.76,20000,0,678.61,409000007573,5-Mar-19,FDRL/INTERNAL FUND TRANSFE,"500,000.00",,-536214359.43,Alexeyeva,481,Spain,44215.86,0,1,0
7575,2011,6,RENT,1,Low,1,4500, 36 months,1,debt_consolidation,6,High,2,Good Loan,0,13.49,C,3,18.53,4989.67,4500,0,152.69,409000007574,5-Mar-19,FDRL/INTERNAL FUND TRANSFE,"10,000,000.00",,-546214359.43,Stevens,749,France,20164.47,0,1,0
7576,2011,1,RENT,1,Low,1,8000, 36 months,1,debt_consolidation,6,Low,1,Good Loan,0,7.9,A,1,26.49,8738.49,8000,0,250.33,409000007575,5-Mar-19,FDRL/INTERNAL FUND TRANSFE,"2,000,000.00",,-548214359.43,Glover,561,Germany,26691.31,0,1,0
7577,2011,6,MORTGAGE,3,Low,1,14000, 60 months,2,medical,9,High,2,Good Loan,0,19.03,E,5,8.43,14439.74,14000,0,363.4,409000007576,5-Mar-19,ICA 17825 Indiaforensic MC INT02,,3859.57,-548210499.86,Ibekwe,676,Spain,107955.67,0,1,0
7578,2011,5,MORTGAGE,3,Low,1,2000, 36 months,1,vacation,11,Low,1,Good Loan,0,7.9,A,1,7.09,2240.865115,2000,0,62.59,409000007577,5-Mar-19,Indiaforensic RUPAY POS C2 ACQ05,,291170.91,-547919328.95,Paterson,615,Germany,150048.37,0,1,0
7579,2011,7,RENT,1,Low,1,11325, 36 months,1,debt_consolidation,6,Low,1,Good Loan,0,12.69,B,2,24.8,13670.28928,11325,0,379.9,409000007578,7-Apr-17,TRF FROM  Indiaforensic SERVICES,,500000.00,-547419328.95,Marsh,582,France,192255.15,0,1,0
7580,2011,9,MORTGAGE,3,Low,1,2500, 36 months,1,major_purchase,8,High,2,Good Loan,0,14.65,C,3,20.4,2698.94,2500,0,86.24,409000007579,7-Apr-17,SCHRG RCRVRY/LIEN MARKING,150,,-547419478.95,Reeves,601,France,173245.68,0,1,0
7581,2011,0.5,RENT,1,Medium,2,35000, 36 months,1,debt_consolidation,6,High,2,Good Loan,0,18.64,E,5,14.12,45949.55328,35000,0,1276.6,409000007580,7-Apr-17,STAX RCRVRY/LIEN MARKING,21,,-547419499.95,Rees,708,France,121457.88,0,1,0
7582,2011,4,RENT,1,Low,1,6000, 36 months,1,wedding,5,High,2,Good Loan,0,15.96,C,3,20.72,7585.362744,6000,0,210.83,409000007581,7-Apr-17,SWACHH BHARAT CESS/LIEN M,0.75,,-547419500.70,Hanson,708,Germany,104804.74,0,1,0
7583,2011,3,MORTGAGE,3,Medium,2,5000, 36 months,1,debt_consolidation,6,Low,1,Good Loan,0,8.9,A,1,3,5408.3,5000,0,158.77,409000007582,7-Apr-17,KRISHI KALYAN CESS/LIEN M,0.75,,-547419501.45,Onwughara,797,Germany,69767.14,0,1,0
7584,2011,2,MORTGAGE,3,Medium,2,7200, 36 months,1,home_improvement,7,Low,1,Good Loan,0,6.62,A,1,10.28,7955.752036,7200,0,221.07,409000007583,7-Apr-17,SCHRG RCRVRY/LIEN MARKING,150,,-547419651.45,Odinakachukwu,682,France,178373.43,0,1,0
7585,2011,1,RENT,1,Medium,2,8000, 36 months,1,small_business,3,High,2,Bad Loan,1,15.27,C,3,15.08,3452.53,985.24,1690.45,278.39,409000007584,7-Apr-17,STAX RCRVRY/LIEN MARKING,21,,-547419672.45,Huang,694,Spain,99924.04,0,1,0
7586,2011,10,MORTGAGE,3,Low,1,27000, 60 months,2,home_improvement,7,Low,1,Good Loan,0,11.71,B,2,5.58,33492.26549,27000,0,596.66,409000007585,7-Apr-17,SWACHH BHARAT CESS/LIEN M,0.75,,-547419673.20,Trevisani,490,France,49594.19,0,1,0
7587,2011,4,RENT,1,Low,1,10000, 36 months,1,debt_consolidation,6,Low,1,Bad Loan,1,11.71,B,2,24.68,990.06,704.8,0,330.76,409000007586,7-Apr-17,KRISHI KALYAN CESS/LIEN M,0.75,,-547419673.95,Dale,828,Spain,186071.14,0,1,0
7588,2011,10,MORTGAGE,3,Medium,2,6000, 36 months,1,other,4,Low,1,Good Loan,0,12.42,B,2,12.02,7194.946017,6000,0,200.5,409000007587,7-Apr-17,SCHRG RCRVRY/LIEN MARKING,150,,-547419823.95,Pavlova,594,Spain,77511.45,0,1,0
7589,2011,7,MORTGAGE,3,Low,1,7400, 36 months,1,debt_consolidation,6,Low,1,Good Loan,0,12.69,B,2,19.92,7660.26,7400,0,248.24,409000007588,7-Apr-17,STAX RCRVRY/LIEN MARKING,21,,-547419844.95,Meng,579,Spain,54816.57,0,1,0
7590,2011,10,RENT,1,Low,1,5600, 36 months,1,debt_consolidation,6,High,2,Good Loan,0,16.77,D,4,14.76,7085.064976,5600,0,199.02,409000007589,7-Apr-17,SWACHH BHARAT CESS/LIEN M,0.75,,-547419845.70,Dean,723,France,61290.99,0,1,0
7591,2011,6,MORTGAGE,3,Low,1,9750, 36 months,1,house,12,High,2,Bad Loan,1,14.27,C,3,15.68,9139.51,6600.84,459.15,334.52,409000007590,7-Apr-17,KRISHI KALYAN CESS/LIEN M,0.75,,-547419846.45,Chiganu,619,Germany,191821.35,0,1,0
7592,2011,10,OWN,2,Low,1,35000, 60 months,2,debt_consolidation,6,Low,1,Good Loan,0,12.42,B,2,0.37,30985.97,29775,0,668.67,409000007591,7-Apr-17,SCHRG RCRVRY/LIEN MARKING,150,,-547419996.45,Lung,794,Spain,156768.45,0,1,0
7593,2011,5,MORTGAGE,3,Low,1,4000, 36 months,1,medical,9,Low,1,Good Loan,0,7.9,A,1,9.13,4233.54,4000,0,125.17,409000007592,7-Apr-17,STAX RCRVRY/LIEN MARKING,21,,-547420017.45,Donaldson,674,Germany,73731.32,0,1,0
7594,2011,3,MORTGAGE,3,Low,1,16425, 60 months,2,debt_consolidation,6,Low,1,Good Loan,0,11.71,B,2,22.63,16899.22,16425,0,362.97,409000007593,7-Apr-17,SWACHH BHARAT CESS/LIEN M,0.75,,-547420018.20,Li Fonti,418,France,122190.22,0,1,0
7595,2011,6,OWN,2,Low,1,7200, 36 months,1,debt_consolidation,6,Low,1,Good Loan,0,6.62,A,1,14.97,7833.36,7200,0,221.07,409000007594,7-Apr-17,KRISHI KALYAN CESS/LIEN M,0.75,,-547420018.95,Izmailova,502,France,123509.01,0,1,0
7596,2011,1,RENT,1,Low,1,3600, 36 months,1,credit_card,1,Low,1,Bad Loan,1,6.62,A,1,9.35,3116.97,2619.67,146.7,110.54,409000007595,7-Apr-17,SCHRG RCRVRY/LIEN MARKING,150,,-547420168.95,Walker,678,France,8199.50,0,1,0
7597,2011,6,MORTGAGE,3,Low,1,6000, 36 months,1,debt_consolidation,6,Low,1,Good Loan,0,10.65,B,2,10.69,7033.291063,6000,0,195.44,409000007596,7-Apr-17,STAX RCRVRY/LIEN MARKING,21,,-547420189.95,Nnonso,599,Germany,14113.11,0,1,0
7598,2011,10,OWN,2,Low,1,25000, 60 months,2,home_improvement,7,Low,1,Good Loan,0,9.91,B,2,10.27,31347.15474,25000,0,530.07,409000007597,7-Apr-17,SWACHH BHARAT CESS/LIEN M,0.75,,-547420190.70,Stevenson,736,France,51705.01,0,1,0
7599,2011,2,MORTGAGE,3,Low,1,15000, 60 months,2,medical,9,Low,1,Good Loan,0,9.91,B,2,7.28,16219.68,12252.24,0,318.05,409000007598,7-Apr-17,KRISHI KALYAN CESS/LIEN M,0.75,,-547420191.45,Schnaars,430,France,161937.62,0,1,0
7600,2011,3,RENT,1,Low,1,8000, 36 months,1,debt_consolidation,6,Low,1,Good Loan,0,12.69,B,2,11.85,9613.24318,8000,0,268.36,409000007599,7-Apr-17,SCHRG RCRVRY/LIEN MARKING,150,,-547420341.45,Geoghegan,537,France,120892.96,0,1,0
7601,2011,6,RENT,1,Low,1,11000, 60 months,2,debt_consolidation,6,Low,1,Good Loan,0,10.65,B,2,6.72,13580.54858,11000,0,237.26,409000007600,7-Apr-17,STAX RCRVRY/LIEN MARKING,21,,-547420362.45,Ilyina,683,Spain,65035.02,0,1,0
7602,2011,5,RENT,1,Low,1,11100, 36 months,1,other,4,Low,1,Good Loan,0,6.03,A,1,1.41,12161.89978,11100,0,337.84,409000007601,7-Apr-17,SWACHH BHARAT CESS/LIEN M,0.75,,-547420363.20,Muir,828,France,164257.37,0,1,0
7603,2011,4,MORTGAGE,3,Low,1,15000, 60 months,2,debt_consolidation,6,High,2,Good Loan,0,13.49,C,3,16.48,20216.48804,15000,0,345.08,409000007602,7-Apr-17,KRISHI KALYAN CESS/LIEN M,0.75,,-547420363.95,Gardener,691,France,51987.99,0,1,0
7604,2011,2,RENT,1,Low,1,12000, 36 months,1,debt_consolidation,6,High,2,Good Loan,0,15.27,C,3,3.9,14123.91,12000,0,417.58,409000007603,27-Nov-17,TRF FROM  Indiaforensic SERVICES,,100000.00,-547320363.95,Chidi,608,Spain,10899.63,0,1,0
7605,2011,10,RENT,1,Low,1,8000, 36 months,1,debt_consolidation,6,Low,1,Good Loan,0,6.03,A,1,21.33,8646.21,8000,0,243.49,409000007604,16-Jan-18,FDRL/INTERNAL FUND TRANSFE,,200000.00,-547120363.95,Fu,691,France,177355.80,0,1,0
7606,2011,4,RENT,1,Low,1,10000, 36 months,1,moving,10,Low,1,Good Loan,0,11.71,B,2,2.18,10413.37,10000,0,330.76,409000007605,7-Feb-18,FDRL/INTERNAL FUND TRANSFE,,300000.00,-546820363.95,Sun,718,Spain,63889.10,0,1,0
7607,2011,5,MORTGAGE,3,Low,1,4800, 36 months,1,home_improvement,7,Low,1,Good Loan,0,12.42,B,2,14.45,5771.6194,4800,0,160.4,409000007606,7-Feb-18,FDRL/INTERNAL FUND TRANSFE,,300000.00,-546520363.95,Ting,680,Germany,176433.60,0,1,0
7608,2011,0.5,RENT,1,Low,1,7200, 36 months,1,medical,9,Low,1,Bad Loan,1,11.71,B,2,7.83,949.48,679.22,0,238.15,409000007607,15-Feb-18,FDRL/INTERNAL FUND TRANSFE,,15000000.00,-531520363.95,Ashton,838,Spain,81313.51,0,1,0
7609,2011,4,MORTGAGE,3,Low,1,2000, 36 months,1,debt_consolidation,6,High,2,Good Loan,0,15.27,C,3,6.82,2505.39,2000,0,69.6,409000007608,15-Feb-18,FDRL/INTERNAL FUND TRANSFE,,15000000.00,-516520363.95,Uwakwe,695,Spain,13998.88,0,1,0
7610,2011,2,RENT,1,Low,1,6000, 36 months,1,major_purchase,8,Low,1,Good Loan,0,6.03,A,1,5.31,6289.29,6000,0,182.62,409000007609,15-Feb-18,FDRL/INTERNAL FUND TRANSFE,,6647330.40,-509873033.55,Vassiliev,681,France,5771.56,0,1,0
7611,2011,1,MORTGAGE,3,Low,1,18000, 60 months,2,credit_card,1,High,2,Good Loan,0,19.91,E,5,19.06,26892.16114,18000,0,475.99,409000007610,15-Feb-18,FDRL/INTERNAL FUND TRANSFE,,15000000.00,-494873033.55,Kazakova,762,France,42693.65,0,1,0
7612,2011,6.05,RENT,1,Low,1,5950, 36 months,1,credit_card,1,High,2,Good Loan,0,13.49,C,3,8.41,7264.021559,5950,0,201.89,409000007611,15-Feb-18,FDRL/INTERNAL FUND TRANSFE,,15000000.00,-479873033.55,Perry,751,Spain,90839.61,0,1,0
7613,2011,6.05,RENT,1,Low,1,6000, 36 months,1,moving,10,Low,1,Bad Loan,1,7.9,A,1,10.63,4885.57,4196.18,0,187.75,409000007612,16-Feb-18,TRF TO  Indiaforensic SERVICES I,"5,000,000.00",,-484873033.55,Howell,678,Spain,54144.01,0,1,0
7614,2011,6.05,RENT,1,Low,1,3600, 36 months,1,credit_card,1,High,2,Good Loan,0,15.27,C,3,7.78,4509.7,3600,0,125.28,409000007613,16-Feb-18,TRF TO  Indiaforensic SERVICES I,"15,000,000.00",,-499873033.55,Ricci,634,France,184312.88,0,1,0
7615,2011,10,MORTGAGE,3,Low,1,3000, 36 months,1,major_purchase,8,Low,1,Good Loan,0,7.51,A,1,15.83,3165.81,3000,0,93.34,409000007614,16-Feb-18,TRF TO  Indiaforensic SERVICES I,"15,000,000.00",,-514873033.55,Smith,749,France,20306.79,0,1,0
7616,2011,4,RENT,1,Low,1,30000, 60 months,2,debt_consolidation,6,High,2,Bad Loan,1,18.64,E,5,11.35,10961.54,3635.9,2483.95,772.29,409000007615,16-Feb-18,TRF TO  Indiaforensic SERVICES I,"15,000,000.00",,-529873033.55,Rossi,590,Spain,128256.18,0,1,0
7617,2011,6.05,OWN,2,Low,1,6000, 36 months,1,other,4,Low,1,Good Loan,0,11.71,B,2,18,7139.643033,6000,0,198.46,409000007616,17-Feb-18,TRF TO  Indiaforensic SERVICES I,"14,000,000.00",,-543873033.55,Jones,610,France,182720.07,0,1,0
7618,2011,4,MORTGAGE,3,Low,1,3000, 36 months,1,other,4,Low,1,Good Loan,0,12.42,B,2,19.78,3300.4,3000,0,100.25,409000007617,19-Feb-18,TRF FRM  Indiaforensic SERVICES,,350000.00,-543523033.55,Quezada,502,France,4082.52,0,1,0
7619,2011,5,MORTGAGE,3,Low,1,5000, 36 months,1,debt_consolidation,6,Low,1,Good Loan,0,8.9,A,1,3.3,5618.37,5000,0,158.77,409000007618,22-Feb-18,TRF TO  Indiaforensic SERVICES I,"2,647,330.00",,-546170363.55,McCulloch,578,France,102233.73,0,1,0
7620,2011,4,MORTGAGE,3,Low,1,16000, 36 months,1,debt_consolidation,6,Low,1,Good Loan,0,8.9,A,1,23.88,18286.96945,16000,0,508.06,409000007619,7-Mar-18,FDRL/INTERNAL FUND TRANSFE,,300000.00,-545870363.55,Tobeolisa,547,France,132002.83,0,1,0
7621,2011,5,RENT,1,Low,1,21250, 60 months,2,debt_consolidation,6,High,2,Bad Loan,1,14.27,C,3,21.07,23343.83,15270.52,0,497.43,409000007620,7-Mar-18,FDRL/INTERNAL FUND TRANSFE,,300000.00,-545570363.55,Black,579,France,126838.70,0,1,0
7622,2011,0.5,RENT,1,Medium,2,9000, 36 months,1,moving,10,Low,1,Good Loan,0,7.9,A,1,12.04,10137.35153,9000,0,281.62,409000007621,7-Mar-18,FDRL/INTERNAL FUND TRANSFE,,300000.00,-545270363.55,Fraser,661,France,181461.46,0,1,0
7623,2011,2,RENT,1,Low,1,3000, 36 months,1,other,4,High,2,Bad Loan,1,13.49,C,3,13.48,2217.43,1593.35,91.6,101.8,409000007622,7-Mar-18,FDRL/INTERNAL FUND TRANSFE,,300000.00,-544970363.55,Green,794,France,195325.74,0,1,0
7624,2011,10,MORTGAGE,3,Low,1,17000, 60 months,2,major_purchase,8,High,2,Good Loan,0,13.49,C,3,10.92,20292.07,14009.61,0,391.08,409000007623,7-Mar-18,FDRL/INTERNAL FUND TRANSFE,,300000.00,-544670363.55,Allan,719,France,29132.43,0,1,0
7625,2011,6.05,RENT,1,Low,1,16000, 60 months,2,other,4,Low,1,Good Loan,0,10.99,B,2,17.89,18662.82,16000,0,347.8,409000007624,7-Mar-18,FDRL/INTERNAL FUND TRANSFE,,300000.00,-544370363.55,Akudinobi,728,France,131804.86,0,1,0
7626,2011,4,RENT,1,Low,1,11325, 36 months,1,debt_consolidation,6,Low,1,Good Loan,0,11.71,B,2,14.64,13117.19,11325,0,374.59,409000007625,7-Mar-18,FDRL/INTERNAL FUND TRANSFE,,300000.00,-544070363.55,Walker,598,Germany,173784.04,0,1,0
7627,2011,0.5,MORTGAGE,3,High,3,10000, 36 months,1,small_business,3,High,2,Good Loan,0,14.65,C,3,2.9,12415.10135,10000,0,344.95,409000007626,12-Mar-18,TRF FROM  Indiaforensic SERVICES,,220000.00,-543850363.55,Olisaemeka,822,Germany,26249.86,0,1,0
7628,2011,8,MORTGAGE,3,Low,1,2100, 36 months,1,debt_consolidation,6,Low,1,Good Loan,0,6.99,A,1,9.65,2289.84,2100,0,64.84,409000007627,14-Mar-18,TRF TO  Indiaforensic SERVICES I,"3,000,000.00",,-546850363.55,Arcuri,670,Spain,182650.15,0,1,0
7629,2011,6.05,RENT,1,Low,1,6000, 36 months,1,home_improvement,7,High,2,Bad Loan,1,16.77,D,4,9.15,4477.06,3117.91,20.23,213.24,409000007628,22-Mar-18,FDRL/INTERNAL FUND TRANSFE,,200000.00,-546650363.55,Liu,850,France,196582.55,0,1,0
7630,2011,10,MORTGAGE,3,Low,1,14000, 60 months,2,credit_card,1,Low,1,Good Loan,0,7.9,A,1,18.07,16550.99741,14000,0,283.2,409000007629,5-Apr-18,TRF TO  Indiaforensic SERVICES I,"200,000.00",,-546850363.55,Flemming,723,Germany,141977.54,0,1,0
7631,2011,5,MORTGAGE,3,Low,1,22800, 60 months,2,debt_consolidation,6,Low,1,Good Loan,0,12.69,B,2,16.41,26232.56,18374.45,0,515.16,409000007630,5-Apr-18,TRF FROM  Indiaforensic SERVICES,,135801.00,-546714562.55,Bischof,705,Germany,55313.51,0,1,0
7632,2011,4,MORTGAGE,3,Low,1,20000, 60 months,2,debt_consolidation,6,High,2,Good Loan,0,14.65,C,3,20.96,27969.31956,20000,0,472.14,409000007631,10-Apr-18,TRF FROM  Indiaforensic SERVICES,,240000.00,-546474562.55,John,677,Spain,62944.75,0,1,0
7633,2011,1,RENT,1,Low,1,12000, 60 months,2,debt_consolidation,6,High,2,Bad Loan,1,14.27,C,3,7.26,2620.17,1149.49,379.37,280.91,409000007632,11-Apr-18,TRF FROM  Indiaforensic SERVICES,,1935500.00,-544539062.55,Sinnett,736,France,72375.03,0,1,0
7634,2011,1,MORTGAGE,3,Low,1,13200, 60 months,2,debt_consolidation,6,High,2,Good Loan,0,14.27,C,3,8.66,15725.94,10558.75,0,309,409000007633,27-Apr-18,TRF TO  Indiaforensic SERVICES I,"3,000,000.00",,-547539062.55,Ts'ui,661,Germany,188324.01,0,1,0
7635,2011,10,MORTGAGE,3,Low,1,15000, 60 months,2,debt_consolidation,6,Low,1,Good Loan,0,7.9,A,1,4.08,15449.99,12338.52,0,303.43,409000007634,18-May-18,TRF FROM  Indiaforensic SERVICES,,1690492.00,-545848570.55,Pokrovsky,501,Germany,133403.07,0,1,0
7636,2011,10,MORTGAGE,3,Low,1,11700, 60 months,2,medical,9,High,2,Good Loan,0,16.77,D,4,18.95,14366.68143,11700,0,289.34,409000007635,18-May-18,FDRL/INTERNAL FUND TRANSFE,,100000.00,-545748570.55,Azarov,516,France,157378.50,0,1,0
7637,2011,2,RENT,1,Low,1,1500, 36 months,1,major_purchase,8,High,2,Good Loan,0,13.49,C,3,7.33,1830.653847,1500,0,50.9,409000007636,18-May-18,FDRL/INTERNAL FUND TRANSFE,,100000.00,-545648570.55,McCarthy,517,Germany,101240.08,0,1,0
7638,2011,1,RENT,1,Low,1,7500, 36 months,1,major_purchase,8,High,2,Good Loan,0,17.27,D,4,6.39,9655.289629,7500,0,268.41,409000007637,18-May-18,FDRL/INTERNAL FUND TRANSFE,,200000.00,-545448570.55,Simpson,766,France,102502.50,0,1,0
7639,2011,10,MORTGAGE,3,High,3,33000, 36 months,1,debt_consolidation,6,High,2,Good Loan,0,20.3,E,5,6.35,44399.09779,33000,0,1231.45,409000007638,18-May-18,FDRL/INTERNAL FUND TRANSFE,,200000.00,-545248570.55,Stevenson,520,Germany,37577.66,0,1,0
7640,2011,5,MORTGAGE,3,Low,1,12475, 36 months,1,other,4,Low,1,Good Loan,0,6.62,A,1,14.03,13787.33791,12475,0,383.03,409000007639,18-May-18,FDRL/INTERNAL FUND TRANSFE,,200000.00,-545048570.55,Moore,541,France,83456.67,0,1,0
7641,2011,6,MORTGAGE,3,Low,1,20000, 60 months,2,debt_consolidation,6,High,2,Bad Loan,1,19.91,E,5,17.49,5728.68,2340.35,0,477.98,409000007640,18-May-18,FDRL/INTERNAL FUND TRANSFE,,200000.00,-544848570.55,Chill,790,Germany,199420.41,0,1,0
7642,2011,0.5,MORTGAGE,3,Low,1,3200, 36 months,1,debt_consolidation,6,Low,1,Good Loan,0,7.51,A,1,13.51,3510.3,3200,0,99.56,409000007641,18-May-18,FDRL/INTERNAL FUND TRANSFE,,200000.00,-544648570.55,Moore,797,France,24748.89,0,1,0
7643,2011,10,MORTGAGE,3,Low,1,28000, 36 months,1,small_business,3,Low,1,Good Loan,0,11.71,B,2,7.51,33328.47412,28000,0,926.13,409000007642,18-May-18,FDRL/INTERNAL FUND TRANSFE,,200000.00,-544448570.55,Su,811,France,121765.00,0,1,0
7644,2011,6,MORTGAGE,3,Low,1,1200, 36 months,1,wedding,5,Low,1,Good Loan,0,6.03,A,1,4.36,1314.640109,1200,0,36.53,409000007643,18-May-18,FDRL/INTERNAL FUND TRANSFE,,300000.00,-544148570.55,Rees,722,Spain,113666.48,0,1,0
7645,2011,10,RENT,1,Low,1,9600, 36 months,1,debt_consolidation,6,Low,1,Good Loan,0,7.9,A,1,19.82,9739.35,9600,0,300.39,409000007644,18-May-18,FDRL/INTERNAL FUND TRANSFE,,200000.00,-543948570.55,Lung,675,France,134110.93,0,1,0
7646,2011,3,MORTGAGE,3,Low,1,20500, 60 months,2,debt_consolidation,6,Low,1,Good Loan,0,10.65,B,2,28.73,23921.14,20500,0,442.15,409000007645,18-May-18,FDRL/INTERNAL FUND TRANSFE,,200000.00,-543748570.55,Thomas,660,Germany,183095.87,0,1,0
7647,2011,6,MORTGAGE,3,Low,1,8125, 60 months,2,debt_consolidation,6,High,2,Good Loan,0,19.03,E,5,19.73,10705.37,6344.76,0,210.91,409000007646,19-May-18,Indiaforensic  RUPAY SETT 190518,"4,285.44",,-543752855.99,Fuller,566,Spain,159891.03,0,1,0
7648,2011,6.05,OWN,2,Low,1,6000, 36 months,1,debt_consolidation,6,Low,1,Good Loan,0,6.62,A,1,3.31,6629.861829,6000,0,184.23,409000007647,19-May-18,Indiaforensic  RUPAY SETT 190518,896.42,,-543753752.41,Trevisani,768,France,8316.19,0,1,0
7649,2011,5,MORTGAGE,3,Medium,2,7500, 36 months,1,credit_card,1,Low,1,Good Loan,0,8.9,A,1,20.31,8570.780174,7500,0,238.15,409000007648,21-May-18,Indiaforensic RUPAY SETT 200518,"4,454.41",,-543758206.82,Dumolo,610,Spain,63736.36,0,1,0
7650,2011,0.5,MORTGAGE,3,Medium,2,7500, 36 months,1,home_improvement,7,Low,1,Good Loan,0,6.03,A,1,4.42,8130.09,7500,0,228.27,409000007649,21-May-18,Indiaforensic RUPAY SETT 210518,"13,951.00",,-543772157.82,Wu,715,France,94715.24,0,1,0
7651,2011,6,MORTGAGE,3,Low,1,6000, 36 months,1,other,4,High,2,Good Loan,0,15.99,D,4,15.12,7585.299151,6000,0,210.92,409000007650,21-May-18,Indiaforensic RUPAY SETT 210518-,20.71,,-543772178.53,Kerr,750,Germany,68695.38,0,1,0
7652,2011,9,MORTGAGE,3,Low,1,14000, 60 months,2,debt_consolidation,6,Low,1,Good Loan,0,12.99,C,3,21.8,18896.83002,14000,0,318.48,409000007651,22-May-18,Indiaforensic  RUPAY SETT 220518,,750.35,-543771428.18,Geoghegan,431,Germany,36899.62,0,1,0
7653,2011,6,MORTGAGE,3,High,3,7350, 36 months,1,wedding,5,Low,1,Good Loan,0,11.99,B,2,8.67,8166.82,7350,0,244.1,409000007652,22-May-18,Indiaforensic  RUPAY SETT 220518,46.71,,-543771474.89,Bailey,704,France,182775.08,0,1,0
7654,2011,7,MORTGAGE,3,Low,1,32000, 36 months,1,debt_consolidation,6,High,2,Bad Loan,1,15.23,C,3,7.2,37523.12,31115.81,47.24,1112.9,409000007653,22-May-18,OXYGEN NFS SETT 21-05-201,200,,-543771674.89,Hsia,535,Spain,62390.59,0,1,0
7655,2011,10,MORTGAGE,3,Low,1,13150, 60 months,2,debt_consolidation,6,High,2,Bad Loan,1,13.49,C,3,23.84,11314.23,6338.27,995.5,302.52,409000007654,22-May-18,OXYGEN NFS SETT 21-05-201,"2,000.00",,-543773674.89,Holden,614,France,76042.48,0,1,0
7656,2011,3,RENT,1,Low,1,13200, 60 months,2,debt_consolidation,6,High,2,Good Loan,0,14.79,C,3,22.03,16652.49,13200,0,312.58,409000007655,23-May-18,OXYGEN NFS SETT 23-05-201,100,,-543773774.89,Milani,748,France,70956.75,0,1,0
7657,2011,0.5,RENT,1,Low,1,14000, 60 months,2,debt_consolidation,6,High,2,Good Loan,0,14.79,C,3,14.27,16890.7,11182.73,0,331.52,409000007656,23-May-18,OXYGEN NFS SETT 23-05-201,"1,000.00",,-543774774.89,Jamieson,492,Germany,67311.12,0,1,0
7658,2011,2,RENT,1,Low,1,1500, 36 months,1,moving,10,High,2,Good Loan,0,15.23,C,3,20.33,1639.5,1500,0,52.17,409000007657,23-May-18,Indiaforensic  RUPAY SETT 230518,"1,204.25",,-543775979.14,Ndubueze,573,France,110454.46,0,1,0
7659,2011,5,MORTGAGE,3,Low,1,8000, 36 months,1,debt_consolidation,6,Low,1,Good Loan,0,5.42,A,1,2.11,8442.2,8000,0,241.28,409000007658,23-May-18,Indiaforensic  RUPAY SETT 230518,211.42,,-543776190.56,Abramova,706,Spain,88479.02,0,1,0
7660,2011,10,MORTGAGE,3,Low,1,12375, 60 months,2,debt_consolidation,6,Low,1,Good Loan,0,8.49,A,1,20.65,13559.37,12375,0,253.84,409000007659,24-May-18,OXYGEN NFS SETT 24-05-201,"3,500.00",,-543779690.56,Wetherspoon,680,France,122639.73,0,1,0
7661,2011,10,OWN,2,High,3,35000, 36 months,1,debt_consolidation,6,Low,1,Good Loan,0,10.59,B,2,10.28,40850.83383,35000,0,1139.08,409000007660,24-May-18,OXYGEN NFS SETT 24-05-201,"6,500.00",,-543786190.56,Middleton,458,Spain,79723.78,0,1,0
7662,2011,2,RENT,1,Low,1,4200, 60 months,2,major_purchase,8,High,2,Good Loan,0,16.49,D,4,14.52,5966.48,4191.15,0,103.24,409000007661,24-May-18,OXYGEN NFS SETT 24-05-201,"4,000.00",,-543790190.56,Arcuri,612,Germany,97677.52,0,1,0
7663,2011,10,MORTGAGE,3,Low,1,30000, 60 months,2,debt_consolidation,6,High,2,Bad Loan,1,15.23,C,3,20.22,7801.06,3940.97,22.77,600.17,409000007662,24-May-18,OXYGEN NFS SETT 24-05-201,"1,000.00",,-543791190.56,Calabrese,809,Germany,100720.02,0,1,0
7664,2011,0.5,MORTGAGE,3,Low,1,6000, 36 months,1,vacation,11,Low,1,Bad Loan,1,5.42,A,1,5.73,2710.05,2378.5,0,180.96,409000007663,24-May-18,OXYGEN NFS SETT 24-05-201,300,,-543791490.56,Hampton,590,France,104730.52,0,1,0
7665,2011,1,RENT,1,Low,1,20000, 36 months,1,debt_consolidation,6,High,2,Good Loan,0,17.49,D,4,18.42,25832.86846,20000,0,717.95,409000007664,24-May-18,Indiaforensic  RUPAY SETT 240518,"2,218.30",,-543793708.86,Clayton,602,France,22499.29,0,1,0
7666,2011,10,RENT,1,Low,1,30000, 60 months,2,debt_consolidation,6,High,2,Good Loan,0,13.49,C,3,5.27,40079.51883,30000,0,690.15,409000007665,24-May-18,Indiaforensic  RUPAY SETT 240518,121.71,,-543793830.57,Otutodilichukwu,540,Spain,28257.89,0,1,0
7667,2011,10,MORTGAGE,3,Low,1,10000, 60 months,2,debt_consolidation,6,High,2,Good Loan,0,15.23,C,3,11.71,13303.66265,10000,0,239.11,409000007666,25-May-18,Indiaforensic  RUPAY SETT 250518,"1,636.08",,-543795466.65,Chukwuemeka,494,France,109988.09,0,1,0
7668,2011,6.05,MORTGAGE,3,Low,1,24000, 60 months,2,home_improvement,7,Low,1,Good Loan,0,12.99,C,3,15.54,27787.37,19309.09,0,545.96,409000007667,25-May-18,Indiaforensic  RUPAY SETT 250518,591.12,,-543796057.77,Douglas,797,France,149991.32,0,1,0
7669,2011,4,RENT,1,Low,1,8000, 36 months,1,debt_consolidation,6,High,2,Good Loan,0,17.49,D,4,11.3,10326.49777,8000,0,287.18,409000007668,25-May-18,OXYGEN NFS SETT 24-05-201,400,,-543796457.77,Galloway,526,Germany,45180.80,0,1,0
7670,2011,10,RENT,1,Low,1,15000, 60 months,2,debt_consolidation,6,Low,1,Good Loan,0,12.99,C,3,23.95,17354.97,12061.04,0,341.22,409000007669,25-May-18,OXYGEN NFS SETT 24-05-201,500,,-543796957.77,Sochima,631,Spain,181605.85,0,1,0
7671,2011,5,RENT,1,Low,1,4000, 36 months,1,credit_card,1,Low,1,Good Loan,0,10.59,B,2,3.16,4518.73,4000,0,130.18,409000007670,25-May-18,OXYGEN NFS SETT 24-05-201,"5,000.00",,-543801957.77,Wilkins,576,France,126469.09,0,1,0
7672,2011,10,MORTGAGE,3,Low,1,28000, 60 months,2,debt_consolidation,6,Low,1,Good Loan,0,11.99,B,2,10.43,35082.76094,28000,0,622.71,409000007671,25-May-18,OXYGEN NFS SETT 24-05-201,500,,-543802457.77,Rice,405,France,160810.85,0,1,0
7673,2011,6,RENT,1,Low,1,10000, 36 months,1,debt_consolidation,6,High,2,Good Loan,0,15.62,D,4,21.43,11064.49,10000,0,349.7,409000007672,25-May-18,OXYGEN NFS SETT 24-05-201,700,,-543803157.77,Pope,555,France,88146.86,0,1,0
7674,2011,3,MORTGAGE,3,Low,1,7200, 36 months,1,major_purchase,8,Low,1,Good Loan,0,11.49,B,2,4.65,8544.000224,7200,0,237.4,409000007673,25-May-18,OXYGEN NFS SETT 24-05-201,"1,500.00",,-543804657.77,Romani,750,Spain,88333.74,0,1,0
7675,2011,5,RENT,1,Medium,2,10000, 36 months,1,debt_consolidation,6,Low,1,Good Loan,0,9.99,B,2,22.95,11130.57,10000,0,322.63,409000007674,25-May-18,OXYGEN NFS SETT 24-05-201,500,,-543805157.77,Ch'ang,665,France,90174.83,0,1,0
7676,2011,9,MORTGAGE,3,Low,1,20000, 60 months,2,debt_consolidation,6,High,2,Good Loan,0,15.23,C,3,11.35,28150.07809,20000,0,478.22,409000007675,28-May-18,Indiaforensic RUPAY SETT 260518,"1,352.71",,-543806510.48,Chizuoke,640,Spain,81298.09,0,1,0
7677,2011,1,RENT,1,Low,1,3000, 36 months,1,major_purchase,8,High,2,Good Loan,0,15.99,D,4,8.2,3792.0022,3000,0,105.46,409000007676,28-May-18,Indiaforensic RUPAY SETT 270518,"3,522.18",,-543810032.66,Ireland,457,France,60013.17,0,1,0
7678,2011,4,MORTGAGE,3,Low,1,10975, 60 months,2,debt_consolidation,6,Low,1,Good Loan,0,11.99,B,2,12.93,14513.98,10975,0,244.08,409000007677,28-May-18,Indiaforensic RUPAY SETT 280518,"7,232.58",,-543817265.24,Finch,695,France,100940.91,0,1,0
7679,2011,10,MORTGAGE,3,Medium,2,8000, 36 months,1,home_improvement,7,Low,1,Good Loan,0,11.49,B,2,17.48,9425.03,8000,0,263.78,409000007678,29-May-18,OXYGEN NFS SETT 28-05-201,300,,-543817565.24,Meng,645,France,12599.94,0,1,0
7680,2011,10,MORTGAGE,3,Low,1,20950, 60 months,2,debt_consolidation,6,Low,1,Bad Loan,1,11.49,B,2,25.8,12086.87,6473.71,1620.67,401.83,409000007679,29-May-18,OXYGEN NFS SETT 28-05-201,300,,-543817865.24,Hibbins,647,Spain,128590.73,0,1,0
7681,2011,10,MORTGAGE,3,Low,1,21400, 36 months,1,debt_consolidation,6,High,2,Good Loan,0,15.23,C,3,13.37,25728.93,21400,0,744.26,409000007680,29-May-18,OXYGEN NFS SETT 28-05-201,100,,-543817965.24,Chung,808,Spain,23180.37,0,1,0
7682,2011,6.05,MORTGAGE,3,Low,1,6500, 36 months,1,credit_card,1,Low,1,Good Loan,0,5.42,A,1,17.68,6780.81,6500,0,196.04,409000007681,29-May-18,OXYGEN NFS SETT 28-05-201,"1,000.00",,-543818965.24,Black,641,France,55796.83,0,1,0
7683,2011,6.05,MORTGAGE,3,Low,1,8000, 36 months,1,home_improvement,7,Low,1,Good Loan,0,5.42,A,1,22.71,8685.024148,8000,0,241.28,409000007682,29-May-18,OXYGEN NFS SETT 28-05-201,200,,-543819165.24,Balashov,700,Spain,152097.02,0,1,0
7684,2011,10,MORTGAGE,3,High,3,5500, 36 months,1,car,2,Low,1,Good Loan,0,5.42,A,1,5.75,5595.98,5500,0,165.88,409000007683,29-May-18,OXYGEN NFS SETT 28-05-201,"1,000.00",,-543820165.24,Palmer,660,Germany,162443.05,0,1,0
7685,2011,10,RENT,1,Low,1,15000, 36 months,1,wedding,5,Low,1,Good Loan,0,8.49,A,1,7.44,17040.14367,15000,0,473.45,409000007684,29-May-18,OXYGEN NFS SETT 28-05-201,"2,000.00",,-543822165.24,Lea,615,Spain,55551.26,0,1,0
7686,2011,10,MORTGAGE,3,Low,1,25450, 60 months,2,debt_consolidation,6,High,2,Good Loan,0,21.36,F,6,16.89,25843,14412.92,0,506.97,409000007685,29-May-18,OXYGEN NFS SETT 28-05-201,"2,000.00",,-543824165.24,Singleton,705,Germany,109496.69,0,1,0
7687,2011,1,MORTGAGE,3,Low,1,13000, 60 months,2,other,4,Low,1,Good Loan,0,7.49,A,1,9.09,13278.38,10725.07,0,260.44,409000007686,29-May-18,OXYGEN NFS SETT 28-05-201,"1,000.00",,-543825165.24,Burt,718,France,72105.63,0,1,0
7688,2011,6,RENT,1,Low,1,28000, 60 months,2,major_purchase,8,High,2,Good Loan,0,18.79,E,5,0.33,35139.72,27999.99,0,723.11,409000007687,29-May-18,OXYGEN NFS SETT 28-05-201,100,,-543825265.24,Siciliano,754,France,41815.22,0,1,0
7689,2011,10,MORTGAGE,3,Low,1,35000, 36 months,1,other,4,Low,1,Good Loan,0,10.99,B,2,16.95,40869.79,35000,0,1145.69,409000007688,29-May-18,OXYGEN NFS SETT 28-05-201,"1,000.00",,-543826265.24,Sun,713,Germany,74005.04,0,1,0
7690,2011,1,RENT,1,Low,1,2900, 60 months,2,car,2,High,2,Good Loan,0,16.49,D,4,23.74,4185.436278,2900,0,71.28,409000007689,29-May-18,OXYGEN NFS SETT 25-05-18,500,,-543826765.24,Sauve,587,France,70224.34,0,1,0
7691,2011,6.05,MORTGAGE,3,Low,1,3000, 60 months,2,car,2,Low,1,Good Loan,0,11.99,B,2,0,3383.01,3000,0,66.72,409000007690,29-May-18,OXYGEN NFS SETT 25-05-18,"1,000.00",,-543827765.24,Thompson,569,Spain,145528.22,0,1,0
7692,2011,10,RENT,1,Low,1,6925, 36 months,1,debt_consolidation,6,High,2,Good Loan,0,15.99,D,4,21.24,8758.014926,6925,0,243.43,409000007691,29-May-18,OXYGEN NFS SETT 25-05-18,500,,-543828265.24,Boni,568,France,124486.28,0,1,0
7693,2011,0.5,RENT,1,Low,1,3000, 36 months,1,other,4,Low,1,Good Loan,0,5.99,A,1,0.48,3284.93457,3000,0,91.26,409000007692,29-May-18,OXYGEN NFS SETT 25-05-18,300,,-543828565.24,Wood,634,Germany,10078.02,0,1,0
7694,2011,2,RENT,1,Low,1,5000, 36 months,1,wedding,5,Low,1,Good Loan,0,8.49,A,1,17.24,5678.001585,5000,0,157.82,409000007693,29-May-18,OXYGEN NFS SETT 25-05-18,200,,-543828765.24,Buccho,770,Germany,164967.21,0,1,0
7695,2011,2,RENT,1,Low,1,10000, 36 months,1,moving,10,Low,1,Good Loan,0,8.49,A,1,9.19,11360.34098,10000,0,315.63,409000007694,29-May-18,OXYGEN NFS SETT 25-05-18,100,,-543828865.24,Spencer,676,Spain,91149.48,0,1,0
7696,2011,8,MORTGAGE,3,Low,1,5500, 36 months,1,other,4,Low,1,Good Loan,0,7.49,A,1,17.03,6139.098957,5500,0,171.06,409000007695,29-May-18,OXYGEN NFS SETT 25-05-18,"3,000.00",,-543831865.24,Eidson,723,Germany,103379.31,0,1,0
7697,2011,6.05,MORTGAGE,3,Low,1,14000, 36 months,1,credit_card,1,Low,1,Bad Loan,1,7.49,A,1,15.27,7427,5829.94,468.76,435.43,409000007696,29-May-18,OXYGEN NFS SETT 25-05-18,"1,200.00",,-543833065.24,Hung,614,Germany,128049.34,0,1,0
7698,2011,2,MORTGAGE,3,Low,1,20000, 60 months,2,debt_consolidation,6,Low,1,Bad Loan,1,9.99,B,2,25.7,9521.79,6440.12,0,346.25,409000007697,29-May-18,OXYGEN NFS SETT 25-05-18,"1,100.00",,-543834165.24,Melvin,601,Spain,54342.83,0,1,0
7699,2011,10,MORTGAGE,3,Medium,2,10000, 60 months,2,other,4,High,2,Good Loan,0,17.49,D,4,10.83,12766.96,7874.25,0,251.17,409000007698,29-May-18,OXYGEN NFS SETT 25-05-18,"2,300.00",,-543836465.24,Dawkins,592,France,13614.01,0,1,0
7700,2011,0.5,RENT,1,Low,1,6000, 36 months,1,credit_card,1,Low,1,Good Loan,0,9.99,B,2,19.48,6192.42,6000,0,193.58,409000007699,29-May-18,OXYGEN NFS SETT 25-05-18,"1,000.00",,-543837465.24,Rizzo,605,Spain,35521.63,0,1,0
7701,2011,7,RENT,1,Low,1,5100, 60 months,2,debt_consolidation,6,High,2,Bad Loan,1,19.29,E,5,0.83,2556.67,658.05,305.28,133.12,409000007700,29-May-18,OXYGEN NFS SETT 25-05-18,"3,400.00",,-543840865.24,Capon,752,Spain,40496.72,0,1,0
7702,2011,1,RENT,1,Low,1,6800, 36 months,1,moving,10,Low,1,Good Loan,0,10.59,B,2,19.29,7964.806099,6800,0,221.31,409000007701,29-May-18,OXYGEN NFS SETT 26-05-18,"2,000.00",,-543842865.24,Ts'ao,677,France,91903.90,0,1,0
7703,2011,2,MORTGAGE,3,Low,1,6000, 36 months,1,home_improvement,7,Low,1,Good Loan,0,5.42,A,1,21.92,6441.6,6000,0,180.96,409000007702,29-May-18,OXYGEN NFS SETT 26-05-18,500,,-543843365.24,Johnstone,850,France,178667.70,0,1,0
7704,2011,6.05,MORTGAGE,3,Low,1,12000, 60 months,2,debt_consolidation,6,Low,1,Good Loan,0,12.99,C,3,26.4,12630.92,12000,0,272.98,409000007703,29-May-18,OXYGEN NFS SETT 26-05-18,"1,000.00",,-543844365.24,Fleming,608,Germany,32202.61,0,1,0
7705,2011,6.05,RENT,1,Low,1,14500, 36 months,1,credit_card,1,Low,1,Good Loan,0,11.49,B,2,11.35,17206.40574,14500,0,478.09,409000007704,29-May-18,OXYGEN NFS SETT 26-05-18,400,,-543844765.24,Chang,786,Spain,117034.32,0,1,0
7706,2011,10,MORTGAGE,3,Low,1,25000, 60 months,2,debt_consolidation,6,High,2,Bad Loan,1,13.99,C,3,22.98,22423.77,11582.71,3252.8,581.58,409000007705,29-May-18,OXYGEN NFS SETT 26-05-18,600,,-543845365.24,Gibbs,777,France,163746.09,0,1,0
7707,2011,5,RENT,1,Low,1,4800, 36 months,1,other,4,Low,1,Good Loan,0,6.99,A,1,14,5334.080325,4800,0,148.19,409000007706,29-May-18,OXYGEN NFS SETT 26-05-18,600,,-543845965.24,Rita,667,Spain,20346.69,0,1,0
7708,2011,10,MORTGAGE,3,Low,1,25000, 60 months,2,debt_consolidation,6,High,2,Good Loan,0,18.39,E,5,28.19,37790.09239,25000,0,640.16,409000007707,29-May-18,OXYGEN NFS SETT 26-05-18,"1,000.00",,-543846965.24,Munro,848,Spain,84710.65,0,1,0
7709,2011,10,MORTGAGE,3,Low,1,14400, 60 months,2,home_improvement,7,Low,1,Good Loan,0,10.59,B,2,12.26,17203.61,14400,0,310.16,409000007708,29-May-18,OXYGEN NFS SETT 26-05-18,400,,-543847365.24,Duncan,486,France,120531.31,0,1,0
7710,2011,6.05,MORTGAGE,3,Low,1,15000, 36 months,1,debt_consolidation,6,Low,1,Good Loan,0,6.99,A,1,19.3,16670.7413,15000,0,463.09,409000007709,29-May-18,OXYGEN NFS SETT 26-05-18,"1,500.00",,-543848865.24,Okwuadigbo,598,Spain,152273.57,0,1,0
7711,2011,10,MORTGAGE,3,Low,1,14000, 60 months,2,home_improvement,7,Low,1,Good Loan,0,7.49,A,1,2.4,14298.17,11548.77,0,280.47,409000007710,29-May-18,OXYGEN NFS SETT 26-05-18,200,,-543849065.24,McIntosh,506,France,144345.58,0,1,0
7712,2011,7,MORTGAGE,3,Low,1,6000, 36 months,1,major_purchase,8,Low,1,Good Loan,0,5.99,A,1,17.16,6569.962144,6000,0,182.51,409000007711,29-May-18,OXYGEN NFS SETT 26-05-18,"1,300.00",,-543850365.24,Ch'iu,612,Germany,96961.00,0,1,0
7713,2011,6,MORTGAGE,3,Low,1,10500, 36 months,1,other,4,Low,1,Good Loan,0,9.99,B,2,10.15,11782.38,10500,0,338.76,409000007712,29-May-18,OXYGEN NFS SETT 26-05-18,"1,000.00",,-543851365.24,Watt,545,France,170307.43,0,1,0
7714,2011,2,MORTGAGE,3,Low,1,20000, 60 months,2,debt_consolidation,6,High,2,Good Loan,0,16.49,D,4,19.7,20276.75,20000,0,491.59,409000007713,29-May-18,OXYGEN NFS SETT 26-05-18,200,,-543851565.24,Udinese,793,France,29880.99,0,1,0
7715,2011,10,MORTGAGE,3,Low,1,8000, 36 months,1,debt_consolidation,6,Low,1,Good Loan,0,7.49,A,1,29.25,8954.373019,8000,0,248.82,409000007714,29-May-18,OXYGEN NFS SETT 27-05-18,"1,000.00",,-543852565.24,Clark,682,France,195104.91,0,1,0
7716,2011,0.5,RENT,1,Medium,2,2000, 36 months,1,moving,10,High,2,Good Loan,0,16.89,D,4,0.77,2563.02,2000,0,71.2,409000007715,29-May-18,OXYGEN NFS SETT 27-05-18,"10,000.00",,-543862565.24,Hsia,517,France,187756.24,0,1,0
7717,2011,3,RENT,1,Low,1,3850, 36 months,1,debt_consolidation,6,Low,1,Good Loan,0,9.99,B,2,12.3,4030.53,3850,0,124.22,409000007716,29-May-18,OXYGEN NFS SETT 27-05-18,500,,-543863065.24,Obiuto,684,France,67599.69,0,1,0
7718,2011,10,MORTGAGE,3,Low,1,12075, 60 months,2,debt_consolidation,6,Low,1,Good Loan,0,10.59,B,2,27.99,13238.85,9817.6,0,260.08,409000007717,29-May-18,OXYGEN NFS SETT 27-05-18,"3,000.00",,-543866065.24,T'ien,692,Spain,105983.09,0,1,0
7719,2011,10,MORTGAGE,3,Low,1,12000, 36 months,1,debt_consolidation,6,Low,1,Good Loan,0,10.99,B,2,18.05,14135.81688,12000,0,392.81,409000007718,29-May-18,OXYGEN NFS SETT 27-05-18,500,,-543866565.24,McKenzie,740,France,25980.42,0,1,0
7720,2011,0.5,RENT,1,Low,1,5000, 36 months,1,credit_card,1,Low,1,Bad Loan,1,11.49,B,2,19.2,5051.05,4227.98,0,164.86,409000007719,29-May-18,OXYGEN NFS SETT 27-05-18,"1,500.00",,-543868065.24,Tang,666,Germany,112222.64,0,1,0
7721,2011,10,MORTGAGE,3,Low,1,7000, 36 months,1,home_improvement,7,Low,1,Good Loan,0,6.99,A,1,25.15,7779.522314,7000,0,216.11,409000007720,29-May-18,OXYGEN NFS SETT 27-05-18,500,,-543868565.24,Tu,693,France,59864.96,0,1,0
7722,2011,10,RENT,1,Low,1,16000, 60 months,2,debt_consolidation,6,High,2,Bad Loan,1,15.99,D,4,17.59,13615.35,7748.35,51.77,389.01,409000007721,29-May-18,OXYGEN NFS SETT 27-05-18,100,,-543868665.24,Tsui,757,Germany,42581.09,0,1,0
7723,2011,10,RENT,1,Low,1,20000, 60 months,2,debt_consolidation,6,Low,1,Good Loan,0,10.99,B,2,11.36,20364.89,20000,0,434.75,409000007722,29-May-18,OXYGEN NFS SETT 27-05-18,200,,-543868865.24,Lynch,684,Germany,4777.23,0,1,0
7724,2011,3,RENT,1,Low,1,9050, 36 months,1,debt_consolidation,6,Low,1,Good Loan,0,5.99,A,1,16.56,9896.23039,9050,0,275.28,409000007723,29-May-18,OXYGEN NFS SETT 27-05-18,500,,-543869365.24,Hung,691,Spain,178038.17,0,1,0
7725,2011,6,RENT,1,Low,1,2500, 36 months,1,other,4,Low,1,Good Loan,0,9.99,B,2,14.49,2901.938238,2500,0,80.66,409000007724,29-May-18,OXYGEN NFS SETT 27-05-18,300,,-543869665.24,Oluchukwu,842,France,128521.16,0,1,0
7726,2011,5,MORTGAGE,3,Low,1,4800, 36 months,1,home_improvement,7,Low,1,Good Loan,0,10.99,B,2,20.97,5653.685607,4800,0,157.13,409000007725,29-May-18,OXYGEN NFS SETT 27-05-18,100,,-543869765.24,Tuan,482,France,109029.72,0,1,0
7727,2011,3,MORTGAGE,3,Low,1,10000, 36 months,1,small_business,3,Low,1,Good Loan,0,11.49,B,2,3.54,11865.3263,10000,0,329.72,409000007726,29-May-18,OXYGEN NFS SETT 27-05-18,100,,-543869865.24,Lewis,735,France,2267.88,0,1,0
7728,2011,9,MORTGAGE,3,Low,1,8000, 36 months,1,home_improvement,7,Low,1,Good Loan,0,7.49,A,1,17.04,8946.514568,8000,0,248.82,409000007727,29-May-18,OXYGEN NFS SETT 27-05-18,"2,000.00",,-543871865.24,Chidiebere,681,France,55054.48,0,1,0
7729,2011,1,RENT,1,Low,1,2200, 36 months,1,other,4,Low,1,Good Loan,0,11.99,B,2,11.43,2629.962805,2200,0,73.07,409000007728,29-May-18,OXYGEN NFS SETT 27-05-18,500,,-543872365.24,Woolacott,616,France,76456.17,0,1,0
7730,2011,7,MORTGAGE,3,Medium,2,10200, 36 months,1,moving,10,Low,1,Good Loan,0,5.42,A,1,18.62,10735.41,10200,0,307.64,409000007729,29-May-18,OXYGEN NFS SETT 27-05-18,500,,-543872865.24,Yen,850,France,75478.95,0,1,0
7731,2011,10,MORTGAGE,3,Low,1,12000, 36 months,1,debt_consolidation,6,Low,1,Good Loan,0,5.99,A,1,12.62,13059.85,12000,0,365.01,409000007730,29-May-18,OXYGEN NFS SETT 27-05-18,500,,-543873365.24,Service,635,France,179144.54,0,1,0
7732,2011,0.5,RENT,1,Low,1,17475, 60 months,2,credit_card,1,Low,1,Good Loan,0,10.99,B,2,27.43,19354.23,14195.6,0,379.87,409000007731,29-May-18,Indiaforensic  RUPAY SETT 290518,"3,324.08",,-543876689.32,Lin,638,Germany,193471.74,0,1,0
7733,2011,10,MORTGAGE,3,High,3,16000, 60 months,2,debt_consolidation,6,High,2,Good Loan,0,17.99,E,5,18.09,22202.06858,16000,0,406.21,409000007732,29-May-18,Indiaforensic  RUPAY SETT 290518,110.71,,-543876800.03,Chuang,820,Spain,103570.80,0,1,0
7734,2011,5,RENT,1,Low,1,10400, 60 months,2,debt_consolidation,6,High,2,Bad Loan,1,19.29,E,5,16.54,4303.72,1618.5,512.94,271.45,409000007733,30-May-18,FDRL/INTERNAL FUND TRANSFE,,100000.00,-543776800.03,Akhtar,694,Germany,102628.56,0,1,0
7735,2011,5,MORTGAGE,3,Low,1,14000, 60 months,2,debt_consolidation,6,Low,1,Bad Loan,1,11.99,B,2,19.3,9616.38,5043.5,1521.92,311.36,409000007734,30-May-18,OXYGEN NFS SETT 29-05-201,400,,-543777200.03,Faulkner,713,France,55772.04,0,1,0
7736,2011,5,MORTGAGE,3,Low,1,5500, 36 months,1,debt_consolidation,6,Low,1,Good Loan,0,10.99,B,2,21.59,6440.504733,5500,0,180.04,409000007735,30-May-18,OXYGEN NFS SETT 29-05-201,"1,500.00",,-543778700.03,Liang,543,Germany,192070.16,0,1,0
7737,2011,0.5,RENT,1,Low,1,12000, 60 months,2,wedding,5,High,2,Good Loan,0,14.79,C,3,24.74,16678.28407,12000,0,284.16,409000007736,30-May-18,OXYGEN NFS SETT 29-05-201,200,,-543778900.03,Dancy,649,France,144808.37,0,1,0
7738,2011,3,RENT,1,Low,1,3600, 36 months,1,debt_consolidation,6,High,2,Good Loan,0,15.99,D,4,20,4506.48,3600,0,126.55,409000007737,30-May-18,OXYGEN NFS SETT 29-05-201,300,,-543779200.03,Duigan,777,France,5008.23,0,1,0
7739,2011,2,MORTGAGE,3,Medium,2,15000, 36 months,1,debt_consolidation,6,Low,1,Good Loan,0,5.42,A,1,9.72,16285.49444,15000,0,452.4,409000007738,30-May-18,OXYGEN NFS SETT 29-05-201,"1,400.00",,-543780600.03,McLean,561,France,173680.39,0,1,0
7740,2011,4,RENT,1,Low,1,1600, 36 months,1,vacation,11,High,2,Good Loan,0,13.49,C,3,9.67,1892.41,1600,0,54.29,409000007739,30-May-18,OXYGEN NFS SETT 29-05-201,"1,000.00",,-543781600.03,Zuyeva,724,Spain,115753.94,0,1,0
7741,2011,1,MORTGAGE,3,Low,1,4000, 36 months,1,other,4,Low,1,Good Loan,0,7.49,A,1,1.58,4025.13,4000,0,124.41,409000007740,30-May-18,OXYGEN NFS SETT 29-05-201,300,,-543781900.03,Hankinson,665,Spain,38928.48,0,1,0
7742,2011,2,RENT,1,Low,1,20000, 60 months,2,credit_card,1,High,2,Good Loan,0,15.23,C,3,18.69,24311.39,15925.41,0,478.22,409000007741,30-May-18,Indiaforensic  RUPAY SETT 300518,640.58,,-543782540.61,Wei,441,France,174381.23,0,1,0
7743,2011,2,OWN,2,Low,1,6000, 36 months,1,major_purchase,8,Low,1,Good Loan,0,7.49,A,1,8.81,6715.865116,6000,0,186.61,409000007742,31-May-18,OXYGEN NFS SETT 30-05-201,500,,-543783040.61,Afamefula,579,Spain,49829.80,0,1,0
7744,2011,10,RENT,1,Low,1,11500, 36 months,1,credit_card,1,High,2,Good Loan,0,15.23,C,3,19.8,14381.4301,11500,0,399.95,409000007743,31-May-18,OXYGEN NFS SETT 30-05-201,"1,300.00",,-543784340.61,Chiang,777,Germany,76169.68,0,1,0
7745,2011,5,RENT,1,Low,1,4800, 36 months,1,debt_consolidation,6,Low,1,Good Loan,0,7.49,A,1,11.7,5372.411878,4800,0,149.29,409000007744,31-May-18,OXYGEN NFS SETT 30-05-201,"2,000.00",,-543786340.61,Myers,739,France,133465.57,0,1,0
7746,2011,10,MORTGAGE,3,Medium,2,24000, 36 months,1,debt_consolidation,6,Low,1,Good Loan,0,5.99,A,1,8.94,26084.07,24000,0,730.02,409000007745,31-May-18,OXYGEN NFS SETT 30-05-201,"1,000.00",,-543787340.61,Chinedum,660,France,38761.61,0,1,0
7747,2011,6,MORTGAGE,3,Low,1,6250, 36 months,1,debt_consolidation,6,Low,1,Good Loan,0,12.99,C,3,23.67,7516.432374,6250,0,210.56,409000007746,31-May-18,OXYGEN NFS SETT 30-05-201,"1,000.00",,-543788340.61,Ukaegbunam,554,France,176779.46,0,1,0
7748,2011,7,RENT,1,Low,1,20000, 60 months,2,debt_consolidation,6,High,2,Good Loan,0,20.62,F,6,11.3,27362.52,15552.93,0,536.81,409000007747,31-May-18,OXYGEN NFS SETT 30-05-201,"2,500.00",,-543790840.61,Akubundu,850,France,13159.90,0,1,0
7749,2011,3,RENT,1,Low,1,4000, 36 months,1,debt_consolidation,6,Low,1,Good Loan,0,10.99,B,2,4.58,4501.57,4000,0,130.94,409000007748,31-May-18,OXYGEN NFS SETT 30-05-201,"8,000.00",,-543798840.61,Sal,842,Germany,48217.97,0,1,0
7750,2011,10,MORTGAGE,3,Low,1,18000, 60 months,2,major_purchase,8,Low,1,Good Loan,0,10.59,B,2,15.03,19708.94,14618.11,0,387.7,409000007749,31-May-18,OXYGEN NFS SETT 30-05-201,"10,000.00",,-543808840.61,Stevenson,785,France,134964.85,0,1,0
7751,2011,10,MORTGAGE,3,Low,1,14750, 36 months,1,small_business,3,Low,1,Good Loan,0,5.42,A,1,18.32,16013.1819,14750,0,444.86,409000007750,31-May-18,OXYGEN NFS SETT 30-05-201,200,,-543809040.61,Sutherland,550,France,184221.11,0,1,0
7752,2011,1,RENT,1,Low,1,6800, 36 months,1,debt_consolidation,6,Low,1,Good Loan,0,11.49,B,2,16.25,7793.9,6800,0,224.21,409000007751,31-May-18,OXYGEN NFS SETT 30-05-201,"3,300.00",,-543812340.61,Ts'ao,750,Spain,19264.33,0,1,0
7753,2011,10,MORTGAGE,3,Low,1,6000, 60 months,2,debt_consolidation,6,High,2,Good Loan,0,14.79,C,3,11.86,6763.6,6000,0,142.08,409000007752,31-May-18,OXYGEN NFS SETT 30-05-201,"2,500.00",,-543814840.61,Sung,490,Spain,92797.23,0,1,0
7754,2011,4,RENT,1,Low,1,3000, 36 months,1,debt_consolidation,6,Low,1,Good Loan,0,7.49,A,1,20.8,3192.85,3000,0,93.31,409000007753,31-May-18,OXYGEN NFS SETT 30-05-201,200,,-543815040.61,Pisani,605,Germany,33114.24,0,1,0
7755,2011,10,MORTGAGE,3,Low,1,4800, 60 months,2,other,4,Low,1,Good Loan,0,11.99,B,2,9.24,5833.61,4800,0,106.75,409000007754,31-May-18,OXYGEN NFS SETT 30-05-201,200,,-543815240.61,Hs?eh,563,Spain,154347.95,0,1,0
7756,2011,5,RENT,1,Low,1,25000, 60 months,2,wedding,5,High,2,Good Loan,0,17.49,D,4,17.34,32581.83,20368.76,0,627.93,409000007755,31-May-18,Indiaforensic  RUPAY SETT 310518,"2,118.42",,-543817359.03,Sherrod,675,France,184842.21,0,1,0
7757,2011,10,MORTGAGE,3,Low,1,5000, 36 months,1,major_purchase,8,Low,1,Good Loan,0,6.99,A,1,23.41,5498.51,5000,0,154.37,409000007756,31-May-18,Indiaforensic  RUPAY SETT 310518,411.42,,-543817770.45,Holloway,621,Spain,155743.48,0,1,0
7758,2011,3,RENT,1,Low,1,7000, 36 months,1,credit_card,1,Low,1,Good Loan,0,11.49,B,2,12.52,7913.88,7000,0,230.8,409000007757,1-Jun-18,OXYGEN NFS SETT 31-05-201,400,,-543818170.45,Newton,850,France,88815.25,0,1,0
7759,2011,3,MORTGAGE,3,Low,1,12000, 36 months,1,credit_card,1,Low,1,Good Loan,0,5.42,A,1,16,12394.07,12000,0,361.92,409000007758,1-Jun-18,OXYGEN NFS SETT 31-05-201,"9,000.00",,-543827170.45,Kang,711,France,193747.57,0,1,0
7760,2011,10,MORTGAGE,3,Medium,2,35000, 60 months,2,debt_consolidation,6,High,2,Good Loan,0,20.99,F,6,9,26323.64,25025,0,676.87,409000007759,1-Jun-18,OXYGEN NFS SETT 31-05-201,100,,-543827270.45,Walton,549,Germany,116548.02,0,1,0
7761,2011,5,RENT,1,Low,1,5825, 36 months,1,credit_card,1,Low,1,Good Loan,0,9.99,B,2,21.56,6561.43,5825,0,187.93,409000007760,1-Jun-18,OXYGEN NFS SETT 31-05-201,"3,500.00",,-543830770.45,Bradley,764,Germany,166324.79,0,1,0
7762,2011,10,RENT,1,Low,1,2750, 60 months,2,debt_consolidation,6,Low,1,Good Loan,0,11.49,B,2,4.45,3435.951306,2750,0,60.47,409000007761,1-Jun-18,OXYGEN NFS SETT 31-05-201,"8,000.00",,-543838770.45,Watkins,627,Germany,40199.01,0,1,0
7763,2011,1,RENT,1,Low,1,4200, 36 months,1,debt_consolidation,6,High,2,Good Loan,0,16.49,D,4,10.36,5349.494198,4200,0,148.68,409000007762,1-Jun-18,OXYGEN NFS SETT 31-05-201,600,,-543839370.45,Tien,850,France,51919.04,0,1,0
7764,2011,10,MORTGAGE,3,Low,1,35000, 60 months,2,debt_consolidation,6,Low,1,Bad Loan,1,12.99,C,3,11.66,28534.5,19088.23,84.97,634.1,409000007763,1-Jun-18,OXYGEN NFS SETT 31-05-201,500,,-543839870.45,Davide,614,Spain,73329.08,0,1,0
7765,2011,8,OWN,2,Low,1,4200, 36 months,1,major_purchase,8,Low,1,Good Loan,0,12.99,C,3,24.6,5092.850305,4200,0,141.5,409000007764,1-Jun-18,OXYGEN NFS SETT 31-05-201,"1,000.00",,-543840870.45,Milne,685,Germany,145387.05,0,1,0
7766,2011,10,MORTGAGE,3,Low,1,8400, 36 months,1,debt_consolidation,6,Low,1,Good Loan,0,11.99,B,2,10.63,8483.98,8400,0,278.97,409000007765,1-Jun-18,OXYGEN NFS SETT 31-05-201,"10,000.00",,-543850870.45,Barling,683,Germany,140763.18,0,1,0
7767,2011,9,MORTGAGE,3,Low,1,20000, 60 months,2,other,4,Low,1,Good Loan,0,10.59,B,2,16.82,21934.96,16266.55,0,430.78,409000007766,1-Jun-18,OXYGEN NFS SETT 31-05-201,"1,000.00",,-543851870.45,Barnett,643,Spain,67979.35,0,1,0
7768,2011,4,MORTGAGE,3,Low,1,2000, 36 months,1,debt_consolidation,6,High,2,Good Loan,0,15.62,D,4,5.84,2516.056741,2000,0,69.94,409000007767,1-Jun-18,Indiaforensic  RUPAY SETT 010618,100.71,,-543851971.16,Ellis,561,Germany,133051.64,0,1,0
7769,2011,3,RENT,1,Low,1,10000, 36 months,1,other,4,Low,1,Bad Loan,1,12.99,C,3,23.43,4139.1,2651.83,421.66,336.9,409000007768,2-Jun-18,OXYGEN NFS SETT 01-06-201,"6,000.00",,-543857971.16,Hsia,601,Spain,86791.90,0,1,0
7770,2011,2,MORTGAGE,3,Low,1,17000, 60 months,2,debt_consolidation,6,Low,1,Good Loan,0,10.99,B,2,19.1,17904.04,17000,0,369.54,409000007769,2-Jun-18,OXYGEN NFS SETT 01-06-201,200,,-543858171.16,Chukwujamuike,766,France,47579.25,0,1,0
7771,2011,10,MORTGAGE,3,Low,1,10000, 36 months,1,debt_consolidation,6,High,2,Good Loan,0,13.99,C,3,11.19,11904.85,10000,0,341.73,409000007770,2-Jun-18,OXYGEN NFS SETT 01-06-201,400,,-543858571.16,Venables,699,France,151623.71,0,1,0
7772,2011,5,MORTGAGE,3,Low,1,3500, 36 months,1,wedding,5,Low,1,Good Loan,0,12.99,C,3,21.97,4243.865606,3500,0,117.92,409000007771,2-Jun-18,OXYGEN NFS SETT 01-06-201,"1,900.00",,-543860471.16,Hsia,850,Germany,164039.51,0,1,0
7773,2011,10,RENT,1,Low,1,3000, 36 months,1,debt_consolidation,6,Low,1,Good Loan,0,10.59,B,2,14.86,3515.486599,3000,0,97.64,409000007772,2-Jun-18,OXYGEN NFS SETT 01-06-201,"1,000.00",,-543861471.16,Alexander,792,Germany,16528.40,0,1,0
7774,2011,10,MORTGAGE,3,Low,1,5500, 36 months,1,debt_consolidation,6,Low,1,Good Loan,0,11.99,B,2,13.4,6511.92,5500,0,182.66,409000007773,2-Jun-18,Indiaforensic  RUPAY SETT 020618,"5,571.48",,-543867042.64,Yuan,636,Germany,66753.10,0,1,0
7775,2011,5,MORTGAGE,3,Medium,2,28500, 60 months,2,debt_consolidation,6,Low,1,Good Loan,0,9.99,B,2,26.67,30866.05,23265.29,0,605.41,409000007774,2-Jun-18,Indiaforensic  RUPAY SETT 020618,200.71,,-543867243.35,Johnston,850,Germany,19244.58,0,1,0
7776,2011,0.5,RENT,1,Low,1,35000, 60 months,2,house,12,High,2,Good Loan,0,13.49,C,3,8.8,24024.97,22550,0,518.76,409000007775,4-Jun-18,TRF FROM  Indiaforensic SERVICES,,24000.00,-543843243.35,Hobler,628,Spain,103832.58,0,1,0
7777,2011,2,MORTGAGE,3,Low,1,8975, 60 months,2,home_improvement,7,Low,1,Good Loan,0,7.49,A,1,22.67,9677.49,8975,0,179.8,409000007776,4-Jun-18,Indiaforensic  RUPAY SETT 030618,"1,494.42",,-543844737.77,Jamieson,736,France,502.70,0,1,0
7778,2011,1,RENT,1,Low,1,16000, 36 months,1,debt_consolidation,6,Low,1,Good Loan,0,11.99,B,2,8.64,19128.0771,16000,0,531.36,409000007777,4-Jun-18,Indiaforensic  RUPAY SETT 040618,"5,118.29",,-543849856.06,Macleod,711,France,1408.68,0,1,0
7779,2011,4,MORTGAGE,3,Medium,2,14000, 60 months,2,debt_consolidation,6,Low,1,Good Loan,0,8.49,A,1,9.89,14635.81,11497.86,0,287.17,409000007778,4-Jun-18,Indiaforensic  RUPAY SETT 040618,"5,000.71",,-543854856.77,Norris,583,Spain,5985.36,0,1,0
7780,2011,1,RENT,1,Low,1,7000, 36 months,1,other,4,Low,1,Good Loan,0,6.99,A,1,7.06,7779.384379,7000,0,216.11,409000007779,5-Jun-18,OXYGEN NFS SETT 02-06-201,"2,000.00",,-543856856.77,Pirozzi,757,France,37460.05,0,1,0
7781,2011,9,MORTGAGE,3,Medium,2,15000, 36 months,1,home_improvement,7,Low,1,Good Loan,0,8.49,A,1,10.58,17038.77727,15000,0,473.45,409000007780,5-Jun-18,OXYGEN NFS SETT 02-06-201,200,,-543857056.77,Folliero,749,Germany,30396.43,0,1,0
7782,2011,3,RENT,1,Low,1,8000, 36 months,1,medical,9,Low,1,Bad Loan,1,9.99,B,2,1.25,1802.05,577.32,1030.39,258.1,409000007781,5-Jun-18,OXYGEN NFS SETT 02-06-201,500,,-543857556.77,Russell,705,France,2498.67,0,1,0
7783,2011,2,OWN,2,Low,1,6000, 36 months,1,other,4,High,2,Good Loan,0,15.23,C,3,6.7,7211.97,5999.99,0,208.67,409000007782,5-Jun-18,OXYGEN NFS SETT 02-06-201,400,,-543857956.77,Hsiung,585,France,55346.14,0,1,0
7784,2011,0.5,MORTGAGE,3,Low,1,14000, 60 months,2,debt_consolidation,6,Low,1,Good Loan,0,12.99,C,3,21.68,16194.86,11255.37,0,318.48,409000007783,5-Jun-18,OXYGEN NFS SETT 02-06-201,"2,200.00",,-543860156.77,Tate,437,France,148330.97,0,1,0
7785,2011,3,MORTGAGE,3,Medium,2,7000, 36 months,1,debt_consolidation,6,High,2,Good Loan,0,13.99,C,3,6.01,8167.53,6999.99,0,239.21,409000007784,5-Jun-18,OXYGEN NFS SETT 02-06-201,"1,000.00",,-543861156.77,Davis,741,France,59237.72,0,1,0
7786,2011,0.5,RENT,1,Medium,2,31325, 60 months,2,debt_consolidation,6,High,2,Good Loan,0,22.85,G,7,19.74,37567.15,31325,0,880.37,409000007785,5-Jun-18,OXYGEN NFS SETT 02-06-201,"9,600.00",,-543870756.77,Bair,738,France,48644.94,0,1,0
7787,2011,1,RENT,1,Low,1,5500, 36 months,1,debt_consolidation,6,High,2,Good Loan,0,15.23,C,3,19.25,6880.467801,5500,0,191.28,409000007786,5-Jun-18,OXYGEN NFS SETT 03-06-201,"10,000.00",,-543880756.77,Drury,586,Spain,140759.03,0,1,0
7788,2011,3,RENT,1,Low,1,5000, 36 months,1,car,2,High,2,Good Loan,0,14.79,C,3,10.63,5189.18,5000,0,172.82,409000007787,5-Jun-18,OXYGEN NFS SETT 03-06-201,"1,700.00",,-543882456.77,Padovano,627,France,107712.42,0,1,0
7789,2011,6,MORTGAGE,3,Low,1,16000, 60 months,2,small_business,3,High,2,Good Loan,0,16.89,D,4,13.33,20180.36,12642.8,0,396.7,409000007788,5-Jun-18,OXYGEN NFS SETT 03-06-201,"1,100.00",,-543883556.77,Conway,551,Spain,181718.73,0,1,0
7790,2011,4,RENT,1,Low,1,12000, 36 months,1,debt_consolidation,6,Low,1,Good Loan,0,9.99,B,2,14.5,12730.8,12000,0,387.15,409000007789,5-Jun-18,OXYGEN NFS SETT 03-06-201,"4,000.00",,-543887556.77,Waters,606,Germany,37054.65,0,1,0
7791,2011,3,RENT,1,Low,1,3600, 36 months,1,credit_card,1,Low,1,Good Loan,0,10.99,B,2,18.22,4255.257937,3600,0,117.85,409000007790,5-Jun-18,Indiaforensic  RUPAY SETT 050618,510.71,,-543888067.48,Kang,674,France,173940.59,0,1,0
7792,2011,3,RENT,1,Low,1,11750, 36 months,1,debt_consolidation,6,Low,1,Good Loan,0,10.99,B,2,10.3,12788.11,11750,0,384.63,409000007791,5-Jun-18,Indiaforensic  RUPAY SETT 050618,"5,111.42",,-543893178.90,Martin,584,Germany,99298.80,0,1,0
7793,2011,2,RENT,1,Low,1,8000, 36 months,1,small_business,3,High,2,Bad Loan,1,15.23,C,3,9.51,8346.9,6382.92,0,278.23,409000007792,6-Jun-18,OXYGEN NFS SETT 04-06-201,100,,-543893278.90,Ugochukwutubelum,590,France,62933.03,0,1,0
7794,2011,5,RENT,1,Low,1,10000, 36 months,1,wedding,5,Low,1,Good Loan,0,5.42,A,1,4.5,10856.31154,10000,0,301.6,409000007793,6-Jun-18,OXYGEN NFS SETT 04-06-201,100,,-543893378.90,Burns,585,France,55287.84,0,1,0
7795,2011,4,RENT,1,Low,1,24000, 60 months,2,debt_consolidation,6,High,2,Good Loan,0,17.99,E,5,15.32,34418.67902,24000,0,609.32,409000007794,6-Jun-18,OXYGEN NFS SETT 05-06-201,"1,000.00",,-543894378.90,Genovese,508,France,48197.06,0,1,0
7796,2011,7,MORTGAGE,3,Low,1,20000, 60 months,2,debt_consolidation,6,High,2,Good Loan,0,18.39,E,5,22.27,30013.09184,20000,0,512.13,409000007795,6-Jun-18,TRF FROM  Indiaforensic SERVICES,,2140000.00,-541754378.90,Beale,458,Germany,178642.73,0,1,0
7797,2011,5,OWN,2,Low,1,7000, 36 months,1,debt_consolidation,6,Low,1,Good Loan,0,8.49,A,1,20.03,7475.6,7000,0,220.95,409000007796,6-Jun-18,Indiaforensic  RUPAY SETT 060518,"1,752.75",,-541756131.65,Cherkasova,692,France,8282.22,0,1,0
7798,2011,8,MORTGAGE,3,Medium,2,15000, 36 months,1,home_improvement,7,Low,1,Good Loan,0,10.99,B,2,10.27,17669.82445,15000,0,491.01,409000007797,7-Jun-18,Indiaforensic  RUPAY SETT 070618,"1,403.17",,-541757534.82,Coles,502,Germany,33300.56,0,1,0
7799,2011,4,RENT,1,Low,1,6000, 36 months,1,moving,10,Low,1,Good Loan,0,6.99,A,1,6.49,6667.929103,6000,0,185.24,409000007798,7-Jun-18,Indiaforensic  RUPAY SETT 070618,"13,580.12",,-541771114.94,Potter,518,France,76515.79,0,1,0
7800,2011,10,RENT,1,Low,1,30000, 60 months,2,debt_consolidation,6,High,2,Bad Loan,1,16.49,D,4,9.34,2943.16,1324.71,0,737.38,409000007799,7-Jun-18,OXYGEN NFS SETT 06-06-201,"2,000.00",,-541773114.94,McMinn,660,Germany,33680.56,0,1,0
7801,2011,10,MORTGAGE,3,Low,1,19600, 60 months,2,debt_consolidation,6,High,2,Good Loan,0,13.49,C,3,14.96,26043.31973,19600,0,450.9,409000007800,8-Jun-18,OXYGEN NFS SETT 07-06-201,"2,000.00",,-541775114.94,Bergamaschi,698,Germany,168886.39,0,1,0
7802,2011,6.05,RENT,1,Low,1,4800, 36 months,1,credit_card,1,High,2,Good Loan,0,13.49,C,3,23.56,5859.488288,4800,0,162.87,409000007801,8-Jun-18,OXYGEN NFS SETT 07-06-201,"9,000.00",,-541784114.94,Chijindum,678,France,191746.23,0,1,0
7803,2011,6,RENT,1,Low,1,4000, 36 months,1,debt_consolidation,6,Low,1,Good Loan,0,12.99,C,3,17.52,4773.34,4000,0,134.76,409000007802,8-Jun-18,OXYGEN NFS SETT 07-06-201,"8,500.00",,-541792614.94,Ch'iu,773,Spain,93091.02,0,1,0
7804,2011,5,MORTGAGE,3,Low,1,18000, 60 months,2,debt_consolidation,6,Low,1,Good Loan,0,11.99,B,2,8.13,20391.16,14555.21,0,400.31,409000007803,8-Jun-18,OXYGEN NFS SETT 07-06-201,300,,-541792914.94,Yusupova,619,Germany,23904.52,0,1,0
7805,2011,4,RENT,1,Low,1,5000, 36 months,1,small_business,3,Low,1,Bad Loan,1,7.49,A,1,9.06,955.84,137.15,650.86,155.51,409000007804,8-Jun-18,OXYGEN NFS SETT 07-06-201,300,,-541793214.94,Davis,684,Germany,15807.07,0,1,0
7806,2011,10,MORTGAGE,3,Medium,2,10000, 36 months,1,major_purchase,8,Low,1,Good Loan,0,5.42,A,1,12.25,10856.20793,10000,0,301.6,409000007805,8-Jun-18,OXYGEN NFS SETT 07-06-201,300,,-541793514.94,Iadanza,635,France,83773.02,0,1,0
7807,2011,6,MORTGAGE,3,Medium,2,20000, 60 months,2,home_improvement,7,Low,1,Good Loan,0,11.99,B,2,8.39,24321.52,20000.01,0,444.79,409000007806,8-Jun-18,OXYGEN NFS SETT 07-06-201,"8,000.00",,-541801514.94,Jordan,680,France,90162.35,0,1,0
7808,2011,8,MORTGAGE,3,Low,1,9250, 36 months,1,debt_consolidation,6,Low,1,Good Loan,0,8.49,A,1,20.13,9926.24,9250,0,291.96,409000007807,8-Jun-18,OXYGEN NFS SETT 07-06-201,"5,500.00",,-541807014.94,Kruglova,608,Germany,36639.25,0,1,0
7809,2011,5,RENT,1,Low,1,6800, 36 months,1,wedding,5,Low,1,Good Loan,0,5.42,A,1,6.55,7381.978241,6800,0,205.09,409000007808,8-Jun-18,OXYGEN NFS SETT 07-06-201,"6,000.00",,-541813014.94,Echezonachukwu,603,Germany,139469.11,0,1,0
7810,2011,5,MORTGAGE,3,Low,1,10000, 36 months,1,debt_consolidation,6,Low,1,Good Loan,0,5.99,A,1,12.93,10927.62009,10000,0,304.18,409000007809,8-Jun-18,OXYGEN NFS SETT 07-06-201,"8,000.00",,-541821014.94,Hajek,579,Spain,198402.37,0,1,0
7811,2011,0.5,MORTGAGE,3,Low,1,3600, 36 months,1,other,4,Low,1,Good Loan,0,7.49,A,1,8.16,3948.4,3600,0,111.97,409000007810,8-Jun-18,OXYGEN NFS SETT 07-06-201,"10,000.00",,-541831014.94,Welch,756,Germany,194584.48,0,1,0
7812,2011,2,RENT,1,Low,1,13000, 36 months,1,debt_consolidation,6,Low,1,Good Loan,0,10.99,B,2,10.32,14730.08,13000,0,425.55,409000007811,8-Jun-18,OXYGEN NFS SETT 07-06-201,"8,000.00",,-541839014.94,Vinogradoff,611,France,159629.64,0,1,0
7813,2011,1,OWN,2,Low,1,1800, 36 months,1,other,4,High,2,Good Loan,0,16.49,D,4,2.57,2325.526053,1800,0,63.72,409000007812,8-Jun-18,OXYGEN NFS SETT 07-06-201,400,,-541839414.94,Hung,532,Germany,34231.48,0,1,0
7814,2011,3,MORTGAGE,3,Medium,2,7000, 36 months,1,major_purchase,8,High,2,Good Loan,0,15.62,D,4,0.9,8808.540604,7000,0,244.79,409000007813,8-Jun-18,OXYGEN NFS SETT 07-06-201,"5,000.00",,-541844414.94,Okwudiliolisa,684,Germany,69643.31,0,1,0
7815,2011,8,MORTGAGE,3,Medium,2,13200, 60 months,2,debt_consolidation,6,High,2,Good Loan,0,19.69,E,5,18.39,14050.34,13200,0,347.45,409000007814,8-Jun-18,OXYGEN NFS SETT 07-06-201,"10,000.00",,-541854414.94,Mays,647,Germany,90270.16,0,1,0
7816,2011,6.05,RENT,1,Low,1,6400, 36 months,1,debt_consolidation,6,High,2,Good Loan,0,14.79,C,3,5.35,7957.589648,6400,0,221.21,409000007815,8-Jun-18,OXYGEN NFS SETT 07-06-201,"3,000.00",,-541857414.94,Gardner,583,France,47848.56,0,1,0
7817,2011,10,MORTGAGE,3,High,3,20000, 60 months,2,wedding,5,High,2,Good Loan,0,18.39,E,5,12,26935.99,20000,0,512.13,409000007816,8-Jun-18,OXYGEN NFS SETT 07-06-201,"5,000.00",,-541862414.94,Mamelu,774,Germany,162865.52,0,1,0
7818,2011,5,MORTGAGE,3,Low,1,16800, 36 months,1,other,4,High,2,Good Loan,0,16.49,D,4,22.69,21237.35573,16800,0,594.72,409000007817,8-Jun-18,OXYGEN NFS SETT 07-06-201,"2,500.00",,-541864914.94,Ross,677,France,168650.40,0,1,0
7819,2011,4,RENT,1,Low,1,3350, 36 months,1,debt_consolidation,6,Low,1,Good Loan,0,10.99,B,2,15.92,3523.02,3350,0,109.66,409000007818,8-Jun-18,OXYGEN NFS SETT 07-06-201,"2,000.00",,-541866914.94,Barese,542,Germany,54372.37,0,1,0
7820,2011,2,RENT,1,Low,1,7100, 36 months,1,major_purchase,8,Low,1,Bad Loan,1,6.99,A,1,0.14,5513.25,4434.28,362.4,219.2,409000007819,8-Jun-18,OXYGEN NFS SETT 07-06-201,"5,000.00",,-541871914.94,Swayne,613,Spain,133897.32,0,1,0
7821,2011,4,RENT,1,Low,1,6000, 60 months,2,debt_consolidation,6,Low,1,Good Loan,0,10.99,B,2,13.27,6872.27,5128.96,0,130.43,409000007820,8-Jun-18,OXYGEN NFS SETT 07-06-201,"1,500.00",,-541873414.94,Phillips,666,France,147878.05,0,1,0
7822,2011,10,MORTGAGE,3,Medium,2,5000, 36 months,1,home_improvement,7,Low,1,Good Loan,0,8.49,A,1,6.86,5678.084045,5000,0,157.82,409000007821,8-Jun-18,OXYGEN NFS SETT 07-06-201,"2,500.00",,-541875914.94,Manfrin,777,France,118313.38,0,1,0
7823,2011,1,RENT,1,Low,1,1600, 36 months,1,debt_consolidation,6,Low,1,Good Loan,0,9.99,B,2,19.02,1848.154186,1600,0,51.62,409000007822,8-Jun-18,OXYGEN NFS SETT 07-06-201,"2,500.00",,-541878414.94,Tan,581,Germany,181224.24,0,1,0
7824,2011,9,RENT,1,Low,1,21000, 60 months,2,debt_consolidation,6,High,2,Bad Loan,1,14.79,C,3,24.2,12432,6919.78,22.5,497.28,409000007823,8-Jun-18,OXYGEN NFS SETT 07-06-201,"2,000.00",,-541880414.94,Adams,705,France,7921.57,0,1,0
7825,2011,0.5,RENT,1,Low,1,8000, 36 months,1,debt_consolidation,6,High,2,Good Loan,0,13.49,C,3,14.52,9794.50252,8000,0,271.45,409000007824,8-Jun-18,OXYGEN NFS SETT 07-06-201,300,,-541880714.94,Teng,673,France,5708.19,0,1,0
7826,2011,10,MORTGAGE,3,Low,1,19000, 60 months,2,debt_consolidation,6,High,2,Good Loan,0,20.62,F,6,20.55,28724.65068,19000,0,509.97,409000007825,8-Jun-18,OXYGEN NFS SETT 07-06-201,"5,000.00",,-541885714.94,Chinwendu,594,Germany,56756.52,0,1,0
7827,2011,10,RENT,1,Low,1,9200, 36 months,1,credit_card,1,Low,1,Bad Loan,1,7.49,A,1,21.52,3250.18,2346.81,393.8,286.14,409000007826,8-Jun-18,OXYGEN NFS SETT 07-06-201,800,,-541886514.94,Davison,648,Germany,4121.04,0,1,0
7828,2011,10,RENT,1,Low,1,30000, 60 months,2,small_business,3,High,2,Bad Loan,1,18.39,E,5,14.99,9446.03,3696.83,1121.21,594.71,409000007827,8-Jun-18,OXYGEN NFS SETT 07-06-201,"7,000.00",,-541893514.94,Hsing,605,France,97213.09,0,1,0
7829,2011,2,MORTGAGE,3,Medium,2,24000, 36 months,1,debt_consolidation,6,Low,1,Good Loan,0,10.99,B,2,10.96,28206.12865,24000,0,785.62,409000007828,8-Jun-18,OXYGEN NFS SETT 07-06-201,"8,500.00",,-541902014.94,Castro,734,France,12799.23,0,1,0
7830,2011,5,MORTGAGE,3,Low,1,4600, 36 months,1,debt_consolidation,6,High,2,Good Loan,0,14.79,C,3,23.11,5413.06,4600,0,158.99,409000007829,8-Jun-18,OXYGEN NFS SETT 07-06-201,"1,000.00",,-541903014.94,Parkin,572,France,50400.32,0,1,0
7831,2011,7,MORTGAGE,3,Low,1,13000, 36 months,1,credit_card,1,Low,1,Good Loan,0,5.42,A,1,13.53,14114.17474,13000,0,392.08,409000007830,8-Jun-18,OXYGEN NFS SETT 07-06-201,"6,000.00",,-541909014.94,Manna,595,France,41447.86,0,1,0
7832,2011,5,MORTGAGE,3,Low,1,6000, 36 months,1,other,4,Low,1,Good Loan,0,6.99,A,1,22.45,6667.977239,6000,0,185.24,409000007831,8-Jun-18,OXYGEN NFS SETT 07-06-201,"8,000.00",,-541917014.94,Fennescey,749,France,185543.35,0,1,0
7833,2011,4,RENT,1,Low,1,6400, 60 months,2,major_purchase,8,High,2,Bad Loan,1,17.49,D,4,9.01,5966.12,2927.91,527.88,160.75,409000007832,8-Jun-18,OXYGEN NFS SETT 07-06-201,"6,000.00",,-541923014.94,Colon,573,Spain,189988.65,0,1,0
7834,2011,3,MORTGAGE,3,Medium,2,24000, 60 months,2,debt_consolidation,6,High,2,Good Loan,0,18.79,E,5,19.89,26917.3,20850,0,538.46,409000007833,8-Jun-18,OXYGEN NFS SETT 07-06-201,"5,000.00",,-541928014.94,Yeh,624,Spain,170819.01,0,1,0
7835,2011,4,RENT,1,Low,1,2200, 36 months,1,debt_consolidation,6,High,2,Good Loan,0,15.99,D,4,14.48,2781.266812,2200,0,77.34,409000007834,8-Jun-18,OXYGEN NFS SETT 07-06-201,"2,400.00",,-541930414.94,Bergamaschi,703,France,85547.33,0,1,0
7836,2011,5,MORTGAGE,3,Low,1,4000, 36 months,1,major_purchase,8,Low,1,Good Loan,0,7.49,A,1,10.98,4455.83,4000,0,124.41,409000007835,8-Jun-18,OXYGEN NFS SETT 07-06-201,"6,900.00",,-541937314.94,Matveyeva,665,France,137037.97,0,1,0
7837,2011,2,RENT,1,Low,1,7200, 36 months,1,debt_consolidation,6,Low,1,Good Loan,0,11.99,B,2,21.15,8607.620749,7200,0,239.11,409000007836,8-Jun-18,OXYGEN NFS SETT 07-06-201,"8,700.00",,-541946014.94,Ignatyeva,648,France,19283.14,0,1,0
7838,2011,10,RENT,1,Low,1,5000, 36 months,1,moving,10,Low,1,Good Loan,0,10.59,B,2,4.45,5801.76991,5000,0,162.73,409000007837,8-Jun-18,OXYGEN NFS SETT 07-06-201,"8,000.00",,-541954014.94,Lederer,850,Spain,169425.30,0,1,0
7839,2011,4,RENT,1,Low,1,4700, 60 months,2,home_improvement,7,High,2,Good Loan,0,20.25,F,6,3.25,6953.372292,4700,0,125.18,409000007838,8-Jun-18,OXYGEN NFS SETT 07-06-201,"7,000.00",,-541961014.94,Nwabugwu,569,Germany,132038.65,0,1,0
7840,2011,4,RENT,1,Low,1,4800, 36 months,1,debt_consolidation,6,High,2,Bad Loan,1,14.79,C,3,5.23,1866.5,1126.59,210.5,165.91,409000007839,8-Jun-18,OXYGEN NFS SETT 07-06-201,"8,200.00",,-541969214.94,Abramowitz,566,France,3626.47,0,1,0
7841,2011,10,MORTGAGE,3,High,3,15000, 60 months,2,debt_consolidation,6,High,2,Good Loan,0,16.89,D,4,26.27,18874.03,11828.31,0,371.91,409000007840,8-Jun-18,OXYGEN NFS SETT 07-06-201,"10,000.00",,-541979214.94,Chapman,537,Germany,50881.51,0,1,0
7842,2011,10,MORTGAGE,3,Low,1,10000, 60 months,2,home_improvement,7,Low,1,Good Loan,0,10.99,B,2,28.98,12804.53051,10000,0,217.38,409000007841,8-Jun-18,OXYGEN NFS SETT 07-06-201,"10,000.00",,-541989214.94,Fiorentino,706,Germany,149170.25,0,1,0
7843,2011,6,RENT,1,Low,1,12000, 60 months,2,debt_consolidation,6,High,2,Bad Loan,1,18.79,E,5,18,6816.3,3162.87,0,309.91,409000007842,8-Jun-18,OXYGEN NFS SETT 07-06-201,500,,-541989714.94,Cecil,734,France,182505.68,0,1,0
7844,2011,0.5,RENT,1,Low,1,11600, 36 months,1,debt_consolidation,6,Low,1,Good Loan,0,6.99,A,1,8.62,12780.01,11600,0,358.13,409000007843,8-Jun-18,OXYGEN NFS SETT 07-06-201,"5,000.00",,-541994714.94,Ikechukwu,586,Germany,194072.56,0,1,0
7845,2011,10,MORTGAGE,3,Low,1,20000, 60 months,2,debt_consolidation,6,High,2,Good Loan,0,15.99,D,4,20.53,24719.19,15859.69,0,486.26,409000007844,8-Jun-18,OXYGEN NFS SETT 07-06-201,"9,000.00",,-542003714.94,Allen,612,France,9209.21,0,1,0
7846,2011,10,MORTGAGE,3,Low,1,9500, 36 months,1,debt_consolidation,6,High,2,Bad Loan,1,15.62,D,4,10.67,6604.66,3918.54,320.5,332.22,409000007845,8-Jun-18,OXYGEN NFS SETT 07-06-201,200,,-542003914.94,Kao,648,France,167931.81,0,1,0
7847,2011,10,MORTGAGE,3,Low,1,3000, 36 months,1,small_business,3,Low,1,Good Loan,0,7.49,A,1,23.3,3357.269295,3000,0,93.31,409000007846,8-Jun-18,OXYGEN NFS SETT 07-06-201,"8,700.00",,-542012614.94,Hart,557,France,123096.56,0,1,0
7848,2011,4,RENT,1,Medium,2,18000, 36 months,1,debt_consolidation,6,High,2,Bad Loan,1,13.99,C,3,17.67,15074.67,9693.21,1161.31,615.11,409000007847,8-Jun-18,OXYGEN NFS SETT 07-06-201,"4,000.00",,-542016614.94,Charlton,643,Spain,3965.69,0,1,0
7849,2011,10,MORTGAGE,3,Low,1,25000, 36 months,1,major_purchase,8,Low,1,Good Loan,0,7.49,A,1,10.28,25600.78,25000,0,777.55,409000007848,8-Jun-18,OXYGEN NFS SETT 07-06-201,500,,-542017114.94,Turnbull,433,France,87711.61,0,1,0
7850,2011,3,MORTGAGE,3,Medium,2,18500, 36 months,1,debt_consolidation,6,Low,1,Good Loan,0,8.49,A,1,18.62,20596.3,18500.01,0,583.92,409000007849,8-Jun-18,OXYGEN NFS SETT 07-06-201,"4,000.00",,-542021114.94,Manners,643,Germany,49667.28,0,1,0
7851,2011,0.5,RENT,1,Low,1,5000, 36 months,1,major_purchase,8,Low,1,Good Loan,0,5.99,A,1,10.49,5115.47,5000,0,152.09,409000007850,8-Jun-18,OXYGEN NFS SETT 07-06-201,"3,500.00",,-542024614.94,Chiazagomekpere,488,France,136675.22,0,1,0
7852,2011,0.5,RENT,1,Medium,2,30000, 60 months,2,debt_consolidation,6,High,2,Bad Loan,1,19.69,E,5,20.5,12511.05,4622.88,1478.53,789.66,409000007851,8-Jun-18,OXYGEN NFS SETT 07-06-201,"2,000.00",,-542026614.94,Lavrentyev,758,Germany,35865.44,0,1,0
7853,2011,0.5,RENT,1,Low,1,32000, 36 months,1,debt_consolidation,6,Low,1,Good Loan,0,11.99,B,2,20.85,37200.63,32000,0,1062.71,409000007852,8-Jun-18,OXYGEN NFS SETT 07-06-201,"9,000.00",,-542035614.94,Wallace,743,Germany,26136.13,0,1,0
7854,2011,2,RENT,1,Low,1,4800, 36 months,1,other,4,High,2,Good Loan,0,13.49,C,3,9.53,5745.95,4800,0,162.87,409000007853,8-Jun-18,OXYGEN NFS SETT 07-06-201,500,,-542036114.94,Miller,730,France,33373.26,0,1,0
7855,2011,7,RENT,1,Low,1,3500, 60 months,2,major_purchase,8,High,2,Good Loan,0,15.23,C,3,16.95,4824.276576,3500,0,83.69,409000007854,8-Jun-18,OXYGEN NFS SETT 07-06-201,"8,700.00",,-542044814.94,Bazhenov,746,Spain,10096.25,0,1,0
7856,2011,10,RENT,1,Medium,2,35000, 60 months,2,house,12,High,2,Bad Loan,1,20.25,F,6,4.69,36291.3,8933.32,14004.01,932.17,409000007855,8-Jun-18,OXYGEN NFS SETT 07-06-201,"7,000.00",,-542051814.94,Ifesinachi,666,Germany,188782.30,0,1,0
7857,2011,4,RENT,1,Low,1,8000, 36 months,1,debt_consolidation,6,Low,1,Good Loan,0,7.49,A,1,1.48,8876.795565,8000,0,248.82,409000007856,8-Jun-18,OXYGEN NFS SETT 07-06-201,"6,000.00",,-542057814.94,Ma,580,Germany,79775.19,0,1,0
7858,2011,8,MORTGAGE,3,Low,1,10000, 36 months,1,debt_consolidation,6,Low,1,Good Loan,0,5.42,A,1,9.53,10123.31,10000,0,301.6,409000007857,8-Jun-18,OXYGEN NFS SETT 07-06-201,"7,300.00",,-542065114.94,Chu,850,France,152740.16,0,1,0
7859,2011,10,RENT,1,Low,1,2000, 36 months,1,debt_consolidation,6,Low,1,Good Loan,0,5.42,A,1,3.6,2161.02,2000,0,60.32,409000007858,8-Jun-18,OXYGEN NFS SETT 07-06-201,100,,-542065214.94,Kerr,563,France,5791.85,0,1,0
7860,2011,10,MORTGAGE,3,Low,1,9400, 60 months,2,debt_consolidation,6,High,2,Bad Loan,1,16.49,D,4,18.56,9403.7,5020.27,660.69,231.05,409000007859,8-Jun-18,OXYGEN NFS SETT 07-06-201,"10,000.00",,-542075214.94,Wynne,766,Germany,13182.43,0,1,0
7861,2011,8,MORTGAGE,3,Medium,2,20000, 60 months,2,debt_consolidation,6,High,2,Good Loan,0,13.99,C,3,4.77,19381.77415,15100,0,351.28,409000007860,8-Jun-18,OXYGEN NFS SETT 07-06-201,"7,400.00",,-542082614.94,Moon,659,France,187551.24,0,1,0
7862,2011,0.5,RENT,1,Low,1,12000, 36 months,1,debt_consolidation,6,Low,1,Good Loan,0,12.99,C,3,5.87,14545.94121,12000,0,404.27,409000007861,8-Jun-18,OXYGEN NFS SETT 07-06-201,"7,900.00",,-542090514.94,Disher,607,Spain,110560.14,0,1,0
7863,2011,10,MORTGAGE,3,Low,1,26500, 60 months,2,debt_consolidation,6,Low,1,Good Loan,0,10.59,B,2,11.19,22251.43806,17625,0,379.62,409000007862,8-Jun-18,OXYGEN NFS SETT 07-06-201,"9,100.00",,-542099614.94,Cattaneo,644,Germany,63795.62,0,1,0
7864,2011,2,MORTGAGE,3,Medium,2,25000, 60 months,2,major_purchase,8,Low,1,Good Loan,0,10.99,B,2,3.17,26953.53,25000.01,0,543.44,409000007863,8-Jun-18,OXYGEN NFS SETT 07-06-201,"8,000.00",,-542107614.94,Beluchi,746,France,62086.62,0,1,0
7865,2011,7,MORTGAGE,3,Low,1,12000, 36 months,1,car,2,Low,1,Good Loan,0,5.42,A,1,17.11,12350.08,12000,0,361.92,409000007864,8-Jun-18,OXYGEN NFS SETT 07-06-201,"8,000.00",,-542115614.94,Mazzi,588,Spain,12483.56,0,1,0
7866,2011,5,MORTGAGE,3,High,3,28000, 36 months,1,debt_consolidation,6,Low,1,Good Loan,0,7.49,A,1,6.31,31347.0383,28000,0,870.85,409000007865,8-Jun-18,OXYGEN NFS SETT 07-06-201,"8,000.00",,-542123614.94,Ifeajuna,691,Spain,10963.04,0,1,0
7867,2011,6,MORTGAGE,3,Low,1,5000, 36 months,1,debt_consolidation,6,Low,1,Good Loan,0,11.99,B,2,13.21,5992.490789,5000,0,166.05,409000007866,8-Jun-18,OXYGEN NFS SETT 07-06-201,600,,-542124214.94,Howe,666,France,8247.00,0,1,0
7868,2011,10,RENT,1,Low,1,16000, 36 months,1,debt_consolidation,6,Low,1,Bad Loan,1,7.49,A,1,14.15,6959.54,5794.29,0,497.63,409000007867,8-Jun-18,OXYGEN NFS SETT 07-06-201,"8,100.00",,-542132314.94,Yocum,640,Spain,156260.08,0,1,0
7869,2011,6.05,MORTGAGE,3,Low,1,11400, 36 months,1,debt_consolidation,6,Low,1,Bad Loan,1,10.99,B,2,10.12,9857.96,7457.67,545.03,373.17,409000007868,8-Jun-18,OXYGEN NFS SETT 07-06-201,400,,-542132714.94,Moore,611,Germany,26927.69,0,1,0
7870,2011,10,MORTGAGE,3,Low,1,8000, 36 months,1,home_improvement,7,Low,1,Good Loan,0,6.99,A,1,4.32,8890.560357,8000,0,246.99,409000007869,8-Jun-18,OXYGEN NFS SETT 07-06-201,"8,000.00",,-542140714.94,Y?an,651,Spain,84782.42,0,1,0
7871,2011,3,RENT,1,Low,1,8875, 36 months,1,debt_consolidation,6,High,2,Good Loan,0,15.62,D,4,15.39,11167.07708,8875,0,310.36,409000007870,8-Jun-18,OXYGEN NFS SETT 07-06-201,"9,000.00",,-542149714.94,Chinweuba,529,France,19842.11,0,1,0
7872,2011,6.05,MORTGAGE,3,Low,1,19000, 36 months,1,credit_card,1,Low,1,Bad Loan,1,6.99,A,1,17.68,5278.23,4383.49,0,586.58,409000007871,8-Jun-18,OXYGEN NFS SETT 07-06-201,"8,000.00",,-542157714.94,Lowrie,676,France,95393.43,0,1,0
7873,2011,8,RENT,1,Low,1,8000, 36 months,1,debt_consolidation,6,Low,1,Good Loan,0,11.49,B,2,24.66,9477.232867,8000,0,263.78,409000007872,8-Jun-18,OXYGEN NFS SETT 07-06-201,"6,000.00",,-542163714.94,Shen,639,Germany,133995.59,0,1,0
7874,2011,7,RENT,1,Low,1,15000, 36 months,1,debt_consolidation,6,Low,1,Good Loan,0,10.59,B,2,21.16,17152.03118,15000,0,488.18,409000007873,8-Jun-18,OXYGEN NFS SETT 07-06-201,"7,000.00",,-542170714.94,Lavarack,782,France,108003.38,0,1,0
7875,2011,2,OWN,2,Low,1,12200, 36 months,1,debt_consolidation,6,Low,1,Good Loan,0,10.99,B,2,8.36,13017.78,12200,0,399.36,409000007874,8-Jun-18,OXYGEN NFS SETT 07-06-201,700,,-542171414.94,Davide,641,Germany,99154.86,0,1,0
7876,2011,7,OWN,2,Low,1,20000, 60 months,2,debt_consolidation,6,High,2,Good Loan,0,15.99,D,4,12.98,24717.87,15858.02,0,486.26,409000007875,8-Jun-18,OXYGEN NFS SETT 07-06-201,"6,000.00",,-542177414.94,Gomes,697,France,49503.50,0,1,0
7877,2011,3,RENT,1,Low,1,7000, 36 months,1,car,2,Low,1,Good Loan,0,11.49,B,2,8.36,8305.666348,7000,0,230.8,409000007876,8-Jun-18,OXYGEN NFS SETT 07-06-201,"1,100.00",,-542178514.94,Matveyeva,623,France,196533.72,0,1,0
7878,2011,3,MORTGAGE,3,Medium,2,25000, 60 months,2,debt_consolidation,6,High,2,Good Loan,0,13.99,C,3,24.08,26421.81,25000,0,581.58,409000007877,8-Jun-18,OXYGEN NFS SETT 07-06-201,"6,000.00",,-542184514.94,Fiorentino,494,Spain,188426.13,0,1,0
7879,2011,1,RENT,1,Low,1,4200, 36 months,1,debt_consolidation,6,Low,1,Bad Loan,1,10.99,B,2,11.69,2191.36,1691.48,0,137.49,409000007878,8-Jun-18,OXYGEN NFS SETT 07-06-201,"5,000.00",,-542189514.94,Eberechukwu,731,France,171340.68,0,1,0
7880,2011,3,OWN,2,Low,1,4000, 36 months,1,debt_consolidation,6,Low,1,Good Loan,0,5.42,A,1,21.34,4242.16,4000,0,120.64,409000007879,8-Jun-18,OXYGEN NFS SETT 07-06-201,"9,000.00",,-542198514.94,Gibney,657,France,79071.89,0,1,0
7881,2011,2,RENT,1,Low,1,10000, 36 months,1,debt_consolidation,6,Low,1,Good Loan,0,8.49,A,1,19.1,11299.72,10000,0,315.63,409000007880,8-Jun-18,OXYGEN NFS SETT 07-06-201,"4,000.00",,-542202514.94,Virgo,744,France,20940.76,0,1,0
7882,2011,10,MORTGAGE,3,Low,1,8000, 36 months,1,debt_consolidation,6,Low,1,Good Loan,0,10.99,B,2,14.76,8651.87,8000,0,261.88,409000007881,8-Jun-18,OXYGEN NFS SETT 07-06-201,100,,-542202614.94,Kulikova,774,Spain,34774.26,0,1,0
7883,2011,10,MORTGAGE,3,Low,1,10000, 36 months,1,major_purchase,8,Low,1,Good Loan,0,11.99,B,2,17.95,11864.82598,10000,0,332.1,409000007882,8-Jun-18,OXYGEN NFS SETT 07-06-201,"3,000.00",,-542205614.94,Liu,850,Germany,6865.41,0,1,0
7884,2011,9,RENT,1,Low,1,3000, 36 months,1,debt_consolidation,6,Low,1,Good Loan,0,11.49,B,2,17.47,3559.399473,3000,0,98.92,409000007883,8-Jun-18,OXYGEN NFS SETT 07-06-201,"10,000.00",,-542215614.94,Kao,551,France,51143.43,0,1,0
7885,2011,7,MORTGAGE,3,Low,1,15000, 36 months,1,debt_consolidation,6,Low,1,Good Loan,0,7.49,A,1,14.47,16793.23682,15000,0,466.53,409000007884,8-Jun-18,OXYGEN NFS SETT 07-06-201,"2,000.00",,-542217614.94,Foran,638,France,47031.40,0,1,0
7886,2011,1,MORTGAGE,3,Low,1,22000, 36 months,1,debt_consolidation,6,Low,1,Good Loan,0,6.99,A,1,18.85,22605.11,22000,0,679.2,409000007885,8-Jun-18,OXYGEN NFS SETT 07-06-201,"8,500.00",,-542226114.94,Jones,792,France,47160.01,0,1,0
7887,2011,8,MORTGAGE,3,Medium,2,15825, 36 months,1,debt_consolidation,6,High,2,Good Loan,0,15.62,D,4,15.36,19717.76,15825,0,553.4,409000007886,8-Jun-18,OXYGEN NFS SETT 07-06-201,"2,000.00",,-542228114.94,Fowler,666,France,158666.99,0,1,0
7888,2011,10,MORTGAGE,3,Low,1,17000, 60 months,2,credit_card,1,Low,1,Good Loan,0,7.49,A,1,14.42,18984.86,17000,0,340.57,409000007887,8-Jun-18,OXYGEN NFS SETT 07-06-201,300,,-542228414.94,Conti,716,Germany,65464.66,0,1,0
7889,2011,8,RENT,1,Low,1,4200, 36 months,1,major_purchase,8,Low,1,Good Loan,0,7.49,A,1,23.88,4657.43,4200,0,130.63,409000007888,8-Jun-18,OXYGEN NFS SETT 07-06-201,"6,000.00",,-542234414.94,Stephenson,594,France,78255.86,0,1,0
7890,2011,10,RENT,1,Low,1,9500, 36 months,1,debt_consolidation,6,Low,1,Good Loan,0,6.99,A,1,8.86,10557.7448,9500,0,293.29,409000007889,8-Jun-18,OXYGEN NFS SETT 07-06-201,"7,500.00",,-542241914.94,Willis,600,Germany,103548.25,0,1,0
7891,2011,5,MORTGAGE,3,Low,1,3250, 36 months,1,debt_consolidation,6,Low,1,Good Loan,0,10.99,B,2,9.5,3827.457648,3250,0,106.39,409000007890,8-Jun-18,OXYGEN NFS SETT 07-06-201,"5,800.00",,-542247714.94,Ts'ui,565,France,89609.26,0,1,0
7892,2011,0.5,OWN,2,Low,1,2000, 36 months,1,debt_consolidation,6,Low,1,Good Loan,0,8.49,A,1,13.45,2216.43,2000,0,63.13,409000007891,8-Jun-18,OXYGEN NFS SETT 07-06-201,"8,000.00",,-542255714.94,Chibuzo,678,Germany,193476.04,0,1,0
7893,2011,10,MORTGAGE,3,Medium,2,16500, 36 months,1,credit_card,1,Low,1,Good Loan,0,5.42,A,1,9.35,17914.0157,16500,0,497.64,409000007892,8-Jun-18,OXYGEN NFS SETT 07-06-201,"8,000.00",,-542263714.94,Fang,648,Spain,5199.02,0,1,0
7894,2011,6.05,OWN,2,Low,1,12000, 60 months,2,home_improvement,7,Low,1,Bad Loan,1,10.59,B,2,0,9304.92,6382.55,74.44,258.47,409000007893,8-Jun-18,OXYGEN NFS SETT 07-06-201,"8,000.00",,-542271714.94,Wyckoff,642,France,52827.51,0,1,0
7895,2011,9,MORTGAGE,3,Low,1,9600, 36 months,1,debt_consolidation,6,Low,1,Good Loan,0,5.99,A,1,21.69,9949,9600,0,292.01,409000007894,8-Jun-18,OXYGEN NFS SETT 07-06-201,"8,500.00",,-542280214.94,Muir,706,Germany,86507.88,0,1,0
7896,2011,10,MORTGAGE,3,Low,1,27000, 60 months,2,debt_consolidation,6,High,2,Good Loan,0,20.25,F,6,2.97,42182.93347,27000.01,0,719.1,409000007895,8-Jun-18,OXYGEN NFS SETT 07-06-201,"4,800.00",,-542285014.94,Halpern,668,Spain,100423.88,0,1,0
7897,2011,5,RENT,1,High,3,4800, 36 months,1,wedding,5,Low,1,Good Loan,0,10.99,B,2,11.36,5653.529584,4800,0,157.13,409000007896,8-Jun-18,OXYGEN NFS SETT 07-06-201,"7,100.00",,-542292114.94,Flynn,635,Spain,175611.50,0,1,0
7898,2011,10,MORTGAGE,3,Low,1,25000, 60 months,2,credit_card,1,High,2,Good Loan,0,16.49,D,4,15.82,35237.48865,25000,0,614.48,409000007897,8-Jun-18,Indiaforensic  RUPAY SETT 080618,"12,034.99",,-542304149.93,Shao,603,Spain,19282.85,0,1,0
7899,2011,10,RENT,1,Low,1,16800, 60 months,2,debt_consolidation,6,High,2,Good Loan,0,17.99,E,5,18.26,18964,16800,0,426.52,409000007898,8-Jun-18,Indiaforensic  RUPAY SETT 080618,"1,835.91",,-542305985.84,Soares,635,France,27448.33,0,1,0
7900,2011,4,RENT,1,Low,1,10000, 36 months,1,debt_consolidation,6,High,2,Good Loan,0,16.89,D,4,20.87,12670.85146,10000,0,355.99,409000007899,11-Jun-18,FDRL/INTERNAL FUND TRANSFE,,100000.00,-542205985.84,Gallo,642,France,183963.34,0,1,0
7901,2011,10,RENT,1,Low,1,11200, 36 months,1,debt_consolidation,6,Low,1,Good Loan,0,5.42,A,1,23.14,12159.70775,11200,0,337.8,409000007900,11-Jun-18,FDRL/INTERNAL FUND TRANSFE,,100000.00,-542105985.84,Lei,785,Spain,45113.92,0,1,0
7902,2011,2,RENT,1,Low,1,6000, 36 months,1,debt_consolidation,6,Low,1,Good Loan,0,10.59,B,2,12.74,6188.26,6000,0,195.27,409000007901,11-Jun-18,Indiaforensic  RUPAY SETT 090618,"11,854.87",,-542117840.71,Daniels,628,Germany,110776.01,0,1,0
7903,2011,8,MORTGAGE,3,Low,1,18200, 36 months,1,debt_consolidation,6,Low,1,Bad Loan,1,11.99,B,2,10.3,15988.56,11859.65,882.03,604.42,409000007902,11-Jun-18,Indiaforensic  RUPAY SETT 100618,"5,944.49",,-542123785.20,Kenechi,499,France,183042.20,0,1,0
7904,2011,10,RENT,1,Medium,2,15000, 36 months,1,debt_consolidation,6,Low,1,Good Loan,0,12.99,C,3,10.34,18044.29,15000,0,505.34,409000007903,11-Jun-18,OXYGEN NFS SETT 08-06-201,"5,800.00",,-542129585.20,Singleton,567,Spain,161571.79,0,1,0
7905,2011,5,MORTGAGE,3,Low,1,2500, 36 months,1,debt_consolidation,6,Low,1,Good Loan,0,5.99,A,1,25.89,2727,2500,0,76.05,409000007904,11-Jun-18,OXYGEN NFS SETT 08-06-201,500,,-542130085.20,Williams,449,Spain,166692.03,0,1,0
7906,2011,1,RENT,1,Low,1,14400, 36 months,1,debt_consolidation,6,Low,1,Good Loan,0,11.99,B,2,13.33,17215.24835,14400,0,478.22,409000007905,11-Jun-18,OXYGEN NFS SETT 08-06-201,"5,000.00",,-542135085.20,Greece,701,Spain,71173.64,0,1,0
7907,2011,0.5,OWN,2,Low,1,7000, 60 months,2,home_improvement,7,Low,1,Good Loan,0,10.99,B,2,4.4,8569.786145,7000,0,152.17,409000007906,11-Jun-18,OXYGEN NFS SETT 08-06-201,"3,600.00",,-542138685.20,Olisanugo,613,Spain,5353.12,0,1,0
7908,2011,10,MORTGAGE,3,Medium,2,5600, 36 months,1,credit_card,1,High,2,Good Loan,0,13.49,C,3,7.87,6703.14,5600,0,190.02,409000007907,11-Jun-18,OXYGEN NFS SETT 08-06-201,"10,000.00",,-542148685.20,Padovano,683,Germany,86019.48,0,1,0
7909,2011,5,MORTGAGE,3,Low,1,35000, 60 months,2,home_improvement,7,High,2,Good Loan,0,15.99,D,4,0.79,47486.96923,35000,0,850.95,409000007908,11-Jun-18,OXYGEN NFS SETT 08-06-201,"1,500.00",,-542150185.20,Rossi,581,France,86383.82,0,1,0
7910,2011,1,RENT,1,Low,1,9000, 36 months,1,debt_consolidation,6,Low,1,Good Loan,0,11.99,B,2,24.45,10501.18,9000,0,298.89,409000007909,11-Jun-18,OXYGEN NFS SETT 08-06-201,"8,000.00",,-542158185.20,Grant,620,France,31641.52,0,1,0
7911,2011,9,MORTGAGE,3,Low,1,12000, 60 months,2,debt_consolidation,6,High,2,Good Loan,0,17.49,D,4,6.94,16793.57679,12000,0,301.41,409000007910,11-Jun-18,OXYGEN NFS SETT 08-06-201,"7,000.00",,-542165185.20,Ebelegbulam,561,Spain,70548.96,0,1,0
7912,2011,10,MORTGAGE,3,Medium,2,13600, 60 months,2,credit_card,1,Low,1,Good Loan,0,8.49,A,1,24.57,14205.79,11160.63,0,278.96,409000007911,11-Jun-18,OXYGEN NFS SETT 08-06-201,"8,000.00",,-542173185.20,Mitchell,558,Germany,24411.02,0,1,0
7913,2011,10,MORTGAGE,3,Medium,2,8000, 36 months,1,debt_consolidation,6,Low,1,Good Loan,0,6.99,A,1,4.03,8092.17,8000,0,246.99,409000007912,11-Jun-18,OXYGEN NFS SETT 08-06-201,200,,-542173385.20,Buckley,642,France,122254.86,0,1,0
7914,2011,2,MORTGAGE,3,Low,1,6000, 36 months,1,debt_consolidation,6,Low,1,Good Loan,0,7.49,A,1,15.87,6715.828358,6000,0,186.61,409000007913,11-Jun-18,OXYGEN NFS SETT 08-06-201,"2,000.00",,-542175385.20,Repina,805,Germany,186035.72,0,1,0
7915,2011,1,RENT,1,Low,1,4500, 36 months,1,credit_card,1,Low,1,Good Loan,0,5.99,A,1,10.38,4913.277492,4500,0,136.88,409000007914,11-Jun-18,OXYGEN NFS SETT 08-06-201,"1,000.00",,-542176385.20,Ellis,687,France,73133.82,0,1,0
7916,2011,8,OWN,2,Low,1,12000, 36 months,1,small_business,3,Low,1,Good Loan,0,5.42,A,1,6.43,12654.27,12000,0,361.92,409000007915,11-Jun-18,OXYGEN NFS SETT 08-06-201,800,,-542177185.20,Douglas,695,Spain,187734.49,0,1,0
7917,2011,0.5,RENT,1,Low,1,3000, 36 months,1,debt_consolidation,6,Low,1,Bad Loan,1,7.49,A,1,24.62,1671.48,1409.35,0,93.31,409000007916,11-Jun-18,OXYGEN NFS SETT 08-06-201,200,,-542177385.20,Becher,562,France,111590.35,0,1,0
7918,2011,3,RENT,1,Medium,2,28000, 60 months,2,small_business,3,Low,1,Good Loan,0,9.99,B,2,5.18,35060.20579,28000,0,594.78,409000007917,11-Jun-18,OXYGEN NFS SETT 08-06-201,"2,000.00",,-542179385.20,Nwachukwu,613,Germany,15859.95,0,1,0
7919,2011,4,MORTGAGE,3,Medium,2,18000, 36 months,1,debt_consolidation,6,Low,1,Good Loan,0,6.99,A,1,10.68,19579.07,18000,0,555.71,409000007918,11-Jun-18,OXYGEN NFS SETT 08-06-201,"9,500.00",,-542188885.20,Smith,589,France,61324.87,0,1,0
7920,2011,1,MORTGAGE,3,Low,1,20950, 60 months,2,debt_consolidation,6,High,2,Good Loan,0,20.99,F,6,19.92,31776.95228,20950,0,566.66,409000007919,11-Jun-18,OXYGEN NFS SETT 08-06-201,"1,000.00",,-542189885.20,Aksyonov,593,Spain,176868.89,0,1,0
7921,2011,2,RENT,1,Low,1,4000, 36 months,1,debt_consolidation,6,High,2,Good Loan,0,15.23,C,3,23.36,4880.45,4000,0,139.12,409000007920,11-Jun-18,OXYGEN NFS SETT 08-06-201,"3,000.00",,-542192885.20,Artyomova,714,France,98896.06,0,1,0
7922,2011,2,MORTGAGE,3,Low,1,15000, 60 months,2,debt_consolidation,6,Low,1,Bad Loan,1,11.99,B,2,25.66,10609.49,5888.96,1289.69,333.6,409000007921,11-Jun-18,OXYGEN NFS SETT 08-06-201,"3,500.00",,-542196385.20,Medvedeva,588,Spain,108739.15,0,1,0
7923,2011,0.5,OWN,2,Low,1,2300, 60 months,2,car,2,High,2,Bad Loan,1,17.49,D,4,14.13,2130.47,1088.48,73.01,57.77,409000007922,11-Jun-18,OXYGEN NFS SETT 08-06-201,"3,500.00",,-542199885.20,Tsui,679,Spain,12266.06,0,1,0
7924,2011,10,MORTGAGE,3,Low,1,7500, 36 months,1,home_improvement,7,Low,1,Good Loan,0,10.99,B,2,0.62,8773.19,7500,0,245.51,409000007923,11-Jun-18,OXYGEN NFS SETT 08-06-201,"1,500.00",,-542201385.20,Runyon,730,Spain,163317.50,0,1,0
7925,2011,10,MORTGAGE,3,Medium,2,35000, 60 months,2,debt_consolidation,6,High,2,Good Loan,0,22.85,G,7,17.77,56809.05163,35000,0,983.66,409000007924,11-Jun-18,OXYGEN NFS SETT 08-06-201,"1,000.00",,-542202385.20,Gallo,833,France,182247.77,0,1,0
7926,2011,3,RENT,1,Low,1,19200, 60 months,2,other,4,High,2,Bad Loan,1,22.85,G,7,9.95,8517.6,2746.15,945.34,539.61,409000007925,11-Jun-18,OXYGEN NFS SETT 08-06-201,"5,000.00",,-542207385.20,Bradshaw,586,Spain,168261.40,0,1,0
7927,2011,10,MORTGAGE,3,Low,1,10000, 60 months,2,home_improvement,7,Low,1,Good Loan,0,10.59,B,2,19.52,11344.53985,10000,0,215.39,409000007926,11-Jun-18,OXYGEN NFS SETT 08-06-201,500,,-542207885.20,Evans,567,Spain,158590.66,0,1,0
7928,2011,1,RENT,1,Low,1,9000, 36 months,1,debt_consolidation,6,Low,1,Good Loan,0,11.49,B,2,16.17,9879.88,9000,0,296.75,409000007927,11-Jun-18,OXYGEN NFS SETT 08-06-201,"5,000.00",,-542212885.20,Hancock,637,Germany,102566.46,0,1,0
7929,2011,6,MORTGAGE,3,Low,1,29100, 60 months,2,house,12,High,2,Good Loan,0,19.29,E,5,16.96,42808.59916,29100,0,759.53,409000007928,11-Jun-18,OXYGEN NFS SETT 08-06-201,"2,500.00",,-542215385.20,Butler,711,France,141827.83,0,1,0
7930,2011,7,RENT,1,Low,1,1500, 36 months,1,debt_consolidation,6,Low,1,Good Loan,0,5.99,A,1,19.15,1600.79,1500,0,45.63,409000007929,11-Jun-18,OXYGEN NFS SETT 08-06-201,"10,000.00",,-542225385.20,Bradshaw,828,France,161671.15,0,1,0
7931,2011,10,MORTGAGE,3,Medium,2,24000, 60 months,2,debt_consolidation,6,High,2,Bad Loan,1,21.36,F,6,8.37,25763.28,8509.38,6812.07,654.16,409000007930,11-Jun-18,OXYGEN NFS SETT 08-06-201,"8,000.00",,-542233385.20,Bergamaschi,500,Spain,192013.23,0,1,0
7932,2011,1,MORTGAGE,3,Medium,2,35000, 60 months,2,debt_consolidation,6,High,2,Good Loan,0,23.22,G,7,17.99,38319.12,35000,0,991.1,409000007931,11-Jun-18,OXYGEN NFS SETT 08-06-201,"5,200.00",,-542238585.20,Ebelegbulam,807,France,127875.10,0,1,0
7933,2011,6.05,MORTGAGE,3,Low,1,6000, 36 months,1,credit_card,1,Low,1,Good Loan,0,9.99,B,2,8.57,6965.803249,6000,0,193.58,409000007932,11-Jun-18,OXYGEN NFS SETT 08-06-201,"10,000.00",,-542248585.20,Greco,850,France,60811.56,0,1,0
7934,2011,3,RENT,1,Low,1,8875, 36 months,1,debt_consolidation,6,Low,1,Good Loan,0,5.42,A,1,28.68,9635.227259,8875,0,267.67,409000007933,11-Jun-18,OXYGEN NFS SETT 08-06-201,"8,700.00",,-542257285.20,Lucas,782,France,131177.22,0,1,0
7935,2011,7,OWN,2,Low,1,5000, 36 months,1,other,4,Low,1,Good Loan,0,7.49,A,1,5.5,5398.08,5000,0,155.51,409000007934,11-Jun-18,OXYGEN NFS SETT 08-06-201,"7,600.00",,-542264885.20,Barber,629,Spain,130862.11,0,1,0
7936,2011,10,MORTGAGE,3,Medium,2,35000, 36 months,1,debt_consolidation,6,Low,1,Good Loan,0,9.99,B,2,6.28,39428.46,35000,0,1129.19,409000007935,11-Jun-18,OXYGEN NFS SETT 08-06-201,"5,000.00",,-542269885.20,Dobbs,582,Spain,72970.93,0,1,0
7937,2011,5,MORTGAGE,3,Low,1,12000, 36 months,1,debt_consolidation,6,Low,1,Good Loan,0,5.99,A,1,4.81,13155.2049,12000,0,365.01,409000007936,11-Jun-18,OXYGEN NFS SETT 08-06-201,"9,000.00",,-542278885.20,Thomson,468,France,28123.99,0,1,0
7938,2011,10,RENT,1,Medium,2,35000, 36 months,1,credit_card,1,Low,1,Good Loan,0,10.59,B,2,4.83,40651.42,35000,0,1139.08,409000007937,11-Jun-18,OXYGEN NFS SETT 08-06-201,500,,-542279385.20,Su,670,France,140754.19,0,1,0
7939,2011,4,RENT,1,Low,1,6000, 36 months,1,debt_consolidation,6,Low,1,Good Loan,0,11.49,B,2,23.04,6713.41,6000,0,197.83,409000007938,11-Jun-18,OXYGEN NFS SETT 08-06-201,"10,000.00",,-542289385.20,Watkins,805,France,166650.32,0,1,0
7940,2011,5,RENT,1,Low,1,12250, 36 months,1,debt_consolidation,6,Low,1,Good Loan,0,9.99,B,2,16.08,14222.7244,12250,0,395.22,409000007939,11-Jun-18,OXYGEN NFS SETT 08-06-201,"8,000.00",,-542297385.20,Ch'ien,720,France,45507.24,0,1,0
7941,2011,2,RENT,1,Low,1,6000, 36 months,1,debt_consolidation,6,High,2,Good Loan,0,13.49,C,3,16.27,7067.8,6000,0,203.59,409000007940,11-Jun-18,OXYGEN NFS SETT 08-06-201,"1,000.00",,-542298385.20,Monds,781,Spain,112202.64,0,1,0
7942,2011,3,RENT,1,Low,1,3000, 36 months,1,moving,10,Low,1,Bad Loan,1,11.49,B,2,6.35,1972.6,1534.73,0,98.92,409000007941,11-Jun-18,OXYGEN NFS SETT 08-06-201,"7,000.00",,-542305385.20,McClemans,592,Germany,37140.20,0,1,0
7943,2011,3,RENT,1,Low,1,8650, 36 months,1,credit_card,1,Low,1,Good Loan,0,8.49,A,1,7.83,9822.292225,8650,0,273.02,409000007942,11-Jun-18,OXYGEN NFS SETT 08-06-201,"8,500.00",,-542313885.20,Shen,542,France,178256.58,0,1,0
7944,2011,10,MORTGAGE,3,Low,1,20000, 60 months,2,debt_consolidation,6,High,2,Good Loan,0,20.25,F,6,20.7,31017.58664,20000,0,532.67,409000007943,11-Jun-18,OXYGEN NFS SETT 08-06-201,"10,000.00",,-542323885.20,Gallo,532,France,100982.93,0,1,0
7945,2011,1,RENT,1,Low,1,23400, 36 months,1,debt_consolidation,6,Low,1,Good Loan,0,7.49,A,1,15.66,26130.19875,23400,0,727.78,409000007944,11-Jun-18,OXYGEN NFS SETT 08-06-201,100,,-542323985.20,Foveaux,520,France,109626.13,0,1,0
7946,2011,6,MORTGAGE,3,Low,1,7000, 36 months,1,home_improvement,7,Low,1,Good Loan,0,7.49,A,1,19.2,7835.08063,7000,0,217.72,409000007945,11-Jun-18,OXYGEN NFS SETT 08-06-201,100,,-542324085.20,Longo,759,France,99251.24,0,1,0
7947,2011,10,MORTGAGE,3,Medium,2,20000, 60 months,2,home_improvement,7,Low,1,Good Loan,0,11.49,B,2,0,20571.56004,16075,0,353.46,409000007946,11-Jun-18,OXYGEN NFS SETT 08-06-201,100,,-542324185.20,Calabresi,473,France,143345.69,0,1,0
7948,2011,1,RENT,1,Medium,2,10000, 36 months,1,credit_card,1,High,2,Good Loan,0,15.62,D,4,3.07,12077.12,10000,0,349.7,409000007947,11-Jun-18,OXYGEN NFS SETT 08-06-201,100,,-542324285.20,Randall,639,Spain,59653.03,0,1,0
7949,2011,6,MORTGAGE,3,Medium,2,20000, 60 months,2,debt_consolidation,6,High,2,Good Loan,0,15.23,C,3,19.01,24297,15905.26,0,478.22,409000007948,11-Jun-18,OXYGEN NFS SETT 08-06-201,100,,-542324385.20,Garcia,705,France,196864.61,0,1,0
7950,2011,10,MORTGAGE,3,Low,1,20000, 60 months,2,debt_consolidation,6,Low,1,Good Loan,0,11.49,B,2,19.66,15848.53,14775,0,324.87,409000007949,11-Jun-18,OXYGEN NFS SETT 08-06-201,100,,-542324485.20,Sullivan,530,France,109960.40,0,1,0
7951,2011,2,RENT,1,Low,1,7000, 36 months,1,credit_card,1,Low,1,Good Loan,0,11.49,B,2,18.3,8305.449952,7000,0,230.8,409000007950,11-Jun-18,OXYGEN NFS SETT 08-06-201,"9,000.00",,-542333485.20,Higgins,516,Germany,127256.70,0,1,0
7952,2011,4,RENT,1,Low,1,10000, 36 months,1,medical,9,High,2,Good Loan,0,16.89,D,4,9.38,11944.22,10000,0,355.99,409000007951,11-Jun-18,OXYGEN NFS SETT 08-06-201,"1,000.00",,-542334485.20,Crawford,850,France,1099.95,0,1,0
7953,2011,4,RENT,1,Low,1,5000, 36 months,1,debt_consolidation,6,Low,1,Good Loan,0,5.42,A,1,22.4,5302.72,5000,0,150.8,409000007952,11-Jun-18,OXYGEN NFS SETT 08-06-201,"3,000.00",,-542337485.20,Martin,746,Germany,146192.40,0,1,0
7954,2011,10,MORTGAGE,3,Medium,2,32000, 36 months,1,debt_consolidation,6,Low,1,Good Loan,0,7.49,A,1,9.05,35827.45943,32000,0,995.26,409000007953,11-Jun-18,OXYGEN NFS SETT 08-06-201,"3,000.00",,-542340485.20,Currey,622,Germany,48553.77,0,1,0
7955,2011,1,MORTGAGE,3,Low,1,13200, 36 months,1,debt_consolidation,6,Low,1,Good Loan,0,12.99,C,3,23.36,16005.38582,13200,0,444.7,409000007954,11-Jun-18,OXYGEN NFS SETT 08-06-201,"1,500.00",,-542341985.20,Teng,743,France,144407.10,0,1,0
7956,2011,6,MORTGAGE,3,Low,1,6500, 36 months,1,small_business,3,Low,1,Good Loan,0,10.99,B,2,7.27,7343.9,6500,0,212.78,409000007955,11-Jun-18,OXYGEN NFS SETT 08-06-201,"5,000.00",,-542346985.20,Austin,732,Germany,195760.53,0,1,0
7957,2011,3,MORTGAGE,3,Low,1,15000, 36 months,1,debt_consolidation,6,High,2,Good Loan,0,16.49,D,4,20.01,15207.04,15000,0,531,409000007956,11-Jun-18,OXYGEN NFS SETT 08-06-201,"5,000.00",,-542351985.20,Hudson,850,France,44827.47,0,1,0
7958,2011,10,OWN,2,Low,1,25000, 36 months,1,debt_consolidation,6,High,2,Good Loan,0,15.62,D,4,22.13,27917.8,25000,0,874.25,409000007957,11-Jun-18,OXYGEN NFS SETT 08-06-201,"2,000.00",,-542353985.20,Ts'ui,850,Germany,88743.99,0,1,0
7959,2011,10,RENT,1,Low,1,8000, 36 months,1,debt_consolidation,6,Low,1,Bad Loan,1,5.99,A,1,14.53,6811.28,6094.31,0,243.34,409000007958,11-Jun-18,OXYGEN NFS SETT 08-06-201,"5,000.00",,-542358985.20,Hancock,686,France,88837.11,0,1,0
7960,2011,6,MORTGAGE,3,Low,1,10200, 36 months,1,major_purchase,8,Low,1,Good Loan,0,10.59,B,2,24.13,11947.9073,10200,0,331.96,409000007959,11-Jun-18,OXYGEN NFS SETT 08-06-201,"7,000.00",,-542365985.20,Nicholas,556,France,62112.70,0,1,0
7961,2011,1,RENT,1,Low,1,15000, 36 months,1,credit_card,1,Low,1,Good Loan,0,7.49,A,1,7.15,15444.61,15000,0,466.53,409000007960,11-Jun-18,OXYGEN NFS SETT 08-06-201,"5,000.00",,-542370985.20,Napolitano,673,France,163563.07,0,1,0
7962,2011,10,MORTGAGE,3,Low,1,18000, 60 months,2,debt_consolidation,6,Low,1,Bad Loan,1,10.59,B,2,13.96,1160.94,686.46,8.19,387.7,409000007961,11-Jun-18,OXYGEN NFS SETT 08-06-201,"5,000.00",,-542375985.20,Jamieson,809,France,174800.31,0,1,0
7963,2011,3,RENT,1,Low,1,3600, 36 months,1,renewable_energy,13,Low,1,Bad Loan,1,7.49,A,1,10.77,3128.53,2195.57,565.64,111.97,409000007962,11-Jun-18,OXYGEN NFS SETT 08-06-201,"5,000.00",,-542380985.20,Foster,634,Germany,42429.88,0,1,0
7964,2011,2,MORTGAGE,3,Low,1,6400, 36 months,1,debt_consolidation,6,Low,1,Good Loan,0,8.49,A,1,18.82,6692.72,6400,0,202.01,409000007963,11-Jun-18,OXYGEN NFS SETT 08-06-201,"10,000.00",,-542390985.20,Moretti,630,France,82647.65,0,1,0
7965,2011,10,MORTGAGE,3,Low,1,1500, 36 months,1,car,2,Low,1,Good Loan,0,5.42,A,1,6.72,1628.096296,1500,0,45.24,409000007964,11-Jun-18,OXYGEN NFS SETT 08-06-201,800,,-542391785.20,Chiedozie,564,Germany,134175.15,0,1,0
7966,2011,3,RENT,1,Low,1,7525, 36 months,1,major_purchase,8,Low,1,Good Loan,0,11.49,B,2,22.32,8928.664051,7525,0,248.11,409000007965,11-Jun-18,OXYGEN NFS SETT 08-06-201,"7,300.00",,-542399085.20,Okwukwe,625,France,92243.94,0,1,0
7967,2011,0.5,RENT,1,Low,1,12000, 36 months,1,debt_consolidation,6,Low,1,Good Loan,0,11.99,B,2,14.25,13415.42,12000,0,398.52,409000007966,11-Jun-18,OXYGEN NFS SETT 08-06-201,"10,000.00",,-542409085.20,Lumholtz,677,Spain,6175.53,0,1,0
7968,2011,7,RENT,1,Medium,2,12000, 60 months,2,debt_consolidation,6,Low,1,Good Loan,0,12.99,C,3,12.82,14264.49,12000,0,272.98,409000007967,11-Jun-18,OXYGEN NFS SETT 08-06-201,"1,500.00",,-542410585.20,Rose,583,France,29213.63,0,1,0
7969,2011,10,MORTGAGE,3,Low,1,4000, 36 months,1,home_improvement,7,High,2,Good Loan,0,15.99,D,4,4.6,5079.829916,4000,0,140.61,409000007968,11-Jun-18,OXYGEN NFS SETT 08-06-201,"1,500.00",,-542412085.20,Wan,592,Spain,67214.02,0,1,0
7970,2011,1,RENT,1,Low,1,10000, 36 months,1,major_purchase,8,High,2,Good Loan,0,15.62,D,4,23.45,12348,10000,0,349.7,409000007969,11-Jun-18,OXYGEN NFS SETT 08-06-201,"8,500.00",,-542420585.20,De Bernales,637,Germany,169037.84,0,1,0
7971,2011,10,MORTGAGE,3,Medium,2,19000, 36 months,1,debt_consolidation,6,Low,1,Good Loan,0,9.99,B,2,24.35,22064.09069,19000,0,612.99,409000007970,11-Jun-18,OXYGEN NFS SETT 08-06-201,"5,500.00",,-542426085.20,Ch'eng,850,France,188809.23,0,1,0
7972,2011,3,RENT,1,Low,1,4500, 36 months,1,credit_card,1,Low,1,Bad Loan,1,8.49,A,1,2.54,3013.76,1731.11,890.96,142.04,409000007971,11-Jun-18,OXYGEN NFS SETT 08-06-201,400,,-542426485.20,Edmondson,633,Spain,79408.17,0,1,0
7973,2011,4,MORTGAGE,3,Medium,2,24000, 36 months,1,home_improvement,7,Low,1,Good Loan,0,5.99,A,1,7.78,26281.53423,24000,0,730.02,409000007972,11-Jun-18,OXYGEN NFS SETT 08-06-201,"6,000.00",,-542432485.20,Ch'ien,751,Germany,89222.66,0,1,0
7974,2011,0.5,RENT,1,Low,1,3900, 36 months,1,home_improvement,7,High,2,Good Loan,0,14.79,C,3,5.88,4253.33,3900,0,134.8,409000007973,11-Jun-18,OXYGEN NFS SETT 08-06-201,500,,-542432985.20,Millar,592,Germany,86079.67,0,1,0
7975,2011,6,OWN,2,Low,1,7000, 36 months,1,debt_consolidation,6,Low,1,Good Loan,0,9.99,B,2,5.23,8126.885157,7000,0,225.84,409000007974,11-Jun-18,OXYGEN NFS SETT 08-06-201,500,,-542433485.20,Dickson,716,Germany,12944.17,0,1,0
7976,2011,9,MORTGAGE,3,Low,1,12600, 60 months,2,debt_consolidation,6,High,2,Bad Loan,1,15.99,D,4,19.83,7350.65,3857.64,0,306.35,409000007975,11-Jun-18,OXYGEN NFS SETT 08-06-201,500,,-542433985.20,Toscani,641,Germany,166516.84,0,1,0
7977,2011,4,MORTGAGE,3,Low,1,1300, 36 months,1,car,2,Low,1,Good Loan,0,5.42,A,1,6.7,1410.990709,1300,0,39.21,409000007976,11-Jun-18,OXYGEN NFS SETT 08-06-201,"4,000.00",,-542437985.20,Pan,849,France,126419.80,0,1,0
7978,2011,8,RENT,1,Medium,2,10200, 36 months,1,debt_consolidation,6,High,2,Good Loan,0,15.99,D,4,21.63,12771.93095,10200,0,358.56,409000007977,11-Jun-18,OXYGEN NFS SETT 09-06-201,"7,000.00",,-542444985.20,Chigozie,647,Spain,89103.05,0,1,0
7979,2011,8,RENT,1,Low,1,13000, 60 months,2,debt_consolidation,6,Low,1,Good Loan,0,11.49,B,2,18.5,10897.58,9650,0,212.19,409000007978,11-Jun-18,OXYGEN NFS SETT 09-06-201,"10,000.00",,-542454985.20,Sagese,608,Germany,132973.17,0,1,0
7980,2011,10,MORTGAGE,3,Low,1,2000, 36 months,1,major_purchase,8,Low,1,Good Loan,0,5.42,A,1,8.09,2186.016853,2000,0,60.32,409000007979,11-Jun-18,OXYGEN NFS SETT 09-06-201,600,,-542455585.20,Reilly,555,France,93122.41,0,1,0
7981,2011,10,MORTGAGE,3,Medium,2,14000, 36 months,1,debt_consolidation,6,Low,1,Good Loan,0,10.99,B,2,22.48,15885.9,14000.01,0,458.28,409000007980,11-Jun-18,OXYGEN NFS SETT 09-06-201,"2,000.00",,-542457585.20,Taylor,497,Spain,167522.19,0,1,0
7982,2011,2,MORTGAGE,3,Low,1,3300, 36 months,1,home_improvement,7,Low,1,Good Loan,0,5.99,A,1,11.04,3613.45994,3300,0,100.38,409000007981,11-Jun-18,OXYGEN NFS SETT 09-06-201,"8,200.00",,-542465785.20,Yen,599,Germany,157239.60,0,1,0
7983,2011,2,RENT,1,Low,1,3500, 36 months,1,major_purchase,8,High,2,Good Loan,0,15.62,D,4,15.35,4040.88,3500,0,122.4,409000007982,11-Jun-18,OXYGEN NFS SETT 09-06-201,"6,500.00",,-542472285.20,Kapustin,545,Germany,107429.71,0,1,0
7984,2011,10,MORTGAGE,3,Medium,2,13600, 36 months,1,debt_consolidation,6,Low,1,Good Loan,0,11.99,B,2,12.59,16258.99219,13600,0,451.65,409000007983,11-Jun-18,OXYGEN NFS SETT 09-06-201,500,,-542472785.20,Singh,774,France,75304.09,0,1,0
7985,2011,8,RENT,1,Low,1,25000, 60 months,2,debt_consolidation,6,Low,1,Good Loan,0,11.99,B,2,15.6,21139.6,17575,0,390.86,409000007984,11-Jun-18,OXYGEN NFS SETT 09-06-201,"2,000.00",,-542474785.20,Yeh,464,France,182944.47,0,1,0
7986,2011,6,RENT,1,Medium,2,25000, 60 months,2,small_business,3,Low,1,Good Loan,0,11.49,B,2,9.74,24532.28089,19850,0,436.46,409000007985,11-Jun-18,OXYGEN NFS SETT 09-06-201,"10,000.00",,-542484785.20,Genovese,696,Germany,5983.70,0,1,0
7987,2011,10,MORTGAGE,3,Low,1,10000, 36 months,1,wedding,5,Low,1,Good Loan,0,9.99,B,2,12.59,11220.97,10000,0,322.63,409000007986,11-Jun-18,OXYGEN NFS SETT 09-06-201,"6,000.00",,-542490785.20,Boyle,667,Spain,163655.01,0,1,0
7988,2011,5,MORTGAGE,3,Low,1,14400, 60 months,2,home_improvement,7,High,2,Good Loan,0,13.49,C,3,0.64,15035.19,14400,0,331.27,409000007987,11-Jun-18,OXYGEN NFS SETT 09-06-201,"1,700.00",,-542492485.20,Blair,812,France,89385.92,0,1,0
7989,2011,10,MORTGAGE,3,Low,1,30000, 60 months,2,car,2,High,2,Good Loan,0,20.62,F,6,4.96,44750.31494,30000,0,805.21,409000007988,11-Jun-18,OXYGEN NFS SETT 09-06-201,"9,000.00",,-542501485.20,Okagbue,516,France,168773.54,0,1,0
7990,2011,5,MORTGAGE,3,Medium,2,32400, 60 months,2,home_improvement,7,Low,1,Good Loan,0,12.99,C,3,4.55,40247.86,32400,0,737.04,409000007989,11-Jun-18,OXYGEN NFS SETT 09-06-201,"5,000.00",,-542506485.20,Khan,645,France,96864.36,0,1,0
7991,2011,9,MORTGAGE,3,Low,1,28000, 60 months,2,debt_consolidation,6,Low,1,Good Loan,0,11.99,B,2,21.21,24275.53,17422.66,0,467.59,409000007990,11-Jun-18,OXYGEN NFS SETT 09-06-201,500,,-542506985.20,Robertson,664,Spain,134455.84,0,1,0
7992,2011,0.5,RENT,1,Low,1,28000, 36 months,1,debt_consolidation,6,High,2,Good Loan,0,15.99,D,4,15.57,35265.71025,28000,0,984.26,409000007991,11-Jun-18,OXYGEN NFS SETT 09-06-201,"2,500.00",,-542509485.20,Tikhonov,427,Spain,28368.37,0,1,0
7993,2011,10,RENT,1,Low,1,10000, 36 months,1,debt_consolidation,6,Low,1,Good Loan,0,11.99,B,2,9.27,11579.22,10000,0,332.1,409000007992,11-Jun-18,OXYGEN NFS SETT 09-06-201,"8,000.00",,-542517485.20,MacDonald,685,France,103898.59,0,1,0
7994,2011,2,MORTGAGE,3,Low,1,21250, 60 months,2,debt_consolidation,6,High,2,Good Loan,0,16.49,D,4,23.27,21222.74,16300,0,400.65,409000007993,11-Jun-18,OXYGEN NFS SETT 09-06-201,"1,000.00",,-542518485.20,Ah Mouy,585,France,63239.65,0,1,0
7995,2011,0.5,RENT,1,Low,1,15000, 36 months,1,debt_consolidation,6,Low,1,Good Loan,0,12.99,C,3,17.1,17953.08,15000,0,505.34,409000007994,11-Jun-18,OXYGEN NFS SETT 09-06-201,500,,-542518985.20,Barese,519,Germany,170138.68,0,1,0
7996,2011,4,RENT,1,Low,1,7650, 36 months,1,credit_card,1,High,2,Bad Loan,1,19.29,E,5,12.28,2342.9,1164.94,372.19,281.55,409000007995,11-Jun-18,OXYGEN NFS SETT 09-06-201,"6,000.00",,-542524985.20,Winter-Irving,708,France,3837.08,0,1,0
7997,2011,10,MORTGAGE,3,Low,1,13150, 60 months,2,debt_consolidation,6,Low,1,Good Loan,0,10.99,B,2,22.11,9627.87,8800,0,191.29,409000007996,11-Jun-18,OXYGEN NFS SETT 09-06-201,"3,000.00",,-542527985.20,Wilson,717,France,92977.75,0,1,0
7998,2011,10,MORTGAGE,3,Low,1,8500, 36 months,1,debt_consolidation,6,Low,1,Good Loan,0,10.59,B,2,6.76,9955.670651,8500,0,276.64,409000007997,11-Jun-18,OXYGEN NFS SETT 09-06-201,500,,-542528485.20,Fiorentino,465,Germany,191368.37,0,1,0
7999,2011,9,MORTGAGE,3,Medium,2,14400, 60 months,2,small_business,3,Low,1,Good Loan,0,11.99,B,2,6.22,14543.94,14400,0,320.25,409000007998,11-Jun-18,OXYGEN NFS SETT 09-06-201,"2,800.00",,-542531285.20,Iloerika,829,Germany,104889.20,0,1,0
8000,2011,5,OWN,2,Low,1,2200, 36 months,1,debt_consolidation,6,High,2,Good Loan,0,13.49,C,3,3.27,2225.22,2200,0,74.65,409000007999,11-Jun-18,OXYGEN NFS SETT 09-06-201,700,,-542531985.20,Davison,826,France,60285.30,0,1,0
8001,2011,6.05,RENT,1,Low,1,3550, 36 months,1,debt_consolidation,6,Low,1,Bad Loan,1,11.49,B,2,10,1988.64,1424.5,121.44,117.05,409000008000,11-Jun-18,OXYGEN NFS SETT 10-06-201,"9,100.00",,-542541085.20,Hamilton,747,Germany,180693.61,0,1,0
8002,2011,7,MORTGAGE,3,Low,1,15000, 60 months,2,small_business,3,High,2,Good Loan,0,13.99,C,3,5.1,18120.46,12334.95,0,348.95,409000008001,11-Jun-18,OXYGEN NFS SETT 10-06-201,500,,-542541585.20,Nnachetam,707,Spain,126475.79,0,1,0
8003,2011,10,MORTGAGE,3,Medium,2,11400, 36 months,1,credit_card,1,Low,1,Good Loan,0,10.59,B,2,22.57,13333.90432,11400,0,371.02,409000008002,11-Jun-18,OXYGEN NFS SETT 10-06-201,"8,000.00",,-542549585.20,Blue,590,Spain,133535.99,0,1,0
8004,2011,5,MORTGAGE,3,Low,1,7000, 36 months,1,credit_card,1,Low,1,Good Loan,0,7.49,A,1,0.96,7833.536902,7000,0,217.72,409000008003,11-Jun-18,OXYGEN NFS SETT 10-06-201,100,,-542549685.20,Madukwe,603,Spain,87412.24,0,1,0
8005,2011,0.5,RENT,1,Low,1,5375, 36 months,1,wedding,5,Low,1,Good Loan,0,10.99,B,2,20.25,6350.780641,5375,0,175.95,409000008004,11-Jun-18,OXYGEN NFS SETT 10-06-201,500,,-542550185.20,Mills,615,France,164886.64,0,1,0
8006,2011,10,MORTGAGE,3,Low,1,1000, 36 months,1,medical,9,Low,1,Good Loan,0,5.42,A,1,13.51,1021.55,1000,0,30.16,409000008005,11-Jun-18,OXYGEN NFS SETT 10-06-201,"3,000.00",,-542553185.20,Ferrari,634,France,116238.39,0,1,0
8007,2011,10,MORTGAGE,3,Medium,2,9000, 60 months,2,car,2,Low,1,Good Loan,0,9.99,B,2,29.79,11378.82001,9000,0,191.18,409000008006,11-Jun-18,OXYGEN NFS SETT 10-06-201,100,,-542553285.20,Nixon,716,Germany,138051.19,0,1,0
8008,2011,2,RENT,1,Low,1,12800, 36 months,1,debt_consolidation,6,Low,1,Good Loan,0,10.59,B,2,9.3,14913.2013,12800,0,416.58,409000008007,11-Jun-18,OXYGEN NFS SETT 10-06-201,100,,-542553385.20,Manfrin,647,France,101617.64,0,1,0
8009,2011,1,MORTGAGE,3,Low,1,18000, 60 months,2,debt_consolidation,6,Low,1,Good Loan,0,10.99,B,2,10.97,13733.88,10149.49,0,262.48,409000008008,11-Jun-18,OXYGEN NFS SETT 10-06-201,"4,000.00",,-542557385.20,McCartney,591,Germany,1985.41,0,1,0
8010,2011,3,MORTGAGE,3,Medium,2,35000, 36 months,1,debt_consolidation,6,High,2,Good Loan,0,19.29,E,5,16.57,45954.09396,35000,0,1288.1,409000008009,11-Jun-18,OXYGEN NFS SETT 10-06-201,200,,-542557585.20,Robinson,574,France,165626.60,0,1,0
8011,2011,7,MORTGAGE,3,Low,1,7500, 60 months,2,car,2,Low,1,Good Loan,0,8.49,A,1,7.78,7988.66,6299.73,0,153.84,409000008010,11-Jun-18,OXYGEN NFS SETT 10-06-201,"8,000.00",,-542565585.20,Nkemdirim,467,Germany,177784.68,0,1,0
8012,2011,3,RENT,1,Low,1,7950, 36 months,1,debt_consolidation,6,High,2,Good Loan,0,15.62,D,4,22.74,8956.8,7950,0,278.01,409000008011,11-Jun-18,OXYGEN NFS SETT 10-06-201,"9,000.00",,-542574585.20,Sal,701,France,65765.22,0,1,0
8013,2011,2,RENT,1,Low,1,6800, 36 months,1,debt_consolidation,6,Low,1,Good Loan,0,11.99,B,2,10.67,7905.3,6800,0,225.83,409000008012,11-Jun-18,OXYGEN NFS SETT 10-06-201,"3,000.00",,-542577585.20,Kao,747,France,50759.80,0,1,0
8014,2011,5,MORTGAGE,3,Low,1,1000, 60 months,2,credit_card,1,Low,1,Good Loan,0,11.99,B,2,6.45,1153.87,828.21,0,22.24,409000008013,11-Jun-18,OXYGEN NFS SETT 10-06-201,800,,-542578385.20,Ikechukwu,650,France,163216.48,0,1,0
8015,2011,2,MORTGAGE,3,Low,1,12000, 60 months,2,wedding,5,High,2,Good Loan,0,14.79,C,3,18.08,14930.88,12000,0,284.16,409000008014,11-Jun-18,OXYGEN NFS SETT 10-06-201,"8,000.00",,-542586385.20,Hargreaves,731,Spain,74850.93,0,1,0
8016,2011,4,RENT,1,Low,1,10000, 36 months,1,small_business,3,Low,1,Good Loan,0,5.99,A,1,1.14,10883.26,10000,0,304.18,409000008015,11-Jun-18,OXYGEN NFS SETT 10-06-201,"6,600.00",,-542592985.20,Sievier,638,Germany,23491.09,0,1,0
8017,2011,5,RENT,1,Low,1,3500, 36 months,1,debt_consolidation,6,Low,1,Good Loan,0,12.99,C,3,20.59,4243.685935,3500,0,117.92,409000008016,11-Jun-18,OXYGEN NFS SETT 10-06-201,"3,500.00",,-542596485.20,Murphy,569,Spain,134272.57,0,1,0
8018,2011,3,MORTGAGE,3,Low,1,13200, 60 months,2,other,4,High,2,Good Loan,0,14.79,C,3,18.24,14737.49,13200,0,312.58,409000008017,11-Jun-18,OXYGEN NFS SETT 10-06-201,"2,000.00",,-542598485.20,Munro,459,Germany,155721.15,0,1,0
8019,2011,6,MORTGAGE,3,Low,1,6075, 36 months,1,debt_consolidation,6,Low,1,Good Loan,0,8.49,A,1,28.75,6571.98,6075.01,0,191.75,409000008018,11-Jun-18,OXYGEN NFS SETT 10-06-201,"5,500.00",,-542603985.20,Donnelly,632,Germany,147230.77,0,1,0
8020,2011,3,MORTGAGE,3,Medium,2,20000, 60 months,2,debt_consolidation,6,Low,1,Good Loan,0,10.99,B,2,8.64,16275.19,11997.22,0,313.57,409000008019,11-Jun-18,OXYGEN NFS SETT 10-06-201,300,,-542604285.20,North,683,France,133210.44,0,1,0
8021,2011,7,RENT,1,Low,1,13200, 60 months,2,car,2,High,2,Good Loan,0,16.49,D,4,10.38,16413.22,13200,0,324.45,409000008020,11-Jun-18,OXYGEN NFS SETT 10-06-201,500,,-542604785.20,Cruz,850,France,18986.12,0,1,0
8022,2011,0.5,RENT,1,Low,1,2200, 36 months,1,other,4,High,2,Good Loan,0,15.99,D,4,12.58,2351.9,2200,0,77.34,409000008021,11-Jun-18,Indiaforensic  RUPAY SETT 110618,449.42,,-542605234.62,Sinclair,512,France,100507.81,0,1,0
8023,2011,10,MORTGAGE,3,Low,1,7000, 60 months,2,car,2,Low,1,Good Loan,0,9.99,B,2,4.6,7058.77,7000,0,148.7,409000008022,12-Jun-18,OXYGEN NFS SETT 11-06-201,"2,000.00",,-542607234.62,Vasiliev,616,France,59346.40,0,1,0
8024,2011,2,RENT,1,Low,1,9000, 36 months,1,debt_consolidation,6,High,2,Good Loan,0,13.49,C,3,10.41,10142.78,9000,0,305.38,409000008023,12-Jun-18,OXYGEN NFS SETT 11-06-201,"5,000.00",,-542612234.62,Vasilyeva,664,France,95372.64,0,1,0
8025,2011,3,MORTGAGE,3,Medium,2,21000, 60 months,2,home_improvement,7,High,2,Good Loan,0,18.79,E,5,13.93,23226.57,21000,0,542.33,409000008024,12-Jun-18,OXYGEN NFS SETT 11-06-201,"8,000.00",,-542620234.62,Hamilton,694,France,31805.49,0,1,0
8026,2011,10,OWN,2,Low,1,15000, 36 months,1,other,4,Low,1,Good Loan,0,7.49,A,1,26.47,15093.86,15000,0,466.53,409000008025,12-Jun-18,OXYGEN NFS SETT 11-06-201,"3,000.00",,-542623234.62,Sung,655,France,51959.82,0,1,0
8027,2011,0.5,RENT,1,Low,1,5500, 36 months,1,debt_consolidation,6,High,2,Good Loan,0,13.99,C,3,16.2,6763.112135,5500,0,187.96,409000008026,12-Jun-18,OXYGEN NFS SETT 11-06-201,"6,000.00",,-542629234.62,Genovesi,607,France,130824.57,0,1,0
8028,2011,8,MORTGAGE,3,Low,1,4950, 60 months,2,credit_card,1,High,2,Good Loan,0,13.49,C,3,17.85,6637.523063,4950,0,113.88,409000008027,12-Jun-18,OXYGEN NFS SETT 11-06-201,"4,000.00",,-542633234.62,Atkinson,684,Spain,157694.76,0,1,0
8029,2011,4,MORTGAGE,3,Low,1,14400, 60 months,2,car,2,Low,1,Bad Loan,1,10.99,B,2,23.21,14790.09,363.32,14165.11,313.02,409000008028,12-Jun-18,OXYGEN NFS SETT 11-06-201,"7,500.00",,-542640734.62,Watterston,763,Spain,933.38,0,1,0
8030,2011,10,OWN,2,Low,1,1000, 36 months,1,debt_consolidation,6,Low,1,Good Loan,0,10.99,B,2,14.76,1225.964984,1000,0,32.74,409000008029,12-Jun-18,OXYGEN NFS SETT 11-06-201,"4,000.00",,-542644734.62,Butters,671,Spain,2560.11,0,1,0
8031,2011,10,RENT,1,Low,1,12000, 60 months,2,major_purchase,8,High,2,Good Loan,0,15.99,D,4,2.79,15904.17183,12000,0,291.76,409000008030,12-Jun-18,OXYGEN NFS SETT 11-06-201,400,,-542645134.62,Chien,592,Spain,12905.89,0,1,0
8032,2011,5,OWN,2,Low,1,17500, 60 months,2,credit_card,1,High,2,Bad Loan,1,16.49,D,4,8.13,8526.95,3835.85,799.73,430.14,409000008031,12-Jun-18,OXYGEN NFS SETT 11-06-201,200,,-542645334.62,Gorbunova,666,Spain,176692.87,0,1,0
8033,2011,1,MORTGAGE,3,Low,1,11200, 36 months,1,home_improvement,7,High,2,Bad Loan,1,14.79,C,3,16.58,2655.35,1538.24,337.19,387.11,409000008032,12-Jun-18,OXYGEN NFS SETT 11-06-201,"1,800.00",,-542647134.62,Bulgakov,667,France,102908.63,0,1,0
8034,2011,10,RENT,1,Low,1,3600, 60 months,2,other,4,High,2,Bad Loan,1,14.79,C,3,17.68,867.36,340.58,187.2,85.25,409000008033,12-Jun-18,OXYGEN NFS SETT 11-06-201,100,,-542647234.62,Steele,850,Spain,41291.05,0,1,0
8035,2011,10,RENT,1,Low,1,12000, 36 months,1,debt_consolidation,6,Low,1,Good Loan,0,5.42,A,1,17.01,12994.06648,12000,0,361.92,409000008034,12-Jun-18,OXYGEN NFS SETT 11-06-201,500,,-542647734.62,Polyakova,622,Spain,119127.06,0,1,0
8036,2011,10,MORTGAGE,3,Low,1,25000, 60 months,2,debt_consolidation,6,Low,1,Good Loan,0,11.49,B,2,27.01,18697.86,16024.99,0,352.36,409000008035,12-Jun-18,OXYGEN NFS SETT 11-06-201,500,,-542648234.62,Bull,577,France,126434.61,0,1,0
8037,2011,4,MORTGAGE,3,Medium,2,8000, 36 months,1,debt_consolidation,6,Low,1,Good Loan,0,11.49,B,2,6.78,8743.5,8000,0,263.78,409000008036,12-Jun-18,OXYGEN NFS SETT 11-06-201,"9,000.00",,-542657234.62,Weaver,555,Spain,103901.35,0,1,0
8038,2011,0.5,RENT,1,Low,1,5000, 36 months,1,moving,10,Low,1,Good Loan,0,10.59,B,2,18.89,5856.034761,5000,0,162.73,409000008037,12-Jun-18,OXYGEN NFS SETT 11-06-201,"4,000.00",,-542661234.62,Earl,547,France,85153.00,0,1,0
8039,2011,9,MORTGAGE,3,Low,1,1000, 36 months,1,home_improvement,7,Low,1,Good Loan,0,9.99,B,2,8.8,1160.976628,1000,0,32.27,409000008038,12-Jun-18,OXYGEN NFS SETT 11-06-201,"2,000.00",,-542663234.62,Giordano,613,Germany,12493.61,0,1,0
8040,2011,10,MORTGAGE,3,Low,1,30000, 60 months,2,debt_consolidation,6,High,2,Good Loan,0,15.99,D,4,2.64,28991.6,18734.26,0,558.59,409000008039,12-Jun-18,Indiaforensic RUPAY SETT 110618,"5,063.21",,-542668297.83,Begg,672,France,167336.78,0,1,0
8041,2011,3,OWN,2,Low,1,7200, 36 months,1,debt_consolidation,6,Low,1,Good Loan,0,10.99,B,2,20.92,7770.14,7200,0,235.69,409000008040,12-Jun-18,Indiaforensic RUPAY SETT 120618,"9,808.96",,-542678106.79,Pickering,624,Spain,186180.42,0,1,0
8042,2011,7,MORTGAGE,3,Low,1,28000, 60 months,2,debt_consolidation,6,Low,1,Good Loan,0,11.49,B,2,10.87,25161.75,18303.88,0,485.38,409000008041,13-Jun-18,Indiaforensic  RUPAY SETT 130618,,5.11,-542678101.68,Fanucci,698,Spain,88566.90,0,1,0
8043,2011,4,RENT,1,Medium,2,16000, 60 months,2,wedding,5,High,2,Good Loan,0,19.69,E,5,13.29,17281.86,16000.01,0,421.15,409000008042,14-Jun-18,TRF FROM  Indiaforensic SERVICES,,5000.00,-542673101.68,Chang,606,France,172526.90,0,1,0
8044,2011,7,MORTGAGE,3,Low,1,20000, 60 months,2,debt_consolidation,6,Low,1,Good Loan,0,11.99,B,2,18.55,23106.75,16582.46,0,444.79,409000008043,14-Jun-18,Indiaforensic  RUPAY SETT 140618,556.94,,-542673658.62,Sopuluchi,720,Spain,137985.69,0,1,0
8045,2011,10,MORTGAGE,3,Medium,2,10000, 36 months,1,major_purchase,8,Low,1,Good Loan,0,5.99,A,1,4.72,10852.12,10000,0,304.18,409000008044,14-Jun-18,Indiaforensic  RUPAY SETT 140618,7.71,,-542673666.33,Martin,835,France,19793.73,0,1,0
8046,2011,1,RENT,1,Low,1,6000, 36 months,1,debt_consolidation,6,Low,1,Good Loan,0,5.99,A,1,12.5,6567.249301,6000,0,182.51,409000008045,15-Jun-18,Indiaforensic NFS SETT 13-06-18,"2,000.00",,-542675666.33,McNaughtan,771,Spain,107874.39,0,1,0
8047,2011,6.05,RENT,1,Low,1,2400, 36 months,1,debt_consolidation,6,Low,1,Good Loan,0,11.49,B,2,23.6,2846.816379,2400,0,79.14,409000008046,15-Jun-18,Indiaforensic NFS SETT 13-06-18,"9,000.00",,-542684666.33,Stewart,811,France,171995.34,0,1,0
8048,2011,10,MORTGAGE,3,Low,1,14000, 60 months,2,major_purchase,8,Low,1,Good Loan,0,10.59,B,2,12.66,15637.45,11652.26,0,301.54,409000008047,15-Jun-18,Indiaforensic NFS SETT 13-06-18,300,,-542684966.33,Reagan,734,Germany,61829.89,0,1,0
8049,2011,3,RENT,1,Low,1,35000, 36 months,1,small_business,3,Low,1,Bad Loan,1,10.99,B,2,3.25,8017.62,5927.49,10.88,1145.69,409000008048,15-Jun-18,Indiaforensic NFS SETT 13-06-18,"5,000.00",,-542689966.33,Heller,548,Spain,31728.35,0,1,0
8050,2011,5,MORTGAGE,3,Low,1,12000, 60 months,2,wedding,5,High,2,Good Loan,0,15.99,D,4,9.58,15128.89,9777.13,0,291.76,409000008049,15-Jun-18,Indiaforensic NFS SETT 13-06-18,"3,000.00",,-542692966.33,Nwokeocha,652,France,155221.05,0,1,0
8051,2011,7,RENT,1,Low,1,20500, 36 months,1,debt_consolidation,6,Low,1,Good Loan,0,7.49,A,1,15.67,22950.91314,20500,0,637.59,409000008050,15-Jun-18,Indiaforensic NFS SETT 13-06-18,"10,000.00",,-542702966.33,Liu,707,France,130866.95,0,1,0
8052,2011,10,MORTGAGE,3,Low,1,16000, 60 months,2,debt_consolidation,6,Low,1,Good Loan,0,10.59,B,2,2.56,16417.32,15999.99,0,344.62,409000008051,15-Jun-18,Indiaforensic NFS SETT 13-06-18,"5,000.00",,-542707966.33,Sokolova,605,Germany,62199.78,0,1,0
8053,2011,10,OWN,2,Medium,2,14000, 36 months,1,credit_card,1,Low,1,Good Loan,0,5.99,A,1,5.84,15141.94517,14000,0,425.85,409000008052,15-Jun-18,Indiaforensic NFS SETT 13-06-18,900,,-542708866.33,Bancroft,623,France,24255.21,0,1,0
8054,2011,4,MORTGAGE,3,Low,1,7200, 60 months,2,wedding,5,High,2,Good Loan,0,18.39,E,5,6.6,9585.79,5821.59,0,184.37,409000008053,15-Jun-18,Indiaforensic NFS SETT 13-06-18,"2,000.00",,-542710866.33,Nnanna,686,Germany,64679.07,0,1,0
8055,2011,0.5,RENT,1,Low,1,1500, 36 months,1,other,4,High,2,Good Loan,0,18.79,E,5,18.65,1972.320539,1500,0,54.83,409000008054,15-Jun-18,Indiaforensic NFS SETT 13-06-18,"2,000.00",,-542712866.33,Trevisani,525,Germany,88120.78,0,1,0
8056,2011,6.05,MORTGAGE,3,Low,1,5800, 36 months,1,house,12,Low,1,Good Loan,0,5.99,A,1,13.3,6284.29,5800,0,176.43,409000008055,15-Jun-18,Indiaforensic NFS SETT 13-06-18,500,,-542713366.33,Nwachinemelu,657,Spain,66463.62,0,1,0
8057,2011,3,MORTGAGE,3,Low,1,31000, 60 months,2,small_business,3,High,2,Bad Loan,1,13.99,C,3,13.78,13639.34,7887.55,12.22,524.59,409000008056,15-Jun-18,Indiaforensic NFS SETT 13-06-18,"5,500.00",,-542718866.33,Ting,730,Germany,15142.10,0,1,0
8058,2011,5,RENT,1,Low,1,8000, 36 months,1,debt_consolidation,6,High,2,Bad Loan,1,13.49,C,3,8.57,5914.41,4261.62,228.45,271.45,409000008057,15-Jun-18,Indiaforensic NFS SETT 13-06-18,200,,-542719066.33,Lo Duca,816,Germany,102908.91,0,1,0
8059,2011,4,RENT,1,Low,1,6000, 36 months,1,debt_consolidation,6,High,2,Good Loan,0,15.99,D,4,13.8,7587.888652,6000,0,210.92,409000008058,15-Jun-18,Indiaforensic NFS SETT 13-06-18,"6,000.00",,-542725066.33,Marshall,484,France,48170.57,0,1,0
8060,2011,9,MORTGAGE,3,Low,1,6300, 36 months,1,debt_consolidation,6,Low,1,Good Loan,0,11.49,B,2,13.75,6741.6,6300,0,207.72,409000008059,15-Jun-18,Indiaforensic NFS SETT 13-06-18,"3,000.00",,-542728066.33,Band,728,France,11597.69,0,1,0
8061,2011,8,RENT,1,Low,1,2900, 60 months,2,car,2,Low,1,Good Loan,0,11.49,B,2,18.17,3745.060395,2900,0,63.77,409000008060,15-Jun-18,Indiaforensic NFS SETT 13-06-18,900,,-542728966.33,Ferri,730,Spain,172450.04,0,1,0
8062,2011,0.5,MORTGAGE,3,Medium,2,9175, 36 months,1,debt_consolidation,6,Low,1,Good Loan,0,10.99,B,2,19.33,10215.68,9175,0,300.34,409000008061,15-Jun-18,Indiaforensic NFS SETT 14-06-201,"3,000.00",,-542731966.33,Carter,477,Spain,184061.17,0,1,0
8063,2011,9,MORTGAGE,3,Medium,2,8500, 36 months,1,credit_card,1,Low,1,Good Loan,0,5.42,A,1,3.07,9176.85,8500,0,256.36,409000008062,15-Jun-18,Indiaforensic NFS SETT 14-06-201,"2,000.00",,-542733966.33,Wilson,663,Germany,21038.58,0,1,0
8064,2011,5,MORTGAGE,3,Low,1,15075, 60 months,2,home_improvement,7,Low,1,Good Loan,0,10.99,B,2,29,17018.94,12544.68,0,327.7,409000008063,15-Jun-18,Indiaforensic NFS SETT 14-06-201,500,,-542734466.33,Connor,549,Germany,109538.35,0,1,0
8065,2011,0.5,RENT,1,Low,1,12000, 36 months,1,debt_consolidation,6,Low,1,Good Loan,0,5.99,A,1,12.24,12616.89,12000,0,365.01,409000008064,15-Jun-18,Indiaforensic NFS SETT 14-06-201,"1,500.00",,-542735966.33,Reid,714,Spain,129192.55,0,1,0
8066,2011,6,MORTGAGE,3,Medium,2,10000, 36 months,1,credit_card,1,Low,1,Good Loan,0,5.99,A,1,2.91,10237.5,10000,0,304.18,409000008065,15-Jun-18,Indiaforensic NFS SETT 14-06-201,800,,-542736766.33,Sandefur,430,Germany,146516.86,0,1,0
8067,2011,10,MORTGAGE,3,Low,1,14075, 60 months,2,debt_consolidation,6,High,2,Bad Loan,1,13.99,C,3,18.39,6873.75,3852.19,13.68,327.43,409000008066,15-Jun-18,Indiaforensic NFS SETT 14-06-201,"5,000.00",,-542741766.33,Bidwill,504,Germany,181430.91,0,1,0
8068,2011,10,RENT,1,Low,1,9000, 36 months,1,debt_consolidation,6,Low,1,Good Loan,0,5.42,A,1,14.52,9744.468184,9000,0,271.44,409000008067,15-Jun-18,Indiaforensic NFS SETT 14-06-201,500,,-542742266.33,Cone,530,France,121451.21,0,1,0
8069,2011,4,OWN,2,Low,1,12000, 36 months,1,small_business,3,Low,1,Good Loan,0,6.99,A,1,7.45,13172.5,12000,0,370.48,409000008068,15-Jun-18,Indiaforensic NFS SETT 14-06-201,"6,000.00",,-542748266.33,Saunders,619,Germany,131712.51,0,1,0
8070,2011,6.05,RENT,1,Low,1,12000, 36 months,1,debt_consolidation,6,High,2,Good Loan,0,14.79,C,3,10.15,14202.54,12000,0,414.76,409000008069,15-Jun-18,Indiaforensic NFS SETT 14-06-201,"6,500.00",,-542754766.33,Liardet,617,Germany,53294.17,0,1,0
8071,2011,8,MORTGAGE,3,Low,1,17000, 60 months,2,debt_consolidation,6,High,2,Good Loan,0,14.79,C,3,9.96,19346.82,17000.01,0,402.56,409000008070,15-Jun-18,Indiaforensic NFS SETT 14-06-201,100,,-542754866.33,Wilkes,791,Germany,96546.55,0,1,0
8072,2011,2,MORTGAGE,3,Low,1,6000, 36 months,1,debt_consolidation,6,High,2,Good Loan,0,15.23,C,3,24.06,7433.76,6000,0,208.67,409000008071,15-Jun-18,Indiaforensic NFS SETT 14-06-201,"2,000.00",,-542756866.33,Martin,609,France,184524.65,0,1,0
8073,2011,1,RENT,1,Low,1,3300, 36 months,1,other,4,Low,1,Good Loan,0,6.99,A,1,20.04,3663.575617,3300,0,101.88,409000008072,15-Jun-18,Indiaforensic NFS SETT 14-06-201,"6,500.00",,-542763366.33,Boni,780,Germany,195259.31,0,1,0
8074,2011,8,MORTGAGE,3,Medium,2,2800, 36 months,1,debt_consolidation,6,Low,1,Good Loan,0,8.49,A,1,0.58,3088.35,2800,0,88.38,409000008073,15-Jun-18,Indiaforensic NFS SETT 14-06-201,"2,000.00",,-542765366.33,Patel,777,Germany,172618.52,0,1,0
8075,2011,0.5,RENT,1,Low,1,3150, 36 months,1,credit_card,1,High,2,Good Loan,0,15.62,D,4,6.32,3962.693039,3150,0,110.16,409000008074,15-Jun-18,Indiaforensic NFS SETT 14-06-201,"1,800.00",,-542767166.33,Howell-Price,817,Germany,59259.44,0,1,0
8076,2011,10,RENT,1,Low,1,25000, 60 months,2,major_purchase,8,High,2,Good Loan,0,13.49,C,3,3.05,29876.95,20605.95,0,575.12,409000008075,15-Jun-18,Indiaforensic NFS SETT 14-06-201,500,,-542767666.33,Simpson,850,France,25899.21,0,1,0
8077,2011,2,RENT,1,Low,1,7000, 36 months,1,debt_consolidation,6,Low,1,Good Loan,0,11.99,B,2,18.21,8305.372567,7000,0,232.47,409000008076,15-Jun-18,Indiaforensic NFS SETT 14-06-201,200,,-542767866.33,Rowland,732,France,3749.00,0,1,0
8078,2011,10,MORTGAGE,3,Medium,2,2000, 36 months,1,debt_consolidation,6,Low,1,Good Loan,0,9.99,B,2,11.22,2215.7,2000,0,64.53,409000008077,15-Jun-18,Indiaforensic NFS SETT 14-06-201,100,,-542767966.33,Barnard,693,France,101918.96,0,1,0
8079,2011,7,OWN,2,Low,1,15000, 36 months,1,debt_consolidation,6,High,2,Good Loan,0,16.49,D,4,11.9,19111.628,15000,0,531,409000008078,15-Jun-18,Indiaforensic NFS SETT 14-06-201,"9,000.00",,-542776966.33,Nnonso,576,France,57802.62,0,1,0
8080,2011,6,MORTGAGE,3,Medium,2,12000, 60 months,2,debt_consolidation,6,High,2,Bad Loan,1,16.89,D,4,19.8,6169.76,2757.08,544.2,297.53,409000008079,15-Jun-18,Indiaforensic NFS SETT 14-06-201,"8,800.00",,-542785766.33,Rossi,643,France,142454.77,0,1,0
8081,2011,10,MORTGAGE,3,Low,1,6000, 36 months,1,debt_consolidation,6,Low,1,Good Loan,0,7.49,A,1,26.66,6715.30354,6000,0,186.61,409000008080,15-Jun-18,Indiaforensic NFS SETT 14-06-201,"2,500.00",,-542788266.33,Pendred,757,France,143829.54,0,1,0
8082,2011,10,MORTGAGE,3,Low,1,15000, 60 months,2,credit_card,1,Low,1,Good Loan,0,10.59,B,2,5.51,17097.72,14999.99,0,323.08,409000008081,15-Jun-18,Indiaforensic NFS SETT 14-06-201,"10,000.00",,-542798266.33,Martin,569,Germany,44114.88,0,1,0
8083,2011,6,OWN,2,Low,1,10000, 60 months,2,home_improvement,7,High,2,Bad Loan,1,16.49,D,4,2.36,3203.77,1271.63,512.62,245.8,409000008082,15-Jun-18,Indiaforensic NFS SETT 14-06-201,"6,900.00",,-542805166.33,K?,772,Spain,186948.35,0,1,0
8084,2011,10,MORTGAGE,3,Medium,2,35000, 60 months,2,debt_consolidation,6,Low,1,Good Loan,0,12.99,C,3,16.75,23142.79,21775.01,0,495.34,409000008083,15-Jun-18,Indiaforensic NFS SETT 14-06-201,"2,000.00",,-542807166.33,Miller,576,Germany,173629.78,0,1,0
8085,2011,1,RENT,1,Low,1,8500, 36 months,1,other,4,Low,1,Bad Loan,1,12.99,C,3,10.06,3921.06,2540.75,341.97,286.36,409000008084,15-Jun-18,Indiaforensic NFS SETT 14-06-201,"2,500.00",,-542809666.33,Afamefula,608,Germany,49133.45,0,1,0
8086,2011,10,RENT,1,Low,1,12000, 60 months,2,debt_consolidation,6,High,2,Good Loan,0,16.49,D,4,10.47,15509.36,12000,0,294.96,409000008085,15-Jun-18,Indiaforensic NFS SETT 14-06-201,"8,300.00",,-542817966.33,Sims,794,France,178122.71,0,1,0
8087,2011,1,RENT,1,Low,1,9200, 60 months,2,small_business,3,High,2,Good Loan,0,13.99,C,3,0,11906.90151,9200,0,214.03,409000008086,15-Jun-18,Indiaforensic NFS SETT 14-06-201,"2,500.00",,-542820466.33,Knight,593,France,20893.61,0,1,0
8088,2011,10,RENT,1,Low,1,7500, 36 months,1,debt_consolidation,6,Low,1,Good Loan,0,12.99,C,3,17.15,8922.44,7500,0,252.67,409000008087,15-Jun-18,Indiaforensic NFS SETT 14-06-201,"9,000.00",,-542829466.33,Obijiaku,597,Spain,41303.29,0,1,0
8089,2011,10,MORTGAGE,3,Low,1,9000, 36 months,1,home_improvement,7,Low,1,Good Loan,0,10.99,B,2,5.32,10064.57,9000,0,294.61,409000008088,15-Jun-18,Indiaforensic NFS SETT 14-06-201,"5,000.00",,-542834466.33,Hopkins,541,Germany,199808.10,0,1,0
8090,2011,1,OWN,2,Low,1,15000, 36 months,1,debt_consolidation,6,High,2,Good Loan,0,14.79,C,3,11.07,16654.94,15000,0,518.44,409000008089,15-Jun-18,Indiaforensic NFS SETT 14-06-201,"4,000.00",,-542838466.33,Onio,692,Germany,180490.53,0,1,0
8091,2011,2,MORTGAGE,3,Low,1,8000, 36 months,1,credit_card,1,Low,1,Good Loan,0,5.99,A,1,0.55,8747.915924,8000,0,243.34,409000008090,15-Jun-18,Indiaforensic NFS SETT 14-06-201,"7,000.00",,-542845466.33,Black,697,France,87400.53,0,1,0
8092,2011,1,RENT,1,Low,1,14000, 60 months,2,debt_consolidation,6,Low,1,Bad Loan,1,12.99,C,3,13.49,7103.02,3589.97,597.07,318.48,409000008091,15-Jun-18,Indiaforensic NFS SETT 14-06-201,"5,000.00",,-542850466.33,Eluemuno,768,France,73686.75,0,1,0
8093,2011,3,RENT,1,Low,1,5000, 36 months,1,other,4,High,2,Good Loan,0,14.79,C,3,15.56,6151,5000,0,172.82,409000008092,15-Jun-18,Indiaforensic NFS SETT 14-06-201,400,,-542850866.33,Doyle,802,France,172497.73,0,1,0
8094,2011,8,RENT,1,Low,1,5000, 36 months,1,small_business,3,Low,1,Bad Loan,1,9.99,B,2,6.4,1114.27,731.33,148.93,161.32,409000008093,15-Jun-18,Indiaforensic  RUPAY SETT 150618,"1,605.30",,-542852471.63,Onyemere,584,France,89286.29,0,1,0
8095,2011,8,MORTGAGE,3,Low,1,14400, 60 months,2,debt_consolidation,6,High,2,Good Loan,0,14.79,C,3,19.84,15597.91,14400,0,340.99,409000008094,15-Jun-18,Indiaforensic  RUPAY SETT 150618,327.12,,-542852798.75,Rahman,614,Spain,180082.70,0,1,0
8096,2011,4,RENT,1,Low,1,3000, 36 months,1,debt_consolidation,6,High,2,Good Loan,0,13.49,C,3,6.2,3660.560874,3000,0,101.8,409000008095,18-Jun-18,Indiaforensic RUPAY SETT 160618,"14,325.92",,-542867124.67,Su,850,Germany,22102.25,0,1,0
8097,2011,6,RENT,1,Medium,2,16000, 60 months,2,debt_consolidation,6,Low,1,Good Loan,0,12.99,C,3,9.57,18490.55,12849.44,0,363.97,409000008096,18-Jun-18,Indiaforensic RUPAY SETT 170618,"5,447.08",,-542872571.75,Walker,671,France,76068.95,0,1,0
8098,2011,0.5,MORTGAGE,3,Medium,2,12000, 60 months,2,home_improvement,7,Low,1,Good Loan,0,10.99,B,2,13.38,13543.32,9982.93,0,260.85,409000008097,18-Jun-18,Indiaforensic RUPAY SETT 180618,"4,540.31",,-542877112.06,Ferguson,626,France,32159.46,0,1,0
8099,2011,10,OWN,2,Low,1,3625, 36 months,1,debt_consolidation,6,Low,1,Good Loan,0,8.49,A,1,29.43,4088.51,3625,0,114.42,409000008098,19-Jun-18,Indiaforensic NFS SETT 15-06-201,500,,-542877612.06,Samaniego,770,France,159557.28,0,1,0
8100,2011,3,RENT,1,Low,1,8000, 36 months,1,debt_consolidation,6,Low,1,Good Loan,0,8.49,A,1,12.05,9084.723604,8000,0,252.51,409000008099,19-Jun-18,Indiaforensic NFS SETT 15-06-201,900,,-542878512.06,Onwumelu,633,France,107673.35,0,1,0
8101,2011,7,OWN,2,Low,1,11000, 36 months,1,debt_consolidation,6,Low,1,Bad Loan,1,8.49,A,1,21.33,4513.32,3546.72,0,347.2,409000008100,19-Jun-18,Indiaforensic NFS SETT 15-06-201,"8,500.00",,-542887012.06,Young,663,France,33607.72,0,1,0
8102,2011,0.5,MORTGAGE,3,Low,1,4200, 36 months,1,credit_card,1,Low,1,Good Loan,0,11.99,B,2,20.44,4972.72,4200,0,139.49,409000008101,19-Jun-18,Indiaforensic NFS SETT 15-06-201,200,,-542887212.06,Mazzi,581,Germany,141035.65,0,1,0
8103,2011,2,MORTGAGE,3,Low,1,5400, 60 months,2,car,2,Low,1,Good Loan,0,10.59,B,2,1.8,6017.67,4485.18,0,116.31,409000008102,19-Jun-18,Indiaforensic NFS SETT 15-06-201,400,,-542887612.06,Toscano,561,Germany,115719.08,0,1,0
8104,2011,1,RENT,1,Low,1,2800, 36 months,1,other,4,Low,1,Good Loan,0,7.49,A,1,10.38,2898.51,2800,0,87.09,409000008103,19-Jun-18,Indiaforensic NFS SETT 15-06-201,"10,000.00",,-542897612.06,Walton,479,Germany,86128.21,0,1,0
8105,2011,5,MORTGAGE,3,Low,1,12800, 36 months,1,debt_consolidation,6,Low,1,Good Loan,0,9.99,B,2,8.78,14842.96312,12800,0,412.96,409000008104,19-Jun-18,Indiaforensic NFS SETT 15-06-201,"2,000.00",,-542899612.06,Chiang,769,France,147668.64,0,1,0
8106,2011,6,MORTGAGE,3,Low,1,14125, 36 months,1,debt_consolidation,6,Low,1,Good Loan,0,12.99,C,3,22.24,17127.6052,14125,0,475.86,409000008105,19-Jun-18,Indiaforensic NFS SETT 15-06-201,"4,000.00",,-542903612.06,Burgos,659,Spain,177480.45,0,1,0
8107,2011,10,MORTGAGE,3,Low,1,16100, 60 months,2,debt_consolidation,6,High,2,Good Loan,0,18.39,E,5,24.07,21022.65,12657.59,0,412.26,409000008106,19-Jun-18,Indiaforensic NFS SETT 15-06-201,400,,-542904012.06,Spinelli,590,Spain,190937.09,0,1,0
8108,2011,10,RENT,1,Low,1,9600, 36 months,1,debt_consolidation,6,Low,1,Good Loan,0,11.99,B,2,16.63,10794.32,9600,0,318.82,409000008107,19-Jun-18,Indiaforensic NFS SETT 15-06-201,"4,900.00",,-542908912.06,Lung,560,France,84531.79,0,1,0
8109,2011,0.5,RENT,1,Low,1,16000, 60 months,2,debt_consolidation,6,Low,1,Good Loan,0,7.49,A,1,5.06,18986.55608,16000,0,320.54,409000008108,19-Jun-18,Indiaforensic NFS SETT 15-06-201,100,,-542909012.06,Noble,437,Germany,161133.40,0,1,0
8110,2011,3,RENT,1,Low,1,13400, 36 months,1,debt_consolidation,6,Low,1,Good Loan,0,9.99,B,2,15.76,14978.3,13400,0,432.32,409000008109,19-Jun-18,Indiaforensic NFS SETT 15-06-201,"6,000.00",,-542915012.06,Pai,661,France,185555.63,0,1,0
8111,2011,2,RENT,1,Low,1,4000, 36 months,1,credit_card,1,Low,1,Good Loan,0,5.99,A,1,20.44,4349.622154,4000,0,121.67,409000008110,19-Jun-18,Indiaforensic NFS SETT 15-06-201,"5,700.00",,-542920712.06,Chigozie,677,Germany,33075.24,0,1,0
8112,2011,7,RENT,1,Low,1,5000, 36 months,1,debt_consolidation,6,Low,1,Good Loan,0,9.99,B,2,21.79,5804.96017,5000,0,161.32,409000008111,19-Jun-18,Indiaforensic NFS SETT 15-06-201,"8,000.00",,-542928712.06,Peavy,560,France,39806.75,0,1,0
8113,2011,0.5,RENT,1,Low,1,6600, 60 months,2,car,2,High,2,Good Loan,0,16.89,D,4,12.45,9680.420007,6600,0,163.64,409000008112,19-Jun-18,Indiaforensic NFS SETT 15-06-201,"8,500.00",,-542937212.06,Yermakov,578,France,26389.92,0,1,0
8114,2011,5,MORTGAGE,3,Low,1,4200, 36 months,1,major_purchase,8,Low,1,Good Loan,0,5.42,A,1,7.26,4547.29863,4200,0,126.68,409000008113,19-Jun-18,Indiaforensic NFS SETT 15-06-201,400,,-542937612.06,Burton,421,Spain,12162.76,0,1,0
8115,2011,3,MORTGAGE,3,Low,1,20000, 60 months,2,debt_consolidation,6,High,2,Bad Loan,1,17.99,E,5,24.23,8575.62,3232.24,961.74,507.76,409000008114,19-Jun-18,Indiaforensic NFS SETT 15-06-201,500,,-542938112.06,Costa,492,Germany,167237.94,0,1,0
8116,2011,10,RENT,1,Low,1,12000, 60 months,2,debt_consolidation,6,High,2,Good Loan,0,15.99,D,4,15.06,17287.64996,12000,0,291.76,409000008115,19-Jun-18,Indiaforensic NFS SETT 15-06-201,500,,-542938612.06,Pugliesi,545,France,52067.37,0,1,0
8117,2011,0.5,MORTGAGE,3,Low,1,4200, 36 months,1,wedding,5,Low,1,Good Loan,0,10.59,B,2,19.78,4915.241385,4200,0,136.69,409000008116,19-Jun-18,Indiaforensic NFS SETT 15-06-201,"1,000.00",,-542939612.06,Lindell,640,Germany,184006.36,0,1,0
8118,2011,6,MORTGAGE,3,Low,1,21200, 60 months,2,debt_consolidation,6,High,2,Bad Loan,1,13.99,C,3,9.44,3407.11,1760.27,0,487.95,409000008117,19-Jun-18,Indiaforensic NFS SETT 15-06-201,"5,000.00",,-542944612.06,Sorenson,624,Spain,582.59,0,1,0
8119,2011,1,MORTGAGE,3,Low,1,4400, 36 months,1,other,4,Low,1,Good Loan,0,10.59,B,2,13.44,5152.536514,4400,0,143.2,409000008118,19-Jun-18,Indiaforensic NFS SETT 15-06-201,"7,900.00",,-542952512.06,Arcuri,577,Spain,143274.41,0,1,0
8120,2011,6,RENT,1,Low,1,4000, 36 months,1,home_improvement,7,Low,1,Good Loan,0,7.49,A,1,26.21,4476.671243,4000,0,124.41,409000008119,19-Jun-18,Indiaforensic NFS SETT 15-06-201,"6,500.00",,-542959012.06,Banks,704,France,54474.48,0,1,0
8121,2011,9,RENT,1,Low,1,12000, 36 months,1,debt_consolidation,6,Low,1,Good Loan,0,5.42,A,1,9.12,12594.4,12000,0,361.92,409000008120,19-Jun-18,Indiaforensic NFS SETT 15-06-201,500,,-542959512.06,Parry,523,France,121428.20,0,1,0
8122,2011,2,RENT,1,Low,1,2000, 36 months,1,other,4,Low,1,Good Loan,0,7.49,A,1,20.09,2237.891993,2000,0,62.21,409000008121,19-Jun-18,Indiaforensic NFS SETT 15-06-201,"3,000.00",,-542962512.06,Cockett,793,France,79704.12,0,1,0
8123,2011,5,MORTGAGE,3,Low,1,12000, 36 months,1,debt_consolidation,6,Low,1,Good Loan,0,7.49,A,1,15.56,13434.17259,12000,0,373.22,409000008122,19-Jun-18,Indiaforensic NFS SETT 15-06-201,"1,500.00",,-542964012.06,Galkina,564,France,41055.71,0,1,0
8124,2011,6,MORTGAGE,3,Low,1,18000, 36 months,1,home_improvement,7,Low,1,Good Loan,0,11.49,B,2,19.03,21360.8839,18000,0,593.49,409000008123,19-Jun-18,Indiaforensic NFS SETT 15-06-201,"7,000.00",,-542971012.06,Su,711,France,41590.40,0,1,0
8125,2011,1,OWN,2,Low,1,10000, 36 months,1,debt_consolidation,6,Low,1,Bad Loan,1,12.99,C,3,24.14,7665.63,5639.16,262.19,336.9,409000008124,19-Jun-18,Indiaforensic NFS SETT 15-06-201,"6,000.00",,-542977012.06,Marino,791,Germany,54019.93,0,1,0
8126,2011,1,MORTGAGE,3,Low,1,15000, 60 months,2,debt_consolidation,6,Low,1,Bad Loan,1,11.49,B,2,7.91,5276.09,3186.12,0,329.82,409000008125,19-Jun-18,Indiaforensic NFS SETT 15-06-201,"5,000.00",,-542982012.06,Spears,629,Germany,76053.07,0,1,0
8127,2011,6,RENT,1,Low,1,5000, 36 months,1,car,2,Low,1,Good Loan,0,10.59,B,2,22.72,5856.034761,5000,0,162.73,409000008126,19-Jun-18,Indiaforensic NFS SETT 15-06-201,300,,-542982312.06,Cunningham,729,Germany,184977.20,0,1,0
8128,2011,2,MORTGAGE,3,Low,1,6500, 36 months,1,car,2,Low,1,Good Loan,0,9.99,B,2,1.61,7275.01,6500,0,209.71,409000008127,19-Jun-18,Indiaforensic NFS SETT 16-06-201,"9,000.00",,-542991312.06,Taylor,651,Germany,127678.95,0,1,0
8129,2011,4,MORTGAGE,3,Low,1,6000, 36 months,1,debt_consolidation,6,Low,1,Good Loan,0,10.99,B,2,6.21,6488.24,6000,0,196.41,409000008128,19-Jun-18,Indiaforensic NFS SETT 16-06-201,"9,000.00",,-543000312.06,Chiazagomekpere,695,Spain,1243.97,0,1,0
8130,2011,10,MORTGAGE,3,Low,1,8000, 36 months,1,debt_consolidation,6,Low,1,Good Loan,0,9.99,B,2,10.08,9073.44,8000,0,258.1,409000008129,19-Jun-18,Indiaforensic NFS SETT 16-06-201,"10,000.00",,-543010312.06,Hardacre,847,Spain,76326.67,0,1,0
8131,2011,6,MORTGAGE,3,Low,1,2200, 36 months,1,small_business,3,Low,1,Bad Loan,1,11.49,B,2,3.2,303.84,207.83,0,72.54,409000008130,19-Jun-18,Indiaforensic NFS SETT 16-06-201,"10,000.00",,-543020312.06,Maslow,704,France,145338.61,0,1,0
8132,2011,6,RENT,1,Low,1,14125, 36 months,1,debt_consolidation,6,Low,1,Good Loan,0,12.99,C,3,9.83,17127.9666,14125,0,475.86,409000008131,19-Jun-18,Indiaforensic NFS SETT 16-06-201,"8,000.00",,-543028312.06,Scott,613,Germany,57751.21,0,1,0
8133,2011,0.5,OWN,2,Low,1,4350, 36 months,1,house,12,Low,1,Good Loan,0,5.99,A,1,3.12,4642.24,4350,0,132.32,409000008132,19-Jun-18,Indiaforensic NFS SETT 16-06-201,"10,000.00",,-543038312.06,Wakelin,692,Spain,138880.24,0,1,0
8134,2011,6,MORTGAGE,3,Low,1,10000, 60 months,2,major_purchase,8,Low,1,Good Loan,0,12.99,C,3,12.67,13239.82367,10000,0,227.48,409000008133,19-Jun-18,Indiaforensic NFS SETT 16-06-201,400,,-543038712.06,Esposito,720,France,136120.29,0,1,0
8135,2011,1,RENT,1,Low,1,11200, 36 months,1,debt_consolidation,6,Low,1,Good Loan,0,12.99,C,3,14,13581.15761,11200,0,377.32,409000008134,19-Jun-18,Indiaforensic NFS SETT 16-06-201,"9,900.00",,-543048612.06,Shah,577,France,167621.18,0,1,0
8136,2011,9,MORTGAGE,3,Medium,2,10000, 36 months,1,small_business,3,High,2,Good Loan,0,15.62,D,4,11.13,12441.81058,10000,0,349.7,409000008135,19-Jun-18,Indiaforensic NFS SETT 16-06-201,"9,900.00",,-543058512.06,Chukwufumnanya,710,Germany,173276.62,0,1,0
8137,2011,2,MORTGAGE,3,Low,1,8000, 36 months,1,debt_consolidation,6,Low,1,Good Loan,0,12.99,C,3,10.51,9708.948674,8000,0,269.52,409000008136,19-Jun-18,Indiaforensic NFS SETT 16-06-201,"9,900.00",,-543068412.06,Fleming,716,France,99661.46,0,1,0
8138,2011,2,MORTGAGE,3,Medium,2,22400, 36 months,1,debt_consolidation,6,Low,1,Good Loan,0,7.49,A,1,10.87,24987.58199,22400,0,696.68,409000008137,19-Jun-18,Indiaforensic NFS SETT 16-06-201,"10,000.00",,-543078412.06,Lori,410,France,66333.56,0,1,0
8139,2011,10,MORTGAGE,3,Medium,2,2800, 60 months,2,debt_consolidation,6,Low,1,Good Loan,0,12.99,C,3,22.35,3295.87,2304.68,0,63.7,409000008138,19-Jun-18,Indiaforensic NFS SETT 16-06-201,900,,-543079312.06,Kennedy,584,Germany,70240.79,0,1,0
8140,2011,6.05,MORTGAGE,3,Low,1,7000, 36 months,1,major_purchase,8,Low,1,Bad Loan,1,7.49,A,1,15.23,2822.82,2342.81,0,217.72,409000008139,19-Jun-18,Indiaforensic NFS SETT 16-06-201,"10,000.00",,-543089312.06,Walters,792,France,113553.42,0,1,0
8141,2011,5,MORTGAGE,3,Low,1,7200, 36 months,1,credit_card,1,Low,1,Good Loan,0,11.99,B,2,17.15,8543.39,7200,0,239.11,409000008140,19-Jun-18,Indiaforensic NFS SETT 16-06-201,900,,-543090212.06,Han,605,France,690.84,0,1,0
8142,2011,2,OWN,2,Low,1,2200, 36 months,1,medical,9,Low,1,Good Loan,0,11.99,B,2,4.17,2629.962805,2200,0,73.07,409000008141,19-Jun-18,Indiaforensic NFS SETT 16-06-201,300,,-543090512.06,Lawrence,486,Spain,98802.76,0,1,0
8143,2011,6,RENT,1,Low,1,12200, 60 months,2,debt_consolidation,6,Low,1,Bad Loan,1,10.99,B,2,8.04,3984.08,2256.13,387.37,190.21,409000008142,19-Jun-18,Indiaforensic NFS SETT 16-06-201,100,,-543090612.06,Cooke,615,France,130661.95,0,1,0
8144,2011,6,MORTGAGE,3,Medium,2,35000, 60 months,2,credit_card,1,High,2,Good Loan,0,16.89,D,4,17.93,28742.53,18150.86,0,554.76,409000008143,19-Jun-18,Indiaforensic NFS SETT 16-06-201,100,,-543090712.06,Wan,676,France,116378.82,0,1,0
8145,2011,10,MORTGAGE,3,Medium,2,24000, 36 months,1,debt_consolidation,6,Low,1,Good Loan,0,7.49,A,1,7.19,26106,24000,0,746.44,409000008144,19-Jun-18,Indiaforensic NFS SETT 16-06-201,300,,-543091012.06,Lo Duca,571,France,186052.15,0,1,0
8146,2011,10,MORTGAGE,3,Low,1,35000, 60 months,2,small_business,3,Low,1,Good Loan,0,11.99,B,2,13.26,26543.82,19049.32,0,510.96,409000008145,19-Jun-18,Indiaforensic NFS SETT 16-06-201,"4,000.00",,-543095012.06,Yermakova,850,France,100101.06,0,1,0
8147,2011,10,MORTGAGE,3,Low,1,8000, 36 months,1,home_improvement,7,Low,1,Good Loan,0,11.99,B,2,10.24,9564.038549,8000,0,265.68,409000008146,19-Jun-18,Indiaforensic NFS SETT 16-06-201,"4,500.00",,-543099512.06,Combs,717,France,169952.82,0,1,0
8148,2011,10,RENT,1,Low,1,7000, 36 months,1,moving,10,Low,1,Bad Loan,1,7.49,A,1,16.95,1163.15,593.87,401.51,217.72,409000008147,19-Jun-18,Indiaforensic NFS SETT 16-06-201,"5,000.00",,-543104512.06,Chien,642,Germany,61792.76,0,1,0
8149,2011,7,OWN,2,Low,1,3375, 60 months,2,small_business,3,High,2,Good Loan,0,17.99,E,5,24.39,4653.237943,3375,0,85.69,409000008148,19-Jun-18,Indiaforensic NFS SETT 16-06-201,"5,000.00",,-543109512.06,Meng,780,Spain,37973.13,0,1,0
8150,2011,6,MORTGAGE,3,Low,1,10000, 60 months,2,other,4,Low,1,Good Loan,0,12.99,C,3,20.61,12574.28525,10000,0,227.48,409000008149,19-Jun-18,Indiaforensic NFS SETT 16-06-201,500,,-543110012.06,Calabresi,492,Germany,188974.81,0,1,0
8151,2011,3,OWN,2,Low,1,13600, 36 months,1,small_business,3,Low,1,Good Loan,0,10.99,B,2,4.13,16022.5023,13600,0,445.19,409000008150,19-Jun-18,Indiaforensic NFS SETT 16-06-201,200,,-543110212.06,Stevenson,760,Germany,86334.64,0,1,0
8152,2011,0.5,MORTGAGE,3,Low,1,2400, 36 months,1,home_improvement,7,Low,1,Good Loan,0,7.49,A,1,18.6,2684.949525,2400,0,74.65,409000008151,19-Jun-18,Indiaforensic NFS SETT 16-06-201,"2,000.00",,-543112212.06,Davidson,500,Spain,152845.99,0,1,0
8153,2011,4,RENT,1,Low,1,30000, 36 months,1,debt_consolidation,6,High,2,Good Loan,0,16.49,D,4,14.64,35695.25,30000.01,0,1061.99,409000008152,19-Jun-18,Indiaforensic NFS SETT 16-06-201,500,,-543112712.06,Ch'in,654,Spain,146652.11,0,1,0
8154,2011,6,MORTGAGE,3,Low,1,6000, 36 months,1,home_improvement,7,Low,1,Good Loan,0,10.59,B,2,18.83,7027.882433,6000,0,195.27,409000008153,19-Jun-18,Indiaforensic NFS SETT 16-06-201,"5,000.00",,-543117712.06,Rose,606,Spain,45482.04,0,1,0
8155,2011,6.05,OWN,2,Low,1,1250, 36 months,1,major_purchase,8,Low,1,Good Loan,0,5.42,A,1,19.29,1325.58,1250,0,37.7,409000008154,19-Jun-18,Indiaforensic NFS SETT 16-06-201,200,,-543117912.06,Ch'ien,367,Spain,168816.73,0,1,0
8156,2011,3,MORTGAGE,3,Low,1,25000, 36 months,1,debt_consolidation,6,Low,1,Bad Loan,1,7.49,A,1,17.05,12432.64,10416.64,0,777.55,409000008155,19-Jun-18,Indiaforensic NFS SETT 16-06-201,200,,-543118112.06,Artyomova,799,Spain,59297.34,0,1,0
8157,2011,6,MORTGAGE,3,Low,1,8000, 36 months,1,debt_consolidation,6,High,2,Good Loan,0,15.23,C,3,2.67,8983.88,8000,0,278.23,409000008156,19-Jun-18,Indiaforensic NFS SETT 16-06-201,200,,-543118312.06,Mayrhofer,434,Germany,125848.88,0,1,0
8158,2011,5,MORTGAGE,3,Low,1,35000, 36 months,1,debt_consolidation,6,Low,1,Good Loan,0,7.49,A,1,12.64,36592.76,35000,0,1088.56,409000008157,19-Jun-18,Indiaforensic NFS SETT 17-06-201,700,,-543119012.06,Yefremov,719,Spain,76264.27,0,1,0
8159,2011,1,MORTGAGE,3,Low,1,1500, 36 months,1,medical,9,Low,1,Bad Loan,1,5.42,A,1,5.26,225.1,193.13,0,45.24,409000008158,19-Jun-18,Indiaforensic NFS SETT 17-06-201,200,,-543119212.06,Kosovich,641,France,3939.87,0,1,0
8160,2011,0.5,RENT,1,Low,1,5400, 60 months,2,debt_consolidation,6,High,2,Bad Loan,1,14.79,C,3,11.03,5105.63,3140.6,0,127.88,409000008159,19-Jun-18,Indiaforensic NFS SETT 17-06-201,"1,000.00",,-543120212.06,Lu,461,Spain,15306.29,0,1,0
8161,2011,2,RENT,1,Low,1,4000, 60 months,2,debt_consolidation,6,High,2,Bad Loan,1,19.29,E,5,4.68,538.19,121.99,225.68,104.41,409000008160,19-Jun-18,Indiaforensic NFS SETT 17-06-201,600,,-543120812.06,Taplin,790,Germany,58214.79,0,1,0
8162,2011,1,MORTGAGE,3,Low,1,15000, 60 months,2,debt_consolidation,6,High,2,Good Loan,0,15.99,D,4,10.74,15546.46,9974.96,0,305.74,409000008161,19-Jun-18,Indiaforensic NFS SETT 17-06-201,200,,-543121012.06,Ebelechukwu,588,France,35877.03,0,1,0
8163,2011,6,RENT,1,Low,1,19000, 60 months,2,debt_consolidation,6,High,2,Good Loan,0,17.49,D,4,18.44,14450.24,13000,0,326.52,409000008162,19-Jun-18,Indiaforensic  RUPAY SETT 190618,214.71,,-543121226.77,Fleming,621,France,21254.06,0,1,0
8164,2011,4,MORTGAGE,3,Low,1,20000, 60 months,2,home_improvement,7,Low,1,Good Loan,0,10.59,B,2,2.87,23677.06,20000,0,430.78,409000008163,19-Jun-18,Indiaforensic NFS SETT 18-06-201,300,,-543121526.77,Yefimov,768,Germany,24533.89,0,1,0
8165,2011,4,RENT,1,Medium,2,8000, 36 months,1,debt_consolidation,6,Low,1,Good Loan,0,5.99,A,1,7.96,8225.39,8000,0,243.34,409000008164,19-Jun-18,Indiaforensic NFS SETT 18-06-201,"10,000.00",,-543131526.77,Andreyeva,681,Spain,23531.50,0,1,0
8166,2011,1,MORTGAGE,3,Low,1,3500, 36 months,1,other,4,High,2,Bad Loan,1,16.89,D,4,20.6,2054.17,387.44,1431.17,124.6,409000008165,19-Jun-18,Indiaforensic NFS SETT 18-06-201,500,,-543132026.77,Pickering,606,Spain,89099.18,0,1,0
8167,2011,6,RENT,1,Low,1,16000, 60 months,2,credit_card,1,High,2,Good Loan,0,13.99,C,3,19.5,16850.97,11470.74,0,324.52,409000008166,19-Jun-18,Indiaforensic NFS SETT 18-06-201,"2,000.00",,-543134026.77,Allan,542,Spain,807.06,0,1,0
8168,2011,6.05,MORTGAGE,3,Low,1,8000, 36 months,1,credit_card,1,Low,1,Good Loan,0,5.99,A,1,6.9,8618.73,8000,0,243.34,409000008167,19-Jun-18,Indiaforensic NFS SETT 18-06-201,"2,000.00",,-543136026.77,Wang,713,Germany,121592.50,0,1,0
8169,2011,3,RENT,1,Low,1,20000, 60 months,2,other,4,High,2,Bad Loan,1,16.49,D,4,19.09,3426.99,1592.35,9.6,380.98,409000008168,19-Jun-18,Indiaforensic NFS SETT 18-06-201,"2,000.00",,-543138026.77,Reynolds,597,Spain,4700.66,0,1,0
8170,2011,10,MORTGAGE,3,Low,1,2200, 36 months,1,credit_card,1,Low,1,Bad Loan,1,7.49,A,1,10.98,1119.38,866.43,75.98,68.43,409000008169,19-Jun-18,Indiaforensic NFS SETT 18-06-201,"2,000.00",,-543140026.77,Hales,635,France,161909.95,0,1,0
8171,2011,1,RENT,1,Low,1,15000, 36 months,1,wedding,5,Low,1,Good Loan,0,7.49,A,1,11.93,16793.27358,15000,0,466.53,409000008170,20-Jun-18,TRF FROM  Indiaforensic SERVICES,,374000.00,-542766026.77,Y?an,599,Germany,90389.61,0,1,0
8172,2011,5,MORTGAGE,3,Medium,2,11500, 60 months,2,wedding,5,Low,1,Good Loan,0,10.99,B,2,19.56,11740.33,10124.99,0,220.1,409000008171,20-Jun-18,Indiaforensic NFS SETT 19-06-201,100,,-542766126.77,Rowley,496,Spain,2919.21,0,1,0
8173,2011,0.5,RENT,1,Low,1,2425, 36 months,1,car,2,Low,1,Good Loan,0,8.49,A,1,24.87,2750.21,2425,0,76.55,409000008172,20-Jun-18,Indiaforensic  RUPAY SETT 200618,"1,178.00",,-542767304.77,Chia,759,Spain,99086.74,0,1,0
8174,2011,5,RENT,1,Low,1,4000, 36 months,1,credit_card,1,High,2,Good Loan,0,13.49,C,3,15.94,4881.749428,4000,0,135.73,409000008173,21-Jun-18,Indiaforensic NFS SETT 20-06-201,"5,000.00",,-542772304.77,Moore,757,Germany,163170.32,0,1,0
8175,2011,10,OWN,2,Low,1,4500, 36 months,1,other,4,Low,1,Good Loan,0,7.49,A,1,6.71,5017.250749,4500,0,139.96,409000008174,21-Jun-18,Indiaforensic NFS SETT 20-06-201,400,,-542772704.77,Copeland,564,Spain,72757.33,0,1,0
8176,2011,5,RENT,1,Low,1,3200, 36 months,1,debt_consolidation,6,High,2,Bad Loan,1,16.49,D,4,13.96,1596.41,657.36,579.68,113.28,409000008175,21-Jun-18,Indiaforensic NFS SETT 20-06-201,300,,-542773004.77,Rishel,561,France,73286.80,0,1,0
8177,2011,1,RENT,1,Low,1,20000, 60 months,2,debt_consolidation,6,Low,1,Good Loan,0,10.59,B,2,29.12,16102.68,13475,0,290.24,409000008176,21-Jun-18,Indiaforensic NFS SETT 20-06-201,"5,000.00",,-542778004.77,Wan,702,France,146056.29,0,1,0
8178,2011,10,RENT,1,Low,1,4000, 36 months,1,renewable_energy,13,Low,1,Good Loan,0,7.49,A,1,19.89,4477.075561,4000,0,124.41,409000008177,21-Jun-18,Indiaforensic NFS SETT 20-06-201,500,,-542778504.77,Eluemuno,678,Germany,167673.37,0,1,0
8179,2011,5,MORTGAGE,3,Low,1,3000, 36 months,1,home_improvement,7,High,2,Good Loan,0,18.39,E,5,21.68,3921.84733,3000,0,109.05,409000008178,21-Jun-18,Indiaforensic NFS SETT 20-06-201,"4,000.00",,-542782504.77,Hsia,707,France,146011.55,0,1,0
8180,2011,10,MORTGAGE,3,Low,1,17000, 36 months,1,debt_consolidation,6,Low,1,Bad Loan,1,11.99,B,2,11.56,12859.84,9621.24,450.76,564.57,409000008179,21-Jun-18,Indiaforensic  RUPAY SETT 210618,"1,354.25",,-542783859.02,Kelly,610,France,103381.47,0,1,0
8181,2011,10,MORTGAGE,3,Low,1,21000, 36 months,1,credit_card,1,High,2,Good Loan,0,15.62,D,4,14.13,25365.2,21000,0,734.37,409000008180,22-Jun-18,Indiaforensic NFS SETT 21-06-201,"1,000.00",,-542784859.02,Muir,744,France,83022.92,0,1,0
8182,2011,10,RENT,1,Low,1,8600, 36 months,1,major_purchase,8,High,2,Good Loan,0,15.99,D,4,2.88,10626.16,8600.01,0,302.31,409000008181,22-Jun-18,Indiaforensic NFS SETT 21-06-201,"6,000.00",,-542790859.02,McIntyre,598,France,46041.08,0,1,0
8183,2011,10,MORTGAGE,3,Low,1,13000, 60 months,2,medical,9,Low,1,Good Loan,0,7.49,A,1,3.43,13535.34,10968.72,0,260.44,409000008182,22-Jun-18,Indiaforensic NFS SETT 21-06-201,500,,-542791359.02,Donaldson,562,Spain,182843.24,0,1,0
8184,2011,3,RENT,1,Low,1,18000, 36 months,1,wedding,5,Low,1,Good Loan,0,7.49,A,1,5.29,18112.68,18000,0,559.83,409000008183,22-Jun-18,Indiaforensic NFS SETT 21-06-201,500,,-542791859.02,Wright,621,Spain,171364.18,0,1,0
8185,2011,1,RENT,1,Low,1,14300, 60 months,2,other,4,High,2,Bad Loan,1,20.62,F,6,19.2,3446.34,1016.83,762.61,383.82,409000008184,22-Jun-18,Indiaforensic NFS SETT 21-06-201,"8,000.00",,-542799859.02,Uvarova,659,France,183399.12,0,1,0
8186,2011,7,RENT,1,Medium,2,5000, 36 months,1,medical,9,Low,1,Good Loan,0,11.49,B,2,5.58,5775.54,5000,0,164.86,409000008185,22-Jun-18,Indiaforensic  RUPAY SETT 220618,"3,611.79",,-542803470.81,Doherty,722,Germany,152883.95,0,1,0
8187,2011,0.5,RENT,1,Low,1,6000, 36 months,1,other,4,Low,1,Good Loan,0,9.99,B,2,3.76,6983.125446,6000,0,193.58,409000008186,25-Jun-18,Indiaforensic RUPAY SETT 230618,"6,984.07",,-542810454.88,Allen,606,France,50560.45,0,1,0
8188,2011,0.5,RENT,1,Low,1,6000, 36 months,1,debt_consolidation,6,Low,1,Good Loan,0,10.59,B,2,13.1,7027.832108,6000,0,195.27,409000008187,25-Jun-18,Indiaforensic RUPAY SETT 240618,"3,985.29",,-542814440.17,Ma,603,Spain,54702.66,0,1,0
8189,2011,8,MORTGAGE,3,Medium,2,5225, 36 months,1,major_purchase,8,Low,1,Bad Loan,1,7.49,A,1,13.52,2457.31,1886.87,190.99,162.51,409000008188,25-Jun-18,Indiaforensic RUPAY SETT 250618,"23,742.97",,-542838183.14,Tucker,506,Germany,78365.75,0,1,0
8190,2011,5,RENT,1,Low,1,7800, 36 months,1,debt_consolidation,6,Low,1,Good Loan,0,10.99,B,2,3.6,9081.64,7800,0,255.33,409000008189,25-Jun-18,Indiaforensic NFS SETT 22-06-201,400,,-542838583.14,Ch'eng,715,France,68666.63,0,1,0
8191,2011,0.5,RENT,1,Low,1,3500, 36 months,1,major_purchase,8,Low,1,Good Loan,0,10.99,B,2,11.98,3652.13,3500,0,114.57,409000008190,25-Jun-18,Indiaforensic NFS SETT 22-06-201,200,,-542838783.14,Hs?,690,France,151375.73,0,1,0
8192,2011,4,RENT,1,Low,1,6000, 36 months,1,vacation,11,Low,1,Bad Loan,1,10.99,B,2,12.64,195.87,141.07,0,196.41,409000008191,25-Jun-18,Indiaforensic NFS SETT 22-06-201,"5,000.00",,-542843783.14,H?,644,France,19959.67,0,1,0
8193,2011,2,RENT,1,Low,1,9600, 36 months,1,credit_card,1,Low,1,Good Loan,0,8.49,A,1,4.83,10904.48165,9600,0,303.01,409000008192,25-Jun-18,Indiaforensic NFS SETT 22-06-201,"9,000.00",,-542852783.14,Chimaijem,589,France,26955.72,0,1,0
8194,2011,3,MORTGAGE,3,Low,1,15000, 36 months,1,wedding,5,Low,1,Good Loan,0,5.42,A,1,4.58,16285.08119,15000,0,452.4,409000008193,25-Jun-18,Indiaforensic NFS SETT 22-06-201,"5,000.00",,-542857783.14,Esomchi,592,France,76267.59,0,1,0
8195,2011,6,MORTGAGE,3,Low,1,12000, 60 months,2,home_improvement,7,Low,1,Good Loan,0,8.49,A,1,6.75,14459.39312,12000,0,246.15,409000008194,25-Jun-18,Indiaforensic NFS SETT 23-06-201,300,,-542858083.14,Lorenzo,632,France,100998.50,0,1,0
8196,2011,10,OWN,2,Low,1,8000, 60 months,2,major_purchase,8,High,2,Good Loan,0,16.89,D,4,0.84,8459.92,8000,0,198.35,409000008195,25-Jun-18,Indiaforensic NFS SETT 23-06-201,200,,-542858283.14,Pirogov,577,Germany,191070.01,0,1,0
8197,2011,5,MORTGAGE,3,Low,1,18000, 36 months,1,debt_consolidation,6,Low,1,Good Loan,0,6.99,A,1,5.88,20003.65408,18000,0,555.71,409000008196,25-Jun-18,Indiaforensic NFS SETT 23-06-201,100,,-542858383.14,Larkin,588,France,176858.50,0,1,0
8198,2011,10,RENT,1,Low,1,24000, 60 months,2,debt_consolidation,6,High,2,Good Loan,0,17.99,E,5,18.8,26096.29,24000,0,609.32,409000008197,25-Jun-18,Indiaforensic NFS SETT 24-06-201,"1,500.00",,-542859883.14,Eddy,617,France,45325.26,0,1,0
8199,2011,6,RENT,1,Low,1,14800, 36 months,1,moving,10,Low,1,Good Loan,0,7.49,A,1,12.71,15319.36,14800,0,460.31,409000008198,25-Jun-18,Indiaforensic NFS SETT 24-06-201,500,,-542860383.14,Sells,668,Spain,190958.48,0,1,0
8200,2011,6.05,MORTGAGE,3,Low,1,2500, 36 months,1,other,4,High,2,Good Loan,0,16.49,D,4,15.15,3136.540081,2500,0,88.5,409000008199,25-Jun-18,Indiaforensic NFS SETT 24-06-201,600,,-542860983.14,Crawford,810,France,78896.59,0,1,0
8201,2011,2,RENT,1,Low,1,8000, 36 months,1,debt_consolidation,6,Low,1,Good Loan,0,12.99,C,3,19.83,9023.19,8000,0,269.52,409000008200,25-Jun-18,Indiaforensic NFS SETT 24-06-201,200,,-542861183.14,Bezrukov,767,Spain,121964.46,0,1,0
8202,2011,6,RENT,1,Low,1,30000, 60 months,2,debt_consolidation,6,High,2,Good Loan,0,13.49,C,3,20.03,24618.04088,19150,0,440.54,409000008201,25-Jun-18,Indiaforensic NFS SETT 24-06-201,100,,-542861283.14,Mancini,718,Spain,11144.40,0,1,0
8203,2011,5,MORTGAGE,3,Low,1,4800, 36 months,1,home_improvement,7,Low,1,Good Loan,0,5.99,A,1,25.02,5255.927224,4800,0,146.01,409000008202,25-Jun-18,Indiaforensic NFS SETT 24-06-201,500,,-542861783.14,Iadanza,589,Spain,144181.48,0,1,0
8204,2011,3,MORTGAGE,3,Medium,2,28000, 60 months,2,home_improvement,7,Low,1,Good Loan,0,11.99,B,2,5.95,21291.47,17800,0,395.87,409000008203,26-Jun-18,Indiaforensic  RUPAY SETT 260618,"1,556.98",,-542863340.12,Wilkinson,778,Spain,32757.55,0,1,0
8205,2011,6.05,MORTGAGE,3,Low,1,5500, 36 months,1,debt_consolidation,6,Low,1,Good Loan,0,7.49,A,1,18.63,6174.251892,5500,0,171.06,409000008204,26-Jun-18,Indiaforensic  RUPAY SETT 260618,0.02,,-542863340.14,P'eng,724,France,80320.30,0,1,0
8206,2011,3,OWN,2,Low,1,32400, 60 months,2,debt_consolidation,6,High,2,Bad Loan,1,22.85,G,7,14.11,10287.44,2903.16,1352.59,744.77,409000008205,26-Jun-18,Indiaforensic NFS SETT 25-06-201,"1,800.00",,-542865140.14,St Clair,477,Germany,185830.72,0,1,0
8207,2011,3,RENT,1,Low,1,10000, 36 months,1,debt_consolidation,6,Low,1,Good Loan,0,9.99,B,2,10.28,11583.56659,10000,0,322.63,409000008206,26-Jun-18,Indiaforensic NFS SETT 25-06-201,"5,000.00",,-542870140.14,Preston,580,France,160095.31,0,1,0
8208,2011,10,MORTGAGE,3,Medium,2,14000, 60 months,2,debt_consolidation,6,Low,1,Good Loan,0,12.99,C,3,16.75,17072.85,14000.01,0,318.48,409000008207,26-Jun-18,Indiaforensic NFS SETT 25-06-201,"1,200.00",,-542871340.14,Findlay,566,Spain,52198.84,0,1,0
8209,2011,1,RENT,1,Low,1,4800, 60 months,2,other,4,Low,1,Good Loan,0,11.99,B,2,10.92,5529.54,3969.59,0,106.75,409000008208,26-Jun-18,Indiaforensic NFS SETT 25-06-201,"1,600.00",,-542872940.14,Nixon,711,France,31811.44,0,1,0
8210,2011,7,OWN,2,Low,1,6000, 36 months,1,debt_consolidation,6,Low,1,Good Loan,0,5.42,A,1,20.85,6441.57,6000,0,180.96,409000008209,26-Jun-18,Indiaforensic NFS SETT 25-06-201,"3,800.00",,-542876740.14,Gorshkov,706,Germany,104181.78,0,1,0
8211,2011,10,MORTGAGE,3,Low,1,3500, 36 months,1,debt_consolidation,6,Low,1,Good Loan,0,7.49,A,1,22.69,3754.18,3500,0,108.86,409000008210,26-Jun-18,Indiaforensic NFS SETT 25-06-201,400,,-542877140.14,Chukwubuikem,703,Spain,67667.19,0,1,0
8212,2011,4,MORTGAGE,3,Low,1,8000, 36 months,1,debt_consolidation,6,Low,1,Good Loan,0,5.99,A,1,12.84,8760.031444,8000,0,243.34,409000008211,26-Jun-18,Indiaforensic NFS SETT 25-06-201,500,,-542877640.14,Medvedeva,679,Germany,193974.47,0,1,0
8213,2011,10,OWN,2,Low,1,20000, 60 months,2,debt_consolidation,6,Low,1,Good Loan,0,11.49,B,2,18.73,22748.21,16554.93,0,439.76,409000008212,26-Jun-18,Indiaforensic NFS SETT 25-06-201,"1,500.00",,-542879140.14,Chukwuhaenye,603,France,198055.94,0,1,0
8214,2011,6.05,RENT,1,Low,1,15000, 60 months,2,debt_consolidation,6,High,2,Bad Loan,1,17.49,D,4,11.22,9040.94,4482.57,0,376.76,409000008213,26-Jun-18,Indiaforensic NFS SETT 25-06-201,100,,-542879240.14,Endrizzi,598,Spain,43249.67,0,1,0
8215,2011,0.5,MORTGAGE,3,Medium,2,13500, 36 months,1,debt_consolidation,6,Low,1,Good Loan,0,8.49,A,1,18.68,14616.76,13500,0,426.1,409000008214,26-Jun-18,Indiaforensic NFS SETT 25-06-201,"1,500.00",,-542880740.14,Ch'ang,836,Germany,55218.02,0,1,0
8216,2011,1,RENT,1,Low,1,19600, 60 months,2,credit_card,1,High,2,Good Loan,0,16.49,D,4,16.5,20353.49525,15150,0,372.38,409000008215,26-Jun-18,Indiaforensic NFS SETT 25-06-201,800,,-542881540.14,Piccio,687,France,131305.37,0,1,0
8217,2011,6.05,RENT,1,Low,1,4650, 36 months,1,credit_card,1,Low,1,Good Loan,0,9.99,B,2,9.27,5398.155435,4650,0,150.03,409000008216,26-Jun-18,Indiaforensic NFS SETT 25-06-201,200,,-542881740.14,Lockington,704,Germany,43117.10,0,1,0
8218,2011,3,MORTGAGE,3,Low,1,3000, 36 months,1,other,4,Low,1,Good Loan,0,11.99,B,2,21.36,3169.94,3000,0,99.63,409000008217,26-Jun-18,Indiaforensic NFS SETT 25-06-201,800,,-542882540.14,Seleznyov,605,Germany,186655.11,0,1,0
8219,2011,6,MORTGAGE,3,Low,1,6000, 36 months,1,car,2,Low,1,Good Loan,0,7.49,A,1,8.78,6525.23,6000,0,186.61,409000008218,26-Jun-18,Indiaforensic NFS SETT 25-06-201,200,,-542882740.14,Weston,516,France,33266.29,0,1,0
8220,2011,3,MORTGAGE,3,Low,1,28000, 36 months,1,small_business,3,Low,1,Good Loan,0,7.49,A,1,9.35,31348.9862,28000,0,870.85,409000008219,26-Jun-18,Indiaforensic NFS SETT 25-06-201,200,,-542882940.14,Groom,572,France,555.28,0,1,0
8221,2011,6,RENT,1,Low,1,14675, 60 months,2,debt_consolidation,6,Low,1,Good Loan,0,12.99,C,3,29.18,19079.68667,14675,0,333.83,409000008220,26-Jun-18,Indiaforensic NFS SETT 25-06-201,400,,-542883340.14,Manfrin,557,France,150944.31,0,1,0
8222,2011,10,RENT,1,Low,1,4200, 60 months,2,other,4,High,2,Bad Loan,1,17.49,D,4,18.66,5885.4,3918.05,0,105.5,409000008221,26-Jun-18,Indiaforensic NFS SETT 25-06-201,400,,-542883740.14,Robertson,443,Germany,72846.58,0,1,0
8223,2011,2,RENT,1,Low,1,15000, 60 months,2,debt_consolidation,6,High,2,Good Loan,0,16.49,D,4,22.17,19126.35,12201.96,0,368.69,409000008222,26-Jun-18,Indiaforensic NFS SETT 25-06-201,400,,-542884140.14,Ch'ang,604,Germany,35279.74,0,1,0
8224,2011,5,RENT,1,Low,1,12000, 60 months,2,debt_consolidation,6,Low,1,Good Loan,0,8.49,A,1,20.31,12873.11,12000.01,0,246.15,409000008223,26-Jun-18,Indiaforensic NFS SETT 25-06-201,400,,-542884540.14,Lucchesi,483,France,2101.89,0,1,0
8225,2011,2,RENT,1,Low,1,6400, 36 months,1,debt_consolidation,6,Low,1,Good Loan,0,8.49,A,1,20.71,6898.74,6400,0,202.01,409000008224,26-Jun-18,Indiaforensic NFS SETT 25-06-201,500,,-542885040.14,Cambage,702,France,94949.84,0,1,0
8226,2011,1,MORTGAGE,3,Low,1,16000, 60 months,2,credit_card,1,Low,1,Good Loan,0,12.99,C,3,21.96,21384.12977,16000,0,363.97,409000008225,26-Jun-18,Indiaforensic NFS SETT 25-06-201,"1,500.00",,-542886540.14,Tan,670,Spain,99061.75,0,1,0
8227,2011,10,MORTGAGE,3,Medium,2,35000, 60 months,2,credit_card,1,High,2,Good Loan,0,16.49,D,4,18.77,35558.98,22682.83,0,685.15,409000008226,26-Jun-18,Indiaforensic NFS SETT 25-06-201,"5,000.00",,-542891540.14,Tao,804,Spain,74692.06,0,1,0
8228,2011,10,OWN,2,Medium,2,4800, 36 months,1,car,2,Low,1,Good Loan,0,10.99,B,2,13.24,5371.56,4800,0,157.13,409000008227,26-Jun-18,Indiaforensic NFS SETT 25-06-201,100,,-542891640.14,Hsieh,850,France,116692.80,0,1,0
8229,2011,4,RENT,1,Low,1,6475, 36 months,1,debt_consolidation,6,Low,1,Bad Loan,1,6.99,A,1,9.89,2652.48,2007.36,256.56,199.9,409000008228,27-Jun-18,Indiaforensic  RUPAY SETT 270618,167.12,,-542891807.26,Burdekin,554,France,32824.15,0,1,0
8230,2011,10,MORTGAGE,3,Low,1,20000, 60 months,2,credit_card,1,Low,1,Good Loan,0,11.99,B,2,18.9,23670.44869,17975,0,399.76,409000008229,27-Jun-18,Indiaforensic  RUPAY SETT 250618,0.04,,-542891807.30,Longo,588,Germany,139607.61,0,1,0
8231,2011,3,MORTGAGE,3,Low,1,24000, 60 months,2,home_improvement,7,High,2,Good Loan,0,14.79,C,3,4.82,28760.04,24000,0,568.32,409000008230,27-Jun-18,Indiaforensic NFS SETT 26-06-201,300,,-542892107.30,Maughan,758,Germany,115525.13,0,1,0
8232,2011,10,RENT,1,Medium,2,8000, 36 months,1,debt_consolidation,6,High,2,Good Loan,0,15.99,D,4,16.69,10118.01731,8000,0,281.22,409000008231,27-Jun-18,Indiaforensic NFS SETT 26-06-201,600,,-542892707.30,Franz,787,Germany,20955.03,0,1,0
8233,2011,4,MORTGAGE,3,Medium,2,5000, 60 months,2,other,4,Low,1,Good Loan,0,8.49,A,1,17.74,5320.36,4195.9,0,102.56,409000008232,27-Jun-18,Indiaforensic NFS SETT 26-06-201,100,,-542892807.30,Piazza,582,Spain,52341.15,0,1,0
8234,2011,2,MORTGAGE,3,Medium,2,9600, 36 months,1,wedding,5,Low,1,Good Loan,0,11.49,B,2,17.18,11259.91,9600,0,316.53,409000008233,27-Jun-18,Indiaforensic NFS SETT 26-06-201,400,,-542893207.30,Morant,633,Spain,159813.18,0,1,0
8235,2011,10,MORTGAGE,3,Low,1,9000, 36 months,1,debt_consolidation,6,Low,1,Good Loan,0,9.99,B,2,2.59,9971.35,9000,0,290.37,409000008234,27-Jun-18,Indiaforensic NFS SETT 26-06-201,200,,-542893407.30,Becher,766,Germany,169935.46,0,1,0
8236,2011,5,MORTGAGE,3,Low,1,8000, 36 months,1,debt_consolidation,6,Low,1,Good Loan,0,5.42,A,1,21.08,8609.98,8000,0,241.28,409000008235,27-Jun-18,Indiaforensic NFS SETT 26-06-201,300,,-542893707.30,Lombardi,564,Spain,146033.52,0,1,0
8237,2011,2,RENT,1,Low,1,9000, 36 months,1,debt_consolidation,6,Low,1,Good Loan,0,10.59,B,2,14.05,10541.44067,9000,0,292.91,409000008236,27-Jun-18,Indiaforensic NFS SETT 26-06-201,"1,000.00",,-542894707.30,Loton,602,Spain,153122.73,0,1,0
8238,2011,10,MORTGAGE,3,Low,1,20000, 36 months,1,credit_card,1,Low,1,Good Loan,0,6.99,A,1,8.8,22192.18882,20000,0,617.46,409000008237,27-Jun-18,Indiaforensic NFS SETT 26-06-201,"10,000.00",,-542904707.30,Conti,649,France,60335.24,0,1,0
8239,2011,1,RENT,1,Low,1,14000, 36 months,1,debt_consolidation,6,Low,1,Good Loan,0,11.49,B,2,12.45,14638.3,14000,0,461.6,409000008238,27-Jun-18,Indiaforensic NFS SETT 26-06-201,"2,000.00",,-542906707.30,Sani,679,Spain,163757.29,0,1,0
8240,2011,2,MORTGAGE,3,Low,1,1000, 36 months,1,home_improvement,7,High,2,Good Loan,0,15.23,C,3,16.55,1250.680829,1000,0,34.78,409000008239,27-Jun-18,Indiaforensic NFS SETT 26-06-201,100,,-542906807.30,Lori,639,Spain,156648.81,0,1,0
8241,2011,1,OWN,2,Low,1,6000, 36 months,1,moving,10,Low,1,Bad Loan,1,11.49,B,2,22.35,6768.14,5743.1,40.91,197.83,409000008240,28-Jun-18,Indiaforensic  RUPAY SETT 280618,"1,118.79",,-542907926.09,Wong,790,Germany,176471.78,0,1,0
8242,2011,2,MORTGAGE,3,Low,1,3700, 36 months,1,other,4,Low,1,Good Loan,0,5.99,A,1,15.14,3788.09,3700,0,112.55,409000008241,29-Jun-18,Indiaforensic  RUPAY SETT 290618,"9,849.04",,-542917775.13,Lombardi,565,France,5388.30,0,1,0
8243,2011,2,MORTGAGE,3,Low,1,35000, 60 months,2,small_business,3,Low,1,Good Loan,0,10.99,B,2,0.87,26624.85,23675.01,0,514.64,409000008242,29-Jun-18,Indiaforensic  RUPAY SETT 290618,382.12,,-542918157.25,Obialo,478,France,93332.64,0,1,0
8244,2011,1,MORTGAGE,3,Low,1,6500, 36 months,1,home_improvement,7,Low,1,Good Loan,0,10.99,B,2,12,7532.94,6500,0,212.78,409000008243,29-Jun-18,Indiaforensic NFS SETT 27-06-201,"1,000.00",,-542919157.25,Mazzi,825,France,71192.82,0,1,0
8245,2011,1,RENT,1,Low,1,4000, 36 months,1,major_purchase,8,Low,1,Good Loan,0,5.42,A,1,6.81,4101.69,4000,0,120.64,409000008244,29-Jun-18,Indiaforensic NFS SETT 27-06-201,500,,-542919657.25,Von Doussa,528,Spain,170309.19,0,1,0
8246,2011,10,MORTGAGE,3,Medium,2,15000, 60 months,2,other,4,High,2,Good Loan,0,13.49,C,3,20.4,17911.93,12355.96,0,345.08,409000008245,29-Jun-18,Indiaforensic NFS SETT 27-06-201,500,,-542920157.25,Miller,577,Spain,109794.31,0,1,0
8247,2011,5,RENT,1,Low,1,1325, 36 months,1,debt_consolidation,6,High,2,Good Loan,0,14.79,C,3,16.15,1640.51604,1325,0,45.8,409000008246,30-Jun-18,Indiaforensic  RUPAY SETT 300618,406.42,,-542920563.67,Miracle,663,France,166310.82,0,1,0
8248,2011,6.05,MORTGAGE,3,Medium,2,15000, 36 months,1,house,12,Low,1,Good Loan,0,11.49,B,2,22.41,17391.49,15000,0,494.57,409000008247,30-Jun-18,Indiaforensic NFS SETT 29-06-201,300,,-542920863.67,Su,505,Germany,126728.27,0,1,0
8249,2011,10,MORTGAGE,3,Low,1,3200, 36 months,1,car,2,Low,1,Good Loan,0,5.42,A,1,6.51,3467.108076,3200,0,96.52,409000008248,30-Jun-18,Indiaforensic NFS SETT 29-06-201,300,,-542921163.67,Wyatt,633,Germany,30338.94,0,1,0
8250,2011,10,MORTGAGE,3,Medium,2,19000, 36 months,1,debt_consolidation,6,High,2,Good Loan,0,13.49,C,3,6.62,23191.03777,19000,0,644.68,409000008249,30-Jun-18,Indiaforensic NFS SETT 29-06-201,"10,000.00",,-542931163.67,Anayolisa,586,France,37935.83,0,1,0
8251,2011,2,MORTGAGE,3,Low,1,20000, 60 months,2,debt_consolidation,6,Low,1,Good Loan,0,9.99,B,2,14.21,25020.25963,20000,0,424.85,409000008250,30-Jun-18,Indiaforensic NFS SETT 29-06-201,"10,000.00",,-542941163.67,Wade,850,France,25329.48,0,1,0
8252,2011,10,MORTGAGE,3,Low,1,2200, 36 months,1,credit_card,1,Low,1,Good Loan,0,11.49,B,2,22.29,2558.57,2200,0,72.54,409000008251,30-Jun-18,Indiaforensic NFS SETT 28-06-201,"4,000.00",,-542945163.67,Enemuo,629,Germany,49676.33,0,1,0
8253,2011,2,MORTGAGE,3,Low,1,21750, 60 months,2,small_business,3,High,2,Good Loan,0,18.79,E,5,17,22083.54767,15800,0,408.04,409000008252,30-Jun-18,Indiaforensic NFS SETT 28-06-201,"1,500.00",,-542946663.67,Bruno,744,France,169498.61,0,1,0
8254,2011,0.5,MORTGAGE,3,Low,1,8000, 36 months,1,credit_card,1,Low,1,Good Loan,0,6.99,A,1,13.47,8301.79,8000,0,246.99,409000008253,30-Jun-18,Indiaforensic NFS SETT 28-06-201,600,,-542947263.67,Greece,750,France,26500.29,0,1,0
8255,2011,6.05,RENT,1,Low,1,15000, 36 months,1,credit_card,1,Low,1,Good Loan,0,8.49,A,1,22.16,17042.12279,15000,0,473.45,409000008254,2-Jul-18,Indiaforensic RUPAY SETT 300618_,151.42,,-542947415.09,Yang,637,Germany,166458.41,0,1,0
8256,2011,4,MORTGAGE,3,Medium,2,35000, 60 months,2,debt_consolidation,6,Low,1,Good Loan,0,12.99,C,3,18.84,30460.11728,23375,0,531.74,409000008255,2-Jul-18,Indiaforensic RUPAY SETT 010718,"4,849.66",,-542952264.75,Brown,575,France,181294.39,0,1,0
8257,2011,10,MORTGAGE,3,Medium,2,11000, 36 months,1,car,2,Low,1,Good Loan,0,5.42,A,1,6.47,11666.01,11000,0,331.76,409000008256,2-Jul-18,Indiaforensic RUPAY SETT 020718,"12,867.52",,-542965132.27,Anderson,671,Spain,21768.21,0,1,0
8258,2011,3,MORTGAGE,3,Medium,2,16800, 60 months,2,debt_consolidation,6,Low,1,Good Loan,0,11.99,B,2,17.22,21796.44957,16800,0,373.63,409000008257,2-Jul-18,Indiaforensic RUPAY SETT 020718_,110.71,,-542965242.98,Johnston,571,France,72849.29,0,1,0
8259,2011,3,RENT,1,Low,1,4000, 36 months,1,major_purchase,8,High,2,Good Loan,0,18.79,E,5,8.02,5142.16,4000,0,146.2,409000008258,3-Jul-18,Indiaforensic  RUPAY SETT 030718,181.58,,-542965424.56,Zakharov,590,France,24499.97,0,1,0
8260,2011,4,MORTGAGE,3,Low,1,5200, 36 months,1,debt_consolidation,6,High,2,Good Loan,0,15.23,C,3,17.66,5935.44,5200,0,180.85,409000008259,3-Jul-18,Indiaforensic  RUPAY SETT 030718,"7,646.61",,-542973071.17,Golibe,619,Spain,98994.92,0,1,0
8261,2011,2,RENT,1,Low,1,7000, 36 months,1,debt_consolidation,6,Low,1,Bad Loan,1,10.99,B,2,6.2,3249.78,2255.87,286.04,229.14,409000008260,4-Jul-18,TRF FROM  Indiaforensic SERVICES,,97000.00,-542876071.17,Nikitina,640,Germany,141446.01,0,1,0
8262,2011,3,RENT,1,Medium,2,13000, 36 months,1,debt_consolidation,6,High,2,Bad Loan,1,15.99,D,4,24.8,6894.04,4323.15,514.8,456.98,409000008261,4-Jul-18,Indiaforensic RUPAY SETT 040718,"1,895.35",,-542877966.52,Leonard,670,France,77864.41,0,1,0
8263,2011,10,OWN,2,Low,1,20000, 36 months,1,debt_consolidation,6,Low,1,Good Loan,0,11.99,B,2,6.54,23910.06829,20000,0,664.2,409000008262,4-Jul-18,Indiaforensic RUPAY SETT 040718_,1.71,,-542877968.23,Burns,737,France,115115.32,0,1,0
8264,2011,1,MORTGAGE,3,Low,1,10500, 60 months,2,medical,9,High,2,Good Loan,0,18.39,E,5,2.96,11133.96,10500,0,268.87,409000008263,4-Jul-18,OXYGEN NFS SETT 02-07-201,"10,000.00",,-542887968.23,Burtch,555,Spain,168605.96,0,1,0
8265,2011,1,RENT,1,Low,1,19425, 36 months,1,debt_consolidation,6,Low,1,Good Loan,0,11.99,B,2,23.47,23282.70606,19425,0,645.1,409000008264,4-Jul-18,OXYGEN NFS SETT 02-07-201,"1,000.00",,-542888968.23,Clark,742,France,38550.40,0,1,0
8266,2011,3,MORTGAGE,3,Medium,2,12000, 36 months,1,medical,9,Low,1,Bad Loan,1,6.99,A,1,4.71,2937.04,2140.44,344.59,370.48,409000008265,4-Jul-18,OXYGEN NFS SETT 02-07-201,"9,000.00",,-542897968.23,Woodward,618,Germany,160618.61,0,1,0
8267,2011,10,MORTGAGE,3,Low,1,7000, 36 months,1,major_purchase,8,Low,1,Good Loan,0,5.42,A,1,19.19,7599.40552,7000,0,211.12,409000008266,4-Jul-18,OXYGEN NFS SETT 02-07-201,"10,000.00",,-542907968.23,Spencer,560,France,3701.63,0,1,0
8268,2011,8,MORTGAGE,3,Low,1,4200, 36 months,1,home_improvement,7,Low,1,Good Loan,0,5.42,A,1,4.13,4547.407359,4200,0,126.68,409000008267,4-Jul-18,OXYGEN NFS SETT 02-07-201,500,,-542908468.23,Chao,654,France,88659.44,0,1,0
8269,2011,10,RENT,1,Low,1,17000, 60 months,2,debt_consolidation,6,Low,1,Good Loan,0,11.49,B,2,26.18,10928.8,10825,0,238.02,409000008268,4-Jul-18,OXYGEN NFS SETT 02-07-201,400,,-542908868.23,Costa,787,Germany,44273.91,0,1,0
8270,2011,5,RENT,1,Low,1,2400, 36 months,1,debt_consolidation,6,Low,1,Good Loan,0,5.99,A,1,6.63,2617.91,2400,0,73.01,409000008269,4-Jul-18,OXYGEN NFS SETT 02-07-201,"8,000.00",,-542916868.23,McLachlan,611,France,156495.39,0,1,0
8271,2011,6,RENT,1,Low,1,2500, 36 months,1,debt_consolidation,6,Low,1,Good Loan,0,10.59,B,2,22.55,2927.584163,2500,0,81.37,409000008270,4-Jul-18,OXYGEN NFS SETT 30-06-201,"10,000.00",,-542926868.23,Hung,559,Spain,182988.94,0,1,0
8272,2011,10,MORTGAGE,3,Low,1,5600, 36 months,1,credit_card,1,Low,1,Good Loan,0,5.42,A,1,18.69,6079.310194,5600,0,168.9,409000008271,4-Jul-18,OXYGEN NFS SETT 30-06-201,"10,000.00",,-542936868.23,Akhtar,481,France,175082.20,0,1,0
8273,2011,2,MORTGAGE,3,Medium,2,30000, 60 months,2,debt_consolidation,6,Low,1,Bad Loan,1,11.49,B,2,18.59,12846.61,5528.24,3924.29,424.92,409000008272,4-Jul-18,OXYGEN NFS SETT 30-06-201,500,,-542937368.23,Toscani,753,Germany,148811.14,0,1,0
8274,2011,6.05,MORTGAGE,3,Low,1,35000, 60 months,2,debt_consolidation,6,High,2,Good Loan,0,18.39,E,5,14.23,41605.95,35000,0,896.22,409000008273,4-Jul-18,OXYGEN NFS SETT 01-07-201,"10,000.00",,-542947368.23,Gray,675,France,85901.09,0,1,0
8275,2011,6,OWN,2,Medium,2,14400, 60 months,2,moving,10,High,2,Good Loan,0,19.29,E,5,4.88,19209.18,14400,0,375.85,409000008274,4-Jul-18,OXYGEN NFS SETT 01-07-201,"5,000.00",,-542952368.23,Warren,748,Germany,199255.32,0,1,0
8276,2011,7,RENT,1,Low,1,9500, 36 months,1,other,4,Low,1,Good Loan,0,7.49,A,1,15.81,10632.71263,9500,0,295.47,409000008275,4-Jul-18,OXYGEN NFS SETT 01-07-201,200,,-542952568.23,Ramsden,610,Spain,107973.44,0,1,0
8277,2011,9,RENT,1,Low,1,1200, 36 months,1,other,4,High,2,Good Loan,0,13.99,C,3,24.6,1440.491195,1200,0,41.01,409000008276,4-Jul-18,OXYGEN NFS SETT 01-07-201,400,,-542952968.23,Bartlett,580,Spain,128028.60,0,1,0
8278,2011,10,RENT,1,Low,1,10000, 36 months,1,other,4,Low,1,Good Loan,0,5.99,A,1,17.17,10950.12718,10000,0,304.18,409000008277,5-Jul-18,TRF FROM  Indiaforensic SERVICES,,50000.00,-542902968.23,Wenz,624,Germany,104610.86,0,1,0
8279,2011,10,MORTGAGE,3,Low,1,5650, 36 months,1,car,2,Low,1,Good Loan,0,5.42,A,1,17.32,6065.84,5650,0,170.41,409000008278,5-Jul-18,Indiaforensic RUPAY SETT 050718,"8,367.83",,-542911336.06,Kisch,709,France,69676.55,0,1,0
8280,2011,4,MORTGAGE,3,Medium,2,26400, 60 months,2,debt_consolidation,6,Low,1,Good Loan,0,10.59,B,2,15.24,19283.94,14368.65,0,371.54,409000008279,5-Jul-18,Indiaforensic RUPAY SETT 050718_,"1,295.71",,-542912631.77,Mai,605,France,35982.42,0,1,0
8281,2011,0.5,RENT,1,Low,1,8000, 36 months,1,debt_consolidation,6,Low,1,Good Loan,0,11.99,B,2,20.49,9561.355649,8000,0,265.68,409000008280,6-Jul-18,Indiaforensic NFS SETT 04-07-201,500,,-542913131.77,McGregor,706,Spain,117939.17,0,1,0
8282,2011,1,RENT,1,Low,1,13500, 36 months,1,wedding,5,Low,1,Good Loan,0,7.49,A,1,20.85,13799.23,13500,0,419.88,409000008281,6-Jul-18,Indiaforensic NFS SETT 04-07-201,100,,-542913231.77,Pinto,567,Spain,95140.62,0,1,0
8283,2011,10,MORTGAGE,3,Low,1,6200, 36 months,1,home_improvement,7,Low,1,Good Loan,0,5.99,A,1,5.52,6788.949197,6200,0,188.59,409000008282,6-Jul-18,TRF FROM  Indiaforensic SERVICES,,70000.00,-542843231.77,Newman,747,France,167682.57,0,1,0
8284,2011,6.05,MORTGAGE,3,Low,1,24000, 36 months,1,house,12,Low,1,Good Loan,0,5.99,A,1,1.8,26269.68342,24000,0,730.02,409000008283,6-Jul-18,Indiaforensic RUPAY SETT 060718,"4,320.72",,-542847552.49,Pagnotto,664,France,56562.57,0,1,0
8285,2011,8,RENT,1,Low,1,5000, 36 months,1,debt_consolidation,6,Low,1,Good Loan,0,6.99,A,1,12.8,5531.224251,5000,0,154.37,409000008284,6-Jul-18,Indiaforensic RUPAY SETT 060718_,"5,545.12",,-542853097.61,Williams,711,France,90305.97,0,1,0
8286,2011,6.05,OWN,2,Low,1,29600, 60 months,2,small_business,3,High,2,Good Loan,0,13.49,C,3,15.47,20681.68,19225,0,442.27,409000008285,6-Jul-18,Indiaforensic  RUPAY SETT 050718,,0.01,-542853097.60,Ndubuisi,609,France,109895.16,0,1,0
8287,2011,10,MORTGAGE,3,Low,1,16800, 36 months,1,debt_consolidation,6,Low,1,Good Loan,0,11.99,B,2,23.02,17132.7,16800,0,557.93,409000008286,7-Jul-18,Indiaforensic  RUPAY SETT 070718,"8,859.98",,-542861957.58,Plummer,632,Spain,1843.24,0,1,0
8288,2011,10,MORTGAGE,3,Low,1,5000, 36 months,1,debt_consolidation,6,Low,1,Good Loan,0,10.59,B,2,7.66,5749.02,5000,0,162.73,409000008287,7-Jul-18,Indiaforensic  RUPAY SETT 070718,"8,485.83",,-542870443.41,Chimezie,725,France,102747.02,0,1,0
8289,2011,10,MORTGAGE,3,Low,1,20000, 60 months,2,debt_consolidation,6,Low,1,Good Loan,0,11.99,B,2,10.1,25035.08538,20000,0,444.79,409000008288,9-Jul-18,TRF FROM  Indiaforensic SERVICES,,150000.00,-542720443.41,Nash,850,France,97465.89,0,1,0
8290,2011,6.05,OWN,2,Low,1,5000, 36 months,1,credit_card,1,Low,1,Good Loan,0,10.59,B,2,8.69,5045.09,5000,0,162.73,409000008289,9-Jul-18,Indiaforensic  RUPAY SETT 090718,"3,901.83",,-542724345.24,Onochie,682,France,105352.55,0,1,0
8291,2011,10,MORTGAGE,3,Medium,2,14400, 36 months,1,renewable_energy,13,Low,1,Good Loan,0,12.99,C,3,16.33,17459.63969,14400,0,485.13,409000008290,9-Jul-18,Indiaforensic  RUPAY SETT 080718,"2,451.66",,-542726796.90,Rizzo,797,France,85801.77,0,1,0
8292,2011,0.5,RENT,1,Low,1,16000, 60 months,2,credit_card,1,Low,1,Good Loan,0,12.99,C,3,16.63,14204.09,9930.59,0,274.12,409000008291,9-Jul-18,Indiaforensic  RUPAY SETT 090718,"22,575.62",,-542749372.52,Boni,668,Spain,69370.05,0,1,0
8293,2011,7,MORTGAGE,3,Low,1,4000, 36 months,1,debt_consolidation,6,Low,1,Good Loan,0,10.59,B,2,16.77,4684.047158,4000,0,130.18,409000008292,10-Jul-18,Indiaforensic  RUPAY SETT 100718,"4,843.32",,-542754215.84,Davies,783,Germany,176945.96,0,1,0
8294,2011,6,OWN,2,Low,1,12000, 60 months,2,debt_consolidation,6,Low,1,Good Loan,0,8.49,A,1,6.36,14598.73302,12000,0,246.15,409000008293,10-Jul-18,OXYGEN NFS SETT 06-07-201,"1,000.00",,-542755215.84,Lu,766,Germany,21597.20,0,1,0
8295,2011,7,RENT,1,Low,1,1500, 36 months,1,medical,9,High,2,Good Loan,0,13.99,C,3,13.14,1844.038391,1500,0,51.26,409000008294,10-Jul-18,OXYGEN NFS SETT 06-07-201,"10,000.00",,-542765215.84,Burrows,704,Spain,152039.67,0,1,0
8296,2011,2,RENT,1,Medium,2,12500, 36 months,1,debt_consolidation,6,Low,1,Good Loan,0,5.42,A,1,5.1,13570.55945,12500,0,377,409000008295,10-Jul-18,OXYGEN NFS SETT 07-07-201,"7,000.00",,-542772215.84,Ershova,722,France,111893.09,0,1,0
8297,2011,10,MORTGAGE,3,Low,1,2000, 36 months,1,medical,9,Low,1,Good Loan,0,12.99,C,3,15.5,2296.69,2000,0,67.38,409000008296,10-Jul-18,OXYGEN NFS SETT 07-07-201,500,,-542772715.84,Udokamma,692,France,195074.62,0,1,0
8298,2011,10,MORTGAGE,3,Low,1,20000, 60 months,2,debt_consolidation,6,High,2,Bad Loan,1,16.49,D,4,19.47,5784.7,2156.44,1024.63,491.59,409000008297,10-Jul-18,OXYGEN NFS SETT 07-07-201,"10,000.00",,-542782715.84,Aitken,584,France,15959.01,0,1,0
8299,2011,4,MORTGAGE,3,Low,1,6000, 60 months,2,other,4,Low,1,Good Loan,0,8.49,A,1,16.94,6042.98,6000,0,123.08,409000008298,10-Jul-18,OXYGEN NFS SETT 07-07-201,"10,000.00",,-542792715.84,Turnbull,644,Germany,72628.84,0,1,0
8300,2011,6,RENT,1,Low,1,12600, 60 months,2,debt_consolidation,6,Low,1,Bad Loan,1,11.99,B,2,16.18,6164.36,3751.61,12.27,280.22,409000008299,10-Jul-18,OXYGEN NFS SETT 07-07-201,"3,000.00",,-542795715.84,Reilly,598,Germany,64157.24,0,1,0
8301,2011,10,RENT,1,Low,1,25000, 60 months,2,debt_consolidation,6,Low,1,Good Loan,0,11.99,B,2,24.74,31301.7096,25000,0,555.99,409000008300,10-Jul-18,OXYGEN NFS SETT 07-07-201,"8,800.00",,-542804515.84,Hardy,733,Germany,23860.50,0,1,0
8302,2011,3,OWN,2,Low,1,4800, 60 months,2,small_business,3,High,2,Bad Loan,1,21.74,F,6,6.37,535.52,90.2,273.04,131.87,409000008301,10-Jul-18,OXYGEN NFS SETT 07-07-201,"3,100.00",,-542807615.84,Brookman,615,Germany,85687.09,0,1,0
8303,2011,6.05,MORTGAGE,3,Low,1,22350, 60 months,2,debt_consolidation,6,Low,1,Good Loan,0,10.59,B,2,15.36,18234.21,13597.93,0,351.62,409000008302,10-Jul-18,OXYGEN NFS SETT 07-07-201,"6,500.00",,-542814115.84,Kerr,850,France,179451.42,0,1,0
8304,2011,4,OWN,2,Low,1,10000, 36 months,1,credit_card,1,Low,1,Bad Loan,1,11.49,B,2,16.44,3094.39,1931.42,462.47,329.72,409000008303,10-Jul-18,OXYGEN NFS SETT 07-07-201,"8,000.00",,-542822115.84,McBurney,521,France,93180.09,0,1,0
8305,2011,3,RENT,1,Low,1,3000, 36 months,1,major_purchase,8,Low,1,Good Loan,0,12.99,C,3,10.81,3637.08151,3000,0,101.07,409000008304,10-Jul-18,OXYGEN NFS SETT 07-07-201,"8,000.00",,-542830115.84,Mickey,675,France,157097.09,0,1,0
8306,2011,5,RENT,1,Low,1,2500, 60 months,2,other,4,Low,1,Bad Loan,1,12.99,C,3,13.21,112.92,59.51,0,56.87,409000008305,10-Jul-18,OXYGEN NFS SETT 07-07-201,700,,-542830815.84,Harrison,746,France,80344.96,0,1,0
8307,2011,6,MORTGAGE,3,Medium,2,21000, 36 months,1,credit_card,1,Low,1,Good Loan,0,10.99,B,2,12.4,24571.74,21000,0,687.42,409000008306,10-Jul-18,OXYGEN NFS SETT 07-07-201,"1,400.00",,-542832215.84,Olszewski,770,France,26080.54,0,1,0
8308,2011,10,MORTGAGE,3,Medium,2,15000, 60 months,2,home_improvement,7,High,2,Good Loan,0,17.49,D,4,22.54,21886.34316,15000,0,376.76,409000008307,10-Jul-18,OXYGEN NFS SETT 07-07-201,"6,000.00",,-542838215.84,Chijioke,618,France,31406.93,0,1,0
8309,2011,10,RENT,1,Low,1,20000, 36 months,1,debt_consolidation,6,Low,1,Good Loan,0,10.99,B,2,13.62,23564.87567,20000,0,654.68,409000008308,10-Jul-18,OXYGEN NFS SETT 07-07-201,500,,-542838715.84,Young,556,France,32044.64,0,1,0
8310,2011,10,MORTGAGE,3,Low,1,16000, 36 months,1,credit_card,1,Low,1,Good Loan,0,11.99,B,2,12.86,19128.24559,16000,0,531.36,409000008309,10-Jul-18,OXYGEN NFS SETT 07-07-201,"9,200.00",,-542847915.84,Bellasis,749,France,132734.87,0,1,0
8311,2011,6.05,OWN,2,Low,1,3000, 36 months,1,home_improvement,7,Low,1,Good Loan,0,5.99,A,1,3.97,3174.82,3000,0,91.26,409000008310,10-Jul-18,OXYGEN NFS SETT 07-07-201,"7,500.00",,-542855415.84,De Mestre,702,Spain,61602.42,0,1,0
8312,2011,3,MORTGAGE,3,Medium,2,30000, 36 months,1,house,12,Low,1,Good Loan,0,11.49,B,2,5.22,35576.82399,30000,0,989.14,409000008311,10-Jul-18,OXYGEN NFS SETT 07-07-201,"9,000.00",,-542864415.84,De Luca,555,Germany,41304.44,0,1,0
8313,2011,5,RENT,1,Low,1,18000, 60 months,2,major_purchase,8,Low,1,Good Loan,0,10.59,B,2,6.19,15006.27,13474.99,0,290.24,409000008312,10-Jul-18,OXYGEN NFS SETT 07-07-201,"1,000.00",,-542865415.84,Mundy,587,France,57962.41,0,1,0
8314,2011,1,RENT,1,Low,1,14300, 60 months,2,house,12,High,2,Bad Loan,1,16.49,D,4,14.91,5974.44,3273.72,17.8,351.49,409000008313,10-Jul-18,OXYGEN NFS SETT 07-07-201,"5,000.00",,-542870415.84,Tung,639,France,42862.82,0,1,0
8315,2011,2,MORTGAGE,3,Medium,2,16000, 60 months,2,debt_consolidation,6,High,2,Good Loan,0,15.99,D,4,3.82,17631.21,16000,0,389.01,409000008314,10-Jul-18,OXYGEN NFS SETT 07-07-201,"5,800.00",,-542876215.84,Donahue,643,France,152992.04,0,1,0
8316,2011,6,MORTGAGE,3,Medium,2,35000, 60 months,2,debt_consolidation,6,High,2,Good Loan,0,18.39,E,5,8.72,28955.27,26575,0,680.49,409000008315,10-Jul-18,OXYGEN NFS SETT 07-07-201,"5,000.00",,-542881215.84,Okagbue,600,France,91193.65,0,1,0
8317,2011,6,MORTGAGE,3,Low,1,18250, 36 months,1,credit_card,1,Low,1,Good Loan,0,7.49,A,1,14.92,19964.78,18249.99,0,567.61,409000008316,10-Jul-18,OXYGEN NFS SETT 07-07-201,"10,000.00",,-542891215.84,Nnaemeka,651,France,130132.41,0,1,0
8318,2011,10,RENT,1,Low,1,7300, 36 months,1,small_business,3,Low,1,Good Loan,0,8.49,A,1,17.57,7903.8,7300,0,230.41,409000008317,10-Jul-18,OXYGEN NFS SETT 07-07-201,"5,000.00",,-542896215.84,Verjus,666,France,88751.45,0,1,0
8319,2011,3,RENT,1,Low,1,14400, 60 months,2,credit_card,1,Low,1,Bad Loan,1,11.49,B,2,16.69,10221.5,6487.65,656.34,246.27,409000008318,10-Jul-18,OXYGEN NFS SETT 07-07-201,"4,000.00",,-542900215.84,H?,520,France,104118.93,0,1,0
8320,2011,1,RENT,1,Low,1,15000, 60 months,2,debt_consolidation,6,High,2,Good Loan,0,17.99,E,5,9.65,19752.41,12124.21,0,380.82,409000008319,10-Jul-18,OXYGEN NFS SETT 07-07-201,"5,000.00",,-542905215.84,Napolitani,650,Spain,42028.16,0,1,0
8321,2011,4,MORTGAGE,3,Low,1,1400, 36 months,1,other,4,Low,1,Good Loan,0,5.99,A,1,6.39,1532.928972,1400,0,42.59,409000008320,10-Jul-18,OXYGEN NFS SETT 07-07-201,300,,-542905515.84,Ginikanwa,564,Germany,75632.78,0,1,0
8322,2011,10,MORTGAGE,3,Low,1,15000, 60 months,2,debt_consolidation,6,High,2,Bad Loan,1,16.49,D,4,18,4423.26,2095.88,18.54,368.69,409000008321,10-Jul-18,OXYGEN NFS SETT 07-07-201,"4,000.00",,-542909515.84,Spaull,586,France,53710.23,0,1,0
8323,2011,0.5,RENT,1,Low,1,18500, 36 months,1,debt_consolidation,6,Low,1,Good Loan,0,7.49,A,1,5.3,20554.41,18500,0,575.39,409000008322,10-Jul-18,OXYGEN NFS SETT 07-07-201,"5,000.00",,-542914515.84,Siciliani,617,France,13066.30,0,1,0
8324,2011,5,OWN,2,Low,1,5000, 36 months,1,debt_consolidation,6,High,2,Good Loan,0,17.49,D,4,4.46,6490.288056,5000,0,179.49,409000008323,10-Jul-18,OXYGEN NFS SETT 07-07-201,"2,000.00",,-542916515.84,Voronina,712,Spain,152417.97,0,1,0
8325,2011,3,MORTGAGE,3,Medium,2,32000, 60 months,2,credit_card,1,High,2,Bad Loan,1,13.49,C,3,17.25,14087.36,4046.95,6650.36,621.13,409000008324,10-Jul-18,OXYGEN NFS SETT 07-07-201,"9,000.00",,-542925515.84,Tang,654,France,3299.01,0,1,0
8326,2011,5,RENT,1,Low,1,12000, 60 months,2,debt_consolidation,6,Low,1,Good Loan,0,12.99,C,3,16.83,14124.6,9876.61,0,272.98,409000008325,10-Jul-18,OXYGEN NFS SETT 07-07-201,"7,200.00",,-542932715.84,Crumbley,605,France,198091.81,0,1,0
8327,2011,1,MORTGAGE,3,Medium,2,28000, 60 months,2,credit_card,1,Low,1,Good Loan,0,11.99,B,2,16.04,25320.97931,20225,0,449.8,409000008326,10-Jul-18,OXYGEN NFS SETT 07-07-201,"7,000.00",,-542939715.84,Hamilton,491,France,103934.12,0,1,0
8328,2011,3,RENT,1,Low,1,22250, 36 months,1,debt_consolidation,6,High,2,Good Loan,0,23.22,G,7,21.47,32103.00095,22250,0,863.85,409000008327,10-Jul-18,OXYGEN NFS SETT 07-07-201,"4,000.00",,-542943715.84,Piazza,707,France,70403.65,0,1,0
8329,2011,8,MORTGAGE,3,Medium,2,35000, 60 months,2,small_business,3,High,2,Bad Loan,1,22.48,G,7,1.22,10735.86,3866.47,0,976.24,409000008328,10-Jul-18,OXYGEN NFS SETT 07-07-201,"8,000.00",,-542951715.84,Birch,638,Spain,102179.86,0,1,0
8330,2011,5,RENT,1,Low,1,4500, 36 months,1,major_purchase,8,Low,1,Bad Loan,1,8.49,A,1,14.98,5127.74,3248.74,1295.88,142.04,409000008329,10-Jul-18,OXYGEN NFS SETT 07-07-201,"5,000.00",,-542956715.84,Custance,683,France,30375.18,0,1,0
8331,2011,10,RENT,1,Low,1,1000, 36 months,1,debt_consolidation,6,Low,1,Good Loan,0,11.49,B,2,21.36,1154.93,1000,0,32.98,409000008330,10-Jul-18,OXYGEN NFS SETT 07-07-201,"3,000.00",,-542959715.84,Anayochukwu,815,Spain,184796.84,0,1,0
8332,2011,7,RENT,1,Low,1,20400, 60 months,2,other,4,High,2,Good Loan,0,18.39,E,5,3.63,29846.77822,20400,0,522.37,409000008331,10-Jul-18,OXYGEN NFS SETT 07-07-201,"1,000.00",,-542960715.84,Galkin,645,Spain,166264.89,0,1,0
8333,2011,10,MORTGAGE,3,Low,1,35000, 60 months,2,credit_card,1,Low,1,Good Loan,0,10.99,B,2,13.65,27616.48,24375,0,529.86,409000008332,10-Jul-18,OXYGEN NFS SETT 07-07-201,"9,000.00",,-542969715.84,Adams,645,Germany,88391.97,0,1,0
8334,2011,5,RENT,1,Low,1,21500, 36 months,1,small_business,3,High,2,Bad Loan,1,16.89,D,4,9.18,18691.79,13278.29,0,765.36,409000008333,10-Jul-18,OXYGEN NFS SETT 07-07-201,"8,800.00",,-542978515.84,Toomey,683,France,115186.97,0,1,0
8335,2011,6,RENT,1,Low,1,9200, 60 months,2,debt_consolidation,6,High,2,Good Loan,0,13.99,C,3,14.94,12415.15293,9200,0,214.03,409000008334,10-Jul-18,OXYGEN NFS SETT 07-07-201,"9,800.00",,-542988315.84,Marshall-Hall,705,France,13935.53,0,1,0
8336,2011,4,MORTGAGE,3,Low,1,35000, 60 months,2,debt_consolidation,6,Low,1,Good Loan,0,11.99,B,2,1.18,44703.66926,35000,0,778.38,409000008335,10-Jul-18,OXYGEN NFS SETT 07-07-201,"4,000.00",,-542992315.84,Shen,647,France,83910.40,0,1,0
8337,2011,4,RENT,1,Low,1,6000, 36 months,1,other,4,Low,1,Good Loan,0,5.42,A,1,18.6,6514.333142,6000,0,180.96,409000008336,10-Jul-18,OXYGEN NFS SETT 07-07-201,300,,-542992615.84,Pagnotto,786,Germany,34712.34,0,1,0
8338,2011,4,MORTGAGE,3,Low,1,27000, 60 months,2,debt_consolidation,6,Low,1,Good Loan,0,11.49,B,2,10.34,35105.36998,27000,0,593.67,409000008337,10-Jul-18,OXYGEN NFS SETT 07-07-201,"4,000.00",,-542996615.84,Wood,534,France,13871.34,0,1,0
8339,2011,4,MORTGAGE,3,Low,1,11000, 36 months,1,debt_consolidation,6,Low,1,Good Loan,0,10.99,B,2,4.26,12428.48,11000,0,360.08,409000008338,10-Jul-18,OXYGEN NFS SETT 07-07-201,"2,000.00",,-542998615.84,More,602,Spain,139494.75,0,1,0
8340,2011,10,MORTGAGE,3,Medium,2,35000, 60 months,2,other,4,High,2,Bad Loan,1,18.79,E,5,24.49,8146.75,2941.94,1240.84,628.85,409000008339,10-Jul-18,OXYGEN NFS SETT 07-07-201,"1,800.00",,-543000415.84,Piccio,695,France,140724.64,0,1,0
8341,2011,10,MORTGAGE,3,Low,1,12000, 36 months,1,credit_card,1,Low,1,Good Loan,0,5.99,A,1,12.26,13140.13676,12000,0,365.01,409000008340,10-Jul-18,OXYGEN NFS SETT 07-07-201,"6,500.00",,-543006915.84,Tochukwu,553,Germany,20682.46,0,1,0
8342,2011,4,MORTGAGE,3,Medium,2,19200, 60 months,2,small_business,3,High,2,Good Loan,0,16.49,D,4,15.09,25409.28007,17450,0,428.91,409000008341,10-Jul-18,OXYGEN NFS SETT 07-07-201,"5,000.00",,-543011915.84,Graham,516,Spain,124202.26,0,1,0
8343,2011,0.5,RENT,1,Low,1,4350, 36 months,1,moving,10,Low,1,Good Loan,0,10.99,B,2,9.07,5095.479391,4350,0,142.4,409000008342,10-Jul-18,OXYGEN NFS SETT 07-07-201,"4,700.00",,-543016615.84,Tung,655,France,159638.77,0,1,0
8344,2011,6.05,OWN,2,Low,1,7800, 36 months,1,wedding,5,High,2,Good Loan,0,15.99,D,4,1.63,9866.428722,7800,0,274.19,409000008343,10-Jul-18,OXYGEN NFS SETT 07-07-201,"2,000.00",,-543018615.84,P'eng,849,Germany,171056.65,0,1,0
8345,2011,1,RENT,1,Low,1,10000, 36 months,1,debt_consolidation,6,High,2,Good Loan,0,15.99,D,4,6.53,12642.78844,10000,0,351.53,409000008344,10-Jul-18,OXYGEN NFS SETT 07-07-201,"3,000.00",,-543021615.84,Nevzorova,520,Germany,25333.03,0,1,0
8346,2011,10,MORTGAGE,3,Low,1,18000, 36 months,1,home_improvement,7,Low,1,Good Loan,0,12.99,C,3,7.02,21822.83358,18000,0,606.41,409000008345,10-Jul-18,OXYGEN NFS SETT 07-07-201,"7,700.00",,-543029315.84,Toscani,568,Spain,29372.62,0,1,0
8347,2011,10,RENT,1,Low,1,27000, 60 months,2,debt_consolidation,6,High,2,Bad Loan,1,18.39,E,5,10.28,22393.25,11283.33,1475.81,550.54,409000008346,10-Jul-18,OXYGEN NFS SETT 07-07-201,"7,200.00",,-543036515.84,McKenzie,695,Spain,38533.79,0,1,0
8348,2011,2,RENT,1,Low,1,8500, 36 months,1,major_purchase,8,Low,1,Bad Loan,1,8.49,A,1,22.44,5343.26,4205.64,259.62,268.29,409000008347,10-Jul-18,OXYGEN NFS SETT 07-07-201,"8,000.00",,-543044515.84,Okwuoma,807,Spain,156122.13,0,1,0
8349,2011,8,RENT,1,Low,1,7200, 36 months,1,major_purchase,8,Low,1,Good Loan,0,7.49,A,1,1.85,8059.668546,7200,0,223.94,409000008348,10-Jul-18,OXYGEN NFS SETT 07-07-201,200,,-543044715.84,Morley,642,Germany,57904.22,0,1,0
8350,2011,10,MORTGAGE,3,Medium,2,35000, 60 months,2,major_purchase,8,Low,1,Good Loan,0,11.49,B,2,2.92,28704.98,20878.46,0,552.99,409000008349,10-Jul-18,OXYGEN NFS SETT 07-07-201,"9,500.00",,-543054215.84,Kerr,703,Germany,31257.10,0,1,0
8351,2011,10,MORTGAGE,3,Low,1,9000, 36 months,1,debt_consolidation,6,Low,1,Good Loan,0,5.99,A,1,7.44,9832.902506,9000,0,273.76,409000008350,10-Jul-18,OXYGEN NFS SETT 07-07-201,"7,500.00",,-543061715.84,Harding,556,France,193214.05,0,1,0
8352,2011,3,RENT,1,Low,1,15250, 60 months,2,debt_consolidation,6,Low,1,Bad Loan,1,11.99,B,2,26.08,4803.06,2364.77,740.1,339.16,409000008351,10-Jul-18,OXYGEN NFS SETT 07-07-201,"6,000.00",,-543067715.84,Butler,585,France,137757.69,0,1,0
8353,2011,8,MORTGAGE,3,Low,1,24925, 60 months,2,small_business,3,Low,1,Bad Loan,1,11.99,B,2,12.27,24240.02,14902.11,1915.22,554.32,409000008352,10-Jul-18,OXYGEN NFS SETT 07-07-201,"5,500.00",,-543073215.84,Crawford,587,Germany,13308.20,0,1,0
8354,2011,2,MORTGAGE,3,Medium,2,20000, 36 months,1,credit_card,1,Low,1,Good Loan,0,7.49,A,1,13.26,22391.48535,20000,0,622.04,409000008353,10-Jul-18,OXYGEN NFS SETT 07-07-201,200,,-543073415.84,Brown,524,Spain,132861.90,0,1,0
8355,2011,7,MORTGAGE,3,Low,1,5000, 36 months,1,debt_consolidation,6,Low,1,Good Loan,0,7.49,A,1,13.6,5594.645752,5000,0,155.51,409000008354,10-Jul-18,OXYGEN NFS SETT 07-07-201,"9,000.00",,-543082415.84,Greece,556,Germany,125083.29,0,1,0
8356,2011,4,MORTGAGE,3,Low,1,6000, 36 months,1,major_purchase,8,Low,1,Good Loan,0,5.42,A,1,9.21,6513.814207,6000,0,180.96,409000008355,10-Jul-18,OXYGEN NFS SETT 07-07-201,"8,000.00",,-543090415.84,Matthews,504,Spain,12405.20,0,1,0
8357,2011,3,RENT,1,Low,1,3825, 36 months,1,debt_consolidation,6,Low,1,Good Loan,0,5.42,A,1,11.37,3950.55,3825,0,115.37,409000008356,10-Jul-18,OXYGEN NFS SETT 07-07-201,200,,-543090615.84,Heath,731,Spain,37697.29,0,1,0
8358,2011,4,RENT,1,Low,1,5000, 36 months,1,debt_consolidation,6,Low,1,Good Loan,0,6.99,A,1,9.17,5290.15,5000,0,154.37,409000008357,10-Jul-18,OXYGEN NFS SETT 07-07-201,"1,300.00",,-543091915.84,Vincent,651,France,105599.65,0,1,0
8359,2011,10,RENT,1,Low,1,25000, 60 months,2,debt_consolidation,6,High,2,Good Loan,0,19.29,E,5,20.19,33891.49,20120.91,0,652.51,409000008358,10-Jul-18,OXYGEN NFS SETT 07-07-201,"2,500.00",,-543094415.84,Sal,675,Spain,142783.98,0,1,0
8360,2011,2,MORTGAGE,3,Medium,2,1000, 36 months,1,home_improvement,7,Low,1,Good Loan,0,5.99,A,1,10.45,1094.958284,1000,0,30.42,409000008359,10-Jul-18,OXYGEN NFS SETT 07-07-201,"7,000.00",,-543101415.84,Milne,657,Spain,168412.07,0,1,0
8361,2011,3,OWN,2,Medium,2,8000, 36 months,1,debt_consolidation,6,High,2,Good Loan,0,13.99,C,3,7.12,9727.45,8000,0,273.39,409000008360,10-Jul-18,OXYGEN NFS SETT 07-07-201,"1,500.00",,-543102915.84,Bazile,686,Germany,184036.47,0,1,0
8362,2011,5,MORTGAGE,3,Low,1,20000, 36 months,1,debt_consolidation,6,Low,1,Good Loan,0,8.49,A,1,14.78,22268.06,20000,0,631.26,409000008361,10-Jul-18,OXYGEN NFS SETT 07-07-201,"10,000.00",,-543112915.84,Wardle,690,France,48478.47,0,1,0
8363,2011,3,RENT,1,Medium,2,10175, 36 months,1,debt_consolidation,6,Low,1,Bad Loan,1,12.99,C,3,24.03,9083.54,6622.57,512.8,342.79,409000008362,10-Jul-18,OXYGEN NFS SETT 07-07-201,400,,-543113315.84,Lilly,567,France,3896.08,0,1,0
8364,2011,3,RENT,1,Low,1,5000, 36 months,1,debt_consolidation,6,Low,1,Good Loan,0,11.49,B,2,19.72,5658.77,5000,0,164.86,409000008363,10-Jul-18,OXYGEN NFS SETT 07-07-201,"1,000.00",,-543114315.84,Aitken,557,Germany,132370.75,0,1,0
8365,2011,4,RENT,1,Low,1,15000, 60 months,2,debt_consolidation,6,High,2,Bad Loan,1,21.36,F,6,21.48,11741.29,4411.76,1534.54,408.85,409000008364,10-Jul-18,OXYGEN NFS SETT 07-07-201,800,,-543115115.84,Enderby,446,Spain,128260.86,0,1,0
8366,2011,2,MORTGAGE,3,Medium,2,14000, 36 months,1,home_improvement,7,Low,1,Good Loan,0,10.99,B,2,17.4,15889.15,14000,0,458.28,409000008365,10-Jul-18,OXYGEN NFS SETT 07-07-201,"9,000.00",,-543124115.84,Chiu,850,France,106534.15,0,1,0
8367,2011,2,RENT,1,Low,1,7600, 60 months,2,moving,10,High,2,Good Loan,0,15.99,D,4,16.3,9583.1,6187.11,0,184.78,409000008366,10-Jul-18,OXYGEN NFS SETT 07-07-201,700,,-543124815.84,Ugorji,637,France,102515.42,0,1,0
8368,2011,0.5,RENT,1,Low,1,4000, 36 months,1,other,4,Low,1,Good Loan,0,10.59,B,2,20.43,4366.23,4000,0,130.18,409000008367,10-Jul-18,OXYGEN NFS SETT 07-07-201,"10,000.00",,-543134815.84,Sharpe,499,France,83643.87,0,1,0
8369,2011,5,OWN,2,Low,1,5600, 36 months,1,debt_consolidation,6,Low,1,Good Loan,0,5.42,A,1,8.44,5763.51,5600,0,168.9,409000008368,10-Jul-18,OXYGEN NFS SETT 07-07-201,"1,000.00",,-543135815.84,Houghton,622,Germany,138906.85,0,1,0
8370,2011,10,MORTGAGE,3,Low,1,2500, 36 months,1,debt_consolidation,6,High,2,Good Loan,0,15.99,D,4,19.1,2823.94,2500,0,87.89,409000008369,10-Jul-18,OXYGEN NFS SETT 07-07-201,"8,800.00",,-543144615.84,Konovalova,684,Germany,29995.83,0,1,0
8371,2011,8,MORTGAGE,3,Low,1,30000, 60 months,2,debt_consolidation,6,Low,1,Good Loan,0,12.99,C,3,9.06,26745.23,18567.87,0,525.48,409000008370,10-Jul-18,OXYGEN NFS SETT 07-07-201,"8,000.00",,-543152615.84,Patel,612,France,164081.42,0,1,0
8372,2011,1,MORTGAGE,3,Low,1,6750, 36 months,1,other,4,Low,1,Good Loan,0,10.99,B,2,18.14,7948.162716,6750,0,220.96,409000008371,10-Jul-18,OXYGEN NFS SETT 07-07-201,"7,500.00",,-543160115.84,Ngozichukwuka,813,Germany,187976.88,0,1,0
8373,2011,8,MORTGAGE,3,Low,1,6000, 36 months,1,credit_card,1,Low,1,Good Loan,0,12.99,C,3,13.18,7215.209345,6000,0,202.14,409000008372,10-Jul-18,OXYGEN NFS SETT 07-07-201,100,,-543160215.84,Medland,850,Germany,158171.36,0,1,0
8374,2011,10,MORTGAGE,3,Low,1,9000, 36 months,1,debt_consolidation,6,Low,1,Good Loan,0,11.49,B,2,6.89,10601.28,9000,0,296.75,409000008373,10-Jul-18,OXYGEN NFS SETT 07-07-201,"7,900.00",,-543168115.84,Padovano,795,Spain,155711.64,0,1,0
8375,2011,4,RENT,1,Low,1,6200, 36 months,1,debt_consolidation,6,Low,1,Good Loan,0,8.49,A,1,16.52,6804.99,6200,0,195.7,409000008374,10-Jul-18,OXYGEN NFS SETT 07-07-201,"7,500.00",,-543175615.84,Tsui,628,Spain,85890.75,0,1,0
8376,2011,3,MORTGAGE,3,Medium,2,35000, 60 months,2,debt_consolidation,6,Low,1,Good Loan,0,11.49,B,2,11.04,25809.97,18771.31,0,496.92,409000008375,10-Jul-18,OXYGEN NFS SETT 07-07-201,"2,500.00",,-543178115.84,H?,565,Germany,83844.79,0,1,0
8377,2011,6.05,RENT,1,Low,1,3700, 36 months,1,debt_consolidation,6,Low,1,Good Loan,0,6.99,A,1,10.07,4111.317239,3700,0,114.23,409000008376,10-Jul-18,OXYGEN NFS SETT 07-07-201,"4,500.00",,-543182615.84,Denman,601,France,41777.90,0,1,0
8378,2011,8,OWN,2,Low,1,2000, 36 months,1,other,4,Low,1,Good Loan,0,6.99,A,1,23.4,2222.457572,2000,0,61.75,409000008377,10-Jul-18,OXYGEN NFS SETT 07-07-201,300,,-543182915.84,Ratten,802,Spain,81908.09,0,1,0
8379,2011,7,RENT,1,Low,1,5000, 60 months,2,debt_consolidation,6,High,2,Good Loan,0,17.49,D,4,24.32,6383.34,3937.08,0,125.59,409000008378,10-Jul-18,OXYGEN NFS SETT 07-07-201,"6,000.00",,-543188915.84,Baxter,614,Germany,139377.24,0,1,0
8380,2011,5,MORTGAGE,3,Medium,2,13000, 36 months,1,home_improvement,7,Low,1,Good Loan,0,5.42,A,1,16.06,13956.92,13000,0,392.08,409000008379,10-Jul-18,OXYGEN NFS SETT 07-07-201,"8,000.00",,-543196915.84,Norman,434,Spain,73562.05,0,1,0
8381,2011,7,MORTGAGE,3,Low,1,6000, 36 months,1,credit_card,1,Low,1,Good Loan,0,8.49,A,1,9.61,6596.61,6000,0,189.38,409000008380,10-Jul-18,OXYGEN NFS SETT 07-07-201,"10,000.00",,-543206915.84,Shen,522,Germany,165786.10,0,1,0
8382,2011,1,MORTGAGE,3,Medium,2,35000, 36 months,1,credit_card,1,High,2,Good Loan,0,17.49,D,4,13.36,42069.22,35000,0,1256.4,409000008381,10-Jul-18,OXYGEN NFS SETT 07-07-201,"2,700.00",,-543209615.84,Reilly,550,Germany,174921.91,0,1,0
8383,2011,10,MORTGAGE,3,Low,1,20000, 36 months,1,debt_consolidation,6,Low,1,Good Loan,0,8.49,A,1,11.85,21653.03,20000,0,631.26,409000008382,10-Jul-18,OXYGEN NFS SETT 07-07-201,"10,000.00",,-543219615.84,Ifeanacho,599,Spain,120790.02,0,1,0
8384,2011,10,MORTGAGE,3,Low,1,35000, 36 months,1,credit_card,1,High,2,Good Loan,0,15.99,D,4,20.75,42674.13,35000,0,1230.33,409000008383,10-Jul-18,OXYGEN NFS SETT 07-07-201,"1,700.00",,-543221315.84,Graham,493,France,56092.51,0,1,0
8385,2011,1,RENT,1,Low,1,6000, 36 months,1,car,2,Low,1,Good Loan,0,5.99,A,1,14.45,6450.21,6000,0,182.51,409000008384,10-Jul-18,OXYGEN NFS SETT 07-07-201,"8,900.00",,-543230215.84,Lysaght,755,France,158816.03,0,1,0
8386,2011,0.5,RENT,1,Medium,2,2500, 36 months,1,other,4,Low,1,Good Loan,0,7.49,A,1,10.68,2601,2500,0,77.76,409000008385,10-Jul-18,OXYGEN NFS SETT 07-07-201,"10,000.00",,-543240215.84,T'ang,605,France,125660.99,0,1,0
8387,2011,5,RENT,1,Medium,2,18000, 60 months,2,moving,10,High,2,Bad Loan,1,16.49,D,4,24.24,2204,998.88,0,442.43,409000008386,10-Jul-18,Indiaforensic NFS SETT 09-07-201,"5,000.00",,-543245215.84,Abron,708,France,128400.62,0,1,0
8388,2011,0.5,MORTGAGE,3,Low,1,24000, 36 months,1,other,4,Low,1,Good Loan,0,7.49,A,1,8.16,26869.44792,24000,0,746.44,409000008387,10-Jul-18,Indiaforensic NFS SETT 09-07-201,400,,-543245615.84,Chimaraoke,699,France,107181.22,0,1,0
8389,2011,7,MORTGAGE,3,Low,1,25000, 60 months,2,debt_consolidation,6,Low,1,Good Loan,0,10.59,B,2,19.01,20697.09377,16375,0,352.7,409000008388,10-Jul-18,Indiaforensic NFS SETT 09-07-201,300,,-543245915.84,Y?an,763,France,77203.72,0,1,0
8390,2011,10,MORTGAGE,3,Medium,2,30000, 36 months,1,credit_card,1,High,2,Good Loan,0,15.62,D,4,17.3,37759.45155,30000,0,1049.1,409000008389,10-Jul-18,Indiaforensic NFS SETT 09-07-201,"8,500.00",,-543254415.84,Sergeyeva,743,Spain,129740.11,0,1,0
8391,2011,10,OWN,2,Low,1,4200, 36 months,1,medical,9,Low,1,Good Loan,0,12.99,C,3,21.6,4873.89,4200,0,141.5,409000008390,10-Jul-18,Indiaforensic NFS SETT 09-07-201,500,,-543254915.84,Ma,660,France,187604.97,0,1,0
8392,2011,6,MORTGAGE,3,Low,1,8600, 60 months,2,small_business,3,High,2,Good Loan,0,15.99,D,4,20.52,10666.12,6818.69,0,209.09,409000008391,10-Jul-18,Indiaforensic NFS SETT 09-07-201,"1,000.00",,-543255915.84,Obiajulu,619,Germany,184754.26,0,1,0
8393,2011,3,OWN,2,Low,1,3200, 36 months,1,credit_card,1,Low,1,Good Loan,0,8.49,A,1,24.53,3448.42,3200,0,101.01,409000008392,10-Jul-18,Indiaforensic NFS SETT 09-07-201,"6,000.00",,-543261915.84,Belcher,739,Germany,63981.37,0,1,0
8394,2011,6,RENT,1,Low,1,14600, 60 months,2,debt_consolidation,6,High,2,Good Loan,0,21.36,F,6,8.33,20679.53,11646.08,0,397.95,409000008393,10-Jul-18,Indiaforensic NFS SETT 09-07-201,"3,000.00",,-543264915.84,K?,769,Germany,192831.67,0,1,0
8395,2011,0.5,RENT,1,Low,1,4600, 36 months,1,debt_consolidation,6,High,2,Good Loan,0,14.79,C,3,18.44,5720.513575,4600,0,158.99,409000008394,10-Jul-18,Indiaforensic NFS SETT 09-07-201,"2,000.00",,-543266915.84,Brown,692,France,70849.47,0,1,0
8396,2011,2,RENT,1,Low,1,6225, 36 months,1,debt_consolidation,6,Low,1,Good Loan,0,10.99,B,2,10.19,7144.77,6225,0,203.77,409000008395,10-Jul-18,Indiaforensic NFS SETT 09-07-201,"4,000.00",,-543270915.84,Abernathy,560,France,27914.95,0,1,0
8397,2011,3,RENT,1,Medium,2,35000, 36 months,1,debt_consolidation,6,Low,1,Good Loan,0,11.49,B,2,16.12,41537.07984,35000,0,1154,409000008396,10-Jul-18,Indiaforensic NFS SETT 09-07-201,"8,000.00",,-543278915.84,Pape,607,France,173568.30,0,1,0
8398,2011,5,RENT,1,Low,1,10000, 36 months,1,debt_consolidation,6,Low,1,Good Loan,0,12.99,C,3,22.6,12124.22741,10000,0,336.9,409000008397,10-Jul-18,Indiaforensic NFS SETT 09-07-201,"9,500.00",,-543288415.84,Tao,630,Germany,9324.31,0,1,0
8399,2011,10,MORTGAGE,3,Medium,2,20000, 60 months,2,debt_consolidation,6,High,2,Good Loan,0,18.39,E,5,21.24,21745.97718,14850,0,380.26,409000008398,10-Jul-18,Indiaforensic NFS SETT 09-07-201,"3,000.00",,-543291415.84,Ma,767,Germany,26628.88,0,1,0
8400,2011,7,RENT,1,Low,1,20000, 36 months,1,debt_consolidation,6,Low,1,Good Loan,0,11.99,B,2,13.81,23250.79,20000,0,664.2,409000008399,10-Jul-18,Indiaforensic NFS SETT 09-07-201,"5,000.00",,-543296415.84,Earle,543,France,145601.80,0,1,0
8401,2011,10,MORTGAGE,3,Medium,2,25600, 36 months,1,debt_consolidation,6,Low,1,Good Loan,0,5.99,A,1,4.18,28032.30898,25600,0,778.69,409000008400,10-Jul-18,Indiaforensic NFS SETT 09-07-201,"9,000.00",,-543305415.84,Kazantsev,776,France,144496.07,0,1,0
8402,2011,1,MORTGAGE,3,Medium,2,16800, 36 months,1,major_purchase,8,Low,1,Good Loan,0,5.42,A,1,4.98,17321.75,16800,0,506.69,409000008401,10-Jul-18,Indiaforensic NFS SETT 09-07-201,"8,500.00",,-543313915.84,Uspenskaya,535,Spain,11779.98,0,1,0
8403,2011,8,MORTGAGE,3,Low,1,15000, 60 months,2,credit_card,1,Low,1,Good Loan,0,11.99,B,2,7.97,18521.03,15000,0,333.6,409000008402,10-Jul-18,Indiaforensic NFS SETT 09-07-201,"10,000.00",,-543323915.84,Coombes,549,Germany,83983.39,0,1,0
8404,2011,5,RENT,1,Medium,2,20000, 36 months,1,debt_consolidation,6,Low,1,Good Loan,0,6.99,A,1,12.81,20448.3,20000,0,617.46,409000008403,10-Jul-18,Indiaforensic NFS SETT 09-07-201,"7,000.00",,-543330915.84,Hopman,844,France,123318.37,0,1,0
8405,2011,4,MORTGAGE,3,Medium,2,20000, 60 months,2,debt_consolidation,6,High,2,Good Loan,0,20.25,F,6,16.26,27642,16018.84,0,532.67,409000008404,10-Jul-18,Indiaforensic NFS SETT 09-07-201,"10,000.00",,-543340915.84,McKay,586,Germany,65481.86,0,1,0
8406,2011,10,RENT,1,Low,1,10000, 36 months,1,credit_card,1,Low,1,Good Loan,0,8.49,A,1,20.88,10767.01,10000,0,315.63,409000008405,10-Jul-18,Indiaforensic NFS SETT 09-07-201,"2,000.00",,-543342915.84,Milanesi,583,France,47728.00,0,1,0
8407,2011,3,RENT,1,Low,1,14000, 60 months,2,other,4,High,2,Good Loan,0,20.99,F,6,20.29,17606.4,14000,0,378.67,409000008406,10-Jul-18,Indiaforensic NFS SETT 09-07-201,"10,000.00",,-543352915.84,Chineze,701,Spain,59195.05,0,1,0
8408,2011,0.5,RENT,1,Low,1,4800, 36 months,1,debt_consolidation,6,Low,1,Good Loan,0,8.49,A,1,9,5433.937146,4800,0,151.51,409000008407,10-Jul-18,Indiaforensic NFS SETT 09-07-201,"1,000.00",,-543353915.84,Dawson,726,France,98060.51,0,1,0
8409,2011,4,MORTGAGE,3,Low,1,20000, 60 months,2,debt_consolidation,6,High,2,Good Loan,0,16.89,D,4,17.07,28847.49776,20000,0,495.87,409000008408,10-Jul-18,Indiaforensic NFS SETT 09-07-201,"6,000.00",,-543359915.84,Shih,829,Germany,90106.94,0,1,0
8410,2011,4,MORTGAGE,3,Low,1,8000, 36 months,1,moving,10,Low,1,Good Loan,0,9.99,B,2,13.22,9229.16,8000,0,258.1,409000008409,10-Jul-18,Indiaforensic NFS SETT 09-07-201,"8,500.00",,-543368415.84,Hughes,749,Spain,13549.34,0,1,0
8411,2011,0.5,MORTGAGE,3,Medium,2,25000, 60 months,2,debt_consolidation,6,High,2,Bad Loan,1,17.99,E,5,20.69,4433.03,1899.03,0,634.7,409000008410,10-Jul-18,Indiaforensic NFS SETT 09-07-201,"7,000.00",,-543375415.84,Clark,743,France,113436.08,0,1,0
8412,2011,2,RENT,1,Low,1,16000, 36 months,1,debt_consolidation,6,Low,1,Good Loan,0,11.99,B,2,7.16,18507.68,16000,0,531.36,409000008411,10-Jul-18,Indiaforensic NFS SETT 09-07-201,"6,000.00",,-543381415.84,Chukwuhaenye,619,Spain,42442.21,0,1,0
8413,2011,3,MORTGAGE,3,Low,1,12000, 36 months,1,home_improvement,7,Low,1,Good Loan,0,5.99,A,1,8.79,13112.9437,12000,0,365.01,409000008412,10-Jul-18,Indiaforensic NFS SETT 09-07-201,500,,-543381915.84,Wall,699,France,68297.61,0,1,0
8414,2011,10,MORTGAGE,3,Medium,2,3000, 36 months,1,car,2,Low,1,Good Loan,0,7.49,A,1,19.16,3356.381114,3000,0,93.31,409000008413,10-Jul-18,Indiaforensic NFS SETT 09-07-201,"3,800.00",,-543385715.84,Howell,749,Spain,80134.65,0,1,0
8415,2011,2,RENT,1,Low,1,15000, 60 months,2,debt_consolidation,6,High,2,Bad Loan,1,16.49,D,4,16.29,18015.65,11105.66,0,368.69,409000008414,10-Jul-18,Indiaforensic NFS SETT 09-07-201,"10,000.00",,-543395715.84,Lo,600,Germany,96051.10,0,1,0
8416,2011,8,RENT,1,Low,1,7500, 36 months,1,debt_consolidation,6,Low,1,Bad Loan,1,9.99,B,2,22.64,964.48,724.59,0,241.97,409000008415,10-Jul-18,Indiaforensic NFS SETT 09-07-201,"2,500.00",,-543398215.84,Lazarev,760,Spain,80682.35,0,1,0
8417,2011,1,RENT,1,Low,1,4800, 36 months,1,car,2,Low,1,Good Loan,0,11.99,B,2,13.77,5558.23,4800,0,159.41,409000008416,10-Jul-18,Indiaforensic  RUPAY SETT 100718,219.08,,-543398434.92,Lowe,528,Germany,111149.98,0,1,0
8418,2011,10,RENT,1,Medium,2,15000, 36 months,1,debt_consolidation,6,Low,1,Good Loan,0,11.49,B,2,4.33,17263.23,15000,0,494.57,409000008417,11-Jul-18,Indiaforensic  RUPAY SETT 110718,757.15,,-543399192.07,Folliero,630,France,182612.38,0,1,0
8419,2011,2,RENT,1,Low,1,10000, 60 months,2,debt_consolidation,6,Low,1,Good Loan,0,11.49,B,2,25.34,11353.43,8262.72,0,219.88,409000008418,11-Jul-18,TRF FROM  Indiaforensic SERVICES,,70000.00,-543329192.07,Han,683,Germany,109201.43,0,1,0
8420,2011,0.5,RENT,1,Low,1,1850, 36 months,1,credit_card,1,Low,1,Good Loan,0,11.99,B,2,18.31,1985.54,1850,0,61.44,409000008419,11-Jul-18,Indiaforensic  RUPAY SETT 110718,10,,-543329202.07,Holloway,677,Germany,151146.67,0,1,0
8421,2011,10,RENT,1,Medium,2,30000, 60 months,2,credit_card,1,Low,1,Good Loan,0,10.99,B,2,15.48,21238.57,19700,0,428.23,409000008420,12-Jul-18,Indiaforensic  RUPAY SETT 120718,"2,048.43",,-543331250.50,Pai,669,Spain,93901.61,0,1,0
8422,2011,10,MORTGAGE,3,Low,1,6625, 36 months,1,other,4,High,2,Good Loan,0,15.23,C,3,20.17,8287.822988,6625,0,230.41,409000008421,12-Jul-18,Indiaforensic  RUPAY SETT 120718,966.42,,-543332216.92,Trejo,693,France,36342.79,0,1,0
8423,2011,5,MORTGAGE,3,Low,1,6000, 36 months,1,debt_consolidation,6,Low,1,Good Loan,0,5.42,A,1,0.75,6513.025836,6000,0,180.96,409000008422,12-Jul-18,Indiaforensic NFS SETT 08-07-201,"9,800.00",,-543342016.92,Johnston,612,Spain,98302.57,0,1,0
8424,2011,10,MORTGAGE,3,Low,1,15000, 60 months,2,debt_consolidation,6,Low,1,Good Loan,0,8.49,A,1,13.35,17331.07,15000,0,307.68,409000008423,12-Jul-18,Indiaforensic NFS SETT 08-07-201,"10,000.00",,-543352016.92,Macknight,719,Spain,84972.90,0,1,0
8425,2011,0.5,RENT,1,Low,1,8000, 36 months,1,other,4,Low,1,Good Loan,0,5.99,A,1,3.39,8226.84,8000,0,243.34,409000008424,12-Jul-18,Indiaforensic NFS SETT 08-07-201,800,,-543352816.92,Lo,702,France,108747.12,0,1,0
8426,2011,3,RENT,1,Low,1,35000, 60 months,2,debt_consolidation,6,High,2,Good Loan,0,16.49,D,4,20.49,34613.47,22077.26,0,666.72,409000008425,12-Jul-18,Indiaforensic NFS SETT 08-07-201,"5,000.00",,-543357816.92,Glossop,755,France,21862.19,0,1,0
8427,2011,10,MORTGAGE,3,Low,1,20000, 60 months,2,debt_consolidation,6,High,2,Bad Loan,1,15.23,C,3,16.5,4455.46,1863.19,632.57,478.22,409000008426,12-Jul-18,Indiaforensic NFS SETT 08-07-201,"1,000.00",,-543358816.92,Bishop,514,France,121551.93,0,1,0
8428,2011,10,MORTGAGE,3,Low,1,3000, 60 months,2,car,2,Low,1,Good Loan,0,8.49,A,1,26.09,3627.59126,3000,0,61.54,409000008427,12-Jul-18,Indiaforensic NFS SETT 08-07-201,"8,800.00",,-543367616.92,Yefremova,753,France,177065.24,0,1,0
8429,2011,10,RENT,1,Low,1,6400, 36 months,1,debt_consolidation,6,Low,1,Good Loan,0,9.99,B,2,16.11,7429.026581,6400,0,206.48,409000008428,12-Jul-18,Indiaforensic NFS SETT 08-07-201,100,,-543367716.92,Obialo,548,Germany,140460.01,0,1,0
8430,2011,10,MORTGAGE,3,Low,1,19000, 60 months,2,credit_card,1,Low,1,Bad Loan,1,10.99,B,2,14.83,8956.08,5279.23,987.97,266.29,409000008429,12-Jul-18,Indiaforensic NFS SETT 08-07-201,"3,800.00",,-543371516.92,Nkemjika,850,Germany,35337.31,0,1,0
8431,2011,6.05,MORTGAGE,3,Low,1,33950, 60 months,2,debt_consolidation,6,Low,1,Good Loan,0,9.99,B,2,16.56,26849.77956,21850,0,464.15,409000008430,12-Jul-18,Indiaforensic NFS SETT 08-07-201,"2,500.00",,-543374016.92,Trevisani,612,France,193502.93,0,1,0
8432,2011,3,MORTGAGE,3,Medium,2,8000, 36 months,1,debt_consolidation,6,Low,1,Good Loan,0,10.59,B,2,13.08,8919.48,8000,0,260.36,409000008431,12-Jul-18,Indiaforensic NFS SETT 08-07-201,"8,000.00",,-543382016.92,Parkes,628,Germany,32174.03,0,1,0
8433,2011,2,MORTGAGE,3,Low,1,7000, 60 months,2,debt_consolidation,6,High,2,Good Loan,0,15.23,C,3,2.82,8694.34,7000,0,167.38,409000008432,12-Jul-18,Indiaforensic NFS SETT 08-07-201,"1,000.00",,-543383016.92,Seleznyov,479,France,5811.90,0,1,0
8434,2011,7,MORTGAGE,3,Medium,2,10000, 60 months,2,debt_consolidation,6,High,2,Good Loan,0,16.49,D,4,9.64,11063.79,10000,0,245.8,409000008433,12-Jul-18,Indiaforensic NFS SETT 08-07-201,"4,900.00",,-543387916.92,Naylor,724,France,149593.61,0,1,0
8435,2011,10,MORTGAGE,3,Low,1,12000, 60 months,2,home_improvement,7,Low,1,Good Loan,0,9.99,B,2,23.78,14548.39825,12000,0,254.91,409000008434,12-Jul-18,Indiaforensic NFS SETT 08-07-201,"2,000.00",,-543389916.92,Forbes,512,Germany,37439.90,0,1,0
8436,2011,2,RENT,1,Low,1,7000, 36 months,1,debt_consolidation,6,Low,1,Good Loan,0,10.59,B,2,7.71,7238.15,7000,0,227.82,409000008435,12-Jul-18,Indiaforensic NFS SETT 08-07-201,"7,000.00",,-543396916.92,Douglas,638,France,142763.51,0,1,0
8437,2011,10,RENT,1,Low,1,3000, 36 months,1,debt_consolidation,6,Low,1,Bad Loan,1,11.49,B,2,12.26,2366.16,1877.61,0,98.92,409000008436,12-Jul-18,Indiaforensic NFS SETT 08-07-201,"1,000.00",,-543397916.92,Nwankwo,834,Spain,45038.74,0,1,0
8438,2011,5,MORTGAGE,3,Low,1,25975, 36 months,1,credit_card,1,High,2,Good Loan,0,16.89,D,4,21.58,33272.61606,25975,0,924.66,409000008437,12-Jul-18,Indiaforensic NFS SETT 08-07-201,"10,000.00",,-543407916.92,Myers,781,France,172097.40,0,1,0
8439,2011,1,RENT,1,Low,1,2400, 36 months,1,debt_consolidation,6,High,2,Good Loan,0,13.49,C,3,7.13,2929.108904,2400,0,81.44,409000008438,12-Jul-18,Indiaforensic NFS SETT 08-07-201,400,,-543408316.92,Rogova,707,Germany,180344.69,0,1,0
8440,2011,6,RENT,1,Low,1,4600, 36 months,1,credit_card,1,Low,1,Good Loan,0,11.49,B,2,21.79,5457.427253,4600,0,151.67,409000008439,12-Jul-18,Indiaforensic NFS SETT 08-07-201,"5,900.00",,-543414216.92,Hsing,670,France,37392.56,0,1,0
8441,2011,2,MORTGAGE,3,Low,1,6000, 36 months,1,other,4,Low,1,Good Loan,0,7.49,A,1,23.33,6691.650255,6000,0,186.61,409000008440,12-Jul-18,Indiaforensic NFS SETT 08-07-201,"1,000.00",,-543415216.92,Giordano,663,Spain,36864.05,0,1,0
8442,2011,1,RENT,1,Low,1,14400, 36 months,1,credit_card,1,High,2,Good Loan,0,17.99,E,5,12.23,18685.5428,14400,0,520.53,409000008441,12-Jul-18,Indiaforensic NFS SETT 08-07-201,"6,000.00",,-543421216.92,Okwukwe,624,France,132418.59,0,1,0
8443,2011,1,RENT,1,Low,1,6000, 36 months,1,credit_card,1,Low,1,Good Loan,0,11.99,B,2,5.95,7107.82,6000,0,199.26,409000008442,12-Jul-18,Indiaforensic NFS SETT 08-07-201,"10,000.00",,-543431216.92,Chalmers,598,France,60894.26,0,1,0
8444,2011,3,MORTGAGE,3,Low,1,9800, 36 months,1,debt_consolidation,6,Low,1,Good Loan,0,5.99,A,1,14.44,10618.23,9800,0,298.1,409000008443,12-Jul-18,Indiaforensic NFS SETT 08-07-201,"4,500.00",,-543435716.92,Chiazagomekpere,619,Germany,143913.33,0,1,0
8445,2011,10,MORTGAGE,3,Low,1,13250, 60 months,2,credit_card,1,Low,1,Bad Loan,1,11.49,B,2,25.53,2206.86,1292.1,0,200.64,409000008444,12-Jul-18,Indiaforensic NFS SETT 08-07-201,"3,000.00",,-543438716.92,Evseyev,792,France,172240.27,0,1,0
8446,2011,0.5,RENT,1,Low,1,17000, 60 months,2,debt_consolidation,6,Low,1,Good Loan,0,10.59,B,2,15.56,19507.22,17000,0,366.16,409000008445,12-Jul-18,Indiaforensic NFS SETT 08-07-201,500,,-543439216.92,Parry-Okeden,683,France,86619.77,0,1,0
8447,2011,0.5,OWN,2,Low,1,2400, 36 months,1,major_purchase,8,Low,1,Good Loan,0,10.59,B,2,0.63,2421.66,2400,0,78.11,409000008446,12-Jul-18,Indiaforensic NFS SETT 08-07-201,"7,000.00",,-543446216.92,Picot,691,France,164074.89,0,1,0
8448,2011,5,MORTGAGE,3,Medium,2,12000, 36 months,1,credit_card,1,Low,1,Bad Loan,1,11.49,B,2,15.81,11173.9,8585.02,471.83,395.66,409000008447,12-Jul-18,Indiaforensic NFS SETT 08-07-201,"5,000.00",,-543451216.92,Reid,765,Spain,69039.43,0,1,0
8449,2011,4,MORTGAGE,3,Medium,2,30000, 36 months,1,debt_consolidation,6,High,2,Good Loan,0,17.99,E,5,19.95,39026.98465,30000,0,1084.43,409000008448,12-Jul-18,Indiaforensic NFS SETT 08-07-201,"5,500.00",,-543456716.92,Ferri,508,France,132468.76,0,1,0
8450,2011,4,OWN,2,Low,1,6000, 36 months,1,debt_consolidation,6,High,2,Good Loan,0,13.49,C,3,22.45,6749.22,6000,0,203.59,409000008449,12-Jul-18,Indiaforensic NFS SETT 08-07-201,"7,000.00",,-543463716.92,Genovesi,637,France,65316.50,0,1,0
8451,2011,1,MORTGAGE,3,Medium,2,17850, 36 months,1,debt_consolidation,6,Low,1,Good Loan,0,11.99,B,2,16.23,21339.98384,17850,0,592.8,409000008450,12-Jul-18,Indiaforensic NFS SETT 08-07-201,"10,000.00",,-543473716.92,Neumayer,667,Germany,57164.19,0,1,0
8452,2011,3,MORTGAGE,3,Low,1,13500, 60 months,2,debt_consolidation,6,High,2,Bad Loan,1,18.39,E,5,18.89,606.42,0,606.42,345.69,409000008451,12-Jul-18,Indiaforensic NFS SETT 08-07-201,"1,900.00",,-543475616.92,Murray,575,Spain,34397.08,0,1,0
8453,2011,10,MORTGAGE,3,Low,1,14000, 60 months,2,debt_consolidation,6,Low,1,Good Loan,0,9.99,B,2,9.42,13115.44098,10850,0,230.48,409000008452,12-Jul-18,Indiaforensic NFS SETT 08-07-201,"6,500.00",,-543482116.92,Tien,744,Spain,177431.59,0,1,0
8454,2011,10,MORTGAGE,3,Medium,2,25000, 36 months,1,credit_card,1,Low,1,Good Loan,0,12.99,C,3,9.82,28376.22,25000,0,842.23,409000008453,12-Jul-18,Indiaforensic NFS SETT 08-07-201,"7,000.00",,-543489116.92,Parkes,567,France,142009.46,0,1,0
8455,2011,3,RENT,1,Low,1,5600, 60 months,2,wedding,5,High,2,Good Loan,0,19.69,E,5,0,8760.659995,5600,0,147.41,409000008454,12-Jul-18,Indiaforensic NFS SETT 08-07-201,700,,-543489816.92,Yip,502,France,80618.47,0,1,0
8456,2011,6,RENT,1,Low,1,4000, 36 months,1,debt_consolidation,6,Low,1,Good Loan,0,10.59,B,2,17.86,4673.513924,4000,0,130.18,409000008455,12-Jul-18,Indiaforensic NFS SETT 08-07-201,"1,900.00",,-543491716.92,Ingle,609,France,124218.27,0,1,0
8457,2011,2,MORTGAGE,3,Low,1,12000, 60 months,2,debt_consolidation,6,High,2,Good Loan,0,15.99,D,4,17.48,13076.51,12000,0,291.76,409000008456,12-Jul-18,Indiaforensic NFS SETT 08-07-201,"9,000.00",,-543500716.92,Chidubem,715,France,85286.30,0,1,0
8458,2011,10,MORTGAGE,3,Low,1,25000, 36 months,1,credit_card,1,Low,1,Good Loan,0,6.99,A,1,16.89,27784.17643,25000,0,771.82,409000008457,12-Jul-18,Indiaforensic NFS SETT 08-07-201,"9,000.00",,-543509716.92,Lu,541,France,40889.14,0,1,0
8459,2011,10,OWN,2,Low,1,17875, 36 months,1,debt_consolidation,6,Low,1,Good Loan,0,6.99,A,1,20.32,19865.4901,17875,0,551.85,409000008458,12-Jul-18,Indiaforensic NFS SETT 08-07-201,"10,000.00",,-543519716.92,Vorobyova,850,France,107236.87,0,1,0
8460,2011,6,RENT,1,Low,1,20000, 60 months,2,debt_consolidation,6,Low,1,Bad Loan,1,11.49,B,2,20.94,9913.96,4760.77,2315.02,316.63,409000008459,12-Jul-18,Indiaforensic NFS SETT 08-07-201,"1,500.00",,-543521216.92,Chiedozie,595,Spain,168085.97,0,1,0
8461,2011,0.5,RENT,1,Low,1,18000, 36 months,1,credit_card,1,Low,1,Good Loan,0,9.99,B,2,21.67,20295.2,18000,0,580.73,409000008460,12-Jul-18,Indiaforensic NFS SETT 08-07-201,"1,500.00",,-543522716.92,Napolitani,650,Germany,146663.43,0,1,0
8462,2011,10,MORTGAGE,3,Medium,2,3000, 36 months,1,other,4,Low,1,Good Loan,0,8.49,A,1,16.31,3339.12,3000,0,94.69,409000008461,12-Jul-18,Indiaforensic NFS SETT 08-07-201,"2,500.00",,-543525216.92,Coffey,625,France,4791.80,0,1,0
8463,2011,4,MORTGAGE,3,Medium,2,2500, 36 months,1,medical,9,Low,1,Good Loan,0,6.99,A,1,8.28,2520,2500,0,77.19,409000008462,12-Jul-18,Indiaforensic NFS SETT 08-07-201,500,,-543525716.92,Chigbogu,817,France,120819.58,0,1,0
8464,2011,0.5,MORTGAGE,3,Low,1,22000, 60 months,2,debt_consolidation,6,High,2,Good Loan,0,13.49,C,3,21.31,19527.3927,14800,0,340.47,409000008463,12-Jul-18,Indiaforensic NFS SETT 08-07-201,"3,500.00",,-543529216.92,Akabueze,526,Spain,114539.67,0,1,0
8465,2011,8,MORTGAGE,3,Medium,2,12000, 36 months,1,debt_consolidation,6,Low,1,Good Loan,0,5.99,A,1,9.24,13140.07703,12000,0,365.01,409000008464,12-Jul-18,Indiaforensic NFS SETT 08-07-201,"7,000.00",,-543536216.92,Istomin,850,France,154000.99,0,1,0
8466,2011,10,MORTGAGE,3,Medium,2,30000, 60 months,2,debt_consolidation,6,High,2,Good Loan,0,19.69,E,5,15.15,39160.05,30000,0,789.66,409000008465,12-Jul-18,Indiaforensic NFS SETT 08-07-201,800,,-543537016.92,Ndubueze,598,France,137980.58,0,1,0
8467,2011,5,MORTGAGE,3,Medium,2,30000, 60 months,2,debt_consolidation,6,High,2,Good Loan,0,18.79,E,5,2.62,28689.90647,20350,0,525.55,409000008466,12-Jul-18,Indiaforensic NFS SETT 10-07-201,500,,-543537516.92,Toscani,613,France,83343.73,0,1,0
8468,2011,10,MORTGAGE,3,Low,1,6000, 36 months,1,debt_consolidation,6,Low,1,Good Loan,0,11.99,B,2,20.53,6820.51,6000,0,199.26,409000008467,12-Jul-18,Indiaforensic NFS SETT 10-07-201,500,,-543538016.92,Ross,709,Spain,82195.15,0,1,0
8469,2011,3,MORTGAGE,3,Low,1,10000, 36 months,1,house,12,Low,1,Good Loan,0,12.99,C,3,21.97,12026.81,10000,0,336.9,409000008468,12-Jul-18,Indiaforensic NFS SETT 10-07-201,"6,000.00",,-543544016.92,Fernando,678,Spain,149550.95,0,1,0
8470,2011,10,RENT,1,Low,1,8300, 36 months,1,debt_consolidation,6,Low,1,Good Loan,0,10.99,B,2,13.94,9750.303116,8300,0,271.7,409000008469,12-Jul-18,Indiaforensic NFS SETT 10-07-201,"8,000.00",,-543552016.92,McClaran,720,France,197688.50,0,1,0
8471,2011,6,MORTGAGE,3,Low,1,19000, 60 months,2,credit_card,1,High,2,Good Loan,0,16.49,D,4,13.25,24271.04,15459.84,0,467.01,409000008470,12-Jul-18,Indiaforensic NFS SETT 10-07-201,500,,-543552516.92,Yermakova,662,France,72929.96,0,1,0
8472,2011,4,RENT,1,Low,1,25000, 60 months,2,wedding,5,High,2,Good Loan,0,15.99,D,4,14.68,27436.42,22000,0,534.89,409000008471,12-Jul-18,Indiaforensic NFS SETT 10-07-201,"7,000.00",,-543559516.92,Somadina,525,France,171045.35,0,1,0
8473,2011,0.5,MORTGAGE,3,Medium,2,25000, 60 months,2,debt_consolidation,6,High,2,Bad Loan,1,14.79,C,3,20.62,4890.78,2043.17,860.98,403.75,409000008472,12-Jul-18,Indiaforensic NFS SETT 10-07-201,"1,000.00",,-543560516.92,Wan,662,France,27731.05,0,1,0
8474,2011,8,MORTGAGE,3,Medium,2,18000, 60 months,2,medical,9,High,2,Good Loan,0,16.49,D,4,16.82,22258.37,14197.67,0,428.91,409000008473,12-Jul-18,Indiaforensic NFS SETT 10-07-201,"1,000.00",,-543561516.92,Mazzi,770,France,126131.90,0,1,0
8475,2011,4,RENT,1,Low,1,15000, 60 months,2,credit_card,1,Low,1,Good Loan,0,10.99,B,2,20.44,11849.28,8734.52,0,228.25,409000008474,12-Jul-18,Indiaforensic NFS SETT 10-07-201,"8,300.00",,-543569816.92,Tuan,721,Spain,103931.49,0,1,0
8476,2011,8,MORTGAGE,3,Low,1,18000, 60 months,2,debt_consolidation,6,Low,1,Good Loan,0,10.99,B,2,9.33,18957.36,18000,0,391.28,409000008475,12-Jul-18,Indiaforensic NFS SETT 10-07-201,700,,-543570516.92,Townsley,633,Germany,147635.33,0,1,0
8477,2011,10,MORTGAGE,3,Low,1,14000, 60 months,2,credit_card,1,Low,1,Good Loan,0,9.99,B,2,11.57,16027.52,14000,0,297.39,409000008476,12-Jul-18,Indiaforensic NFS SETT 10-07-201,200,,-543570716.92,Yashina,701,France,61961.57,0,1,0
8478,2011,4,OWN,2,Medium,2,7800, 36 months,1,small_business,3,Low,1,Good Loan,0,10.99,B,2,10.78,9184.284946,7800,0,255.33,409000008477,12-Jul-18,Indiaforensic NFS SETT 10-07-201,500,,-543571216.92,Henderson,556,Germany,125435.47,0,1,0
8479,2011,10,RENT,1,Low,1,21000, 60 months,2,debt_consolidation,6,High,2,Bad Loan,1,16.89,D,4,23.53,24390.87,14811.65,0,520.67,409000008478,12-Jul-18,Indiaforensic NFS SETT 10-07-201,"9,000.00",,-543580216.92,Mueller,639,France,42240.54,0,1,0
8480,2011,6,MORTGAGE,3,Low,1,2400, 36 months,1,wedding,5,Low,1,Good Loan,0,5.99,A,1,18.74,2574.33,2400,0,73.01,409000008479,12-Jul-18,Indiaforensic NFS SETT 11-07-201,500,,-543580716.92,Wright,632,France,57942.88,0,1,0
8481,2011,10,RENT,1,Low,1,4000, 36 months,1,debt_consolidation,6,Low,1,Bad Loan,1,5.99,A,1,4.29,1738.45,1253.79,279.25,121.67,409000008480,12-Jul-18,Indiaforensic NFS SETT 11-07-201,"1,300.00",,-543582016.92,Lung,456,France,153419.62,0,1,0
8482,2011,9,MORTGAGE,3,Low,1,12000, 36 months,1,debt_consolidation,6,Low,1,Good Loan,0,9.99,B,2,27.27,13913.1164,12000,0,387.15,409000008481,12-Jul-18,Indiaforensic NFS SETT 11-07-201,"4,500.00",,-543586516.92,Bryant,729,Spain,189727.12,0,1,0
8483,2011,6,RENT,1,Low,1,12000, 36 months,1,debt_consolidation,6,Low,1,Good Loan,0,11.49,B,2,20.51,14235.64828,12000,0,395.66,409000008482,12-Jul-18,Indiaforensic NFS SETT 11-07-201,"1,300.00",,-543587816.92,Madukaife,632,France,165385.55,0,1,0
8484,2011,10,MORTGAGE,3,Medium,2,18000, 36 months,1,debt_consolidation,6,Low,1,Good Loan,0,10.99,B,2,7.69,18165.11,18000,0,589.22,409000008483,12-Jul-18,Indiaforensic NFS SETT 11-07-201,100,,-543587916.92,Maclean,433,Spain,19687.99,0,1,0
8485,2011,4,RENT,1,Low,1,14000, 36 months,1,credit_card,1,Low,1,Good Loan,0,5.42,A,1,6.76,15115.63,14000,0,422.24,409000008484,12-Jul-18,Indiaforensic NFS SETT 11-07-201,"9,000.00",,-543596916.92,Abdullah,802,France,39473.63,0,1,0
8486,2011,6,RENT,1,Low,1,15000, 36 months,1,debt_consolidation,6,Low,1,Good Loan,0,5.99,A,1,4.15,16048.78,15000,0,456.27,409000008485,12-Jul-18,Indiaforensic NFS SETT 11-07-201,"4,000.00",,-543600916.92,Yao,670,France,144723.38,0,1,0
8487,2011,4,OWN,2,Low,1,10500, 60 months,2,debt_consolidation,6,Low,1,Good Loan,0,11.49,B,2,11.61,11942.02,8689.26,0,230.87,409000008486,12-Jul-18,Indiaforensic NFS SETT 11-07-201,"4,000.00",,-543604916.92,Cheatham,738,Germany,194895.57,0,1,0
8488,2011,4,MORTGAGE,3,Low,1,12000, 36 months,1,credit_card,1,Low,1,Good Loan,0,9.99,B,2,7.25,13923.67757,12000,0,387.15,409000008487,12-Jul-18,Indiaforensic NFS SETT 11-07-201,"3,700.00",,-543608616.92,Gallagher,706,Germany,77271.91,0,1,0
8489,2011,1,MORTGAGE,3,Low,1,8000, 36 months,1,other,4,Low,1,Good Loan,0,5.42,A,1,7.96,8685.433429,8000,0,241.28,409000008488,12-Jul-18,Indiaforensic NFS SETT 11-07-201,"1,000.00",,-543609616.92,Hao,592,Germany,105096.82,0,1,0
8490,2011,10,MORTGAGE,3,Medium,2,20000, 60 months,2,home_improvement,7,Low,1,Good Loan,0,11.99,B,2,15.06,23114,16587.07,0,444.79,409000008489,12-Jul-18,Indiaforensic NFS SETT 11-07-201,"2,000.00",,-543611616.92,Nixon,522,France,176780.39,0,1,0
8491,2011,7,OWN,2,Low,1,15000, 36 months,1,home_improvement,7,Low,1,Good Loan,0,9.99,B,2,11.13,17420.05895,15000,0,483.94,409000008490,12-Jul-18,Indiaforensic NFS SETT 11-07-201,400,,-543612016.92,Wang,746,France,153786.46,0,1,0
8492,2011,0.5,RENT,1,Low,1,1500, 36 months,1,vacation,11,Low,1,Bad Loan,1,12.99,C,3,11.75,252.35,160.04,0,50.54,409000008491,12-Jul-18,Indiaforensic NFS SETT 11-07-201,300,,-543612316.92,Kerr,651,Spain,43612.06,0,1,0
8493,2011,6,MORTGAGE,3,Low,1,8400, 36 months,1,debt_consolidation,6,High,2,Good Loan,0,16.89,D,4,7.24,10639.85661,8400,0,299.03,409000008492,12-Jul-18,Indiaforensic NFS SETT 11-07-201,400,,-543612716.92,Romani,494,France,79479.74,0,1,0
8494,2011,2,RENT,1,Low,1,7500, 36 months,1,debt_consolidation,6,Low,1,Good Loan,0,10.99,B,2,19.12,8435.69,7500,0,245.51,409000008493,12-Jul-18,Indiaforensic NFS SETT 11-07-201,200,,-543612916.92,Lock,753,Germany,92320.37,0,1,0
8495,2011,10,MORTGAGE,3,Medium,2,35000, 60 months,2,debt_consolidation,6,High,2,Good Loan,0,13.49,C,3,8.62,25871.03,22425,0,515.89,409000008494,12-Jul-18,Indiaforensic NFS SETT 11-07-201,"1,100.00",,-543614016.92,Millar,671,Germany,193201.86,0,1,0
8496,2011,9,RENT,1,Low,1,1600, 36 months,1,vacation,11,Low,1,Bad Loan,1,7.49,A,1,27.45,703.64,533.44,60.92,49.77,409000008495,12-Jul-18,Indiaforensic NFS SETT 11-07-201,"2,000.00",,-543616016.92,K'ung,696,France,126353.13,0,1,0
8497,2011,7,MORTGAGE,3,Low,1,12000, 36 months,1,debt_consolidation,6,High,2,Good Loan,0,13.49,C,3,16.29,14524.86,12000,0,407.17,409000008496,12-Jul-18,Indiaforensic NFS SETT 11-07-201,500,,-543616516.92,Onyekachi,577,Spain,135008.92,0,1,0
8498,2011,6,RENT,1,Low,1,13200, 60 months,2,other,4,High,2,Bad Loan,1,15.99,D,4,11.93,10168.13,4866.73,1183.24,320.93,409000008497,13-Jul-18,Indiaforensic  RUPAY SETT 130718,"6,988.26",,-543623505.18,Somayina,587,France,17135.60,0,1,0
8499,2011,0.5,MORTGAGE,3,Low,1,16950, 60 months,2,credit_card,1,High,2,Bad Loan,1,16.49,D,4,13.97,9492.17,3755.38,758.29,416.62,409000008498,13-Jul-18,Indiaforensic  RUPAY SETT 130718,302.12,,-543623807.30,Dennis,712,Germany,60651.77,0,1,0
8500,2011,9,RENT,1,Medium,2,6600, 36 months,1,debt_consolidation,6,Low,1,Good Loan,0,10.99,B,2,19.38,7744.511012,6600,0,216.05,409000008499,16-Jul-18,Indiaforensic RUPAY SETT 140718,"3,258.27",,-543627065.57,Brown,498,Germany,188343.05,0,1,0
8501,2011,2,RENT,1,Low,1,14000, 36 months,1,small_business,3,Low,1,Good Loan,0,10.99,B,2,20.4,16494.57077,14000,0,458.28,409000008500,16-Jul-18,Indiaforensic RUPAY SETT 150718,"21,688.44",,-543648754.01,Ogochukwu,660,France,23291.83,0,1,0
8502,2011,2,RENT,1,Low,1,13000, 60 months,2,major_purchase,8,Low,1,Good Loan,0,9.99,B,2,17.79,11230.29,8502.85,0,216.14,409000008501,16-Jul-18,Indiaforensic RUPAY SETT 160718,"41,652.65",,-543690406.66,Macleod,678,Spain,64443.75,0,1,0
8503,2011,10,MORTGAGE,3,Low,1,12000, 36 months,1,credit_card,1,Low,1,Good Loan,0,5.42,A,1,5.74,13027.9632,12000,0,361.92,409000008502,16-Jul-18,Indiaforensic  RUPAY SETT 160718,"6,085.66",,-543696492.32,Page,530,France,287.99,0,1,0
8504,2011,6.05,OWN,2,Low,1,2400, 36 months,1,debt_consolidation,6,Low,1,Bad Loan,1,9.99,B,2,15.56,2160.48,1796.85,0,77.43,409000008503,16-Jul-18,Indiaforensic NFS SETT 13-07-201,"5,000.00",,-543701492.32,Barese,559,France,137961.41,0,1,0
8505,2011,10,MORTGAGE,3,Low,1,20000, 36 months,1,credit_card,1,Low,1,Good Loan,0,5.99,A,1,13.01,21751.41,20000,0,608.35,409000008504,16-Jul-18,Indiaforensic NFS SETT 13-07-201,"5,000.00",,-543706492.32,Agafonova,624,France,72169.95,0,1,0
8506,2011,3,RENT,1,Low,1,8150, 36 months,1,debt_consolidation,6,High,2,Good Loan,0,16.49,D,4,5.76,10381.34884,8150,0,288.51,409000008505,16-Jul-18,Indiaforensic NFS SETT 13-07-201,200,,-543706692.32,Caraway,592,France,39608.58,0,1,0
8507,2011,10,RENT,1,Low,1,28100, 60 months,2,credit_card,1,High,2,Good Loan,0,17.99,E,5,22.23,30010.97,28100,0,713.41,409000008506,16-Jul-18,Indiaforensic NFS SETT 13-07-201,"2,000.00",,-543708692.32,Stevenson,767,France,175458.21,0,1,0
8508,2011,4,MORTGAGE,3,Medium,2,28000, 36 months,1,wedding,5,Low,1,Good Loan,0,7.49,A,1,12.7,29687.42,28000.01,0,870.85,409000008507,16-Jul-18,Indiaforensic NFS SETT 13-07-201,"8,500.00",,-543717192.32,Duncan,653,Germany,89524.83,0,1,0
8509,2011,5,OWN,2,Low,1,7200, 36 months,1,debt_consolidation,6,Low,1,Bad Loan,1,8.49,A,1,21.6,7792.72,6725.42,95.17,227.26,409000008508,16-Jul-18,Indiaforensic NFS SETT 13-07-201,"7,500.00",,-543724692.32,Wang,678,Spain,13221.25,0,1,0
8510,2011,10,MORTGAGE,3,Medium,2,20000, 60 months,2,debt_consolidation,6,High,2,Bad Loan,1,16.49,D,4,11.32,20470.46,11047.4,1334.48,491.59,409000008509,16-Jul-18,Indiaforensic NFS SETT 13-07-201,"1,000.00",,-543725692.32,Kaur,586,Spain,102889.34,0,1,0
8511,2011,1,RENT,1,Low,1,5000, 36 months,1,moving,10,Low,1,Bad Loan,1,10.99,B,2,8.34,3723.19,2845.66,138.02,163.67,409000008510,16-Jul-18,Indiaforensic NFS SETT 13-07-201,"5,000.00",,-543730692.32,Jenkins,550,France,166468.21,0,1,0
8512,2011,2,MORTGAGE,3,High,3,28000, 60 months,2,house,12,High,2,Good Loan,0,18.79,E,5,11.31,40836.45992,28000,0,723.11,409000008511,16-Jul-18,Indiaforensic NFS SETT 13-07-201,"7,000.00",,-543737692.32,Edwards,643,Germany,27149.27,0,1,0
8513,2011,10,MORTGAGE,3,Low,1,21000, 36 months,1,debt_consolidation,6,Low,1,Good Loan,0,11.99,B,2,19.13,25105.9452,21000,0,697.41,409000008512,16-Jul-18,Indiaforensic NFS SETT 13-07-201,"1,000.00",,-543738692.32,Kelly,612,Spain,59601.15,0,1,0
8514,2011,2,RENT,1,Low,1,4200, 36 months,1,house,12,High,2,Good Loan,0,14.79,C,3,6.15,4941.9,4200,0,145.17,409000008513,16-Jul-18,Indiaforensic NFS SETT 13-07-201,"10,000.00",,-543748692.32,Boyle,674,Germany,22026.18,0,1,0
8515,2011,4,MORTGAGE,3,Medium,2,10000, 36 months,1,credit_card,1,Low,1,Good Loan,0,5.99,A,1,11.29,10541.45,10000,0,304.18,409000008514,16-Jul-18,Indiaforensic NFS SETT 13-07-201,"4,000.00",,-543752692.32,Loane,657,Spain,153059.62,0,1,0
8516,2011,8,MORTGAGE,3,Low,1,5900, 36 months,1,car,2,Low,1,Good Loan,0,5.99,A,1,20.5,6460.423825,5900,0,179.47,409000008515,16-Jul-18,Indiaforensic NFS SETT 14-07-201,"1,000.00",,-543753692.32,Padovano,724,Germany,167313.07,0,1,0
8517,2011,4,RENT,1,Low,1,15000, 36 months,1,debt_consolidation,6,Low,1,Good Loan,0,7.49,A,1,17.06,16790.96178,15000,0,466.53,409000008516,16-Jul-18,Indiaforensic NFS SETT 14-07-201,500,,-543754192.32,Li Fonti,500,France,12833.96,0,1,0
8518,2011,2,RENT,1,Low,1,16000, 36 months,1,other,4,Low,1,Bad Loan,1,12.99,C,3,10.28,10204.53,7219.1,512.97,539.03,409000008517,16-Jul-18,Indiaforensic NFS SETT 14-07-201,"4,000.00",,-543758192.32,Robinson,688,France,197582.79,0,1,0
8519,2011,0.5,MORTGAGE,3,Medium,2,22000, 36 months,1,credit_card,1,Low,1,Good Loan,0,6.99,A,1,6.44,24479.04162,22000,0,679.2,409000008518,16-Jul-18,Indiaforensic NFS SETT 14-07-201,"8,000.00",,-543766192.32,Geach,599,France,4033.39,0,1,0
8520,2011,4,MORTGAGE,3,Low,1,12000, 36 months,1,debt_consolidation,6,Low,1,Good Loan,0,8.49,A,1,17.46,13515.13,12000,0,378.76,409000008519,16-Jul-18,Indiaforensic NFS SETT 14-07-201,"1,500.00",,-543767692.32,Payne,631,France,125877.22,0,1,0
8521,2011,10,RENT,1,Low,1,13000, 60 months,2,car,2,High,2,Bad Loan,1,13.49,C,3,3.52,9214.52,3212.65,3543.78,299.07,409000008520,16-Jul-18,Indiaforensic NFS SETT 14-07-201,"10,000.00",,-543777692.32,Chinonyelum,634,Spain,176913.42,0,1,0
8522,2011,10,MORTGAGE,3,Low,1,10000, 36 months,1,debt_consolidation,6,Low,1,Good Loan,0,10.99,B,2,12.02,11773.93874,10000,0,327.34,409000008521,16-Jul-18,Indiaforensic NFS SETT 14-07-201,"10,000.00",,-543787692.32,Watkins,545,France,105476.65,0,1,0
8523,2011,5,RENT,1,Low,1,12000, 36 months,1,debt_consolidation,6,Low,1,Good Loan,0,11.99,B,2,9.12,14066.45,12000,0,398.52,409000008522,16-Jul-18,Indiaforensic NFS SETT 14-07-201,300,,-543787992.32,Page,644,Spain,59172.42,0,1,0
8524,2011,10,OWN,2,Low,1,12000, 60 months,2,debt_consolidation,6,Low,1,Good Loan,0,10.59,B,2,14.67,14396,12000,0,258.47,409000008523,16-Jul-18,Indiaforensic NFS SETT 14-07-201,"6,000.00",,-543793992.32,Genovese,690,Germany,108731.02,0,1,0
8525,2011,10,MORTGAGE,3,Low,1,1700, 36 months,1,major_purchase,8,Low,1,Good Loan,0,8.49,A,1,12.23,1929.820849,1700,0,53.66,409000008524,16-Jul-18,Indiaforensic NFS SETT 14-07-201,500,,-543794492.32,Watson,711,France,175310.38,0,1,0
8526,2011,8,MORTGAGE,3,Low,1,12900, 60 months,2,small_business,3,High,2,Bad Loan,1,16.49,D,4,17.07,9164.41,4130.23,1250.91,317.08,409000008525,16-Jul-18,Indiaforensic NFS SETT 14-07-201,800,,-543795292.32,Mancini,712,France,38170.04,0,1,0
8527,2011,2,RENT,1,Low,1,12000, 36 months,1,debt_consolidation,6,Low,1,Good Loan,0,10.99,B,2,20.56,14135.60468,12000,0,392.81,409000008526,16-Jul-18,Indiaforensic NFS SETT 14-07-201,"8,000.00",,-543803292.32,Chibueze,627,France,105887.04,0,1,0
8528,2011,5,RENT,1,Low,1,3000, 36 months,1,small_business,3,Low,1,Good Loan,0,10.99,B,2,10.52,3508.42,3000,0,98.21,409000008527,16-Jul-18,Indiaforensic NFS SETT 14-07-201,"6,500.00",,-543809792.32,Hunter,694,Spain,95625.03,0,1,0
8529,2011,3,RENT,1,Low,1,5600, 36 months,1,small_business,3,Low,1,Good Loan,0,10.59,B,2,0.4,6059.13,5600,0,182.26,409000008528,16-Jul-18,Indiaforensic NFS SETT 14-07-201,"10,000.00",,-543819792.32,Buchi,534,Spain,9541.15,0,1,0
8530,2011,5,MORTGAGE,3,Medium,2,3375, 36 months,1,home_improvement,7,High,2,Good Loan,0,14.79,C,3,0.5,3573.38,3375,0,116.65,409000008529,16-Jul-18,Indiaforensic NFS SETT 14-07-201,"8,000.00",,-543827792.32,Charteris,603,France,148516.79,0,1,0
8531,2011,0.5,RENT,1,Low,1,5000, 36 months,1,debt_consolidation,6,Low,1,Bad Loan,1,12.99,C,3,5.28,1681.5,1198.44,0,168.45,409000008530,16-Jul-18,Indiaforensic NFS SETT 14-07-201,"9,000.00",,-543836792.32,Aksenov,808,France,113907.80,0,1,0
8532,2011,5,MORTGAGE,3,Medium,2,20000, 36 months,1,home_improvement,7,Low,1,Good Loan,0,6.99,A,1,8.44,22226.87495,20000,0,617.46,409000008531,16-Jul-18,Indiaforensic NFS SETT 14-07-201,"9,000.00",,-543845792.32,Wright,723,Spain,164647.72,0,1,0
8533,2011,4,RENT,1,Low,1,17000, 36 months,1,debt_consolidation,6,Low,1,Good Loan,0,11.49,B,2,13.69,19639.79,17000,0,560.52,409000008532,16-Jul-18,Indiaforensic NFS SETT 15-07-201,"1,000.00",,-543846792.32,Lu,585,France,98621.04,0,1,0
8534,2011,1,MORTGAGE,3,Low,1,15000, 60 months,2,debt_consolidation,6,High,2,Bad Loan,1,14.79,C,3,18.12,7095.8,3832.03,0,355.2,409000008533,16-Jul-18,Indiaforensic NFS SETT 15-07-201,"5,000.00",,-543851792.32,K?,706,France,37479.97,0,1,0
8535,2011,6,RENT,1,Low,1,13000, 36 months,1,debt_consolidation,6,Low,1,Bad Loan,1,5.99,A,1,6.6,9489.36,8404.57,0,395.43,409000008534,16-Jul-18,Indiaforensic NFS SETT 15-07-201,200,,-543851992.32,Hou,671,France,15846.42,0,1,0
8536,2011,10,MORTGAGE,3,Low,1,12000, 36 months,1,home_improvement,7,Low,1,Good Loan,0,5.99,A,1,1.47,13140.19648,12000,0,365.01,409000008535,16-Jul-18,Indiaforensic NFS SETT 15-07-201,200,,-543852192.32,Descoteaux,597,Spain,5104.08,0,1,0
8537,2011,10,MORTGAGE,3,Low,1,5000, 36 months,1,wedding,5,Low,1,Good Loan,0,10.59,B,2,18.61,5804.42,5000,0,162.73,409000008536,16-Jul-18,Indiaforensic NFS SETT 15-07-201,"6,000.00",,-543858192.32,Stephenson,646,France,61937.60,0,1,0
8538,2011,10,MORTGAGE,3,Low,1,4800, 36 months,1,debt_consolidation,6,Low,1,Good Loan,0,7.49,A,1,15.63,5371.441265,4800,0,149.29,409000008537,16-Jul-18,Indiaforensic NFS SETT 15-07-201,"1,500.00",,-543859692.32,Cooper,801,Spain,170008.74,0,1,0
8539,2011,10,MORTGAGE,3,Low,1,15000, 36 months,1,debt_consolidation,6,Low,1,Good Loan,0,9.99,B,2,21.64,16958.47,15000,0,483.94,409000008538,16-Jul-18,Indiaforensic NFS SETT 15-07-201,400,,-543860092.32,Crump,731,Spain,165000.68,0,1,0
8540,2011,7,RENT,1,Low,1,32000, 60 months,2,debt_consolidation,6,Low,1,Good Loan,0,11.99,B,2,15.54,26950.97201,20575,0,457.58,409000008539,17-Jul-18,Indiaforensic  RUPAY SETT 170718,"10,469.36",,-543870561.68,Diggs,620,Germany,76197.05,0,1,0
8541,2011,0.5,RENT,1,Low,1,6000, 36 months,1,moving,10,High,2,Good Loan,0,15.99,D,4,8.85,7585.730734,6000,0,210.92,409000008540,17-Jul-18,TRF FROM  Indiaforensic SERVICES,,109225.00,-543761336.68,Shih,484,Germany,118045.98,0,1,0
8542,2011,5,MORTGAGE,3,Medium,2,15000, 36 months,1,debt_consolidation,6,Low,1,Good Loan,0,6.99,A,1,7.15,16670.43094,15000,0,463.09,409000008541,17-Jul-18,OXYGEN NFS SETT 12-07-201,100,,-543761436.68,Hudson,647,Spain,157360.90,0,1,0
8543,2011,3,RENT,1,Low,1,12000, 60 months,2,other,4,High,2,Bad Loan,1,15.99,D,4,5.57,14829.75,9515.24,0,291.76,409000008542,17-Jul-18,OXYGEN NFS SETT 12-07-201,"4,500.00",,-543765936.68,Carvosso,688,Germany,196226.38,0,1,0
8544,2011,10,RENT,1,Low,1,14000, 60 months,2,debt_consolidation,6,Low,1,Good Loan,0,7.49,A,1,12.21,16345.75721,14000,0,280.47,409000008543,17-Jul-18,OXYGEN NFS SETT 12-07-201,"6,000.00",,-543771936.68,Wyatt,680,Germany,44384.57,0,1,0
8545,2011,0.5,MORTGAGE,3,Low,1,15000, 60 months,2,major_purchase,8,High,2,Good Loan,0,18.39,E,5,12.43,15683.24,15000,0,384.1,409000008544,17-Jul-18,OXYGEN NFS SETT 12-07-201,500,,-543772436.68,Kodilinyechukwu,689,France,72993.65,0,1,0
8546,2011,10,MORTGAGE,3,Low,1,13000, 60 months,2,car,2,Low,1,Good Loan,0,8.49,A,1,11.74,14245.21,13000,0,266.66,409000008545,17-Jul-18,OXYGEN NFS SETT 12-07-201,"3,000.00",,-543775436.68,Vorobyova,513,Germany,124571.09,0,1,0
8547,2011,5,MORTGAGE,3,Low,1,35000, 60 months,2,other,4,Low,1,Good Loan,0,11.49,B,2,5.02,25710.18,18701.13,0,495.28,409000008546,17-Jul-18,OXYGEN NFS SETT 12-07-201,500,,-543775936.68,Piccio,553,Germany,43640.16,0,1,0
8548,2011,10,MORTGAGE,3,Medium,2,35000, 60 months,2,debt_consolidation,6,High,2,Bad Loan,1,16.49,D,4,10.62,26536.95,13867.96,2010.27,683.31,409000008547,17-Jul-18,OXYGEN NFS SETT 12-07-201,500,,-543776436.68,Hsing,689,Germany,31121.42,0,1,0
8549,2011,10,MORTGAGE,3,Low,1,14125, 60 months,2,credit_card,1,Low,1,Good Loan,0,8.49,A,1,13.58,15063.23,11877.05,0,289.73,409000008548,17-Jul-18,OXYGEN NFS SETT 12-07-201,"3,000.00",,-543779436.68,Lucas,517,Spain,22372.78,0,1,0
8550,2011,3,RENT,1,Low,1,7550, 36 months,1,debt_consolidation,6,High,2,Bad Loan,1,14.79,C,3,13.47,8266.11,6275.1,198.99,260.95,409000008549,17-Jul-18,OXYGEN NFS SETT 12-07-201,"2,500.00",,-543781936.68,T'ang,731,France,170338.35,0,1,0
8551,2011,9,RENT,1,Medium,2,17000, 36 months,1,car,2,Low,1,Good Loan,0,12.99,C,3,16.26,20155.52,17000,0,572.72,409000008550,17-Jul-18,OXYGEN NFS SETT 12-07-201,300,,-543782236.68,North,687,Germany,158845.49,0,1,0
8552,2011,4,MORTGAGE,3,High,3,35000, 60 months,2,debt_consolidation,6,High,2,Good Loan,0,20.25,F,6,17.39,50111.70387,35000,0,932.17,409000008551,17-Jul-18,OXYGEN NFS SETT 12-07-201,"6,500.00",,-543788736.68,Thompson,507,Spain,67926.18,0,1,0
8553,2011,4,OWN,2,Low,1,9200, 60 months,2,small_business,3,High,2,Good Loan,0,14.79,C,3,8.61,11318.41,7544.75,0,217.86,409000008552,17-Jul-18,OXYGEN NFS SETT 12-07-201,100,,-543788836.68,Simpson,468,France,194783.12,0,1,0
8554,2011,3,RENT,1,Low,1,1500, 36 months,1,credit_card,1,Low,1,Good Loan,0,7.49,A,1,15.15,1580.48,1500,0,46.66,409000008553,17-Jul-18,OXYGEN NFS SETT 12-07-201,"2,500.00",,-543791336.68,Nwora,682,Spain,176036.01,0,1,0
8555,2011,2,RENT,1,Low,1,14400, 60 months,2,debt_consolidation,6,High,2,Good Loan,0,13.99,C,3,14.22,17918.47,14400,0,334.99,409000008554,17-Jul-18,OXYGEN NFS SETT 12-07-201,100,,-543791436.68,Chandler,603,France,198826.03,0,1,0
8556,2011,10,OWN,2,Low,1,16750, 60 months,2,debt_consolidation,6,Low,1,Good Loan,0,11.99,B,2,15.85,20262.88,16750,0,372.51,409000008555,17-Jul-18,OXYGEN NFS SETT 12-07-201,"4,400.00",,-543795836.68,Uspensky,522,Germany,168683.57,0,1,0
8557,2011,10,OWN,2,Medium,2,13500, 60 months,2,major_purchase,8,Low,1,Good Loan,0,9.99,B,2,28.22,17030.48634,13500,0,286.77,409000008556,17-Jul-18,OXYGEN NFS SETT 12-07-201,300,,-543796136.68,Ferguson,629,Spain,6936.27,0,1,0
8558,2011,6.05,OWN,2,Low,1,2000, 36 months,1,small_business,3,Low,1,Good Loan,0,7.49,A,1,1.98,2253.635096,2000,0,62.21,409000008557,17-Jul-18,TRF FROM  Indiaforensic SERVICES,,50000.00,-543746136.68,Kerr,729,France,179230.23,0,1,0
8559,2011,10,MORTGAGE,3,Medium,2,18000, 36 months,1,small_business,3,Low,1,Good Loan,0,11.49,B,2,9.22,21362.45276,18000,0,593.49,409000008558,17-Jul-18,Indiaforensic  RUPAY SETT 170718,190.71,,-543746327.39,Furneaux,574,France,103421.91,0,1,0
8560,2011,6.05,RENT,1,Low,1,25475, 36 months,1,credit_card,1,High,2,Good Loan,0,15.99,D,4,20.29,32223.45455,25475,0,895.5,409000008559,18-Jul-18,Indiaforensic  RUPAY SETT 180718,300.67,,-543746628.06,Kambinachi,677,Germany,147578.26,0,1,0
8561,2011,3,MORTGAGE,3,High,3,18000, 36 months,1,home_improvement,7,Low,1,Good Loan,0,11.49,B,2,9.73,20249.22,18000,0,593.49,409000008560,18-Jul-18,Indiaforensic NFS SETT 16-07-201,"4,000.00",,-543750628.06,Black,627,Germany,130504.49,0,1,0
8562,2011,10,OWN,2,Low,1,2500, 36 months,1,car,2,Low,1,Good Loan,0,5.42,A,1,9.2,2511.64,2500,0,75.4,409000008561,18-Jul-18,Indiaforensic NFS SETT 16-07-201,"1,000.00",,-543751628.06,Chizoba,788,Spain,16149.13,0,1,0
8563,2011,0.5,MORTGAGE,3,Medium,2,16800, 36 months,1,debt_consolidation,6,High,2,Good Loan,0,15.62,D,4,5.48,19943.37,16800,0,587.5,409000008562,18-Jul-18,Indiaforensic NFS SETT 16-07-201,"1,900.00",,-543753528.06,Peng,697,France,118862.08,0,1,0
8564,2011,0.5,RENT,1,Low,1,9600, 36 months,1,small_business,3,High,2,Good Loan,0,13.49,C,3,15.75,11718.08695,9600,0,325.74,409000008563,18-Jul-18,Indiaforensic NFS SETT 16-07-201,"2,000.00",,-543755528.06,Leach,578,France,143397.14,0,1,0
8565,2011,10,MORTGAGE,3,Low,1,26500, 60 months,2,house,12,Low,1,Good Loan,0,10.99,B,2,5.79,29914.49,22051.54,0,576.05,409000008564,18-Jul-18,Indiaforensic NFS SETT 16-07-201,"2,000.00",,-543757528.06,Chiazagomekpele,519,France,137959.00,0,1,0
8566,2011,8,MORTGAGE,3,Low,1,30000, 60 months,2,debt_consolidation,6,High,2,Good Loan,0,19.29,E,5,13.39,33267.69,30000,0,783.02,409000008565,18-Jul-18,Indiaforensic NFS SETT 16-07-201,600,,-543758128.06,Nickson,632,France,93702.96,0,1,0
8567,2011,4,OWN,2,Low,1,5000, 36 months,1,debt_consolidation,6,Low,1,Good Loan,0,10.99,B,2,26.84,5887.747145,5000,0,163.67,409000008566,18-Jul-18,Indiaforensic NFS SETT 16-07-201,"2,000.00",,-543760128.06,Lin,679,France,172939.30,0,1,0
8568,2011,6,RENT,1,Low,1,13250, 60 months,2,debt_consolidation,6,High,2,Bad Loan,1,16.89,D,4,21,9502.16,4204.19,1289.39,328.52,409000008567,18-Jul-18,Indiaforensic NFS SETT 16-07-201,"2,000.00",,-543762128.06,Alexeieva,699,France,108162.13,0,1,0
8569,2011,10,OWN,2,Low,1,10400, 60 months,2,major_purchase,8,Low,1,Good Loan,0,12.99,C,3,5.99,13036.12,9751.89,0,236.58,409000008568,18-Jul-18,Indiaforensic NFS SETT 16-07-201,"2,000.00",,-543764128.06,Sykes,615,France,35896.09,0,1,0
8570,2011,3,OWN,2,Low,1,4500, 36 months,1,other,4,Low,1,Good Loan,0,12.99,C,3,12.65,5455.945062,4500,0,151.61,409000008569,18-Jul-18,Indiaforensic NFS SETT 17-07-201,"9,000.00",,-543773128.06,Martin,622,Spain,104852.60,0,1,0
8571,2011,10,MORTGAGE,3,Low,1,16000, 60 months,2,medical,9,Low,1,Good Loan,0,10.99,B,2,23.15,19433.09,16000,0,347.8,409000008570,18-Jul-18,Indiaforensic NFS SETT 17-07-201,"8,500.00",,-543781628.06,Herz,755,France,188850.89,0,1,0
8572,2011,3,MORTGAGE,3,Medium,2,5000, 36 months,1,debt_consolidation,6,Low,1,Good Loan,0,5.42,A,1,18.29,5443.033738,5000,0,150.8,409000008571,18-Jul-18,Indiaforensic NFS SETT 17-07-201,"2,000.00",,-543783628.06,Nikitina,767,France,28615.80,0,1,0
8573,2011,10,RENT,1,Low,1,12000, 60 months,2,debt_consolidation,6,High,2,Bad Loan,1,19.69,E,5,12.03,2841.92,1139.09,10.7,315.87,409000008572,18-Jul-18,Indiaforensic NFS SETT 17-07-201,"1,500.00",,-543785128.06,Ko,752,Germany,172001.44,0,1,0
8574,2011,1,MORTGAGE,3,Medium,2,28000, 36 months,1,debt_consolidation,6,Low,1,Bad Loan,1,12.99,C,3,15.14,20751.38,15793.74,16.16,943.3,409000008573,18-Jul-18,Indiaforensic NFS SETT 17-07-201,300,,-543785428.06,Highett,633,France,60116.57,0,1,0
8575,2011,10,OWN,2,Low,1,12000, 36 months,1,car,2,Low,1,Good Loan,0,12.99,C,3,16.32,14194.27,12000,0,404.27,409000008574,18-Jul-18,Indiaforensic NFS SETT 17-07-201,"6,200.00",,-543791628.06,Jackson,717,France,170528.63,0,1,0
8576,2011,7,RENT,1,Low,1,6000, 36 months,1,debt_consolidation,6,High,2,Good Loan,0,15.23,C,3,7.68,7502.991284,6000,0,208.67,409000008575,18-Jul-18,Indiaforensic NFS SETT 17-07-201,"7,100.00",,-543798728.06,Ball,585,Spain,189683.70,0,1,0
8577,2011,0.5,RENT,1,Low,1,14000, 60 months,2,debt_consolidation,6,High,2,Bad Loan,1,18.79,E,5,8.19,10286.85,4100.85,1425.81,361.56,409000008576,18-Jul-18,Indiaforensic NFS SETT 17-07-201,"10,000.00",,-543808728.06,Nelson,751,France,49734.94,0,1,0
8578,2011,10,MORTGAGE,3,Medium,2,25000, 36 months,1,credit_card,1,High,2,Good Loan,0,13.49,C,3,12.81,30627.50082,25000,0,848.27,409000008577,18-Jul-18,Indiaforensic NFS SETT 17-07-201,"7,700.00",,-543816428.06,Woronoff,754,Germany,121529.59,0,1,0
8579,2011,3,MORTGAGE,3,Low,1,8000, 36 months,1,debt_consolidation,6,Low,1,Good Loan,0,5.42,A,1,9.27,8233.36,7999.99,0,241.28,409000008578,18-Jul-18,Indiaforensic NFS SETT 17-07-201,"3,000.00",,-543819428.06,Morrison,495,France,71071.47,0,1,0
8580,2011,10,OWN,2,Low,1,24000, 36 months,1,debt_consolidation,6,Low,1,Good Loan,0,7.49,A,1,15.63,26620.76,24000,0,746.44,409000008579,18-Jul-18,Indiaforensic NFS SETT 17-07-201,"5,000.00",,-543824428.06,Smith,650,France,142995.32,0,1,0
8581,2011,10,MORTGAGE,3,Low,1,6000, 36 months,1,debt_consolidation,6,Low,1,Bad Loan,1,11.99,B,2,9.15,3204.4,2240.31,216.08,199.26,409000008580,18-Jul-18,Indiaforensic NFS SETT 17-07-201,"6,900.00",,-543831328.06,Rendall,529,France,13054.25,0,1,0
8582,2011,1,RENT,1,Low,1,6000, 36 months,1,credit_card,1,Low,1,Bad Loan,1,11.99,B,2,14.73,6484.44,5219.6,109.52,199.26,409000008581,18-Jul-18,Indiaforensic NFS SETT 17-07-201,"10,000.00",,-543841328.06,McIntyre,585,France,89402.54,0,1,0
8583,2011,3,RENT,1,Low,1,4100, 60 months,2,small_business,3,High,2,Good Loan,0,20.25,F,6,3.38,5867.575539,4100,0,109.2,409000008582,18-Jul-18,Indiaforensic NFS SETT 17-07-201,"10,000.00",,-543851328.06,Wei,668,Spain,111241.37,0,1,0
8584,2011,4,MORTGAGE,3,Low,1,35000, 60 months,2,debt_consolidation,6,Low,1,Good Loan,0,11.99,B,2,19.92,29306.1958,22500,0,500.39,409000008583,18-Jul-18,Indiaforensic NFS SETT 17-07-201,"10,000.00",,-543861328.06,Allardyce,591,France,119638.85,0,1,0
8585,2011,0.5,MORTGAGE,3,Low,1,18000, 60 months,2,debt_consolidation,6,High,2,Bad Loan,1,15.99,D,4,10.76,3474.45,1268.27,584.89,437.63,409000008584,18-Jul-18,Indiaforensic NFS SETT 17-07-201,"1,000.00",,-543862328.06,Cremonesi,731,France,151581.79,0,1,0
8586,2011,10,MORTGAGE,3,Low,1,20000, 36 months,1,debt_consolidation,6,Low,1,Good Loan,0,7.49,A,1,13.59,21288.13,20000,0,622.04,409000008585,18-Jul-18,Indiaforensic NFS SETT 17-07-201,"10,000.00",,-543872328.06,Weatherford,754,France,73881.68,0,1,0
8587,2011,3,MORTGAGE,3,Low,1,28000, 36 months,1,debt_consolidation,6,High,2,Good Loan,0,15.62,D,4,5.7,34000.96,28000,0,979.16,409000008586,18-Jul-18,Indiaforensic NFS SETT 17-07-201,"10,000.00",,-543882328.06,Jen,650,Germany,176902.83,0,1,0
8588,2011,4,OWN,2,Low,1,15000, 36 months,1,credit_card,1,Low,1,Good Loan,0,5.42,A,1,4.35,16285.84224,15000,0,452.4,409000008587,18-Jul-18,Indiaforensic NFS SETT 17-07-201,"10,000.00",,-543892328.06,Macleod,588,Germany,7034.94,0,1,0
8589,2011,4,MORTGAGE,3,Low,1,15000, 36 months,1,debt_consolidation,6,Low,1,Good Loan,0,11.99,B,2,12.76,16337.92,15000,0,498.15,409000008588,18-Jul-18,Indiaforensic NFS SETT 17-07-201,400,,-543892728.06,Mironova,712,Spain,122547.58,0,1,0
8590,2011,10,OWN,2,Low,1,16000, 60 months,2,debt_consolidation,6,High,2,Good Loan,0,19.69,E,5,22.21,12290.37,11375,0,299.41,409000008589,18-Jul-18,Indiaforensic NFS SETT 17-07-201,"2,500.00",,-543895228.06,Sharpe,691,France,161559.12,0,1,0
8591,2011,0.5,RENT,1,Low,1,14000, 36 months,1,debt_consolidation,6,Low,1,Good Loan,0,9.99,B,2,12.46,15035.47,14000,0,451.68,409000008590,18-Jul-18,Indiaforensic NFS SETT 17-07-201,500,,-543895728.06,Osborne,771,France,137510.41,0,1,0
8592,2011,10,MORTGAGE,3,Low,1,12000, 36 months,1,home_improvement,7,Low,1,Good Loan,0,5.99,A,1,16.24,13122.15759,12000,0,365.01,409000008591,18-Jul-18,Indiaforensic  RUPAY SETT 180718,115.15,,-543895843.21,Chu,678,Spain,185366.56,0,1,0
8593,2011,6,OWN,2,Low,1,19750, 36 months,1,debt_consolidation,6,Low,1,Good Loan,0,7.49,A,1,25.22,22112.17773,19750,0,614.26,409000008592,19-Jul-18,Indiaforensic  RUPAY SETT 190718,134.72,,-543895977.93,Chong,719,Spain,182224.14,0,1,0
8594,2011,0.5,RENT,1,Low,1,4000, 36 months,1,major_purchase,8,High,2,Good Loan,0,15.99,D,4,1.98,5057.641912,4000,0,140.61,409000008593,19-Jul-18,Indiaforensic  RUPAY SETT 190718,"3,221.42",,-543899199.35,Alvarez,610,Germany,42581.04,0,1,0
8595,2011,4,RENT,1,Low,1,4000, 36 months,1,debt_consolidation,6,Low,1,Good Loan,0,11.49,B,2,2.89,4744.905226,4000,0,131.89,409000008594,20-Jul-18,Indiaforensic  RUPAY SETT 200718,974.37,,-543900173.72,Palerma,722,Spain,31921.95,0,1,0
8596,2011,3,RENT,1,Low,1,6000, 36 months,1,moving,10,Low,1,Good Loan,0,6.99,A,1,21.5,6490.14,6000,0,185.24,409000008595,20-Jul-18,Indiaforensic NFS SETT 19-07-201,900,,-543901073.72,Chiemenam,758,Germany,102460.84,0,1,0
8597,2011,10,MORTGAGE,3,Medium,2,14500, 36 months,1,home_improvement,7,Low,1,Good Loan,0,5.42,A,1,7.15,15742.47697,14500,0,437.32,409000008596,20-Jul-18,Indiaforensic NFS SETT 19-07-201,100,,-543901173.72,Pritchard,709,France,109681.29,0,1,0
8598,2011,10,MORTGAGE,3,Low,1,17850, 60 months,2,debt_consolidation,6,High,2,Bad Loan,1,18.39,E,5,23.37,19389.28,9569.49,1125.38,457.07,409000008597,20-Jul-18,Indiaforensic NFS SETT 19-07-201,"1,000.00",,-543902173.72,Wallis,634,Germany,106345.05,0,1,0
8599,2011,5,MORTGAGE,3,Medium,2,25000, 60 months,2,credit_card,1,High,2,Good Loan,0,20.62,F,6,9.43,37402.17379,25000,0,671.01,409000008598,20-Jul-18,Indiaforensic NFS SETT 19-07-201,"2,000.00",,-543904173.72,Palerma,678,Spain,102472.90,0,1,0
8600,2011,10,OWN,2,Low,1,10000, 36 months,1,debt_consolidation,6,Low,1,Good Loan,0,9.99,B,2,20.13,11611.41087,10000,0,322.63,409000008599,20-Jul-18,Indiaforensic NFS SETT 19-07-201,100,,-543904273.72,Hill,633,France,36249.76,0,1,0
8601,2011,5,MORTGAGE,3,Medium,2,20000, 60 months,2,debt_consolidation,6,High,2,Good Loan,0,17.49,D,4,16.17,20862.68,20000,0,502.34,409000008600,20-Jul-18,Indiaforensic NFS SETT 19-07-201,"1,000.00",,-543905273.72,Hudson,710,France,32996.89,0,1,0
8602,2011,10,MORTGAGE,3,Low,1,16800, 60 months,2,debt_consolidation,6,Low,1,Good Loan,0,11.99,B,2,8.71,21353.42366,16800,0,373.63,409000008601,20-Jul-18,Indiaforensic NFS SETT 19-07-201,100,,-543905373.72,Chung,640,Germany,195123.94,0,1,0
8603,2011,2,MORTGAGE,3,Low,1,10400, 36 months,1,debt_consolidation,6,Low,1,Good Loan,0,5.99,A,1,14.9,10897.52,10400,0,316.35,409000008602,20-Jul-18,Indiaforensic NFS SETT 19-07-201,200,,-543905573.72,Zhdanova,656,France,57014.43,0,1,0
8604,2011,7,MORTGAGE,3,Low,1,13600, 60 months,2,debt_consolidation,6,High,2,Bad Loan,1,14.79,C,3,16.65,6754.86,3671.29,0,322.05,409000008603,20-Jul-18,Indiaforensic NFS SETT 19-07-201,320,,-543905893.72,Fraser,551,France,159483.76,0,1,0
8605,2011,8,MORTGAGE,3,Low,1,3900, 36 months,1,credit_card,1,Low,1,Good Loan,0,12.99,C,3,19.04,4568.03,3900,0,131.39,409000008604,20-Jul-18,Indiaforensic NFS SETT 19-07-201,"2,500.00",,-543908393.72,Meng,786,Spain,100929.59,0,1,0
8606,2011,5,MORTGAGE,3,Low,1,15000, 60 months,2,debt_consolidation,6,Low,1,Bad Loan,1,12.99,C,3,7.44,2531.87,1094.29,499.85,341.22,409000008605,20-Jul-18,Indiaforensic NFS SETT 19-07-201,"2,800.00",,-543911193.72,Cherkasova,561,France,12513.07,0,1,0
8607,2011,2,RENT,1,Low,1,14000, 36 months,1,credit_card,1,Low,1,Good Loan,0,9.99,B,2,6.68,16251.27578,14000,0,451.68,409000008606,20-Jul-18,Indiaforensic NFS SETT 19-07-201,"1,000.00",,-543912193.72,Rawlings,807,Spain,74900.90,0,1,0
8608,2011,10,MORTGAGE,3,Low,1,16000, 60 months,2,debt_consolidation,6,High,2,Good Loan,0,15.99,D,4,9.63,20514.83,13347.9,0,389.01,409000008607,20-Jul-18,Indiaforensic NFS SETT 19-07-201,"4,000.00",,-543916193.72,Jen,602,Germany,137111.89,0,1,0
8609,2011,5,MORTGAGE,3,Low,1,18250, 60 months,2,debt_consolidation,6,High,2,Bad Loan,1,17.49,D,4,14.26,5513.4,2049.89,941.3,458.39,409000008608,20-Jul-18,Indiaforensic NFS SETT 19-07-201,200,,-543916393.72,Chien,727,Germany,60212.51,0,1,0
8610,2011,8,RENT,1,Low,1,30000, 36 months,1,credit_card,1,Low,1,Good Loan,0,7.49,A,1,21.58,33437.37012,30000,0,933.05,409000008609,20-Jul-18,Indiaforensic  RUPAY SETT 200718,"4,001.42",,-543920395.14,Gorbunov,678,France,187343.40,0,1,0
8611,2011,2,RENT,1,Medium,2,21000, 36 months,1,other,4,High,2,Good Loan,0,16.49,D,4,17.09,26004.5,21000,0,743.39,409000008610,20-Jul-18,Indiaforensic NFS SETT 18-07-201,"4,000.00",,-543924395.14,Lucas,730,France,183284.53,0,1,0
8612,2011,10,MORTGAGE,3,Low,1,25000, 60 months,2,credit_card,1,Low,1,Good Loan,0,11.99,B,2,26.66,32418.93248,25000,0,555.99,409000008611,20-Jul-18,Indiaforensic NFS SETT 18-07-201,500,,-543924895.14,Young,596,Spain,8125.39,0,1,0
8613,2011,8,MORTGAGE,3,Low,1,10000, 36 months,1,credit_card,1,Low,1,Good Loan,0,10.99,B,2,19.53,11776.12946,10000,0,327.34,409000008612,20-Jul-18,Indiaforensic NFS SETT 18-07-201,"8,800.00",,-543933695.14,Colombo,686,Germany,103220.56,0,1,0
8614,2011,0.5,RENT,1,Low,1,20000, 60 months,2,debt_consolidation,6,Low,1,Good Loan,0,10.59,B,2,4.5,16793.73,15400,0,331.7,409000008613,20-Jul-18,Indiaforensic NFS SETT 18-07-201,"1,000.00",,-543934695.14,Tsao,684,Germany,96885.19,0,1,0
8615,2011,10,MORTGAGE,3,Low,1,15000, 60 months,2,debt_consolidation,6,High,2,Good Loan,0,16.89,D,4,15.24,19294.64,12182.45,0,371.91,409000008614,20-Jul-18,Indiaforensic NFS SETT 18-07-201,"1,000.00",,-543935695.14,Lewis,797,Germany,8877.06,0,1,0
8616,2011,5,MORTGAGE,3,Low,1,2000, 36 months,1,major_purchase,8,Low,1,Good Loan,0,10.99,B,2,16.99,2317.07,2000,0,65.47,409000008615,20-Jul-18,Indiaforensic NFS SETT 18-07-201,800,,-543936495.14,Hussain,658,France,147530.06,0,1,0
8617,2011,10,MORTGAGE,3,Low,1,22000, 60 months,2,debt_consolidation,6,High,2,Bad Loan,1,13.99,C,3,24.56,16865.49,10771.93,14.34,511.79,409000008616,20-Jul-18,Indiaforensic NFS SETT 18-07-201,500,,-543936995.14,Anderson,653,Spain,33389.42,0,1,0
8618,2011,1,RENT,1,Low,1,5600, 36 months,1,debt_consolidation,6,Low,1,Good Loan,0,11.99,B,2,23.47,6699.420615,5600,0,185.98,409000008617,20-Jul-18,Indiaforensic NFS SETT 18-07-201,"9,000.00",,-543945995.14,Ulyanov,641,France,45309.24,0,1,0
8619,2011,3,MORTGAGE,3,Low,1,6100, 60 months,2,car,2,Low,1,Good Loan,0,10.99,B,2,9.63,7587.225836,6100,0,132.6,409000008618,20-Jul-18,Indiaforensic NFS SETT 18-07-201,"8,500.00",,-543954495.14,Shaw,656,Spain,35230.61,1,1,0
8620,2011,2,RENT,1,Low,1,3000, 36 months,1,car,2,Low,1,Good Loan,0,5.42,A,1,6.38,3238.75,3000,0,90.48,409000008619,20-Jul-18,Indiaforensic NFS SETT 18-07-201,200,,-543954695.14,Lucciano,750,Spain,59816.41,1,1,0
8621,2011,6,RENT,1,Low,1,3200, 36 months,1,credit_card,1,Low,1,Good Loan,0,8.49,A,1,10.52,3633.3247,3200,0,101.01,409000008620,20-Jul-18,Indiaforensic NFS SETT 18-07-201,"1,000.00",,-543955695.14,Gordon,768,France,69080.46,1,1,0
8622,2011,2,MORTGAGE,3,Low,1,12000, 36 months,1,small_business,3,Low,1,Good Loan,0,5.99,A,1,13.21,13102.46912,12000,0,365.01,409000008621,20-Jul-18,Indiaforensic NFS SETT 18-07-201,"8,000.00",,-543963695.14,Woodward,568,France,143450.61,1,1,0
8623,2011,8,MORTGAGE,3,Low,1,8000, 60 months,2,other,4,High,2,Good Loan,0,15.99,D,4,15.17,10084.07,6517.22,0,194.51,409000008622,20-Jul-18,Indiaforensic NFS SETT 18-07-201,"5,000.00",,-543968695.14,Cunningham,706,Germany,40774.01,1,1,0
8624,2011,1,RENT,1,Low,1,10000, 36 months,1,debt_consolidation,6,Low,1,Good Loan,0,6.99,A,1,15.77,11111.95865,10000,0,308.73,409000008623,20-Jul-18,Indiaforensic NFS SETT 18-07-201,500,,-543969195.14,Boni,430,Germany,99377.27,1,1,0
8625,2011,4,MORTGAGE,3,Low,1,16800, 60 months,2,debt_consolidation,6,High,2,Bad Loan,1,20.25,F,6,12.07,10620.26,4303.41,776.98,447.44,409000008624,20-Jul-18,Indiaforensic NFS SETT 18-07-201,400,,-543969595.14,Truscott,745,Germany,133617.43,1,1,0
8626,2011,10,MORTGAGE,3,Low,1,13000, 36 months,1,debt_consolidation,6,Low,1,Good Loan,0,10.99,B,2,11.08,15315.18576,13000,0,425.55,409000008625,21-Jul-18,Indiaforensic  RUPAY SETT 210718,968.92,,-543970564.06,Ginikanwa,747,France,101495.00,1,1,0
8627,2011,10,MORTGAGE,3,Low,1,13250, 36 months,1,debt_consolidation,6,Low,1,Good Loan,0,5.99,A,1,16.82,14508.86275,13250,0,403.04,409000008626,21-Jul-18,Indiaforensic  RUPAY SETT 210718,"1,044.12",,-543971608.18,Bailey,657,Germany,119333.95,1,1,0
8628,2011,6,MORTGAGE,3,Medium,2,35000, 60 months,2,debt_consolidation,6,High,2,Good Loan,0,17.99,E,5,10,27512.36,24375,0,618.84,409000008627,21-Jul-18,Indiaforensic NFS SETT 20-07-201,"4,000.00",,-543975608.18,Hutchinson,639,France,167682.37,1,1,0
8629,2011,1,MORTGAGE,3,Low,1,4800, 36 months,1,other,4,Low,1,Good Loan,0,11.99,B,2,12.05,5738.35283,4800,0,159.41,409000008628,21-Jul-18,Indiaforensic NFS SETT 20-07-201,"5,000.00",,-543980608.18,Maclean,704,France,152884.85,1,1,0
8630,2011,2,MORTGAGE,3,Medium,2,15000, 36 months,1,debt_consolidation,6,Low,1,Good Loan,0,7.49,A,1,14.99,16470.53,15000,0,466.53,409000008629,21-Jul-18,Indiaforensic NFS SETT 20-07-201,"4,500.00",,-543985108.18,Chiang,651,Spain,70400.86,1,1,0
8631,2011,5,RENT,1,Low,1,3600, 36 months,1,other,4,Low,1,Good Loan,0,6.99,A,1,24.61,4000.630507,3600,0,111.15,409000008630,23-Jul-18,Indiaforensic  RUPAY SETT 220718,"7,369.34",,-543992477.52,Willmore,706,Germany,65413.41,1,1,0
8632,2011,10,MORTGAGE,3,Medium,2,6000, 36 months,1,moving,10,Low,1,Good Loan,0,5.99,A,1,7.67,6435.29,6000,0,182.51,409000008631,23-Jul-18,Indiaforensic  RUPAY SETT 230718,"10,458.57",,-544002936.09,Godson,632,Germany,182728.80,1,1,0
8633,2011,0.5,RENT,1,Low,1,17600, 60 months,2,debt_consolidation,6,Low,1,Good Loan,0,10.59,B,2,12.94,13883.78934,11175,0,240.7,409000008632,23-Jul-18,TRF FROM  Indiaforensic SERVICES,,50000.00,-543952936.09,Smith,751,France,81442.60,1,1,0
8634,2011,10,RENT,1,Low,1,4800, 36 months,1,moving,10,Low,1,Good Loan,0,12.99,C,3,18.56,4852.98,4800,0,161.71,409000008633,23-Jul-18,Indiaforensic NFS SETT 21-07-201,900,,-543953836.09,Bitter,767,France,144251.38,1,1,0
8635,2011,2,MORTGAGE,3,Low,1,15000, 36 months,1,credit_card,1,Low,1,Good Loan,0,7.49,A,1,13.28,16792.28114,15000,0,466.53,409000008634,23-Jul-18,Indiaforensic NFS SETT 21-07-201,200,,-543954036.09,Ts'ao,741,France,40207.06,1,1,0
8636,2011,2,OWN,2,Medium,2,35000, 36 months,1,small_business,3,Low,1,Good Loan,0,8.49,A,1,3.4,38054.68,35000,0,1104.71,409000008635,23-Jul-18,Indiaforensic NFS SETT 21-07-201,"1,500.00",,-543955536.09,Chialuka,651,Germany,54530.51,1,1,0
8637,2011,4,RENT,1,Low,1,18000, 36 months,1,debt_consolidation,6,High,2,Good Loan,0,13.49,C,3,18.39,20108.1,18000,0,610.75,409000008636,23-Jul-18,Indiaforensic NFS SETT 22-07-201,200,,-543955736.09,Scott,601,France,32683.88,1,1,0
8638,2011,4,MORTGAGE,3,High,3,14000, 36 months,1,other,4,Low,1,Good Loan,0,12.99,C,3,4.98,16973.52573,14000,0,471.65,409000008637,23-Jul-18,Indiaforensic NFS SETT 22-07-201,"8,500.00",,-543964236.09,Feng,520,France,104703.96,1,1,0
8639,2011,7,RENT,1,Low,1,5000, 36 months,1,debt_consolidation,6,Low,1,Good Loan,0,7.49,A,1,17.58,5420.81,5000,0,155.51,409000008638,23-Jul-18,Indiaforensic  RUPAY SETT 230718,"5,306.22",,-543969542.31,Castiglione,626,Germany,26907.43,1,1,0
8640,2011,3,MORTGAGE,3,Medium,2,6000, 36 months,1,moving,10,Low,1,Good Loan,0,10.99,B,2,0.61,6929.830815,6000,0,196.41,409000008639,24-Jul-18,Indiaforensic  RUPAY SETT 240718,"2,828.79",,-543972371.10,He,811,France,180591.32,1,1,0
8641,2011,10,MORTGAGE,3,Low,1,7500, 36 months,1,debt_consolidation,6,Low,1,Good Loan,0,11.49,B,2,4.9,8829.318458,7500,0,247.29,409000008640,24-Jul-18,Indiaforensic NFS SETT 23-07-201,"1,000.00",,-543973371.10,Fanucci,730,France,60905.51,1,1,0
8642,2011,5,RENT,1,Low,1,15000, 36 months,1,credit_card,1,High,2,Bad Loan,1,14.79,C,3,11.96,16422.56,12477.49,350.92,518.44,409000008641,24-Jul-18,Indiaforensic NFS SETT 23-07-201,900,,-543974271.10,Ginikanwa,604,Germany,47777.15,1,1,0
8643,2011,2,RENT,1,Low,1,13200, 60 months,2,debt_consolidation,6,High,2,Good Loan,0,18.39,E,5,21.18,19015.16583,13200,0,338.01,409000008642,24-Jul-18,Indiaforensic NFS SETT 23-07-201,500,,-543974771.10,Manning,499,Germany,108222.68,1,1,0
8644,2011,1,MORTGAGE,3,High,3,9600, 36 months,1,home_improvement,7,High,2,Good Loan,0,15.23,C,3,6.42,12056.94486,9600,0,333.87,409000008643,24-Jul-18,Indiaforensic  RUPAY SETT 240718,991.06,,-543975762.16,Forlonge,754,Spain,3554.63,1,1,0
8645,2011,9,RENT,1,Low,1,24000, 36 months,1,other,4,Low,1,Good Loan,0,6.99,A,1,21.92,26199.48951,24000,0,740.95,409000008644,25-Jul-18,Indiaforensic  RUPAY SETT 250718,821.54,,-543976583.70,Liang,716,Spain,78616.92,1,1,0
8646,2011,0.5,RENT,1,Low,1,3200, 36 months,1,other,4,Low,1,Bad Loan,1,5.99,A,1,10.5,1663.21,1351.34,106.25,97.34,409000008645,25-Jul-18,FDRL/INTERNAL FUND TRANSFE,,100000.00,-543876583.70,Uchechukwu,636,France,100566.81,1,1,0
8647,2011,7,MORTGAGE,3,Low,1,13700, 60 months,2,debt_consolidation,6,Low,1,Good Loan,0,10.99,B,2,29.65,15475.1,11406.04,0,297.81,409000008646,25-Jul-18,FDRL/INTERNAL FUND TRANSFE,,100000.00,-543776583.70,Sung,470,France,183259.35,1,1,0
8648,2011,6.05,RENT,1,Low,1,5600, 60 months,2,debt_consolidation,6,High,2,Good Loan,0,16.89,D,4,21.83,7192.65,4542.34,0,138.85,409000008647,25-Jul-18,Indiaforensic  RUPAY SETT 250718,"6,992.39",,-543783576.09,Tochukwu,444,France,159131.21,1,1,0
8649,2011,10,MORTGAGE,3,Low,1,22750, 60 months,2,debt_consolidation,6,High,2,Good Loan,0,17.99,E,5,15.65,21922.69,13317.95,0,430.33,409000008648,25-Jul-18,Indiaforensic NFS SETT 24-07-201,300,,-543783876.09,Reyna,809,Spain,160976.85,1,1,0
8650,2011,7,MORTGAGE,3,Medium,2,10000, 36 months,1,other,4,Low,1,Good Loan,0,6.99,A,1,10.84,11113.40065,10000,0,308.73,409000008649,25-Jul-18,Indiaforensic NFS SETT 24-07-201,500,,-543784376.09,Liang,850,Germany,42933.26,1,1,0
8651,2011,2,RENT,1,Low,1,12000, 36 months,1,debt_consolidation,6,Low,1,Good Loan,0,11.99,B,2,12.25,14346.08591,12000,0,398.52,409000008650,25-Jul-18,Indiaforensic NFS SETT 24-07-201,100,,-543784476.09,Unwin,637,France,91291.20,1,1,0
8652,2011,7,RENT,1,Low,1,15000, 60 months,2,debt_consolidation,6,High,2,Good Loan,0,15.99,D,4,24.6,17219.46,15000,0,364.7,409000008651,25-Jul-18,Indiaforensic NFS SETT 24-07-201,"1,000.00",,-543785476.09,Rutherford,512,France,52471.36,1,1,0
8653,2011,2,MORTGAGE,3,Low,1,5000, 60 months,2,other,4,High,2,Good Loan,0,18.39,E,5,16.37,6993.445554,5000,0,128.04,409000008652,25-Jul-18,Indiaforensic NFS SETT 24-07-201,"1,800.00",,-543787276.09,Howe,774,Spain,108804.28,1,1,0
8654,2011,1,RENT,1,Low,1,12000, 36 months,1,debt_consolidation,6,Low,1,Good Loan,0,10.99,B,2,11.56,12941.44,12000,0,392.81,409000008653,25-Jul-18,Indiaforensic NFS SETT 24-07-201,500,,-543787776.09,Tran,641,France,122449.18,1,1,0
8655,2011,6.05,MORTGAGE,3,Low,1,20000, 60 months,2,small_business,3,Low,1,Good Loan,0,10.99,B,2,21.02,16177.37,12500,0,271.72,409000008654,26-Jul-18,Indiaforensic  RUPAY SETT 260718,390.88,,-543788166.97,Thompson,586,Germany,41682.30,1,1,0
8656,2011,2,RENT,1,Low,1,20000, 60 months,2,debt_consolidation,6,High,2,Good Loan,0,16.89,D,4,18.04,25729.26,16243.83,0,495.87,409000008655,26-Jul-18,Indiaforensic  RUPAY SETT 260718,"10,309.37",,-543798476.34,Linger,611,France,148887.69,1,1,0
8657,2011,5,MORTGAGE,3,Medium,2,11200, 60 months,2,other,4,High,2,Good Loan,0,13.49,C,3,12.02,13383.24,9230.73,0,257.66,409000008656,26-Jul-18,Indiaforensic NFS SETT 25-07-201,400,,-543798876.34,Johnston,660,Spain,137784.25,1,1,0
8658,2011,0.5,RENT,1,Low,1,7200, 36 months,1,other,4,Low,1,Good Loan,0,9.99,B,2,17.42,8360.526988,7200,0,232.29,409000008657,26-Jul-18,Indiaforensic NFS SETT 25-07-201,"2,000.00",,-543800876.34,Udokamma,532,France,190573.91,1,1,0
8659,2011,4,RENT,1,Low,1,12000, 36 months,1,debt_consolidation,6,High,2,Good Loan,0,16.49,D,4,11.67,14468.85,12000,0,424.8,409000008658,26-Jul-18,Indiaforensic NFS SETT 25-07-201,800,,-543801676.34,Barrera,557,Germany,102076.03,1,1,0
8660,2011,9,RENT,1,Low,1,12000, 60 months,2,house,12,High,2,Good Loan,0,17.49,D,4,19.34,13997.25,12000,0,301.41,409000008659,26-Jul-18,Indiaforensic NFS SETT 25-07-201,200,,-543801876.34,Sutherland,730,Spain,56307.51,1,1,0
8661,2011,5,RENT,1,Low,1,35000, 60 months,2,debt_consolidation,6,High,2,Good Loan,0,19.29,E,5,20.62,29525.86,17509.33,0,567.69,409000008660,26-Jul-18,Indiaforensic NFS SETT 25-07-201,"2,000.00",,-543803876.34,Bednall,535,France,49775.58,1,1,0
8662,2011,8,MORTGAGE,3,Low,1,4200, 36 months,1,vacation,11,Low,1,Good Loan,0,10.99,B,2,18.07,4820.97,4200,0,137.49,409000008661,26-Jul-18,Indiaforensic NFS SETT 25-07-201,"2,500.00",,-543806376.34,Otoole,773,Germany,4395.45,1,1,0
8663,2011,1,RENT,1,Low,1,12000, 60 months,2,debt_consolidation,6,Low,1,Bad Loan,1,11.49,B,2,12.48,4748.98,2898.37,20.2,263.86,409000008662,26-Jul-18,Indiaforensic NFS SETT 25-07-201,"1,500.00",,-543807876.34,Cremonesi,510,Germany,28461.29,1,1,0
8664,2011,7,MORTGAGE,3,Low,1,9000, 36 months,1,credit_card,1,Low,1,Good Loan,0,7.49,A,1,26.04,9898.79,8999.99,0,279.92,409000008663,26-Jul-18,Indiaforensic NFS SETT 25-07-201,"2,400.00",,-543810276.34,Hamilton,539,France,28184.70,1,1,0
8665,2011,7,RENT,1,Low,1,18000, 36 months,1,debt_consolidation,6,Low,1,Good Loan,0,10.59,B,2,21.61,18310.5,18000,0,585.81,409000008664,26-Jul-18,Indiaforensic NFS SETT 25-07-201,"1,000.00",,-543811276.34,Donaldson,690,Spain,3149.10,1,1,0
8666,2011,10,MORTGAGE,3,Medium,2,35000, 60 months,2,moving,10,High,2,Good Loan,0,13.49,C,3,8.83,25676.39,21750.01,0,500.36,409000008665,26-Jul-18,Indiaforensic NFS SETT 25-07-201,"1,200.00",,-543812476.34,McKay,821,France,194273.12,1,1,0
8667,2011,6,MORTGAGE,3,Low,1,8000, 36 months,1,home_improvement,7,High,2,Good Loan,0,21.36,F,6,3.9,10895.03765,8000,0,302.89,409000008666,26-Jul-18,Indiaforensic NFS SETT 25-07-201,"1,000.00",,-543813476.34,Black,687,Germany,148537.07,1,1,0
8668,2011,10,MORTGAGE,3,High,3,25000, 60 months,2,home_improvement,7,High,2,Good Loan,0,18.79,E,5,6.46,37174.67009,24300,0,627.56,409000008667,26-Jul-18,Indiaforensic NFS SETT 25-07-201,300,,-543813776.34,Kane,557,France,116378.31,1,1,0
8669,2011,10,MORTGAGE,3,Medium,2,12000, 36 months,1,small_business,3,Low,1,Good Loan,0,12.99,C,3,17.98,14227.5,11999.99,0,404.27,409000008668,26-Jul-18,Indiaforensic NFS SETT 25-07-201,300,,-543814076.34,She,532,Spain,6761.84,1,1,0
8670,2011,6.05,MORTGAGE,3,Low,1,16000, 36 months,1,credit_card,1,Low,1,Good Loan,0,7.49,A,1,16.94,17912.75518,16000,0,497.63,409000008669,26-Jul-18,Indiaforensic NFS SETT 25-07-201,600,,-543814676.34,Bruno,540,Spain,81995.92,1,1,0
8671,2011,3,OWN,2,Low,1,18000, 60 months,2,debt_consolidation,6,Low,1,Good Loan,0,10.99,B,2,10.92,20332.35,14986.01,0,391.28,409000008670,26-Jul-18,Indiaforensic NFS SETT 25-07-201,200,,-543814876.34,Watson,705,France,14392.68,1,1,0
8672,2011,1,RENT,1,Medium,2,21000, 36 months,1,debt_consolidation,6,High,2,Bad Loan,1,16.49,D,4,13.05,15106.15,9148.78,680.67,743.39,409000008671,26-Jul-18,Indiaforensic NFS SETT 25-07-201,100,,-543814976.34,Shih,542,Germany,468.94,1,1,0
8673,2011,10,MORTGAGE,3,Low,1,35000, 60 months,2,debt_consolidation,6,Low,1,Good Loan,0,11.99,B,2,6.13,25108.01,22950,0,510.4,409000008672,26-Jul-18,Indiaforensic NFS SETT 25-07-201,"1,000.00",,-543815976.34,Rose,706,France,122379.54,1,1,0
8674,2011,10,OWN,2,Low,1,8000, 36 months,1,home_improvement,7,Low,1,Good Loan,0,6.99,A,1,5.27,8851.42,8000,0,246.99,409000008673,26-Jul-18,Indiaforensic NFS SETT 25-07-201,"2,000.00",,-543817976.34,Zikoranachukwudimma,765,France,13228.93,1,1,0
8675,2011,4,RENT,1,Low,1,21600, 60 months,2,other,4,Low,1,Good Loan,0,11.99,B,2,6.65,28067.96693,21600,0,480.38,409000008674,26-Jul-18,Indiaforensic NFS SETT 25-07-201,500,,-543818476.34,Cole,529,France,154002.02,1,1,0
8676,2011,10,OWN,2,Low,1,20000, 60 months,2,major_purchase,8,High,2,Bad Loan,1,19.69,E,5,17.78,6290.94,2131.67,1036.54,526.44,409000008675,26-Jul-18,Indiaforensic NFS SETT 25-07-201,200,,-543818676.34,Isaacs,714,France,112777.38,1,1,0
8677,2011,10,MORTGAGE,3,Low,1,20000, 60 months,2,debt_consolidation,6,High,2,Bad Loan,1,16.49,D,4,12.53,6885.5,2800.73,999.5,491.59,409000008676,26-Jul-18,Indiaforensic NFS SETT 25-07-201,"10,000.00",,-543828676.34,Muravyova,582,France,128528.83,1,1,0
8678,2011,8,RENT,1,Low,1,14000, 36 months,1,small_business,3,Low,1,Bad Loan,1,11.99,B,2,19.68,2610.21,1224.47,716.1,464.94,409000008677,27-Jul-18,Indiaforensic  RUPAY SETT 270718,"5,797.30",,-543834473.64,Timperley,609,Germany,170122.22,1,1,0
8679,2011,10,OWN,2,Low,1,14400, 36 months,1,debt_consolidation,6,Low,1,Good Loan,0,7.49,A,1,9.48,16117.66869,14400,0,447.87,409000008678,27-Jul-18,Indiaforensic NFS SETT 26-07-201,"10,000.00",,-543844473.64,Kenechukwu,518,France,2803.89,1,1,0
8680,2011,10,MORTGAGE,3,Low,1,2000, 36 months,1,debt_consolidation,6,Low,1,Good Loan,0,5.99,A,1,24.91,2080.78,2000,0,60.84,409000008679,27-Jul-18,Indiaforensic NFS SETT 26-07-201,100,,-543844573.64,He,791,Germany,181918.26,1,1,0
8681,2011,5,MORTGAGE,3,Medium,2,18000, 36 months,1,debt_consolidation,6,Low,1,Good Loan,0,11.99,B,2,12.49,21524.95604,18000,0,597.78,409000008680,27-Jul-18,Indiaforensic NFS SETT 26-07-201,"1,700.00",,-543846273.64,Storey,747,France,115241.96,1,1,0
8682,2011,10,MORTGAGE,3,Low,1,35000, 60 months,2,debt_consolidation,6,Low,1,Good Loan,0,10.99,B,2,16.69,25889.61,19082.5,0,498.34,409000008681,27-Jul-18,Indiaforensic NFS SETT 26-07-201,"1,000.00",,-543847273.64,Onyekachukwu,565,France,129956.13,1,1,0
8683,2011,10,MORTGAGE,3,Medium,2,15000, 60 months,2,debt_consolidation,6,Low,1,Good Loan,0,11.49,B,2,7.84,17116.4,12450.2,0,329.82,409000008682,27-Jul-18,Indiaforensic NFS SETT 26-07-201,200,,-543847473.64,Kharlamova,735,France,45858.49,1,1,0
8684,2011,5,MORTGAGE,3,Low,1,12300, 60 months,2,debt_consolidation,6,High,2,Good Loan,0,17.99,E,5,13.62,17570.54927,12300,0,312.28,409000008683,27-Jul-18,Indiaforensic NFS SETT 26-07-201,"2,400.00",,-543849873.64,Christopher,697,France,131083.56,1,1,0
8685,2011,6,MORTGAGE,3,Low,1,35000, 60 months,2,debt_consolidation,6,High,2,Good Loan,0,13.49,C,3,4.98,26337.51,22475.01,0,517.04,409000008684,27-Jul-18,Indiaforensic NFS SETT 26-07-201,900,,-543850773.64,Lombardo,813,Germany,46422.46,1,1,0
8686,2011,10,OWN,2,Low,1,6500, 36 months,1,major_purchase,8,Low,1,Good Loan,0,7.49,A,1,11.9,6999.21,6499.99,0,202.17,409000008685,27-Jul-18,Indiaforensic NFS SETT 26-07-201,500,,-543851273.64,Kerr,772,France,57675.88,1,1,0
8687,2011,6,MORTGAGE,3,Low,1,12800, 36 months,1,medical,9,Low,1,Good Loan,0,5.99,A,1,15.95,13891.73,12800,0,389.35,409000008686,27-Jul-18,Indiaforensic NFS SETT 26-07-201,500,,-543851773.64,Duncan,606,France,169741.96,1,1,0
8688,2011,10,MORTGAGE,3,High,3,35000, 36 months,1,house,12,Low,1,Good Loan,0,9.99,B,2,2.77,37152.35,35000,0,1129.19,409000008687,27-Jul-18,Indiaforensic NFS SETT 26-07-201,"1,200.00",,-543852973.64,Lawley,667,Germany,26022.37,1,1,0
8689,2011,10,OWN,2,Low,1,6000, 36 months,1,vacation,11,Low,1,Good Loan,0,5.42,A,1,1.51,6430.33,6000,0,180.96,409000008688,27-Jul-18,Indiaforensic NFS SETT 26-07-201,500,,-543853473.64,Burns,637,Germany,125334.16,1,1,0
8690,2011,10,RENT,1,Low,1,10000, 36 months,1,debt_consolidation,6,High,2,Good Loan,0,15.99,D,4,16.37,12124.88,10000.01,0,351.53,409000008689,27-Jul-18,Indiaforensic NFS SETT 26-07-201,"1,500.00",,-543854973.64,Whitson,542,France,21343.74,1,1,0
8691,2011,2,RENT,1,Low,1,7000, 36 months,1,debt_consolidation,6,Low,1,Good Loan,0,12.99,C,3,20,8461.267409,7000,0,235.83,409000008690,27-Jul-18,Indiaforensic NFS SETT 26-07-201,400,,-543855373.64,Doyne,762,Spain,139971.01,1,1,0
8692,2011,2,MORTGAGE,3,Medium,2,25000, 36 months,1,credit_card,1,Low,1,Good Loan,0,6.99,A,1,12.49,27784.4523,25000,0,771.82,409000008691,27-Jul-18,Indiaforensic  RUPAY SETT 270718,325.71,,-543855699.35,Pinto,698,France,47455.82,1,1,0
8693,2011,0.5,RENT,1,Low,1,2800, 36 months,1,other,4,High,2,Good Loan,0,15.62,D,4,9.38,3522.292482,2800,0,97.92,409000008692,30-Jul-18,TRF FROM  Indiaforensic SERVICES,,60000.00,-543795699.35,Chin,850,France,55593.80,1,1,0
8694,2011,10,RENT,1,Low,1,7500, 36 months,1,debt_consolidation,6,High,2,Good Loan,0,16.49,D,4,15.65,9197.5,7500,0,265.5,409000008693,30-Jul-18,Indiaforensic RUPAY SETT 280718,"2,140.74",,-543797840.09,Davide,621,France,191756.54,1,1,0
8695,2011,5,MORTGAGE,3,Low,1,15000, 36 months,1,small_business,3,Low,1,Bad Loan,1,8.49,A,1,5.18,7171.61,5375.36,552.77,473.45,409000008694,30-Jul-18,Indiaforensic RUPAY SETT 290718,"11,551.68",,-543809391.77,Torres,671,Germany,76373.38,1,1,0
8696,2011,6,MORTGAGE,3,Low,1,25000, 60 months,2,credit_card,1,High,2,Good Loan,0,18.39,E,5,21.71,37813.7314,25000,0,640.16,409000008695,30-Jul-18,Indiaforensic RUPAY SETT 300718,"7,786.22",,-543817177.99,Buccho,775,France,169278.51,1,1,0
8697,2011,6,RENT,1,Low,1,1500, 36 months,1,other,4,High,2,Good Loan,0,14.79,C,3,13.71,1571.42,1500,0,51.85,409000008696,30-Jul-18,Indiaforensic  RUPAY SETT 300718,"9,656.83",,-543826834.82,Greece,504,Spain,136909.88,1,1,0
8698,2011,4,RENT,1,Low,1,8000, 36 months,1,other,4,Low,1,Good Loan,0,8.49,A,1,3.45,9009.8,8000,0,252.51,409000008697,30-Jul-18,Indiaforensic NFS SETT 27-07-201,700,,-543827534.82,Wimble,751,Spain,54865.92,1,1,0
8699,2011,2,MORTGAGE,3,Low,1,7600, 60 months,2,other,4,Low,1,Bad Loan,1,10.99,B,2,2.49,6724.39,2081.31,3430.79,165.21,409000008698,30-Jul-18,Indiaforensic NFS SETT 27-07-201,300,,-543827834.82,Pirozzi,691,Germany,156529.44,1,1,0
8700,2011,6,MORTGAGE,3,Low,1,12000, 60 months,2,debt_consolidation,6,Low,1,Good Loan,0,7.49,A,1,9.6,12952.47,12000,0,240.4,409000008699,30-Jul-18,Indiaforensic NFS SETT 27-07-201,100,,-543827934.82,Hsiung,841,Germany,113482.20,1,1,0
8701,2011,6,MORTGAGE,3,Medium,2,18000, 60 months,2,debt_consolidation,6,High,2,Bad Loan,1,17.49,D,4,18.73,22122.95,13403.64,0,452.11,409000008700,30-Jul-18,Indiaforensic NFS SETT 27-07-201,300,,-543828234.82,Obioma,709,Germany,63446.47,1,1,0
8702,2011,0.5,MORTGAGE,3,Low,1,20050, 60 months,2,debt_consolidation,6,Low,1,Good Loan,0,11.49,B,2,24.34,25907.93559,20050,0,440.86,409000008701,30-Jul-18,Indiaforensic NFS SETT 27-07-201,"1,500.00",,-543829734.82,Onio,673,France,13624.02,1,1,0
8703,2011,1,RENT,1,Medium,2,7000, 36 months,1,debt_consolidation,6,Low,1,Good Loan,0,10.99,B,2,12.83,7304.42,7000,0,229.14,409000008702,30-Jul-18,Indiaforensic NFS SETT 27-07-201,500,,-543830234.82,Udinesi,541,France,148814.54,1,1,0
8704,2011,7,MORTGAGE,3,Medium,2,11800, 36 months,1,credit_card,1,High,2,Good Loan,0,13.99,C,3,22.72,13983.63,11800,0,403.24,409000008703,30-Jul-18,Indiaforensic NFS SETT 27-07-201,500,,-543830734.82,Fermin,661,France,65567.91,1,1,0
8705,2011,4,MORTGAGE,3,Low,1,17800, 60 months,2,wedding,5,Low,1,Bad Loan,1,11.49,B,2,15.63,7044.46,4306.91,17.44,391.38,409000008704,30-Jul-18,Indiaforensic NFS SETT 28-07-201,"1,000.00",,-543831734.82,Moss,784,Spain,6409.55,1,1,0
8706,2011,4,RENT,1,Low,1,15000, 36 months,1,debt_consolidation,6,Low,1,Good Loan,0,10.99,B,2,11.34,17672.60517,15000,0,491.01,409000008705,30-Jul-18,Indiaforensic NFS SETT 28-07-201,"10,000.00",,-543841734.82,Docherty,742,France,126997.53,1,1,0
8707,2011,6,MORTGAGE,3,Low,1,3300, 36 months,1,other,4,Low,1,Good Loan,0,10.99,B,2,18.81,3885.886318,3300,0,108.03,409000008706,30-Jul-18,Indiaforensic NFS SETT 28-07-201,200,,-543841934.82,Marcelo,850,Spain,171762.87,1,1,0
8708,2011,6,OWN,2,Low,1,4800, 36 months,1,debt_consolidation,6,Low,1,Good Loan,0,11.99,B,2,16.52,5738.296667,4800,0,159.41,409000008707,30-Jul-18,Indiaforensic NFS SETT 28-07-201,100,,-543842034.82,Fadden,443,France,129031.19,1,1,0
8709,2011,2,MORTGAGE,3,Low,1,12000, 60 months,2,home_improvement,7,Low,1,Good Loan,0,11.49,B,2,13.74,14689.82,12000,0,263.86,409000008708,30-Jul-18,Indiaforensic NFS SETT 28-07-201,100,,-543842134.82,Zox,778,Germany,182691.31,1,1,0
8710,2011,10,MORTGAGE,3,Low,1,6500, 36 months,1,debt_consolidation,6,Low,1,Good Loan,0,5.99,A,1,1.65,6917.98,6500,0,197.72,409000008709,30-Jul-18,Indiaforensic NFS SETT 28-07-201,100,,-543842234.82,Otitodilinna,529,France,12351.01,1,1,0
8711,2011,10,MORTGAGE,3,Low,1,6175, 60 months,2,other,4,Low,1,Good Loan,0,11.99,B,2,20.54,7129.5,5114.89,0,137.33,409000008710,30-Jul-18,Indiaforensic NFS SETT 28-07-201,100,,-543842334.82,Kennedy,678,Germany,135123.96,1,1,0
8712,2011,5,RENT,1,Medium,2,18000, 60 months,2,debt_consolidation,6,High,2,Good Loan,0,15.99,D,4,16.75,22700.78,14670.87,0,437.63,409000008711,30-Jul-18,Indiaforensic NFS SETT 28-07-201,100,,-543842434.82,Tu,516,Spain,181490.42,1,1,0
8713,2011,6,RENT,1,Low,1,6000, 36 months,1,other,4,Low,1,Good Loan,0,7.49,A,1,10.03,6177.85,6000,0,186.61,409000008712,30-Jul-18,Indiaforensic NFS SETT 28-07-201,100,,-543842534.82,Barnes,469,Spain,186490.37,1,1,0
8714,2011,1,OWN,2,Low,1,9000, 36 months,1,debt_consolidation,6,Low,1,Good Loan,0,5.99,A,1,19.95,9855.109176,9000,0,273.76,409000008713,30-Jul-18,Indiaforensic NFS SETT 28-07-201,500,,-543843034.82,Bibi,786,Spain,41248.80,1,1,0
8715,2011,7,OWN,2,Low,1,13200, 60 months,2,debt_consolidation,6,High,2,Good Loan,0,19.29,E,5,20.1,16990.34,13200,0,344.53,409000008714,30-Jul-18,Indiaforensic NFS SETT 29-07-201,400,,-543843434.82,L?,703,France,116267.28,1,1,0
8716,2011,5,RENT,1,Low,1,6000, 60 months,2,major_purchase,8,High,2,Good Loan,0,18.39,E,5,3.86,7988.12,4851.22,0,153.64,409000008715,30-Jul-18,Indiaforensic NFS SETT 29-07-201,"1,000.00",,-543844434.82,Landseer,579,Germany,9201.53,1,1,0
8717,2011,10,MORTGAGE,3,Low,1,7000, 36 months,1,major_purchase,8,Low,1,Good Loan,0,9.99,B,2,10.23,8062.32,7000,0,225.84,409000008716,30-Jul-18,Indiaforensic NFS SETT 29-07-201,"10,000.00",,-543854434.82,Nwachinemelu,565,France,80630.32,1,1,0
8718,2011,1,RENT,1,Low,1,6500, 36 months,1,major_purchase,8,Low,1,Good Loan,0,10.99,B,2,4.8,7529.74,6500,0,212.78,409000008717,30-Jul-18,Indiaforensic NFS SETT 29-07-201,"10,000.00",,-543864434.82,Ch'iu,443,France,159165.70,1,1,0
8719,2011,10,RENT,1,Medium,2,32000, 60 months,2,debt_consolidation,6,High,2,Good Loan,0,20.99,F,6,10.85,31146.12865,19975,0,540.28,409000008718,31-Jul-18,Indiaforensic  RUPAY SETT 310718,"1,971.86",,-543866406.68,Vinogradova,589,France,86490.09,1,1,0
8720,2011,10,MORTGAGE,3,Medium,2,5000, 36 months,1,debt_consolidation,6,Low,1,Good Loan,0,11.49,B,2,17.15,5795.2,5000,0,164.86,409000008719,31-Jul-18,Indiaforensic  RUPAY SETT 310718,"3,571.96",,-543869978.64,Jenks,691,France,197572.41,1,1,0
8721,2011,1,RENT,1,Low,1,12000, 36 months,1,debt_consolidation,6,Low,1,Good Loan,0,11.49,B,2,11.29,14237.14534,12000,0,395.66,409000008720,1-Aug-18,Indiaforensic  RUPAY SETT 010818,"5,671.76",,-543875650.40,Crace,711,France,105159.89,1,1,0
8722,2011,3,RENT,1,Low,1,5000, 36 months,1,credit_card,1,High,2,Good Loan,0,15.99,D,4,3.77,6319.945231,5000,0,175.77,409000008721,1-Aug-18,Indiaforensic RUPAY STL INTC0108,,105.29,-543875545.11,Packham,775,Spain,40807.26,1,1,0
8723,2011,4,MORTGAGE,3,Low,1,26400, 36 months,1,debt_consolidation,6,High,2,Bad Loan,1,16.49,D,4,16.85,14612.11,7867.85,1125.56,934.55,409000008722,1-Aug-18,Indiaforensic RUPAY STL INTC0108,52,,-543875597.11,T'ien,621,France,143.34,1,1,0
8724,2011,10,RENT,1,Low,1,8800, 36 months,1,debt_consolidation,6,High,2,Good Loan,0,15.62,D,4,19.07,11071.50204,8800,0,307.74,409000008723,1-Aug-18,Indiaforensic RUPAY STL INTC0108,,0.39,-543875596.72,Onyekachi,350,France,125823.79,1,1,0
8725,2011,3,RENT,1,Low,1,14000, 36 months,1,credit_card,1,Low,1,Good Loan,0,5.42,A,1,10.66,14947.68,14000,0,422.24,409000008724,1-Aug-18,Indiaforensic  RUPAY SETT 010818,373.33,,-543875970.05,Solomina,668,Spain,138465.70,1,1,0
8726,2011,10,RENT,1,Low,1,12000, 36 months,1,debt_consolidation,6,Low,1,Good Loan,0,7.49,A,1,16.47,13434.6872,12000,0,373.22,409000008725,1-Aug-18,Indiaforensic RUPAY STL INTC0108,,1.88,-543875968.17,Hawes,633,Spain,44008.91,1,1,0
8727,2011,3,RENT,1,Low,1,30800, 60 months,2,credit_card,1,Low,1,Bad Loan,1,10.99,B,2,23.09,2663.34,1576.98,0,444.54,409000008726,1-Aug-18,Indiaforensic RUPAY STL INTC0108,1.86,,-543875970.03,Benson,697,Germany,66893.28,1,1,0
8728,2011,10,MORTGAGE,3,Low,1,24000, 60 months,2,debt_consolidation,6,High,2,Good Loan,0,18.39,E,5,9.59,32659.15,24000,0,614.55,409000008727,1-Aug-18,Indiaforensic NFS SETT 30-07-201,500,,-543876470.03,Emenike,734,Germany,76503.06,1,1,0
8729,2011,10,MORTGAGE,3,Low,1,30000, 36 months,1,credit_card,1,Low,1,Good Loan,0,11.99,B,2,23.81,34976.11,30000,0,996.29,409000008728,1-Aug-18,Indiaforensic NFS SETT 30-07-201,100,,-543876570.03,Nero,434,France,56784.11,1,1,0
8730,2011,10,MORTGAGE,3,Low,1,16000, 60 months,2,debt_consolidation,6,Low,1,Good Loan,0,10.99,B,2,6.44,19160.4,16000,0,347.8,409000008729,1-Aug-18,Indiaforensic NFS SETT 30-07-201,"2,000.00",,-543878570.03,Toscano,646,Germany,175657.55,1,1,0
8731,2011,4,MORTGAGE,3,Low,1,35000, 60 months,2,small_business,3,High,2,Bad Loan,1,13.99,C,3,17.73,0,0,0,814.21,409000008730,1-Aug-18,Indiaforensic NFS SETT 30-07-201,"4,000.00",,-543882570.03,Yang,764,France,105155.66,1,1,0
8732,2011,1,OWN,2,Low,1,10000, 36 months,1,debt_consolidation,6,Low,1,Bad Loan,1,10.99,B,2,18.92,11238.13,9333.71,113.76,327.34,409000008731,1-Aug-18,Indiaforensic NFS SETT 30-07-201,"1,600.00",,-543884170.03,Palerma,727,Spain,47468.56,1,1,0
8733,2011,4,MORTGAGE,3,Medium,2,30000, 60 months,2,small_business,3,High,2,Bad Loan,1,20.25,F,6,5.46,16949.42,1511.38,12961.32,799,409000008732,1-Aug-18,Indiaforensic NFS SETT 30-07-201,100,,-543884270.03,Trentini,724,France,64729.51,1,1,0
8734,2011,10,RENT,1,Low,1,10000, 36 months,1,debt_consolidation,6,Low,1,Bad Loan,1,8.49,A,1,14.19,8522.01,7245.81,13.5,315.63,409000008733,1-Aug-18,Indiaforensic NFS SETT 31-07-201,"1,000.00",,-543885270.03,Haddon,749,Spain,101108.85,1,1,0
8735,2011,10,MORTGAGE,3,Low,1,11200, 36 months,1,debt_consolidation,6,Low,1,Good Loan,0,10.99,B,2,17.04,12982.44,11200,0,366.63,409000008734,1-Aug-18,Indiaforensic NFS SETT 31-07-201,500,,-543885770.03,Coates,706,Germany,140938.95,1,1,0
8736,2011,10,MORTGAGE,3,Low,1,13600, 60 months,2,home_improvement,7,Low,1,Good Loan,0,8.49,A,1,5.92,16604.06185,13600,0,278.96,409000008735,1-Aug-18,Indiaforensic NFS SETT 31-07-201,"5,000.00",,-543890770.03,Castiglione,728,France,37662.49,1,1,0
8737,2011,4,MORTGAGE,3,Low,1,13800, 36 months,1,debt_consolidation,6,Low,1,Good Loan,0,10.99,B,2,17.34,16174.05685,13800,0,451.73,409000008736,1-Aug-18,Indiaforensic NFS SETT 31-07-201,"1,500.00",,-543892270.03,Stone,636,France,86414.41,1,1,0
8738,2011,6.05,RENT,1,Low,1,8000, 36 months,1,major_purchase,8,Low,1,Good Loan,0,7.49,A,1,6.24,8955.768393,8000,0,248.82,409000008737,1-Aug-18,Indiaforensic NFS SETT 31-07-201,200,,-543892470.03,Maynard,634,France,41820.65,1,1,0
8739,2011,10,MORTGAGE,3,Medium,2,10500, 36 months,1,debt_consolidation,6,Low,1,Good Loan,0,7.49,A,1,12.26,11420.63,10500,0,326.57,409000008738,1-Aug-18,Indiaforensic NFS SETT 31-07-201,"6,000.00",,-543898470.03,Moore,627,France,127734.16,1,1,0
8740,2011,7,RENT,1,Low,1,16200, 60 months,2,debt_consolidation,6,High,2,Bad Loan,1,16.49,D,4,22.07,5576.93,2268.12,810.29,398.19,409000008739,1-Aug-18,Indiaforensic NFS SETT 31-07-201,200,,-543898670.03,Obielumani,518,France,123872.00,1,1,0
8741,2011,6,MORTGAGE,3,Medium,2,25000, 60 months,2,medical,9,Low,1,Good Loan,0,10.99,B,2,17.38,30497.80513,25000,0,543.44,409000008740,1-Aug-18,Indiaforensic NFS SETT 31-07-201,"1,200.00",,-543899870.03,Harding,687,Spain,113050.92,1,1,0
8742,2011,0.5,RENT,1,Low,1,1600, 36 months,1,moving,10,High,2,Good Loan,0,14.79,C,3,13.74,1989.773506,1600,0,55.31,409000008741,1-Aug-18,Indiaforensic NFS SETT 31-07-201,"1,000.00",,-543900870.03,Hill,622,Spain,131389.39,1,1,0
8743,2011,6,MORTGAGE,3,Low,1,4200, 36 months,1,other,4,Low,1,Good Loan,0,10.99,B,2,19.22,4945.01478,4200,0,137.49,409000008742,1-Aug-18,Indiaforensic NFS SETT 31-07-201,"7,300.00",,-543908170.03,Brown,693,Spain,26589.56,1,1,0
8744,2011,0.5,MORTGAGE,3,Medium,2,14400, 36 months,1,home_improvement,7,Low,1,Good Loan,0,5.42,A,1,1.19,14929.25,14400,0,434.31,409000008743,1-Aug-18,Indiaforensic NFS SETT 31-07-201,"1,000.00",,-543909170.03,Pagnotto,450,Spain,195463.35,1,1,0
8745,2011,3,RENT,1,Low,1,2500, 36 months,1,debt_consolidation,6,Low,1,Good Loan,0,10.99,B,2,14.04,2943.217656,2500,0,81.84,409000008744,2-Aug-18,Indiaforensic  RUPAY SETT 020818,710.84,,-543909880.87,Esposito,664,Germany,108876.75,1,1,0
8746,2011,10,MORTGAGE,3,Medium,2,26000, 36 months,1,small_business,3,High,2,Good Loan,0,13.99,C,3,9.94,31976.33511,26000,0,888.5,409000008745,2-Aug-18,Indiaforensic RUPAY STL INTC0208,,7.19,-543909873.68,Tan,663,Spain,136054.45,1,1,0
8747,2011,0.5,RENT,1,Low,1,15575, 60 months,2,debt_consolidation,6,High,2,Bad Loan,1,15.23,C,3,24.39,6675.98,3070.59,732.62,372.42,409000008746,2-Aug-18,Indiaforensic RUPAY STL INTC0208,7.19,,-543909880.87,Hammond,660,France,182262.66,1,1,0
8748,2011,10,MORTGAGE,3,Low,1,15000, 60 months,2,home_improvement,7,Low,1,Good Loan,0,11.99,B,2,14.99,17328.64,12436.2,0,333.6,409000008747,2-Aug-18,Indiaforensic  RUPAY SETT 020818,"3,717.71",,-543913598.58,Chung,579,France,129209.09,1,1,0
8749,2011,0.5,MORTGAGE,3,Low,1,12000, 60 months,2,debt_consolidation,6,High,2,Good Loan,0,13.49,C,3,9.57,12784.86,12000,0,276.06,409000008748,2-Aug-18,Indiaforensic RUPAY STL INTC0208,,27.88,-543913570.70,Houghton,655,Germany,64853.51,1,1,0
8750,2011,3,MORTGAGE,3,Low,1,5000, 36 months,1,wedding,5,Low,1,Good Loan,0,8.49,A,1,24.92,5679.89438,5000,0,157.82,409000008749,2-Aug-18,Indiaforensic RUPAY STL INTC0208,27.88,,-543913598.58,Chia,683,France,148989.15,1,1,0
8751,2011,10,MORTGAGE,3,Medium,2,24000, 36 months,1,debt_consolidation,6,Low,1,Good Loan,0,8.49,A,1,17.76,26199.41,24000,0,757.51,409000008750,3-Aug-18,Indiaforensic  RUPAY SETT 030818,991.24,,-543914589.82,Zikoranachidimma,655,France,71047.51,1,1,0
8752,2011,8,MORTGAGE,3,Low,1,19000, 60 months,2,debt_consolidation,6,Low,1,Good Loan,0,10.99,B,2,21.45,21464.28,15820.19,0,413.02,409000008751,3-Aug-18,Indiaforensic RUPAY STL INTC0308,,70.77,-543914519.05,Boag,575,Spain,185341.63,1,1,0
8753,2011,2,RENT,1,Low,1,8000, 36 months,1,credit_card,1,Low,1,Good Loan,0,8.49,A,1,18.12,8487.12,8000,0,252.51,409000008752,3-Aug-18,Indiaforensic RUPAY STL INTC0308,8.05,,-543914527.10,Pagnotto,574,Spain,137793.35,1,1,0
8754,2011,2,RENT,1,Low,1,4000, 36 months,1,home_improvement,7,High,2,Good Loan,0,15.62,D,4,10.61,5032.4541,4000,0,139.88,409000008753,3-Aug-18,Indiaforensic RUPAY STL INTC0308,,0.46,-543914526.64,Oluchukwu,795,France,198317.23,1,1,0
8755,2011,10,RENT,1,Low,1,10000, 36 months,1,debt_consolidation,6,High,2,Good Loan,0,13.49,C,3,3.66,11602.29,10000.01,0,339.31,409000008754,3-Aug-18,Indiaforensic  RUPAY SETT 030818,"1,552.42",,-543916079.06,Baxter,776,France,162137.50,1,1,0
8756,2011,10,OWN,2,Medium,2,35000, 60 months,2,home_improvement,7,Low,1,Good Loan,0,12.99,C,3,2.43,24915.08,23225,0,528.33,409000008755,3-Aug-18,Indiaforensic RUPAY STL INTC0308,,19.86,-543916059.20,Tien,707,Spain,109688.82,1,1,0
8757,2011,3,RENT,1,Low,1,10000, 36 months,1,credit_card,1,Low,1,Good Loan,0,7.49,A,1,9.91,10643.75,9999.99,0,311.02,409000008756,3-Aug-18,Indiaforensic RUPAY STL INTC0308,19.86,,-543916079.06,Chimezie,705,Germany,36320.87,1,1,0
8758,2011,7,MORTGAGE,3,Low,1,18250, 60 months,2,credit_card,1,Low,1,Good Loan,0,10.99,B,2,14.42,22623.1585,18250,0,396.71,409000008757,3-Aug-18,Indiaforensic NFS SETT 01-08-201,"5,000.00",,-543921079.06,Slone,678,Germany,31384.86,1,1,0
8759,2011,6,RENT,1,Low,1,21000, 36 months,1,other,4,Low,1,Bad Loan,1,11.99,B,2,14.35,5286.33,2995.11,0,697.41,409000008758,3-Aug-18,Indiaforensic NFS SETT 01-08-201,"1,500.00",,-543922579.06,Martin,663,France,114083.73,1,1,0
8760,2011,10,MORTGAGE,3,Low,1,14400, 60 months,2,house,12,Low,1,Good Loan,0,12.99,C,3,3.55,18055.42986,14400,0,327.58,409000008759,3-Aug-18,Indiaforensic NFS SETT 01-08-201,"10,000.00",,-543932579.06,Loggia,748,France,163331.65,1,1,0
8761,2011,5,RENT,1,Low,1,18000, 60 months,2,debt_consolidation,6,High,2,Good Loan,0,14.79,C,3,16.23,24461.40086,18000,0,426.24,409000008760,3-Aug-18,Indiaforensic NFS SETT 01-08-201,"1,900.00",,-543934479.06,Hartley,677,Spain,50777.77,1,1,0
8762,2011,6.05,MORTGAGE,3,Low,1,1550, 36 months,1,major_purchase,8,Low,1,Bad Loan,1,5.42,A,1,14.45,744.96,655.32,0,46.75,409000008761,3-Aug-18,Indiaforensic NFS SETT 01-08-201,"3,500.00",,-543937979.06,Parkin,634,Spain,30772.86,1,1,0
8763,2011,0.5,MORTGAGE,3,Low,1,21125, 60 months,2,debt_consolidation,6,Low,1,Good Loan,0,12.99,C,3,13.81,24941.02,17434.47,0,480.56,409000008762,3-Aug-18,Indiaforensic NFS SETT 02-08-201,800,,-543938779.06,Lin,350,France,113796.15,1,1,0
8764,2011,10,MORTGAGE,3,Low,1,12000, 60 months,2,debt_consolidation,6,High,2,Good Loan,0,16.89,D,4,14.81,13294.91,12000,0,297.53,409000008763,3-Aug-18,Indiaforensic NFS SETT 02-08-201,"1,000.00",,-543939779.06,Brooks,727,France,188729.08,1,1,0
8765,2011,10,RENT,1,Low,1,18400, 60 months,2,debt_consolidation,6,High,2,Good Loan,0,19.69,E,5,13.82,26104.04906,18400,0,484.32,409000008764,3-Aug-18,Indiaforensic NFS SETT 02-08-201,"4,000.00",,-543943779.06,Tien,773,Germany,86701.40,1,1,0
8766,2011,4,RENT,1,Low,1,14400, 36 months,1,debt_consolidation,6,Low,1,Good Loan,0,8.49,A,1,14.44,16358.47829,14400,0,454.51,409000008765,3-Aug-18,Indiaforensic NFS SETT 02-08-201,"9,000.00",,-543952779.06,Dann,675,France,153129.22,1,1,0
8767,2011,0.5,RENT,1,Low,1,6800, 36 months,1,debt_consolidation,6,Low,1,Good Loan,0,10.99,B,2,7.62,7989.419493,6800,0,222.6,409000008766,3-Aug-18,Indiaforensic NFS SETT 02-08-201,"2,800.00",,-543955579.06,Trentino,649,Spain,19825.09,1,1,0
8768,2011,6.05,RENT,1,Low,1,10200, 36 months,1,credit_card,1,High,2,Good Loan,0,17.99,E,5,14.53,12411.01,10200,0,368.71,409000008767,3-Aug-18,Indiaforensic NFS SETT 02-08-201,200,,-543955779.06,Russo,552,France,12186.83,1,1,0
8769,2011,5,RENT,1,Low,1,16000, 36 months,1,credit_card,1,Low,1,Good Loan,0,7.49,A,1,11.54,17912.57139,16000,0,497.63,409000008768,4-Aug-18,Indiaforensic  RUPAY SETT 040818,"10,405.33",,-543966184.39,Christie,761,Germany,86920.97,1,1,0
8770,2011,2,MORTGAGE,3,Low,1,30000, 60 months,2,credit_card,1,High,2,Good Loan,0,13.49,C,3,22.69,34092.74,30000,0,690.15,409000008769,4-Aug-18,Indiaforensic RUPAY STL INTC0408,,142.12,-543966042.27,Ross,622,France,35408.77,1,1,0
8771,2011,2,RENT,1,Low,1,18400, 36 months,1,wedding,5,Low,1,Good Loan,0,9.99,B,2,16.44,21156.75,18400,0,593.63,409000008770,4-Aug-18,Indiaforensic RUPAY STL INTC0408,113.49,,-543966155.76,Nnonso,615,France,165576.55,1,1,0
8772,2011,0.5,RENT,1,Low,1,7000, 36 months,1,debt_consolidation,6,High,2,Good Loan,0,15.99,D,4,19.44,8848.75312,7000,0,246.07,409000008771,4-Aug-18,Indiaforensic RUPAY STL INTC0408,,0.21,-543966155.55,Teng,681,Germany,48226.76,1,1,0
8773,2011,3,RENT,1,Low,1,15000, 36 months,1,credit_card,1,High,2,Good Loan,0,16.49,D,4,14.92,17347.78,15000,0,531,409000008772,4-Aug-18,Indiaforensic  RUPAY SETT 040818,600.71,,-543966756.26,Buccho,768,France,199454.37,1,1,0
8774,2011,0.5,MORTGAGE,3,Low,1,8000, 36 months,1,major_purchase,8,Low,1,Good Loan,0,6.99,A,1,5.45,8890.938377,8000,0,246.99,409000008773,4-Aug-18,Indiaforensic RUPAY STL INTC0408,,3.00,-543966753.26,Madukaife,617,Spain,118749.58,1,1,0
8775,2011,6,MORTGAGE,3,Medium,2,18000, 60 months,2,small_business,3,Low,1,Good Loan,0,12.99,C,3,11.45,24020.4939,18000,0,409.47,409000008774,4-Aug-18,Indiaforensic RUPAY STL INTC0408,3,,-543966756.26,Dunn,452,France,151623.91,1,1,0
8776,2011,0.5,MORTGAGE,3,Low,1,15000, 36 months,1,debt_consolidation,6,Low,1,Good Loan,0,8.49,A,1,18.4,16552.43,15000,0,473.45,409000008775,4-Aug-18,Indiaforensic NFS SETT 03-08-201,100,,-543966856.26,Hooker,807,Germany,172097.95,1,1,0
8777,2011,1,MORTGAGE,3,Low,1,7000, 36 months,1,home_improvement,7,Low,1,Good Loan,0,8.49,A,1,8.42,7919.541879,7000,0,220.95,409000008776,4-Aug-18,Indiaforensic NFS SETT 03-08-201,"9,500.00",,-543976356.26,Griffin,567,Spain,87677.15,1,1,0
8778,2011,10,MORTGAGE,3,Medium,2,14000, 60 months,2,home_improvement,7,Low,1,Good Loan,0,10.59,B,2,19.42,14715.54,14000,0,301.54,409000008777,4-Aug-18,Indiaforensic NFS SETT 03-08-201,400,,-543976756.26,Kistler,603,Spain,21858.28,1,1,0
8779,2011,3,RENT,1,Low,1,5500, 60 months,2,debt_consolidation,6,High,2,Good Loan,0,14.79,C,3,19.82,7342.265165,5500,0,130.24,409000008778,4-Aug-18,Indiaforensic NFS SETT 03-08-201,400,,-543977156.26,Law,617,Spain,123866.28,1,1,0
8780,2011,10,MORTGAGE,3,High,3,15000, 60 months,2,debt_consolidation,6,High,2,Good Loan,0,20.25,F,6,8.12,22457.81664,15000,0,399.5,409000008779,4-Aug-18,Indiaforensic NFS SETT 03-08-201,"5,000.00",,-543982156.26,Grigoryeva,701,France,74694.41,1,1,0
8781,2011,1,MORTGAGE,3,Low,1,4800, 36 months,1,home_improvement,7,High,2,Good Loan,0,14.79,C,3,3.27,5969.162595,4800,0,165.91,409000008780,4-Aug-18,Indiaforensic NFS SETT 03-08-201,"10,000.00",,-543992156.26,Chu,820,Germany,16770.31,1,1,0
8782,2011,0.5,RENT,1,Low,1,8000, 36 months,1,credit_card,1,Low,1,Good Loan,0,7.49,A,1,12.05,8955.437588,8000,0,248.82,409000008781,4-Aug-18,Indiaforensic NFS SETT 03-08-201,"10,000.00",,-544002156.26,Onyemachukwu,438,France,49424.60,1,1,0
8783,2011,3,RENT,1,Low,1,25450, 60 months,2,credit_card,1,High,2,Good Loan,0,13.99,C,3,26.38,34657.35397,25450,0,592.05,409000008782,6-Aug-18,Indiaforensic RUPAY SETT 050818,634.49,,-544002790.75,Lu,600,Spain,172031.22,1,1,0
8784,2011,2,RENT,1,Low,1,3600, 36 months,1,debt_consolidation,6,High,2,Good Loan,0,15.23,C,3,14.63,3857.45,3600,0,125.21,409000008783,6-Aug-18,Indiaforensic RUPAY STL INTC0508,,6.30,-544002784.45,Watson,782,France,183021.06,1,1,0
8785,2011,3,RENT,1,Low,1,5000, 36 months,1,debt_consolidation,6,High,2,Good Loan,0,15.99,D,4,7.95,5647.01,5000,0,175.77,409000008784,6-Aug-18,Indiaforensic RUPAY STL INTC0508,6.3,,-544002790.75,Fallaci,638,Germany,73979.85,1,1,0
8786,2011,8,MORTGAGE,3,Low,1,21000, 36 months,1,debt_consolidation,6,Low,1,Good Loan,0,9.99,B,2,17.8,24249.50181,21000,0,677.52,409000008785,6-Aug-18,Indiaforensic RUPAY SETT 060818,"2,829.42",,-544005620.17,Ni,850,Germany,26265.18,1,1,0
8787,2011,1,OWN,2,Low,1,3000, 36 months,1,credit_card,1,Low,1,Good Loan,0,9.99,B,2,21.3,3338.11,3000,0,96.79,409000008786,6-Aug-18,Indiaforensic RUPAY STL INTC0608,,19.14,-544005601.03,Leason,741,Germany,24857.25,1,1,0
8788,2011,5,RENT,1,Medium,2,12000, 60 months,2,small_business,3,High,2,Good Loan,0,13.49,C,3,9.36,14340.91,9890.93,0,276.06,409000008787,6-Aug-18,Indiaforensic RUPAY STL INTC0608,19.14,,-544005620.17,Tsai,689,Spain,167969.15,1,1,0
8789,2011,0.5,RENT,1,Low,1,2000, 36 months,1,credit_card,1,Low,1,Good Loan,0,10.99,B,2,8.3,2278.76,2000,0,65.47,409000008788,6-Aug-18,Indiaforensic NFS SETT 04-08-201,"2,000.00",,-544007620.17,Bruner,743,Germany,189307.70,1,1,0
8790,2011,10,MORTGAGE,3,Low,1,5000, 36 months,1,debt_consolidation,6,High,2,Bad Loan,1,18.79,E,5,11.52,3269.02,2011.13,170.77,182.75,409000008789,6-Aug-18,Indiaforensic NFS SETT 04-08-201,"3,000.00",,-544010620.17,Wallace,493,France,99770.30,1,1,0
8791,2011,10,RENT,1,Low,1,8000, 36 months,1,major_purchase,8,Low,1,Good Loan,0,5.42,A,1,9.88,8678.704656,8000,0,241.28,409000008790,6-Aug-18,Indiaforensic NFS SETT 04-08-201,"3,000.00",,-544013620.17,Young,416,Spain,119712.78,1,1,0
8792,2011,3,RENT,1,Low,1,7000, 36 months,1,credit_card,1,Low,1,Good Loan,0,11.99,B,2,15.83,8368.554792,7000,0,232.47,409000008791,6-Aug-18,Indiaforensic NFS SETT 04-08-201,"10,000.00",,-544023620.17,Forbes,725,France,168607.74,1,1,0
8793,2011,4,RENT,1,Low,1,6750, 36 months,1,other,4,Low,1,Good Loan,0,5.99,A,1,2.05,7239.78,6750,0,205.32,409000008792,6-Aug-18,Indiaforensic NFS SETT 04-08-201,"10,000.00",,-544033620.17,Muir,497,France,83087.13,1,1,0
8794,2011,7,RENT,1,Medium,2,22000, 60 months,2,debt_consolidation,6,High,2,Good Loan,0,20.62,F,6,5.23,30693.88,17616.86,0,590.49,409000008793,6-Aug-18,Indiaforensic NFS SETT 04-08-201,800,,-544034420.17,Pugh,537,Germany,130664.79,1,1,0
8795,2011,10,MORTGAGE,3,Low,1,14400, 60 months,2,debt_consolidation,6,High,2,Bad Loan,1,20.25,F,6,20.98,8680.26,3492.94,649.66,383.52,409000008794,6-Aug-18,Indiaforensic NFS SETT 04-08-201,300,,-544034720.17,Webb,706,Spain,133267.69,1,1,0
8796,2011,10,OWN,2,Low,1,7000, 36 months,1,debt_consolidation,6,Low,1,Good Loan,0,10.59,B,2,13.49,8169.175446,7000,0,227.82,409000008795,6-Aug-18,Indiaforensic NFS SETT 04-08-201,100,,-544034820.17,Walker,651,Spain,67029.82,1,1,0
8797,2011,6.05,OWN,2,Low,1,20000, 60 months,2,debt_consolidation,6,High,2,Good Loan,0,15.99,D,4,19.75,27675.24471,20000,0,486.26,409000008796,6-Aug-18,Indiaforensic NFS SETT 04-08-201,"2,500.00",,-544037320.17,Cox,720,France,141031.08,1,1,0
8798,2011,3,OWN,2,Low,1,18000, 60 months,2,debt_consolidation,6,Low,1,Bad Loan,1,11.49,B,2,21.16,19337.54,13851.29,0,395.78,409000008797,6-Aug-18,Indiaforensic NFS SETT 04-08-201,500,,-544037820.17,Maclean,797,France,125110.02,1,1,0
8799,2011,10,MORTGAGE,3,Low,1,13250, 60 months,2,debt_consolidation,6,Low,1,Good Loan,0,11.99,B,2,20.62,15289.62,10975.4,0,294.68,409000008798,6-Aug-18,Indiaforensic NFS SETT 04-08-201,"3,000.00",,-544040820.17,Hollis,543,Spain,117832.39,1,1,0
8800,2011,6,MORTGAGE,3,Low,1,9000, 36 months,1,debt_consolidation,6,Low,1,Good Loan,0,12.99,C,3,15.71,10025.2,8999.99,0,303.21,409000008799,6-Aug-18,Indiaforensic NFS SETT 04-08-201,"3,000.00",,-544043820.17,Jamieson,454,France,198817.72,1,1,0
8801,2011,8,RENT,1,Low,1,13800, 60 months,2,medical,9,High,2,Bad Loan,1,17.49,D,4,1.68,960.31,145.1,614.61,346.62,409000008800,6-Aug-18,Indiaforensic NFS SETT 04-08-201,"3,000.00",,-544046820.17,Su,691,France,146411.60,1,1,0
8802,2011,10,RENT,1,Medium,2,14000, 36 months,1,debt_consolidation,6,Low,1,Good Loan,0,5.42,A,1,3.29,14605.03,14000,0,422.24,409000008801,6-Aug-18,Indiaforensic NFS SETT 05-08-201,400,,-544047220.17,P'eng,510,France,131312.56,1,1,0
8803,2011,10,MORTGAGE,3,Low,1,5000, 36 months,1,house,12,Low,1,Good Loan,0,7.49,A,1,27.73,5596.079282,5000,0,155.51,409000008802,6-Aug-18,Indiaforensic NFS SETT 05-08-201,300,,-544047520.17,Hawkins,792,Spain,141652.20,1,1,0
8804,2011,10,MORTGAGE,3,Low,1,20000, 60 months,2,debt_consolidation,6,High,2,Good Loan,0,15.99,D,4,16.94,28118.63768,20000,0,486.26,409000008803,6-Aug-18,Indiaforensic NFS SETT 05-08-201,300,,-544047820.17,Ndubuagha,721,France,64477.25,1,1,0
8805,2011,10,MORTGAGE,3,Low,1,13800, 60 months,2,wedding,5,High,2,Good Loan,0,17.49,D,4,9.7,19337.45583,13800,0,346.62,409000008804,6-Aug-18,Indiaforensic  RUPAY SETT 060818,335.71,,-544048155.88,Hill,765,France,191215.61,1,1,0
8806,2011,10,MORTGAGE,3,Low,1,10000, 36 months,1,small_business,3,Low,1,Good Loan,0,12.99,C,3,23.76,12124.88995,10000,0,336.9,409000008805,6-Aug-18,Indiaforensic RUPAY STL INTC0608,,1.68,-544048154.20,Norton,850,Spain,37090.44,1,1,0
8807,2011,6.05,OWN,2,Low,1,7500, 36 months,1,debt_consolidation,6,Low,1,Good Loan,0,5.42,A,1,16.2,7973.52,7500,0,226.2,409000008806,6-Aug-18,Indiaforensic RUPAY STL INTC0608,1.68,,-544048155.88,Achebe,681,Germany,57517.71,1,1,0
8808,2011,4,MORTGAGE,3,Low,1,2000, 36 months,1,debt_consolidation,6,Low,1,Good Loan,0,10.99,B,2,10.87,2354.389203,2000,0,65.47,409000008807,7-Aug-18,Indiaforensic  RUPAY SETT 070818,935.12,,-544049091.00,Simpson,586,France,63241.21,1,1,0
8809,2011,3,MORTGAGE,3,Low,1,3200, 36 months,1,small_business,3,Low,1,Good Loan,0,10.99,B,2,3.88,3717.4,3200,0,104.75,409000008808,7-Aug-18,Indiaforensic RUPAY STL INTC0708,,11.09,-544049079.91,Chiang,753,France,44567.83,1,1,0
8810,2011,2,RENT,1,Low,1,16000, 36 months,1,debt_consolidation,6,High,2,Bad Loan,1,17.49,D,4,19.82,11433.12,7380.7,493.26,574.36,409000008809,7-Aug-18,Indiaforensic RUPAY STL INTC0708,10.26,,-544049090.17,Dalrymple,593,Germany,135337.11,1,1,0
8811,2011,5,RENT,1,Low,1,22000, 60 months,2,debt_consolidation,6,High,2,Good Loan,0,16.89,D,4,18.02,31768.42287,22000,0,545.46,409000008810,7-Aug-18,TRF FRM  Indiaforensic SERVICES,,1475000.00,-542574090.17,Chukwuemeka,674,France,33964.03,1,1,0
8812,2011,8,MORTGAGE,3,Low,1,8000, 36 months,1,credit_card,1,Low,1,Good Loan,0,6.99,A,1,12.32,8046.91,8000,0,246.99,409000008811,7-Aug-18,Indiaforensic NFS SETT 06-08-201,"9,500.00",,-542583590.17,Ojiofor,610,France,61623.19,1,1,0
8813,2011,6,RENT,1,Low,1,13000, 36 months,1,credit_card,1,Low,1,Good Loan,0,11.49,B,2,14.36,15356.86979,13000,0,428.63,409000008812,7-Aug-18,Indiaforensic NFS SETT 06-08-201,"2,000.00",,-542585590.17,Rubeo,652,France,168989.77,1,1,0
8814,2011,7,MORTGAGE,3,Low,1,6925, 36 months,1,credit_card,1,Low,1,Good Loan,0,9.99,B,2,8.48,7988.88,6925,0,223.42,409000008813,7-Aug-18,Indiaforensic NFS SETT 06-08-201,400,,-542585990.17,Fanucci,850,Germany,74425.41,1,1,0
8815,2011,5,MORTGAGE,3,Low,1,12000, 60 months,2,credit_card,1,High,2,Good Loan,0,17.49,D,4,20.9,13656.91,12000,0,301.41,409000008814,7-Aug-18,Indiaforensic NFS SETT 06-08-201,"6,000.00",,-542591990.17,Zubarev,740,France,178929.84,1,1,0
8816,2011,3,RENT,1,Low,1,2500, 36 months,1,debt_consolidation,6,High,2,Good Loan,0,13.49,C,3,12.39,2595.29,2500,0,84.83,409000008815,8-Aug-18,Indiaforensic  RUPAY SETT 080818,717.26,,-542592707.43,T'ao,637,Germany,101382.86,1,1,0
8817,2011,3,RENT,1,Medium,2,35000, 60 months,2,debt_consolidation,6,High,2,Good Loan,0,16.49,D,4,9.92,42213.66,35000,0,860.28,409000008816,8-Aug-18,Indiaforensic RUPAY STL INTC0808,,10.42,-542592697.01,Pai,685,Spain,180769.55,1,1,0
8818,2011,10,MORTGAGE,3,Medium,2,10000, 36 months,1,debt_consolidation,6,Low,1,Good Loan,0,5.99,A,1,15.61,10949.948,10000,0,304.18,409000008817,8-Aug-18,Indiaforensic RUPAY STL INTC0808,5.92,,-542592702.93,Udegbunam,558,Spain,92378.54,1,1,0
8819,2011,1,OWN,2,Low,1,4800, 36 months,1,moving,10,High,2,Good Loan,0,13.49,C,3,5.11,5874.794319,4800,0,162.87,409000008818,8-Aug-18,Indiaforensic RUPAY STL INTC0808,,0.02,-542592702.91,Claypool,677,France,38252.25,1,1,0
8820,2011,6.05,RENT,1,Low,1,3000, 36 months,1,wedding,5,Low,1,Good Loan,0,12.99,C,3,17.63,3637.08151,3000,0,101.07,409000008819,8-Aug-18,Indiaforensic  RUPAY SETT 080818,"1,602.12",,-542594305.03,Manfrin,592,Germany,146111.35,1,1,0
8821,2011,0.5,MORTGAGE,3,Low,1,12000, 36 months,1,debt_consolidation,6,High,2,Good Loan,0,15.62,D,4,4.47,15100.67723,12000,0,419.64,409000008820,8-Aug-18,Indiaforensic RUPAY STL INTC0808,,15.60,-542594289.43,Baker,652,Germany,72350.17,1,1,0
8822,2011,10,MORTGAGE,3,Medium,2,30000, 60 months,2,debt_consolidation,6,High,2,Good Loan,0,17.99,E,5,20.32,35831.27,30000,0,761.64,409000008821,8-Aug-18,Indiaforensic RUPAY STL INTC0808,15.6,,-542594305.03,Efremov,662,Spain,48242.38,1,1,0
8823,2011,4,RENT,1,Low,1,8000, 36 months,1,debt_consolidation,6,High,2,Good Loan,0,13.49,C,3,16.71,8801.95,8000,0,271.45,409000008822,9-Aug-18,Indiaforensic  RUPAY SETT 090818,"3,833.96",,-542598138.99,Chin,543,France,148305.82,1,1,0
8824,2011,9,MORTGAGE,3,Low,1,30000, 60 months,2,debt_consolidation,6,High,2,Good Loan,0,19.29,E,5,13.46,44719.29798,30000,0,783.02,409000008823,9-Aug-18,Indiaforensic RUPAY STL INTC0908,,28.62,-542598110.37,Brookes,675,Spain,8270.06,1,1,0
8825,2011,3,MORTGAGE,3,Low,1,35000, 60 months,2,credit_card,1,High,2,Bad Loan,1,16.49,D,4,26.51,5336.96,1546.02,1902.12,860.28,409000008824,9-Aug-18,Indiaforensic RUPAY STL INTC0908,28.62,,-542598138.99,Doyle,643,Spain,41549.64,1,1,0
8826,2011,10,MORTGAGE,3,Low,1,9000, 60 months,2,home_improvement,7,High,2,Good Loan,0,16.89,D,4,2.88,11557.98,7299.56,0,223.15,409000008825,9-Aug-18,Indiaforensic NFS SETT 07-08-201,"5,000.00",,-542603138.99,Ajuluchukwu,611,Germany,138656.81,1,1,0
8827,2011,7,RENT,1,Low,1,13000, 60 months,2,debt_consolidation,6,High,2,Good Loan,0,19.29,E,5,12.38,17629.62,10465.22,0,339.31,409000008826,9-Aug-18,Indiaforensic NFS SETT 07-08-201,"1,000.00",,-542604138.99,Ikemefuna,412,France,12510.53,1,1,0
8828,2011,8,MORTGAGE,3,Low,1,7200, 36 months,1,home_improvement,7,High,2,Good Loan,0,14.79,C,3,14.69,8953.620217,7200,0,248.86,409000008827,9-Aug-18,Indiaforensic NFS SETT 07-08-201,"2,000.00",,-542606138.99,Fowler,638,Spain,43889.41,1,1,0
8829,2011,9,MORTGAGE,3,Low,1,11000, 36 months,1,major_purchase,8,Low,1,Good Loan,0,6.99,A,1,19.48,11900.22,10999.99,0,339.6,409000008828,9-Aug-18,Indiaforensic NFS SETT 07-08-201,"2,000.00",,-542608138.99,Liao,824,Spain,192800.25,1,1,0
8830,2011,6.05,MORTGAGE,3,Low,1,1000, 36 months,1,major_purchase,8,High,2,Bad Loan,1,13.49,C,3,4.49,135.04,91.85,0,33.94,409000008829,9-Aug-18,Indiaforensic NFS SETT 07-08-201,"5,000.00",,-542613138.99,Onuora,683,France,75762.00,1,1,0
8831,2011,5,RENT,1,Low,1,14750, 60 months,2,debt_consolidation,6,Low,1,Good Loan,0,11.99,B,2,24,17033.43,12224.87,0,328.04,409000008830,9-Aug-18,Indiaforensic NFS SETT 07-08-201,"2,000.00",,-542615138.99,Aksenov,562,Germany,9854.72,1,1,0
8832,2011,2,MORTGAGE,3,Low,1,14400, 36 months,1,debt_consolidation,6,Low,1,Good Loan,0,5.42,A,1,8.66,14924.6,14400,0,434.31,409000008831,9-Aug-18,Indiaforensic NFS SETT 07-08-201,"5,000.00",,-542620138.99,Trevisani,599,France,115724.78,1,1,0
8833,2011,10,RENT,1,Low,1,14000, 60 months,2,debt_consolidation,6,Low,1,Good Loan,0,11.99,B,2,12.97,16166.36,11602.65,0,311.36,409000008832,9-Aug-18,Indiaforensic NFS SETT 07-08-201,"9,000.00",,-542629138.99,Wood,753,France,106303.40,1,1,0
8834,2011,10,OWN,2,Low,1,4100, 36 months,1,home_improvement,7,High,2,Good Loan,0,13.49,C,3,14.42,4981.514097,4100,0,139.12,409000008833,9-Aug-18,Indiaforensic NFS SETT 07-08-201,"8,000.00",,-542637138.99,Lombardo,594,France,183868.01,1,1,0
8835,2011,10,MORTGAGE,3,Low,1,5000, 36 months,1,debt_consolidation,6,High,2,Good Loan,0,14.79,C,3,17.2,5502.68,5000,0,172.82,409000008834,9-Aug-18,Indiaforensic NFS SETT 07-08-201,"3,000.00",,-542640138.99,Walpole,657,France,153895.46,1,1,0
8836,2011,8,OWN,2,Low,1,5100, 60 months,2,car,2,Low,1,Good Loan,0,11.49,B,2,10.62,5802.86,4222.19,0,112.14,409000008835,9-Aug-18,Indiaforensic NFS SETT 07-08-201,500,,-542640638.99,Chikwendu,716,Spain,66695.71,1,1,0
8837,2011,6,RENT,1,Low,1,7200, 36 months,1,small_business,3,Low,1,Bad Loan,1,11.99,B,2,4.99,1195.25,852.51,0,239.11,409000008836,9-Aug-18,Indiaforensic NFS SETT 07-08-201,"4,000.00",,-542644638.99,Ko,850,France,173851.11,1,1,0
8838,2011,2,MORTGAGE,3,Low,1,10000, 36 months,1,debt_consolidation,6,Low,1,Bad Loan,1,10.99,B,2,23.46,8509.48,6863.39,0,327.34,409000008837,9-Aug-18,Indiaforensic NFS SETT 07-08-201,"1,500.00",,-542646138.99,Steigrad,664,France,177423.02,1,1,0
8839,2011,10,MORTGAGE,3,Medium,2,35000, 60 months,2,major_purchase,8,High,2,Good Loan,0,19.29,E,5,22.88,46739.07,34999.99,0,913.52,409000008838,9-Aug-18,Indiaforensic NFS SETT 07-08-201,"1,000.00",,-542647138.99,Isayeva,558,France,109096.71,1,1,0
8840,2011,6,MORTGAGE,3,Low,1,10000, 36 months,1,debt_consolidation,6,Low,1,Good Loan,0,5.42,A,1,8.03,10697.26,10000,0,301.6,409000008839,9-Aug-18,Indiaforensic NFS SETT 07-08-201,"9,000.00",,-542656138.99,Boni,606,Germany,166656.18,1,1,0
8841,2011,3,MORTGAGE,3,Low,1,7000, 36 months,1,debt_consolidation,6,Low,1,Good Loan,0,7.49,A,1,15.3,7835.588453,7000,0,217.72,409000008840,9-Aug-18,Indiaforensic NFS SETT 07-08-201,"10,000.00",,-542666138.99,Anayolisa,776,Spain,176921.00,1,1,0
8842,2011,5,MORTGAGE,3,Low,1,25000, 60 months,2,debt_consolidation,6,High,2,Good Loan,0,18.39,E,5,5.17,31240.34,25000,0,640.16,409000008841,9-Aug-18,Indiaforensic NFS SETT 07-08-201,"8,500.00",,-542674638.99,Fallaci,557,Spain,98413.10,1,1,0
8843,2011,10,MORTGAGE,3,Low,1,6000, 36 months,1,debt_consolidation,6,High,2,Good Loan,0,15.62,D,4,2.1,7548.786946,6000,0,209.82,409000008842,9-Aug-18,Indiaforensic NFS SETT 07-08-201,200,,-542674838.99,Fenton,614,France,77500.81,1,1,0
8844,2011,7,MORTGAGE,3,Low,1,20000, 60 months,2,debt_consolidation,6,High,2,Good Loan,0,14.79,C,3,23.78,24135.04,15978.46,0,473.6,409000008843,9-Aug-18,Indiaforensic NFS SETT 07-08-201,"8,000.00",,-542682838.99,Chao,620,Spain,119747.08,1,1,0
8845,2011,2,RENT,1,Low,1,7600, 60 months,2,other,4,High,2,Bad Loan,1,16.49,D,4,20.5,6816.73,3149.25,782.23,186.81,409000008844,9-Aug-18,Indiaforensic NFS SETT 07-08-201,"6,000.00",,-542688838.99,Osinachi,695,Spain,160387.98,1,1,0
8846,2011,8,MORTGAGE,3,Low,1,2500, 36 months,1,home_improvement,7,Low,1,Good Loan,0,6.99,A,1,28.58,2777.87255,2500,0,77.19,409000008845,9-Aug-18,Indiaforensic NFS SETT 07-08-201,"5,000.00",,-542693838.99,Chu,729,Germany,193715.00,1,1,0
8847,2011,6.05,MORTGAGE,3,Low,1,25000, 60 months,2,other,4,High,2,Bad Loan,1,13.49,C,3,10.9,1723.56,891.26,0,575.12,409000008846,9-Aug-18,Indiaforensic NFS SETT 07-08-201,"7,600.00",,-542701438.99,Obiuto,571,France,28045.77,1,1,0
8848,2011,4,RENT,1,Low,1,10000, 36 months,1,credit_card,1,Low,1,Good Loan,0,10.99,B,2,20.94,11777.22758,10000,0,327.34,409000008847,9-Aug-18,Indiaforensic NFS SETT 07-08-201,"5,000.00",,-542706438.99,Chu,457,France,150757.35,1,1,0
8849,2011,1,RENT,1,Low,1,9500, 36 months,1,debt_consolidation,6,Low,1,Good Loan,0,5.99,A,1,9.9,10362.86,9500,0,288.97,409000008848,9-Aug-18,Indiaforensic NFS SETT 07-08-201,400,,-542706838.99,Nash,559,France,82252.28,1,1,0
8850,2011,4,RENT,1,Low,1,15000, 60 months,2,major_purchase,8,Low,1,Good Loan,0,10.59,B,2,12.86,19006.69906,15000,0,323.08,409000008849,9-Aug-18,Indiaforensic NFS SETT 07-08-201,"5,500.00",,-542712338.99,Hixson,664,France,154395.56,1,1,0
8851,2011,7,RENT,1,Medium,2,25000, 36 months,1,major_purchase,8,Low,1,Good Loan,0,8.49,A,1,6,25942.76,25000,0,789.08,409000008850,9-Aug-18,Indiaforensic NFS SETT 07-08-201,"7,000.00",,-542719338.99,Fiorentini,500,Spain,83866.35,1,1,0
8852,2011,3,MORTGAGE,3,Low,1,1500, 36 months,1,major_purchase,8,Low,1,Good Loan,0,5.99,A,1,1,1600.79,1500,0,45.63,409000008851,9-Aug-18,Indiaforensic NFS SETT 07-08-201,"8,900.00",,-542728238.99,Chidimma,782,Germany,39830.10,1,1,0
8853,2011,10,RENT,1,Medium,2,21000, 60 months,2,debt_consolidation,6,High,2,Good Loan,0,15.99,D,4,22.27,26754.51,21000,0,510.57,409000008852,9-Aug-18,Indiaforensic NFS SETT 07-08-201,"8,600.00",,-542736838.99,Chiazagomekpere,708,Spain,12429.22,1,1,0
8854,2011,5,MORTGAGE,3,Medium,2,20000, 60 months,2,home_improvement,7,High,2,Good Loan,0,16.49,D,4,8.82,23046.53,20000,0,491.59,409000008853,9-Aug-18,Indiaforensic NFS SETT 07-08-201,"8,000.00",,-542744838.99,Laura,681,France,18772.50,1,1,0
8855,2011,10,MORTGAGE,3,Low,1,25000, 60 months,2,medical,9,Low,1,Good Loan,0,11.99,B,2,25.74,28358.01,20222.46,0,555.99,409000008854,9-Aug-18,Indiaforensic NFS SETT 07-08-201,"5,600.00",,-542750438.99,Wu,674,Spain,9574.83,1,1,0
8856,2011,3,MORTGAGE,3,Low,1,5400, 36 months,1,debt_consolidation,6,Low,1,Bad Loan,1,10.99,B,2,4.25,2738.92,2252.39,9.43,176.77,409000008855,9-Aug-18,Indiaforensic NFS SETT 07-08-201,"8,000.00",,-542758438.99,Toscani,697,Spain,188486.94,1,1,0
8857,2011,2,RENT,1,Low,1,9000, 36 months,1,moving,10,Low,1,Bad Loan,1,6.99,A,1,15.55,4214.8,3275.23,328.54,277.86,409000008856,9-Aug-18,Indiaforensic NFS SETT 07-08-201,"10,000.00",,-542768438.99,McMillan,774,France,64716.08,1,1,0
8858,2011,10,RENT,1,Low,1,13500, 60 months,2,debt_consolidation,6,High,2,Bad Loan,1,19.69,E,5,15.08,4590.13,1592.71,697.01,355.35,409000008857,9-Aug-18,Indiaforensic NFS SETT 07-08-201,300,,-542768738.99,Chiekwugo,624,France,84749.96,1,1,0
8859,2011,0.5,MORTGAGE,3,Low,1,13000, 36 months,1,debt_consolidation,6,Low,1,Good Loan,0,9.99,B,2,21.64,14339.61,13000,0,419.42,409000008858,9-Aug-18,Indiaforensic NFS SETT 07-08-201,"8,100.00",,-542776838.99,Hendley,747,Spain,180551.76,1,1,0
8860,2011,5,MORTGAGE,3,Low,1,23600, 60 months,2,debt_consolidation,6,Low,1,Good Loan,0,11.49,B,2,19.94,26944.17,19596.91,0,518.91,409000008859,9-Aug-18,Indiaforensic NFS SETT 07-08-201,"3,000.00",,-542779838.99,Birnie,715,France,60907.49,1,1,0
8861,2011,10,MORTGAGE,3,Low,1,10000, 36 months,1,small_business,3,Low,1,Good Loan,0,7.49,A,1,0.88,11002.39,10000,0,311.02,409000008860,9-Aug-18,Indiaforensic NFS SETT 07-08-201,"8,700.00",,-542788538.99,Kemp,808,France,174107.04,1,1,0
8862,2011,3,RENT,1,Low,1,5000, 36 months,1,major_purchase,8,Low,1,Good Loan,0,12.99,C,3,0.52,6060.221443,5000,0,168.45,409000008861,9-Aug-18,Indiaforensic NFS SETT 07-08-201,"6,000.00",,-542794538.99,Johnstone,678,France,110405.90,1,1,0
8863,2011,7,MORTGAGE,3,Medium,2,35000, 36 months,1,other,4,Low,1,Good Loan,0,7.49,A,1,1.06,39117.9924,35000,0,1088.56,409000008862,9-Aug-18,Indiaforensic NFS SETT 07-08-201,500,,-542795038.99,Lo Duca,813,Germany,187636.06,1,1,0
8864,2011,3,RENT,1,Low,1,2000, 36 months,1,other,4,Low,1,Good Loan,0,10.99,B,2,24.71,2310.47,2000,0,65.47,409000008863,9-Aug-18,Indiaforensic NFS SETT 07-08-201,100,,-542795138.99,Montgomery,687,Spain,66580.13,1,1,0
8865,2011,6,RENT,1,Low,1,16000, 36 months,1,debt_consolidation,6,Low,1,Good Loan,0,10.99,B,2,14.27,18079.75,16000,0,523.75,409000008864,9-Aug-18,Indiaforensic NFS SETT 07-08-201,"7,000.00",,-542802138.99,Miller,832,France,178779.52,1,1,0
8866,2011,8,MORTGAGE,3,Medium,2,15000, 36 months,1,credit_card,1,High,2,Good Loan,0,15.62,D,4,14.15,18444.67,15000,0,524.55,409000008865,9-Aug-18,Indiaforensic NFS SETT 07-08-201,"5,400.00",,-542807538.99,Chiemezie,668,France,70783.61,1,1,0
8867,2011,4,MORTGAGE,3,Low,1,7125, 36 months,1,credit_card,1,Low,1,Good Loan,0,9.99,B,2,9.68,8269.461781,7125,0,229.88,409000008866,9-Aug-18,Indiaforensic NFS SETT 07-08-201,"8,000.00",,-542815538.99,Wright,526,Germany,46772.36,1,1,0
8868,2011,10,MORTGAGE,3,Medium,2,35000, 60 months,2,debt_consolidation,6,Low,1,Good Loan,0,11.49,B,2,17.13,35335.32,35000,0,769.57,409000008867,9-Aug-18,Indiaforensic NFS SETT 07-08-201,"9,000.00",,-542824538.99,Shaw,457,France,163327.27,1,1,0
8869,2011,5,RENT,1,Low,1,6000, 36 months,1,car,2,Low,1,Good Loan,0,6.99,A,1,11.94,6664.71923,6000,0,185.24,409000008868,9-Aug-18,Indiaforensic NFS SETT 07-08-201,"2,000.00",,-542826538.99,Chapman,649,Spain,103760.53,1,1,0
8870,2011,2,RENT,1,Low,1,7000, 36 months,1,medical,9,High,2,Good Loan,0,13.99,C,3,1.91,7082.59,7000,0,239.21,409000008869,9-Aug-18,Indiaforensic NFS SETT 07-08-201,"9,500.00",,-542836038.99,Y?an,669,France,107839.03,1,1,0
8871,2011,5,MORTGAGE,3,Medium,2,6500, 60 months,2,car,2,Low,1,Good Loan,0,8.49,A,1,14.28,7518.33,6500,0,133.33,409000008870,9-Aug-18,Indiaforensic NFS SETT 07-08-201,"6,000.00",,-542842038.99,Clark,668,France,32900.41,1,1,0
8872,2011,2,RENT,1,Low,1,5000, 36 months,1,debt_consolidation,6,Low,1,Good Loan,0,12.99,C,3,6.21,6024.761097,5000,0,168.45,409000008871,9-Aug-18,Indiaforensic NFS SETT 07-08-201,"9,000.00",,-542851038.99,Howells,466,France,193984.60,1,1,0
8873,2011,2,RENT,1,Low,1,20000, 60 months,2,debt_consolidation,6,Low,1,Good Loan,0,10.59,B,2,17.81,23670.87,20000.01,0,430.78,409000008872,9-Aug-18,Indiaforensic NFS SETT 07-08-201,"7,000.00",,-542858038.99,Gamble,685,France,140889.32,1,1,0
8874,2011,10,RENT,1,Low,1,20000, 60 months,2,debt_consolidation,6,Low,1,Good Loan,0,11.99,B,2,8.8,23080.36,16565.7,0,444.79,409000008873,9-Aug-18,Indiaforensic NFS SETT 07-08-201,"10,000.00",,-542868038.99,Rogers,610,France,125646.82,1,1,0
8875,2011,3,RENT,1,Low,1,22000, 36 months,1,debt_consolidation,6,Low,1,Good Loan,0,10.59,B,2,8.94,24643.7,22000,0,715.99,409000008874,9-Aug-18,Indiaforensic NFS SETT 07-08-201,"7,000.00",,-542875038.99,McMillan,582,Germany,20344.02,1,1,0
8876,2011,10,MORTGAGE,3,Low,1,14300, 60 months,2,debt_consolidation,6,High,2,Good Loan,0,20.25,F,6,20.72,19385.92,11129.02,0,380.86,409000008875,9-Aug-18,Indiaforensic NFS SETT 07-08-201,"8,500.00",,-542883538.99,Brown,702,Germany,174268.87,1,1,0
8877,2011,2,RENT,1,Low,1,5600, 36 months,1,wedding,5,Low,1,Good Loan,0,11.99,B,2,9.54,6667.43545,5600,0,185.98,409000008876,9-Aug-18,Indiaforensic NFS SETT 07-08-201,"8,000.00",,-542891538.99,Robertson,556,Spain,108500.66,1,1,0
8878,2011,0.5,RENT,1,Low,1,3000, 36 months,1,debt_consolidation,6,Low,1,Good Loan,0,10.99,B,2,5.85,3531.942083,3000,0,98.21,409000008877,9-Aug-18,Indiaforensic NFS SETT 07-08-201,500,,-542892038.99,Thomas,812,Spain,83247.14,1,1,0
8879,2011,10,RENT,1,Low,1,5000, 36 months,1,debt_consolidation,6,High,2,Good Loan,0,13.99,C,3,22.06,5428.19,5000,0,170.87,409000008878,9-Aug-18,Indiaforensic NFS SETT 07-08-201,"10,000.00",,-542902038.99,Hsing,645,Germany,121840.20,1,1,0
8880,2011,7,RENT,1,Low,1,18000, 60 months,2,debt_consolidation,6,High,2,Good Loan,0,18.79,E,5,11.65,20679.02,18000,0,464.86,409000008879,9-Aug-18,Indiaforensic NFS SETT 07-08-201,"3,000.00",,-542905038.99,Chiu,809,France,132908.07,1,1,0
8881,2011,2,RENT,1,Low,1,6000, 36 months,1,other,4,Low,1,Good Loan,0,7.49,A,1,25.77,6684.89,6000,0,186.61,409000008880,9-Aug-18,Indiaforensic NFS SETT 07-08-201,"8,000.00",,-542913038.99,Chang,560,France,100075.10,1,1,0
8882,2011,10,OWN,2,Low,1,7000, 36 months,1,major_purchase,8,High,2,Bad Loan,1,15.99,D,4,12.28,2460.7,1615.52,11.2,246.07,409000008881,9-Aug-18,Indiaforensic NFS SETT 07-08-201,500,,-542913538.99,Kornilova,744,France,119327.75,1,1,0
8883,2011,2,RENT,1,Low,1,21000, 60 months,2,small_business,3,High,2,Bad Loan,1,20.25,F,6,14.53,11570.27,4530.77,944.14,559.3,409000008882,9-Aug-18,Indiaforensic NFS SETT 07-08-201,"10,000.00",,-542923538.99,Chifo,731,Spain,136737.13,1,1,0
8884,2011,1,MORTGAGE,3,Low,1,17000, 60 months,2,credit_card,1,Low,1,Good Loan,0,10.99,B,2,25.33,19940.92,17000,0,369.54,409000008883,9-Aug-18,Indiaforensic NFS SETT 07-08-201,"9,000.00",,-542932538.99,Lu,471,Spain,22356.97,1,1,0
8885,2011,0.5,RENT,1,Low,1,5000, 36 months,1,debt_consolidation,6,Low,1,Good Loan,0,7.49,A,1,22.77,5596.814426,5000,0,155.51,409000008884,9-Aug-18,Indiaforensic NFS SETT 07-08-201,"10,000.00",,-542942538.99,Bellucci,686,Germany,10137.34,1,1,0
8886,2011,6,RENT,1,Low,1,10500, 36 months,1,debt_consolidation,6,Low,1,Good Loan,0,11.99,B,2,19.81,12435.675,10500,0,348.71,409000008885,9-Aug-18,Indiaforensic NFS SETT 07-08-201,"9,000.00",,-542951538.99,Michael,668,Spain,158379.25,1,1,0
8887,2011,6.05,RENT,1,Low,1,10000, 36 months,1,debt_consolidation,6,Low,1,Good Loan,0,5.99,A,1,6.2,10725.47,10000,0,304.18,409000008886,9-Aug-18,Indiaforensic NFS SETT 07-08-201,"8,000.00",,-542959538.99,Sinclair,575,France,94570.56,1,1,0
8888,2011,6,RENT,1,Low,1,11000, 36 months,1,debt_consolidation,6,Low,1,Good Loan,0,11.99,B,2,8.96,12626.49,11000,0,365.31,409000008887,9-Aug-18,Indiaforensic NFS SETT 07-08-201,"5,000.00",,-542964538.99,Chukwuebuka,435,Germany,980.93,1,1,0
8889,2011,7,OWN,2,Low,1,4400, 36 months,1,debt_consolidation,6,Low,1,Good Loan,0,10.59,B,2,22.55,5152.580528,4400,0,143.2,409000008888,9-Aug-18,Indiaforensic NFS SETT 07-08-201,"9,000.00",,-542973538.99,Schmidt,743,France,95583.45,1,1,0
8890,2011,2,MORTGAGE,3,Low,1,6900, 36 months,1,major_purchase,8,Low,1,Good Loan,0,9.99,B,2,2.04,8009.605653,6900,0,222.62,409000008889,9-Aug-18,Indiaforensic NFS SETT 07-08-201,500,,-542974038.99,Parry,580,France,86044.98,1,1,0
8891,2011,10,MORTGAGE,3,Low,1,2000, 36 months,1,renewable_energy,13,Low,1,Good Loan,0,5.42,A,1,15.49,2170.772877,2000,0,60.32,409000008890,9-Aug-18,Indiaforensic NFS SETT 07-08-201,"8,000.00",,-542982038.99,McIntyre,599,Germany,166236.38,1,1,0
8892,2011,4,RENT,1,Low,1,4800, 36 months,1,debt_consolidation,6,Low,1,Good Loan,0,12.99,C,3,7.38,5819.839743,4800,0,161.71,409000008891,9-Aug-18,Indiaforensic NFS SETT 07-08-201,300,,-542982338.99,Lo Duca,534,Spain,5240.53,1,1,0
8893,2011,0.5,RENT,1,Low,1,6000, 36 months,1,debt_consolidation,6,Low,1,Good Loan,0,5.42,A,1,20.83,6477.98,6000,0,180.96,409000008892,9-Aug-18,Indiaforensic NFS SETT 07-08-201,"10,000.00",,-542992338.99,Ferrari,680,France,150684.23,1,1,0
8894,2011,1,RENT,1,Low,1,10700, 60 months,2,small_business,3,High,2,Good Loan,0,17.99,E,5,10.32,14113.27,8660.4,0,271.66,409000008893,9-Aug-18,Indiaforensic NFS SETT 07-08-201,"3,500.00",,-542995838.99,Berry,631,Spain,129508.96,1,1,0
8895,2011,0.5,RENT,1,Low,1,1500, 36 months,1,home_improvement,7,Low,1,Good Loan,0,11.49,B,2,9.88,1776.605687,1500,0,49.46,409000008894,9-Aug-18,Indiaforensic NFS SETT 07-08-201,"5,000.00",,-543000838.99,Cattaneo,485,France,70665.16,1,1,0
8896,2011,1,OWN,2,Low,1,7000, 36 months,1,debt_consolidation,6,High,2,Good Loan,0,13.99,C,3,9.38,7461.69,7000,0,239.21,409000008895,9-Aug-18,Indiaforensic NFS SETT 07-08-201,"8,500.00",,-543009338.99,Foster,699,France,102085.35,1,1,0
8897,2011,1,MORTGAGE,3,Low,1,29175, 60 months,2,debt_consolidation,6,Low,1,Good Loan,0,11.99,B,2,20.44,33718.8,24197.27,0,648.84,409000008896,9-Aug-18,Indiaforensic NFS SETT 07-08-201,"7,800.00",,-543017138.99,Gordon,712,France,195052.12,1,1,0
8898,2011,6,RENT,1,Low,1,12800, 36 months,1,debt_consolidation,6,Low,1,Good Loan,0,5.42,A,1,16.17,13896.71373,12800,0,386.05,409000008897,9-Aug-18,Indiaforensic NFS SETT 07-08-201,"7,800.00",,-543024938.99,May,603,France,93739.71,1,1,0
8899,2011,10,MORTGAGE,3,Medium,2,28000, 36 months,1,home_improvement,7,Low,1,Good Loan,0,7.49,A,1,14.44,29454.31,28000.01,0,870.85,409000008898,9-Aug-18,Indiaforensic NFS SETT 07-08-201,"8,900.00",,-543033838.99,Cameron,850,France,65612.12,1,1,0
8900,2011,5,RENT,1,Low,1,5000, 36 months,1,credit_card,1,Low,1,Good Loan,0,7.49,A,1,14.46,5589.140617,5000,0,155.51,409000008899,9-Aug-18,Indiaforensic NFS SETT 07-08-201,"8,500.00",,-543042338.99,Ch'eng,584,France,160095.48,1,1,0
8901,2011,2,RENT,1,Low,1,20000, 60 months,2,debt_consolidation,6,High,2,Good Loan,0,16.49,D,4,14.71,28652.86124,20000,0,491.59,409000008900,9-Aug-18,Indiaforensic NFS SETT 07-08-201,"4,000.00",,-543046338.99,Curtis,604,France,49506.82,1,1,0
8902,2011,4,RENT,1,Low,1,24000, 60 months,2,debt_consolidation,6,High,2,Good Loan,0,16.49,D,4,19.53,30089.95,24000,0,589.91,409000008901,9-Aug-18,Indiaforensic NFS SETT 07-08-201,500,,-543046838.99,Whitehead,586,France,92406.22,1,1,0
8903,2011,10,RENT,1,Low,1,28000, 60 months,2,debt_consolidation,6,High,2,Good Loan,0,20.25,F,6,15.77,40228.13602,28000,0,745.73,409000008902,9-Aug-18,Indiaforensic NFS SETT 07-08-201,"10,000.00",,-543056838.99,Chukwuemeka,467,Spain,7415.96,1,1,0
8904,2011,8,RENT,1,Low,1,5000, 36 months,1,medical,9,Low,1,Good Loan,0,10.59,B,2,7.85,5855.584214,5000,0,162.73,409000008903,9-Aug-18,Indiaforensic NFS SETT 07-08-201,"3,800.00",,-543060638.99,Onwughara,520,France,25059.06,1,1,0
8905,2011,3,RENT,1,Low,1,8000, 36 months,1,debt_consolidation,6,Low,1,Good Loan,0,7.49,A,1,13.32,8913.62,8000,0,248.82,409000008904,9-Aug-18,Indiaforensic NFS SETT 07-08-201,"4,000.00",,-543064638.99,Grant,683,Spain,116816.54,1,1,0
8906,2011,2,RENT,1,Low,1,6000, 36 months,1,small_business,3,Low,1,Good Loan,0,12.99,C,3,8.73,7137.55,6000,0,202.14,409000008905,9-Aug-18,Indiaforensic NFS SETT 07-08-201,"2,500.00",,-543067138.99,Browne,557,France,144078.02,1,1,0
8907,2011,7,MORTGAGE,3,Low,1,6000, 36 months,1,credit_card,1,High,2,Good Loan,0,13.49,C,3,22.69,7324.873437,6000,0,203.59,409000008906,9-Aug-18,Indiaforensic NFS SETT 07-08-201,"4,000.00",,-543071138.99,Goloubev,613,Spain,126675.62,1,1,0
8908,2011,8,MORTGAGE,3,Medium,2,5000, 36 months,1,home_improvement,7,Low,1,Good Loan,0,7.49,A,1,3.43,5596.299825,5000,0,155.51,409000008907,9-Aug-18,Indiaforensic NFS SETT 07-08-201,"8,500.00",,-543079638.99,Gordon,786,France,183682.09,1,1,0
8909,2011,6,OWN,2,Low,1,19000, 36 months,1,debt_consolidation,6,Low,1,Good Loan,0,10.99,B,2,22.36,22024.66,19000,0,621.95,409000008908,9-Aug-18,Indiaforensic NFS SETT 07-08-201,"10,000.00",,-543089638.99,Sutherland,593,Spain,166850.57,1,1,0
8910,2011,10,OWN,2,Low,1,12000, 60 months,2,credit_card,1,High,2,Good Loan,0,17.99,E,5,15.91,15596.9,12000,0,304.66,409000008909,9-Aug-18,Indiaforensic NFS SETT 07-08-201,"8,000.00",,-543097638.99,Quesada,670,Spain,27359.19,1,1,0
8911,2011,4,RENT,1,Low,1,2400, 36 months,1,other,4,Low,1,Good Loan,0,5.99,A,1,11.04,2514.98,2400,0,73.01,409000008910,9-Aug-18,Indiaforensic NFS SETT 07-08-201,500,,-543098138.99,Wright,657,Germany,101314.65,1,1,0
8912,2011,3,OWN,2,Low,1,6000, 36 months,1,credit_card,1,High,2,Good Loan,0,13.99,C,3,11.71,7362.924789,6000,0,205.04,409000008911,9-Aug-18,Indiaforensic NFS SETT 07-08-201,"8,000.00",,-543106138.99,Simmons,718,Germany,27979.16,1,1,0
8913,2011,10,MORTGAGE,3,Low,1,10000, 36 months,1,debt_consolidation,6,Low,1,Good Loan,0,11.49,B,2,24.42,11846.52836,10000,0,329.72,409000008912,9-Aug-18,Indiaforensic  RUPAY SETT 090818,"8,193.54",,-543114332.53,Yobachukwu,623,France,109470.34,1,1,0
8914,2011,3,RENT,1,Medium,2,12000, 36 months,1,wedding,5,Low,1,Good Loan,0,10.59,B,2,18.13,14020.44112,12000,0,390.54,409000008913,10-Aug-18,Indiaforensic NFS SETT 08-08-201,500,,-543114832.53,Read,496,France,93713.13,1,1,0
8915,2011,5,RENT,1,Low,1,6400, 36 months,1,other,4,Low,1,Good Loan,0,7.49,A,1,13.47,6981.98,6400,0,199.06,409000008914,10-Aug-18,Indiaforensic NFS SETT 08-08-201,"4,500.00",,-543119332.53,Wunder,429,France,74870.99,1,1,0
8916,2011,4,RENT,1,Low,1,10000, 36 months,1,debt_consolidation,6,Low,1,Good Loan,0,9.99,B,2,22.45,11608.64037,10000,0,322.63,409000008915,10-Aug-18,Indiaforensic NFS SETT 08-08-201,"9,000.00",,-543128332.53,Nnaife,606,France,192387.51,1,1,0
8917,2011,4,MORTGAGE,3,Low,1,13600, 36 months,1,credit_card,1,High,2,Good Loan,0,15.23,C,3,11.72,16757.8,13600,0,472.99,409000008916,10-Aug-18,Indiaforensic NFS SETT 08-08-201,"7,500.00",,-543135832.53,Shen,499,France,73457.55,1,1,0
8918,2011,3,OWN,2,Low,1,25000, 60 months,2,debt_consolidation,6,High,2,Good Loan,0,20.99,F,6,11.38,28658.26553,18875,0,510.53,409000008917,10-Aug-18,Indiaforensic NFS SETT 08-08-201,"10,000.00",,-543145832.53,Powell,642,France,61120.75,1,1,0
8919,2011,4,MORTGAGE,3,Low,1,25000, 60 months,2,debt_consolidation,6,Low,1,Good Loan,0,10.59,B,2,25.97,20914.29,18450,0,397.39,409000008918,10-Aug-18,Indiaforensic NFS SETT 08-08-201,"9,500.00",,-543155332.53,Goddard,641,France,90964.54,1,1,0
8920,2011,4,RENT,1,Medium,2,15000, 36 months,1,small_business,3,Low,1,Good Loan,0,12.99,C,3,4.82,18039.78,15000,0,505.34,409000008919,10-Aug-18,Indiaforensic NFS SETT 08-08-201,100,,-543155432.53,Buckley,673,France,116969.73,1,1,0
8921,2011,1,RENT,1,Low,1,4000, 36 months,1,debt_consolidation,6,Low,1,Good Loan,0,7.49,A,1,4.36,4306.41,4000,0,124.41,409000008920,10-Aug-18,Indiaforensic NFS SETT 08-08-201,"3,900.00",,-543159332.53,McIntyre,570,France,92118.75,1,1,0
8922,2011,6.05,MORTGAGE,3,Low,1,30225, 60 months,2,debt_consolidation,6,High,2,Good Loan,0,19.69,E,5,20.22,40215.8,30225,0,795.58,409000008921,10-Aug-18,Indiaforensic NFS SETT 08-08-201,"9,000.00",,-543168332.53,Yen,472,France,48357.90,1,1,0
8923,2011,7,RENT,1,Low,1,5000, 36 months,1,wedding,5,Low,1,Good Loan,0,9.99,B,2,21.33,5635.65,5000,0,161.32,409000008922,10-Aug-18,Indiaforensic NFS SETT 08-08-201,"8,500.00",,-543176832.53,Okonkwo,550,Germany,197325.40,1,1,0
8924,2011,2,OWN,2,Low,1,8325, 60 months,2,other,4,High,2,Good Loan,0,16.89,D,4,20.53,10722.3,6768.12,0,206.41,409000008923,10-Aug-18,Indiaforensic NFS SETT 08-08-201,"7,000.00",,-543183832.53,Burlingame,625,Germany,135853.62,1,1,0
8925,2011,5,MORTGAGE,3,Low,1,8000, 36 months,1,credit_card,1,High,2,Good Loan,0,15.99,D,4,9.23,9035.83,8000,0,281.22,409000008924,10-Aug-18,Indiaforensic NFS SETT 08-08-201,"2,000.00",,-543185832.53,Hs?,516,France,169122.54,1,1,0
8926,2011,6,MORTGAGE,3,Low,1,6000, 60 months,2,home_improvement,7,Low,1,Good Loan,0,10.99,B,2,17.11,6764.96,4987.21,0,130.43,409000008925,10-Aug-18,Indiaforensic NFS SETT 08-08-201,"4,000.00",,-543189832.53,Board,682,Germany,164170.46,1,1,0
8927,2011,1,MORTGAGE,3,Low,1,15000, 36 months,1,debt_consolidation,6,Low,1,Good Loan,0,11.99,B,2,7.88,17927.72438,15000,0,498.15,409000008926,10-Aug-18,Indiaforensic NFS SETT 08-08-201,"9,500.00",,-543199332.53,Adams,620,France,199909.32,1,1,0
8928,2011,0.5,MORTGAGE,3,Low,1,15600, 60 months,2,home_improvement,7,Low,1,Bad Loan,1,7.49,A,1,0.86,13034.89,9465.51,848.64,312.52,409000008927,10-Aug-18,Indiaforensic NFS SETT 08-08-201,"5,000.00",,-543204332.53,Rizzo,626,France,83295.09,1,1,0
8929,2011,6,MORTGAGE,3,Low,1,10000, 36 months,1,major_purchase,8,Low,1,Good Loan,0,5.99,A,1,21.71,10612.84,10000,0,304.18,409000008928,10-Aug-18,Indiaforensic NFS SETT 08-08-201,"7,400.00",,-543211732.53,Chukwufumnanya,623,France,39382.06,1,1,0
8930,2011,0.5,RENT,1,Low,1,12000, 60 months,2,debt_consolidation,6,High,2,Bad Loan,1,16.49,D,4,16.94,1470.2,666.33,0,294.96,409000008929,10-Aug-18,Indiaforensic NFS SETT 08-08-201,"1,300.00",,-543213032.53,Fraser,569,France,184748.23,1,1,0
8931,2011,10,RENT,1,Low,1,19200, 60 months,2,debt_consolidation,6,High,2,Bad Loan,1,17.49,D,4,10.02,23591.39,14311.76,0,482.25,409000008930,10-Aug-18,Indiaforensic NFS SETT 08-08-201,"1,600.00",,-543214632.53,Russell,724,France,62280.91,1,1,0
8932,2011,0.5,RENT,1,Low,1,2800, 36 months,1,debt_consolidation,6,Low,1,Good Loan,0,7.49,A,1,10.83,3129.44474,2800,0,87.09,409000008931,10-Aug-18,Indiaforensic NFS SETT 08-08-201,"3,000.00",,-543217632.53,Yefimova,678,France,196794.11,1,1,0
8933,2011,3,RENT,1,Low,1,9000, 36 months,1,major_purchase,8,High,2,Good Loan,0,13.99,C,3,22.63,11066.029,9000,0,307.56,409000008932,10-Aug-18,Indiaforensic NFS SETT 08-08-201,"8,000.00",,-543225632.53,Palermo,713,Spain,144682.17,1,1,0
8934,2011,8,MORTGAGE,3,Medium,2,29000, 60 months,2,debt_consolidation,6,High,2,Good Loan,0,19.69,E,5,14.85,42730.30555,29000,0,763.33,409000008933,10-Aug-18,Indiaforensic NFS SETT 08-08-201,"8,000.00",,-543233632.53,Bergamaschi,631,France,196342.66,1,1,0
8935,2011,6.05,RENT,1,Low,1,3500, 36 months,1,moving,10,Low,1,Bad Loan,1,10.99,B,2,21.74,2169.38,1594.83,122.42,114.57,409000008934,10-Aug-18,Indiaforensic NFS SETT 08-08-201,"8,000.00",,-543241632.53,Shao,846,France,41516.44,1,1,0
8936,2011,3,RENT,1,Low,1,3500, 36 months,1,major_purchase,8,Low,1,Good Loan,0,9.99,B,2,0,4046.883642,3500,0,112.92,409000008935,10-Aug-18,Indiaforensic NFS SETT 08-08-201,"1,400.00",,-543243032.53,Chimaraoke,660,France,112026.10,1,1,0
8937,2011,10,MORTGAGE,3,Low,1,31825, 60 months,2,debt_consolidation,6,Low,1,Good Loan,0,11.99,B,2,20.4,39114.1,31825,0,707.77,409000008936,10-Aug-18,Indiaforensic NFS SETT 08-08-201,500,,-543243532.53,McGregor,567,France,52035.29,1,1,0
8938,2011,2,RENT,1,Low,1,10000, 36 months,1,debt_consolidation,6,Low,1,Good Loan,0,10.99,B,2,11.82,11777.10665,10000,0,327.34,409000008937,10-Aug-18,Indiaforensic NFS SETT 08-08-201,500,,-543244032.53,Kesteven,731,France,185466.85,1,1,0
8939,2011,10,MORTGAGE,3,Low,1,15000, 60 months,2,debt_consolidation,6,High,2,Good Loan,0,18.39,E,5,7.76,19785.73,15000,0,384.1,409000008938,10-Aug-18,Indiaforensic NFS SETT 08-08-201,"9,000.00",,-543253032.53,Ritchie,693,Spain,80149.27,1,1,0
8940,2011,0.5,OWN,2,Low,1,3300, 36 months,1,debt_consolidation,6,Low,1,Bad Loan,1,12.99,C,3,11.86,3425.93,2646.69,89.53,111.18,409000008939,10-Aug-18,Indiaforensic NFS SETT 08-08-201,"6,000.00",,-543259032.53,Jenks,772,France,170980.86,1,1,0
8941,2011,2,RENT,1,Low,1,6000, 36 months,1,credit_card,1,Low,1,Good Loan,0,11.99,B,2,4.5,7153.388853,6000,0,199.26,409000008940,10-Aug-18,Indiaforensic NFS SETT 08-08-201,"3,500.00",,-543262532.53,Udokamma,657,France,185827.74,1,1,0
8942,2011,10,MORTGAGE,3,Low,1,30000, 60 months,2,debt_consolidation,6,High,2,Good Loan,0,13.99,C,3,7.32,40039.70225,30000,0,697.9,409000008941,10-Aug-18,Indiaforensic NFS SETT 08-08-201,"2,100.00",,-543264632.53,Boyle,774,Germany,113407.26,1,1,0
8943,2011,4,RENT,1,Low,1,25000, 36 months,1,debt_consolidation,6,Low,1,Good Loan,0,5.99,A,1,23.57,27130.36,25000,0,760.44,409000008942,10-Aug-18,Indiaforensic NFS SETT 08-08-201,"3,500.00",,-543268132.53,Azuka,667,France,67734.79,1,1,0
8944,2011,3,MORTGAGE,3,Low,1,8450, 60 months,2,credit_card,1,High,2,Good Loan,0,13.49,C,3,17.93,10635.83,8450,0,194.39,409000008943,10-Aug-18,Indiaforensic NFS SETT 08-08-201,"6,000.00",,-543274132.53,Pai,516,France,3363.36,1,1,0
8945,2011,7,RENT,1,Low,1,10000, 36 months,1,debt_consolidation,6,Low,1,Good Loan,0,8.49,A,1,16.05,10826.97,10000,0,315.63,409000008944,10-Aug-18,Indiaforensic NFS SETT 08-08-201,"7,500.00",,-543281632.53,Howells,551,Spain,135757.27,1,1,0
8946,2011,8,MORTGAGE,3,Medium,2,21000, 36 months,1,debt_consolidation,6,Low,1,Good Loan,0,11.49,B,2,16.39,24756.55371,21000,0,692.4,409000008945,10-Aug-18,Indiaforensic NFS SETT 08-08-201,"4,000.00",,-543285632.53,Hs?,542,Spain,22314.55,1,1,0
8947,2011,0.5,MORTGAGE,3,Low,1,20000, 60 months,2,small_business,3,High,2,Good Loan,0,15.99,D,4,16.16,21798.56,20000,0,486.26,409000008946,10-Aug-18,Indiaforensic NFS SETT 08-08-201,"4,000.00",,-543289632.53,Kelly,623,France,129526.57,1,1,0
8948,2011,10,MORTGAGE,3,High,3,3750, 36 months,1,home_improvement,7,High,2,Good Loan,0,15.62,D,4,7.95,4423.33,3750,0,131.14,409000008947,10-Aug-18,Indiaforensic NFS SETT 08-08-201,"6,000.00",,-543295632.53,Walton,701,France,37266.43,1,1,0
8949,2011,2,RENT,1,Low,1,16000, 36 months,1,debt_consolidation,6,Low,1,Good Loan,0,10.99,B,2,16.95,18686.86639,16000,0,523.75,409000008948,10-Aug-18,Indiaforensic NFS SETT 08-08-201,700,,-543296332.53,Ebelechukwu,583,France,60017.46,1,1,0
8950,2011,2,RENT,1,Low,1,35000, 60 months,2,debt_consolidation,6,High,2,Bad Loan,1,17.99,E,5,14.57,5323.8,2263.44,0,888.58,409000008949,10-Aug-18,Indiaforensic NFS SETT 08-08-201,"5,000.00",,-543301332.53,Vasilieva,731,Spain,153015.42,1,1,0
8951,2011,10,MORTGAGE,3,Low,1,23000, 60 months,2,debt_consolidation,6,High,2,Good Loan,0,21.36,F,6,24.81,35958.02888,23000,0,626.9,409000008950,10-Aug-18,Indiaforensic NFS SETT 08-08-201,"3,000.00",,-543304332.53,Hsiao,461,France,54209.02,1,1,0
8952,2011,2,MORTGAGE,3,Low,1,12000, 36 months,1,medical,9,Low,1,Good Loan,0,5.99,A,1,13.66,12771.43,12000,0,365.01,409000008951,10-Aug-18,Indiaforensic NFS SETT 08-08-201,"9,000.00",,-543313332.53,Abrego,702,Germany,114603.96,1,1,0
8953,2011,3,RENT,1,Low,1,2100, 36 months,1,moving,10,Low,1,Good Loan,0,10.99,B,2,22.8,2357.24,2100,0,68.75,409000008952,10-Aug-18,Indiaforensic NFS SETT 08-08-201,"8,000.00",,-543321332.53,Gibson,565,Germany,165849.49,1,1,0
8954,2011,1,MORTGAGE,3,Low,1,2400, 36 months,1,debt_consolidation,6,High,2,Good Loan,0,13.49,C,3,6.36,2528.13,2400,0,81.44,409000008953,10-Aug-18,Indiaforensic NFS SETT 08-08-201,"4,000.00",,-543325332.53,Giordano,711,Spain,16392.72,1,1,0
8955,2011,10,MORTGAGE,3,Low,1,16000, 60 months,2,debt_consolidation,6,High,2,Good Loan,0,13.49,C,3,13.94,20560.56207,16000,0,368.08,409000008954,10-Aug-18,Indiaforensic NFS SETT 08-08-201,"7,500.00",,-543332832.53,Mancini,664,France,162719.69,1,1,0
8956,2011,6.05,OWN,2,Low,1,5000, 36 months,1,home_improvement,7,Low,1,Good Loan,0,9.99,B,2,1.37,5804.100407,5000,0,161.32,409000008955,10-Aug-18,Indiaforensic NFS SETT 08-08-201,"8,000.00",,-543340832.53,Afanasyeva,518,Spain,107112.25,1,1,0
8957,2011,10,RENT,1,Low,1,2200, 36 months,1,car,2,Low,1,Good Loan,0,10.99,B,2,19.46,2540.91,2200,0,72.02,409000008956,10-Aug-18,Indiaforensic NFS SETT 08-08-201,"7,000.00",,-543347832.53,Wright,728,Spain,41823.22,1,1,0
8958,2011,5,MORTGAGE,3,Medium,2,10000, 36 months,1,vacation,11,Low,1,Good Loan,0,10.99,B,2,9.81,11648.87,10000,0,327.34,409000008957,10-Aug-18,Indiaforensic NFS SETT 08-08-201,"7,000.00",,-543354832.53,Okwudiliolisa,585,Germany,99907.29,1,1,0
8959,2011,6,MORTGAGE,3,Low,1,20000, 60 months,2,debt_consolidation,6,High,2,Good Loan,0,13.99,C,3,14.76,27600.91,20000,0,465.27,409000008958,10-Aug-18,Indiaforensic NFS SETT 08-08-201,"1,000.00",,-543355832.53,Hughes,573,France,178229.04,1,1,0
8960,2011,10,MORTGAGE,3,Medium,2,7200, 36 months,1,debt_consolidation,6,Low,1,Good Loan,0,9.99,B,2,19.42,8357.851949,7200,0,232.29,409000008959,10-Aug-18,Indiaforensic NFS SETT 08-08-201,"3,000.00",,-543358832.53,Parrott,568,Germany,22095.73,1,1,0
8961,2011,10,MORTGAGE,3,Low,1,6000, 60 months,2,debt_consolidation,6,High,2,Good Loan,0,19.29,E,5,19.49,8680.955486,6000,0,156.61,409000008960,10-Aug-18,Indiaforensic NFS SETT 08-08-201,"9,000.00",,-543367832.53,Hughes,602,Germany,197861.16,1,1,0
8962,2011,7,MORTGAGE,3,Low,1,15000, 60 months,2,credit_card,1,High,2,Bad Loan,1,17.49,D,4,19.94,16366.08,6779.53,3465,376.76,409000008961,10-Aug-18,Indiaforensic NFS SETT 08-08-201,"1,000.00",,-543368832.53,Zinachukwudi,603,France,138328.24,1,1,0
8963,2011,0.5,MORTGAGE,3,Low,1,14000, 60 months,2,debt_consolidation,6,Low,1,Good Loan,0,11.99,B,2,19.52,16019.93,14000,0,311.36,409000008962,10-Aug-18,Indiaforensic NFS SETT 08-08-201,"10,000.00",,-543378832.53,Keane,687,France,137276.83,1,1,0
8964,2011,6,RENT,1,Low,1,13200, 36 months,1,debt_consolidation,6,High,2,Good Loan,0,13.49,C,3,8.19,15534.08,13200,0,447.89,409000008963,10-Aug-18,Indiaforensic NFS SETT 08-08-201,"8,500.00",,-543387332.53,McCollum,741,France,21834.40,1,1,0
8965,2011,10,RENT,1,Low,1,12000, 36 months,1,debt_consolidation,6,Low,1,Good Loan,0,10.99,B,2,6.67,14194.35645,12000,0,392.81,409000008964,10-Aug-18,Indiaforensic NFS SETT 08-08-201,300,,-543387632.53,Simpson,469,Spain,119890.86,1,1,0
8966,2011,4,RENT,1,Low,1,7500, 36 months,1,car,2,Low,1,Bad Loan,1,8.49,A,1,13.57,4807.59,3798.83,210.41,236.73,409000008965,10-Aug-18,Indiaforensic NFS SETT 08-08-201,"6,000.00",,-543393632.53,Gambrell,477,Germany,24564.70,1,1,0
8967,2011,10,MORTGAGE,3,Medium,2,29000, 60 months,2,debt_consolidation,6,Low,1,Good Loan,0,11.99,B,2,15.25,33657.19,29000,0,644.95,409000008966,10-Aug-18,Indiaforensic NFS SETT 08-08-201,"7,300.00",,-543400932.53,Moretti,737,Germany,10209.80,1,1,0
8968,2011,1,RENT,1,Medium,2,31000, 36 months,1,debt_consolidation,6,Low,1,Good Loan,0,8.49,A,1,15.76,34917.17,31000,0,978.46,409000008967,10-Aug-18,Indiaforensic NFS SETT 08-08-201,"5,000.00",,-543405932.53,Ricci,835,France,83449.65,1,1,0
8969,2011,3,MORTGAGE,3,Low,1,2000, 36 months,1,home_improvement,7,Low,1,Good Loan,0,7.49,A,1,9.4,2238.222753,2000,0,62.21,409000008968,10-Aug-18,Indiaforensic NFS SETT 08-08-201,"8,100.00",,-543414032.53,Rieke,717,Germany,81508.10,1,1,0
8970,2011,10,RENT,1,Low,1,24000, 60 months,2,small_business,3,High,2,Bad Loan,1,17.49,D,4,8.96,3131.93,768.09,1328.33,602.81,409000008969,10-Aug-18,Indiaforensic NFS SETT 08-08-201,"6,000.00",,-543420032.53,Ndubuagha,562,France,32626.21,1,1,0
8971,2011,5,OWN,2,Low,1,10000, 36 months,1,debt_consolidation,6,High,2,Good Loan,0,13.99,C,3,10.03,11041.94,10000,0,341.73,409000008970,10-Aug-18,Indiaforensic NFS SETT 08-08-201,300,,-543420332.53,Chung,758,Spain,43982.41,1,1,0
8972,2011,1,RENT,1,Low,1,10000, 36 months,1,debt_consolidation,6,Low,1,Good Loan,0,10.99,B,2,15.05,11781.65243,10000,0,327.34,409000008971,10-Aug-18,Indiaforensic NFS SETT 08-08-201,"7,000.00",,-543427332.53,Ts'ai,408,France,124874.23,1,1,0
8973,2011,0.5,RENT,1,Low,1,4000, 36 months,1,wedding,5,Low,1,Good Loan,0,12.99,C,3,4.57,4742.19,4000,0,134.76,409000008972,10-Aug-18,Indiaforensic NFS SETT 08-08-201,"9,300.00",,-543436632.53,Cox,650,Spain,118324.75,1,1,0
8974,2011,7,RENT,1,Low,1,11500, 36 months,1,debt_consolidation,6,Low,1,Good Loan,0,11.99,B,2,3.14,13748.12663,11500,0,381.91,409000008973,10-Aug-18,Indiaforensic NFS SETT 08-08-201,"5,100.00",,-543441732.53,Lei,582,Germany,22113.93,1,1,0
8975,2011,3,RENT,1,Low,1,28000, 60 months,2,debt_consolidation,6,High,2,Good Loan,0,17.99,E,5,19.34,37848.74,28000,0,710.87,409000008974,10-Aug-18,Indiaforensic NFS SETT 08-08-201,"8,000.00",,-543449732.53,Ulyanova,706,Spain,31962.77,1,1,0
8976,2011,10,MORTGAGE,3,Medium,2,24000, 60 months,2,debt_consolidation,6,Low,1,Good Loan,0,10.59,B,2,14.53,29729.58274,24000,0,516.93,409000008975,10-Aug-18,Indiaforensic NFS SETT 08-08-201,500,,-543450232.53,Gray,567,Germany,105746.94,1,1,0
8977,2011,6.05,RENT,1,Low,1,10400, 36 months,1,debt_consolidation,6,Low,1,Good Loan,0,8.49,A,1,12.94,11813.78345,10400,0,328.26,409000008976,10-Aug-18,Indiaforensic NFS SETT 08-08-201,"9,200.00",,-543459432.53,McGregor,720,France,39925.52,1,1,0
8978,2011,4,RENT,1,Low,1,8000, 60 months,2,other,4,High,2,Bad Loan,1,20.99,F,6,7.42,5626.14,2481.55,18.98,216.39,409000008977,10-Aug-18,Indiaforensic NFS SETT 08-08-201,"4,000.00",,-543463432.53,Tretiakova,631,Spain,127630.88,1,1,0
8979,2011,6,MORTGAGE,3,Low,1,8000, 36 months,1,wedding,5,Low,1,Good Loan,0,5.42,A,1,17.58,8685.266479,8000,0,241.28,409000008978,10-Aug-18,Indiaforensic NFS SETT 08-08-201,"5,000.00",,-543468432.53,Genovesi,623,Spain,28778.98,1,1,0
8980,2011,6.05,RENT,1,Medium,2,29600, 60 months,2,small_business,3,High,2,Good Loan,0,19.69,E,5,4.65,36122.3,29600,0,779.13,409000008979,10-Aug-18,Indiaforensic NFS SETT 08-08-201,"5,000.00",,-543473432.53,Gordon,514,France,10008.68,1,1,0
8981,2011,0.5,RENT,1,Low,1,7500, 36 months,1,car,2,Low,1,Good Loan,0,11.99,B,2,19.76,8966.120923,7500,0,249.08,409000008980,10-Aug-18,Indiaforensic NFS SETT 08-08-201,200,,-543473632.53,Aitken,650,Germany,24482.16,1,1,0
8982,2011,10,OWN,2,Low,1,6425, 36 months,1,debt_consolidation,6,Low,1,Good Loan,0,5.42,A,1,10.96,6973.403633,6425,0,193.78,409000008981,10-Aug-18,Indiaforensic NFS SETT 08-08-201,100,,-543473732.53,Ginikanwa,673,Spain,98618.79,1,1,0
8983,2011,2,MORTGAGE,3,Medium,2,6000, 36 months,1,car,2,Low,1,Good Loan,0,5.42,A,1,3.93,6512.700005,6000,0,180.96,409000008982,10-Aug-18,Indiaforensic NFS SETT 08-08-201,"5,000.00",,-543478732.53,Coates,504,France,16281.94,1,1,0
8984,2011,0.5,RENT,1,Medium,2,12000, 60 months,2,debt_consolidation,6,High,2,Good Loan,0,16.49,D,4,14.22,17037.14429,12000,0,294.96,409000008983,10-Aug-18,Indiaforensic NFS SETT 08-08-201,"10,000.00",,-543488732.53,Piazza,723,Germany,121239.65,1,1,0
8985,2011,10,RENT,1,Low,1,12000, 60 months,2,car,2,High,2,Bad Loan,1,15.99,D,4,8.94,6351.05,3003.3,516.28,291.76,409000008984,10-Aug-18,Indiaforensic NFS SETT 08-08-201,500,,-543489232.53,Cawood,645,France,42669.37,1,1,0
8986,2011,7,OWN,2,Low,1,20000, 36 months,1,other,4,Low,1,Good Loan,0,7.49,A,1,10.89,22390.34828,20000,0,622.04,409000008985,10-Aug-18,Indiaforensic NFS SETT 08-08-201,"8,000.00",,-543497232.53,Ignatieff,664,Spain,164924.11,1,1,0
8987,2011,4,RENT,1,Low,1,9000, 36 months,1,debt_consolidation,6,High,2,Bad Loan,1,18.39,E,5,18.23,1041.39,379.94,389.49,327.14,409000008986,10-Aug-18,Indiaforensic NFS SETT 08-08-201,300,,-543497532.53,Gallo,760,Spain,157337.29,1,1,0
8988,2011,1,RENT,1,Low,1,13250, 60 months,2,debt_consolidation,6,High,2,Good Loan,0,16.49,D,4,23.66,16924.92,10793.44,0,325.68,409000008987,10-Aug-18,Indiaforensic NFS SETT 08-08-201,"9,000.00",,-543506532.53,Yelverton,766,Spain,153831.60,1,1,0
8989,2011,0.5,MORTGAGE,3,High,3,10000, 36 months,1,major_purchase,8,High,2,Good Loan,0,13.99,C,3,14.27,12116.3111,10000,0,341.73,409000008988,10-Aug-18,Indiaforensic NFS SETT 08-08-201,500,,-543507032.53,William,634,France,168781.80,1,1,0
8990,2011,0.5,RENT,1,Low,1,10000, 36 months,1,debt_consolidation,6,Low,1,Good Loan,0,5.99,A,1,22.15,10896.39,10000,0,304.18,409000008989,10-Aug-18,Indiaforensic NFS SETT 08-08-201,"2,500.00",,-543509532.53,Mault,640,Germany,168469.65,1,1,0
8991,2011,2,RENT,1,Low,1,2000, 60 months,2,other,4,High,2,Good Loan,0,20.25,F,6,8.89,2762.5,1601.26,0,53.27,409000008990,10-Aug-18,Indiaforensic NFS SETT 08-08-201,"3,500.00",,-543513032.53,Mackay,784,Germany,170829.87,1,1,0
8992,2011,2,RENT,1,Low,1,5000, 36 months,1,debt_consolidation,6,High,2,Good Loan,0,13.99,C,3,13.89,6105.683908,5000,0,170.87,409000008991,10-Aug-18,Indiaforensic NFS SETT 08-08-201,"9,500.00",,-543522532.53,McIntyre,547,Germany,86207.49,1,1,0
8993,2011,2,MORTGAGE,3,Low,1,27575, 60 months,2,debt_consolidation,6,Low,1,Good Loan,0,10.99,B,2,26.4,34774.03546,27575,0,599.41,409000008992,10-Aug-18,Indiaforensic NFS SETT 08-08-201,"8,000.00",,-543530532.53,Henry,608,Germany,61164.45,1,1,0
8994,2011,5,MORTGAGE,3,Medium,2,24000, 36 months,1,debt_consolidation,6,Low,1,Good Loan,0,7.49,A,1,6.78,26870.21984,24000,0,746.44,409000008993,10-Aug-18,Indiaforensic NFS SETT 08-08-201,"10,000.00",,-543540532.53,Kao,547,France,133287.73,1,1,0
8995,2011,10,MORTGAGE,3,Low,1,20000, 60 months,2,debt_consolidation,6,Low,1,Good Loan,0,11.99,B,2,20.42,24451.02,20000,0,444.79,409000008994,10-Aug-18,Indiaforensic NFS SETT 08-08-201,"3,000.00",,-543543532.53,Frewin,612,France,77128.23,1,1,0
8996,2011,2,MORTGAGE,3,Medium,2,25000, 60 months,2,medical,9,High,2,Good Loan,0,16.89,D,4,5.05,32179.19,20313.66,0,619.84,409000008995,10-Aug-18,Indiaforensic  RUPAY SETT 100818,"10,623.54",,-543554156.07,Yefremova,573,Spain,77660.03,1,1,0
8997,2011,0.5,RENT,1,Low,1,2000, 36 months,1,car,2,Low,1,Good Loan,0,8.49,A,1,3.16,2060.06,2000,0,63.13,409000008996,10-Aug-18,Indiaforensic RUPAY STL INTC1008,,164.90,-543553991.17,Anenechukwu,615,Spain,56897.10,1,1,0
8998,2011,10,RENT,1,Low,1,12000, 36 months,1,major_purchase,8,Low,1,Good Loan,0,5.42,A,1,15.36,12337.06,12000,0,361.92,409000008997,10-Aug-18,Indiaforensic RUPAY STL INTC1008,164.9,,-543554156.07,Trentino,710,France,72945.32,1,1,0
8999,2011,2,RENT,1,Low,1,17200, 60 months,2,home_improvement,7,High,2,Good Loan,0,19.69,E,5,9.95,23521.6,13822.17,0,452.74,409000008998,13-Aug-18,Indiaforensic RUPAY SETT 110818,"13,932.57",,-543568088.64,Tomlinson,674,Germany,45418.12,1,1,0
9000,2011,9,MORTGAGE,3,Low,1,14550, 60 months,2,debt_consolidation,6,Low,1,Good Loan,0,11.99,B,2,12.91,16799.13,12056.92,0,323.59,409000008999,13-Aug-18,Indiaforensic RUPAY STL INTC1108,,109.26,-543567979.38,Royston,702,Spain,158527.45,1,1,0
9001,2011,10,OWN,2,Low,1,12000, 60 months,2,debt_consolidation,6,High,2,Good Loan,0,18.39,E,5,19.34,15695.68,12000,0,307.28,409000009000,13-Aug-18,Indiaforensic RUPAY STL INTC1108,106.27,,-543568085.65,Cremonesi,616,France,111312.96,1,1,0
9002,2011,3,MORTGAGE,3,Low,1,2000, 36 months,1,moving,10,Low,1,Good Loan,0,10.99,B,2,16.86,2259.05,2000,0,65.47,409000009001,13-Aug-18,Indiaforensic RUPAY STL INTC1108,,0.02,-543568085.63,Yeh,688,Spain,138759.15,1,1,0
9003,2011,3,MORTGAGE,3,Low,1,14400, 60 months,2,home_improvement,7,High,2,Good Loan,0,13.49,C,3,9.27,17192.4,11859.02,0,331.27,409000009002,13-Aug-18,Indiaforensic RUPAY SETT 120818,"1,835.02",,-543569920.65,Ch'in,605,France,190588.59,1,1,0
9004,2011,4,RENT,1,Low,1,10000, 36 months,1,home_improvement,7,Low,1,Good Loan,0,5.42,A,1,6.63,10856.7189,10000,0,301.6,409000009003,13-Aug-18,Indiaforensic RUPAY STL INTC1208,23.29,,-543569943.94,Martinez,676,France,79099.64,1,1,0
9005,2011,10,MORTGAGE,3,Low,1,20000, 36 months,1,other,4,Low,1,Good Loan,0,11.49,B,2,12.33,20191.73,20000,0,659.43,409000009004,13-Aug-18,Indiaforensic RUPAY SETT 130818,"3,220.39",,-543573164.33,Wearing,708,Spain,138613.21,1,1,0
9006,2011,8,MORTGAGE,3,Low,1,13000, 60 months,2,other,4,High,2,Good Loan,0,16.49,D,4,14.47,15812.34,13000,0,319.53,409000009005,13-Aug-18,Indiaforensic RUPAY STL INTC1308,35.04,,-543573199.37,Maclean,745,Spain,194230.82,1,1,0
9007,2011,6.05,MORTGAGE,3,Low,1,5000, 36 months,1,home_improvement,7,Low,1,Good Loan,0,9.99,B,2,19.33,5804.052642,5000,0,161.32,409000009006,13-Aug-18,Indiaforensic RUPAY STL INTC1208,,47.81,-543573151.56,T'ao,661,Spain,110252.53,1,1,0
9008,2011,4,RENT,1,Low,1,19200, 36 months,1,debt_consolidation,6,Low,1,Good Loan,0,6.99,A,1,6.51,21338.26658,19200,0,592.76,409000009007,13-Aug-18,Indiaforensic RUPAY STL INTC1208,,0.17,-543573151.39,Rose,726,France,106117.30,1,1,0
9009,2011,4,RENT,1,Low,1,2500, 36 months,1,major_purchase,8,Low,1,Good Loan,0,5.99,A,1,7.44,2737.395709,2500,0,76.05,409000009008,13-Aug-18,Indiaforensic RUPAY STL INTC1308,,38.23,-543573113.16,Whitworth,475,France,169642.13,1,1,0
9010,2011,9,MORTGAGE,3,Medium,2,12000, 36 months,1,small_business,3,Low,1,Good Loan,0,12.99,C,3,20.77,14550.93296,12000,0,404.27,409000009009,13-Aug-18,Indiaforensic RUPAY STL INTC1308,,0.02,-543573113.14,Suttor,751,Germany,116179.92,1,1,0
9011,2011,0.5,RENT,1,Low,1,2800, 36 months,1,credit_card,1,Low,1,Good Loan,0,9.99,B,2,17.27,3182.327037,2800,0,90.34,409000009010,13-Aug-18,Indiaforensic  RUPAY SETT 130818,130.71,,-543573243.85,Hsing,645,Germany,91.75,1,1,0
9012,2011,6,RENT,1,Low,1,11000, 36 months,1,debt_consolidation,6,Low,1,Good Loan,0,5.42,A,1,4.93,11937.05046,11000,0,331.76,409000009011,13-Aug-18,Indiaforensic RUPAY STL INTC1308,,1.43,-543573242.42,Boni,775,France,187839.90,1,1,0
9013,2011,10,MORTGAGE,3,Low,1,12000, 60 months,2,debt_consolidation,6,High,2,Good Loan,0,13.49,C,3,4.49,14059.02,12000,0,276.06,409000009012,13-Aug-18,Indiaforensic RUPAY STL INTC1308,1.43,,-543573243.85,Marshall,540,France,121098.65,1,1,0
9014,2011,0.5,MORTGAGE,3,Low,1,20000, 60 months,2,debt_consolidation,6,High,2,Good Loan,0,17.49,D,4,12.59,27008.56,20000,0,502.34,409000009013,13-Aug-18,Indiaforensic NFS SETT 09-08-201,"9,000.00",,-543582243.85,Catchpole,591,France,30972.06,1,1,0
9015,2011,7,RENT,1,Low,1,20000, 36 months,1,major_purchase,8,Low,1,Good Loan,0,6.99,A,1,4.75,22227.04974,20000,0,617.46,409000009014,13-Aug-18,Indiaforensic NFS SETT 09-08-201,"8,000.00",,-543590243.85,Tang,596,Spain,30314.04,1,1,0
9016,2011,10,MORTGAGE,3,Medium,2,28000, 60 months,2,home_improvement,7,Low,1,Good Loan,0,11.49,B,2,0.27,30754.13,28000,0,615.66,409000009015,13-Aug-18,Indiaforensic NFS SETT 09-08-201,300,,-543590543.85,Siddons,573,Spain,14479.29,1,1,0
9017,2011,3,OWN,2,Low,1,10000, 36 months,1,home_improvement,7,Low,1,Good Loan,0,5.99,A,1,8.46,10795.13,10000,0,304.18,409000009016,13-Aug-18,Indiaforensic NFS SETT 09-08-201,"8,000.00",,-543598543.85,Wan,577,Spain,196395.25,1,1,0
9018,2011,4,RENT,1,Low,1,4000, 36 months,1,other,4,Low,1,Bad Loan,1,9.99,B,2,24.14,770.52,583.73,0,129.05,409000009017,13-Aug-18,Indiaforensic NFS SETT 09-08-201,400,,-543598943.85,Efimov,830,Germany,19512.38,1,1,0
9019,2011,10,OWN,2,Low,1,6000, 36 months,1,debt_consolidation,6,Low,1,Good Loan,0,5.42,A,1,13.1,6448.818469,6000,0,180.96,409000009018,13-Aug-18,Indiaforensic NFS SETT 09-08-201,"6,000.00",,-543604943.85,Rose,663,France,72318.77,1,1,0
9020,2011,1,OWN,2,Low,1,3800, 36 months,1,credit_card,1,Low,1,Good Loan,0,7.49,A,1,10.28,4119.06,3800,0,118.19,409000009019,13-Aug-18,Indiaforensic NFS SETT 09-08-201,"9,000.00",,-543613943.85,Fanucci,421,France,96615.23,1,1,0
9021,2011,7,RENT,1,Low,1,20000, 60 months,2,debt_consolidation,6,Low,1,Good Loan,0,11.99,B,2,4.03,23100.66,16578.59,0,444.79,409000009020,13-Aug-18,Indiaforensic NFS SETT 09-08-201,100,,-543614043.85,Iweobiegbulam,718,Spain,30772.22,1,1,0
9022,2011,5,MORTGAGE,3,Medium,2,15000, 36 months,1,other,4,Low,1,Good Loan,0,7.49,A,1,4.64,15526.91,15000,0,466.53,409000009021,13-Aug-18,Indiaforensic NFS SETT 09-08-201,"5,000.00",,-543619043.85,Ijendu,655,Germany,161217.18,1,1,0
9023,2011,10,MORTGAGE,3,Low,1,6000, 36 months,1,other,4,Low,1,Good Loan,0,7.49,A,1,18.77,6716.259724,6000,0,186.61,409000009022,13-Aug-18,Indiaforensic NFS SETT 09-08-201,"10,000.00",,-543629043.85,O'Sullivan,712,France,66795.78,1,1,0
9024,2011,1,MORTGAGE,3,Low,1,6000, 60 months,2,debt_consolidation,6,High,2,Good Loan,0,20.99,F,6,21.2,6710.6,6000,0,162.29,409000009023,13-Aug-18,Indiaforensic NFS SETT 09-08-201,"7,000.00",,-543636043.85,Hutchinson,663,France,123969.64,1,1,0
9025,2011,3,MORTGAGE,3,Medium,2,35000, 36 months,1,debt_consolidation,6,Low,1,Good Loan,0,8.49,A,1,12.44,36306.86,35000,0,1104.71,409000009024,13-Aug-18,Indiaforensic NFS SETT 09-08-201,"9,000.00",,-543645043.85,Kwemto,640,France,13783.77,1,1,0
9026,2011,3,MORTGAGE,3,Low,1,10000, 36 months,1,credit_card,1,Low,1,Good Loan,0,10.99,B,2,22.05,11775.80636,10000,0,327.34,409000009025,13-Aug-18,Indiaforensic NFS SETT 09-08-201,100,,-543645143.85,Chiu,577,Spain,168924.41,1,1,0
9027,2011,5,RENT,1,Low,1,35000, 60 months,2,debt_consolidation,6,High,2,Good Loan,0,15.99,D,4,5.08,38573.97,35000,0,850.95,409000009026,13-Aug-18,Indiaforensic NFS SETT 09-08-201,"9,000.00",,-543654143.85,Berry,546,Spain,134778.01,1,1,0
9028,2011,0.5,MORTGAGE,3,Low,1,30000, 60 months,2,major_purchase,8,Low,1,Good Loan,0,10.59,B,2,0,26103.35,19449.37,0,502.93,409000009027,13-Aug-18,Indiaforensic NFS SETT 09-08-201,"8,500.00",,-543662643.85,Hung,802,Germany,119782.89,1,1,0
9029,2011,10,RENT,1,Low,1,12800, 36 months,1,other,4,High,2,Bad Loan,1,14.79,C,3,8.47,8362.46,5682.53,407.99,442.41,409000009028,13-Aug-18,Indiaforensic NFS SETT 09-08-201,"6,000.00",,-543668643.85,Mordvinova,590,France,52167.97,1,1,0
9030,2011,1,RENT,1,Low,1,12000, 36 months,1,debt_consolidation,6,Low,1,Good Loan,0,11.49,B,2,4.73,13270.08,12000,0,395.66,409000009029,13-Aug-18,Indiaforensic NFS SETT 09-08-201,"7,000.00",,-543675643.85,Bruno,594,Germany,167689.56,1,1,0
9031,2011,8,MORTGAGE,3,Medium,2,35000, 60 months,2,debt_consolidation,6,High,2,Good Loan,0,16.49,D,4,7.45,49692.07216,35000,0,860.28,409000009030,13-Aug-18,Indiaforensic NFS SETT 09-08-201,"9,500.00",,-543685143.85,Arbour,577,Spain,140800.66,1,1,0
9032,2011,5,OWN,2,Low,1,15000, 36 months,1,credit_card,1,High,2,Good Loan,0,13.49,C,3,22.76,18200.15,15000,0,508.96,409000009031,13-Aug-18,Indiaforensic NFS SETT 09-08-201,"7,000.00",,-543692143.85,Barese,541,France,19823.02,1,1,0
9033,2011,10,MORTGAGE,3,Low,1,4650, 36 months,1,small_business,3,High,2,Good Loan,0,13.49,C,3,17.18,5693.054989,4650,0,157.78,409000009032,13-Aug-18,Indiaforensic NFS SETT 09-08-201,"4,500.00",,-543696643.85,Hingston,781,France,72969.90,1,1,0
9034,2011,4,MORTGAGE,3,Low,1,1500, 36 months,1,other,4,Low,1,Good Loan,0,12.99,C,3,20.6,1516.21,1500,0,50.54,409000009033,13-Aug-18,Indiaforensic NFS SETT 09-08-201,"5,000.00",,-543701643.85,Davis,806,Germany,143711.02,1,1,0
9035,2011,10,MORTGAGE,3,Low,1,15000, 36 months,1,debt_consolidation,6,High,2,Bad Loan,1,17.99,E,5,14.6,13986.04,8926.84,853.25,542.22,409000009034,13-Aug-18,Indiaforensic NFS SETT 09-08-201,"10,000.00",,-543711643.85,Lawrence,723,Germany,180862.26,1,1,0
9036,2011,0.5,RENT,1,Low,1,4200, 36 months,1,wedding,5,High,2,Good Loan,0,15.23,C,3,4.67,5252.279574,4200,0,146.07,409000009035,13-Aug-18,Indiaforensic NFS SETT 09-08-201,"2,000.00",,-543713643.85,Chung,535,France,125658.28,1,1,0
9037,2011,4,RENT,1,Low,1,12000, 60 months,2,debt_consolidation,6,High,2,Good Loan,0,15.23,C,3,12.75,16652.54717,12000,0,286.93,409000009036,13-Aug-18,Indiaforensic NFS SETT 09-08-201,800,,-543714443.85,Padovano,768,France,125870.50,1,1,0
9038,2011,4,MORTGAGE,3,Medium,2,6000, 36 months,1,debt_consolidation,6,Low,1,Good Loan,0,10.59,B,2,16.78,7010.396698,6000,0,195.27,409000009037,13-Aug-18,Indiaforensic NFS SETT 09-08-201,"6,500.00",,-543720943.85,Blinova,653,Germany,15126.32,1,1,0
9039,2011,4,RENT,1,Low,1,10800, 60 months,2,debt_consolidation,6,High,2,Good Loan,0,16.89,D,4,7.56,14616.72959,10800,0,267.77,409000009038,13-Aug-18,Indiaforensic NFS SETT 09-08-201,400,,-543721343.85,Carter,803,Germany,22457.25,1,1,0
9040,2011,1,MORTGAGE,3,Low,1,4000, 60 months,2,debt_consolidation,6,High,2,Good Loan,0,16.89,D,4,23.56,5791.521788,4000,0,99.18,409000009039,13-Aug-18,Indiaforensic NFS SETT 09-08-201,"6,600.00",,-543727943.85,Webb,545,Spain,82614.89,1,1,0
9041,2011,10,MORTGAGE,3,Low,1,22000, 60 months,2,debt_consolidation,6,Low,1,Bad Loan,1,11.99,B,2,17.15,8824.37,4641.43,1010.29,489.27,409000009040,13-Aug-18,Indiaforensic NFS SETT 09-08-201,900,,-543728843.85,T'an,581,Germany,32919.42,1,1,0
9042,2011,0.5,RENT,1,Low,1,4500, 36 months,1,major_purchase,8,Low,1,Good Loan,0,5.42,A,1,5.39,4884.504294,4500,0,135.72,409000009041,13-Aug-18,Indiaforensic NFS SETT 09-08-201,"8,100.00",,-543736943.85,Yates,513,Germany,126223.84,1,1,0
9043,2011,7,RENT,1,Low,1,10000, 36 months,1,debt_consolidation,6,Low,1,Good Loan,0,9.99,B,2,3.75,11030.82,10000,0,322.63,409000009042,13-Aug-18,Indiaforensic NFS SETT 09-08-201,"5,000.00",,-543741943.85,Su,731,France,112010.02,1,1,0
9044,2011,10,MORTGAGE,3,Low,1,14500, 36 months,1,credit_card,1,Low,1,Bad Loan,1,5.42,A,1,8.73,7471.48,6150.73,479.32,437.32,409000009043,13-Aug-18,Indiaforensic NFS SETT 09-08-201,"4,500.00",,-543746443.85,Christian,727,Germany,180962.32,1,1,0
9045,2011,1,MORTGAGE,3,Low,1,5200, 60 months,2,home_improvement,7,Low,1,Bad Loan,1,11.49,B,2,0.32,1708.48,808.76,264.89,114.34,409000009044,13-Aug-18,Indiaforensic NFS SETT 09-08-201,"7,000.00",,-543753443.85,Chiu,560,Spain,128882.66,1,1,0
9046,2011,5,MORTGAGE,3,Low,1,5000, 36 months,1,major_purchase,8,Low,1,Good Loan,0,5.42,A,1,4.56,5376.02,5000,0,150.8,409000009045,13-Aug-18,Indiaforensic NFS SETT 09-08-201,"8,500.00",,-543761943.85,Sacco,766,Germany,177614.17,1,1,0
9047,2011,8,RENT,1,Low,1,18000, 36 months,1,debt_consolidation,6,Low,1,Good Loan,0,5.99,A,1,7.2,18396.5,17999.99,0,547.52,409000009046,13-Aug-18,Indiaforensic NFS SETT 09-08-201,"6,000.00",,-543767943.85,Lettiere,630,Germany,174570.55,1,1,0
9048,2011,5,MORTGAGE,3,Low,1,13000, 36 months,1,debt_consolidation,6,Low,1,Good Loan,0,5.42,A,1,5.82,14113.78885,13000,0,392.08,409000009047,13-Aug-18,Indiaforensic NFS SETT 09-08-201,"8,500.00",,-543776443.85,Daluchi,652,Germany,178373.93,1,1,0
9049,2011,0.5,RENT,1,Low,1,4800, 36 months,1,debt_consolidation,6,Low,1,Good Loan,0,7.49,A,1,18.12,4993.92,4800,0,149.29,409000009048,13-Aug-18,Indiaforensic NFS SETT 09-08-201,100,,-543776543.85,T'ien,729,Germany,103396.08,1,1,0
9050,2011,0.5,RENT,1,Low,1,3000, 36 months,1,other,4,High,2,Bad Loan,1,15.62,D,4,9.65,903.61,271.06,379.42,104.91,409000009049,13-Aug-18,Indiaforensic NFS SETT 09-08-201,"8,000.00",,-543784543.85,Hung,629,France,59129.72,1,1,0
9051,2011,0.5,OWN,2,Low,1,7000, 36 months,1,debt_consolidation,6,Low,1,Good Loan,0,5.42,A,1,7.36,7599.513308,7000,0,211.12,409000009050,13-Aug-18,Indiaforensic NFS SETT 09-08-201,"6,000.00",,-543790543.85,Liu,667,Germany,683.37,1,1,0
9052,2011,10,MORTGAGE,3,Low,1,10000, 60 months,2,debt_consolidation,6,High,2,Good Loan,0,20.99,F,6,13.77,14141.87,10000,0,270.48,409000009051,13-Aug-18,Indiaforensic NFS SETT 09-08-201,"7,500.00",,-543798043.85,Feng,671,Germany,145567.34,1,1,0
9053,2011,2,RENT,1,Low,1,12000, 60 months,2,debt_consolidation,6,Low,1,Good Loan,0,9.99,B,2,10.43,13948.81,12000,0,254.91,409000009052,13-Aug-18,Indiaforensic NFS SETT 09-08-201,"4,000.00",,-543802043.85,Gilbert,768,Germany,48137.08,1,1,0
9054,2011,10,RENT,1,Medium,2,4000, 60 months,2,other,4,Low,1,Good Loan,0,11.49,B,2,15.55,4543.76,3306.9,0,87.96,409000009053,13-Aug-18,Indiaforensic NFS SETT 10-08-201,"8,500.00",,-543810543.85,Robb,732,France,90876.95,1,1,0
9055,2011,3,MORTGAGE,3,Low,1,6250, 36 months,1,debt_consolidation,6,Low,1,Good Loan,0,7.49,A,1,11.59,6995.088601,6250,0,194.39,409000009054,13-Aug-18,Indiaforensic NFS SETT 10-08-201,100,,-543810643.85,Manfrin,546,France,198543.09,1,1,0
9056,2011,3,RENT,1,Low,1,4000, 60 months,2,other,4,High,2,Good Loan,0,13.99,C,3,13.27,5351.356881,4000,0,93.06,409000009055,13-Aug-18,Indiaforensic NFS SETT 10-08-201,"8,000.00",,-543818643.85,Chinwenma,630,France,106202.07,1,1,0
9057,2011,2,MORTGAGE,3,Low,1,4400, 36 months,1,debt_consolidation,6,Low,1,Good Loan,0,5.42,A,1,13.61,4776.155459,4400,0,132.71,409000009056,13-Aug-18,Indiaforensic NFS SETT 10-08-201,500,,-543819143.85,Smith,765,Germany,166896.01,1,1,0
9058,2011,4,MORTGAGE,3,Medium,2,12000, 36 months,1,other,4,Low,1,Good Loan,0,5.42,A,1,7.05,13027.66412,12000,0,361.92,409000009057,13-Aug-18,Indiaforensic NFS SETT 10-08-201,"6,500.00",,-543825643.85,Rowe,704,France,74804.36,1,1,0
9059,2011,5,MORTGAGE,3,Low,1,19000, 60 months,2,debt_consolidation,6,Low,1,Good Loan,0,10.99,B,2,18,24436.79902,19000,0,413.02,409000009058,13-Aug-18,Indiaforensic NFS SETT 10-08-201,"8,000.00",,-543833643.85,Moran,470,Spain,116971.05,1,1,0
9060,2011,0.5,OWN,2,Low,1,5400, 36 months,1,debt_consolidation,6,High,2,Good Loan,0,16.49,D,4,16.97,6895.374402,5400,0,191.16,409000009059,13-Aug-18,Indiaforensic NFS SETT 10-08-201,100,,-543833743.85,Walker,688,Germany,163783.00,1,1,0
9061,2011,6,MORTGAGE,3,Low,1,6000, 36 months,1,wedding,5,High,2,Good Loan,0,15.23,C,3,12.96,6076.46,6000,0,208.67,409000009060,13-Aug-18,Indiaforensic NFS SETT 10-08-201,"7,000.00",,-543840743.85,Myers,685,France,70221.13,1,1,0
9062,2011,6,MORTGAGE,3,Low,1,3000, 36 months,1,vacation,11,Low,1,Good Loan,0,6.99,A,1,21.89,3222.91,3000,0,92.62,409000009061,13-Aug-18,Indiaforensic NFS SETT 10-08-201,500,,-543841243.85,Wall,567,France,107841.77,1,1,0
9063,2011,10,MORTGAGE,3,Low,1,2700, 36 months,1,other,4,Low,1,Good Loan,0,11.99,B,2,22.32,3227.768094,2700,0,89.67,409000009062,13-Aug-18,Indiaforensic NFS SETT 10-08-201,"5,000.00",,-543846243.85,McKay,720,Spain,79623.28,1,1,0
9064,2011,8,MORTGAGE,3,Low,1,14400, 60 months,2,credit_card,1,Low,1,Good Loan,0,8.49,A,1,7.37,15529.54,14400,0,295.37,409000009063,13-Aug-18,Indiaforensic NFS SETT 10-08-201,"3,000.00",,-543849243.85,Egobudike,609,France,138399.67,1,1,0
9065,2011,6,MORTGAGE,3,Low,1,7600, 36 months,1,credit_card,1,Low,1,Good Loan,0,5.99,A,1,7.51,8321.758713,7600,0,231.18,409000009064,13-Aug-18,Indiaforensic NFS SETT 10-08-201,"8,000.00",,-543857243.85,Williams,521,Germany,182765.14,1,1,0
9066,2011,1,MORTGAGE,3,Low,1,3500, 36 months,1,debt_consolidation,6,Low,1,Good Loan,0,9.99,B,2,7.38,3897.32,3500,0,112.92,409000009065,13-Aug-18,Indiaforensic NFS SETT 10-08-201,"8,000.00",,-543865243.85,Ochoa,556,France,186648.19,1,1,0
9067,2011,10,OWN,2,Low,1,25000, 60 months,2,debt_consolidation,6,Low,1,Good Loan,0,10.59,B,2,21.43,23756.06126,18925,0,407.62,409000009066,13-Aug-18,Indiaforensic NFS SETT 10-08-201,"7,000.00",,-543872243.85,Otutodilinna,662,Germany,149587.92,1,1,0
9068,2011,3,RENT,1,Low,1,10025, 36 months,1,debt_consolidation,6,Low,1,Good Loan,0,5.42,A,1,19.13,10870.0984,10025,0,302.36,409000009067,13-Aug-18,Indiaforensic NFS SETT 10-08-201,"1,000.00",,-543873243.85,Ajuluchukwu,704,Germany,129050.67,1,1,0
9069,2011,6,MORTGAGE,3,Medium,2,35000, 60 months,2,small_business,3,High,2,Good Loan,0,13.49,C,3,10.63,47679.29938,35000,0,805.17,409000009068,13-Aug-18,Indiaforensic NFS SETT 10-08-201,"9,500.00",,-543882743.85,Bellucci,750,France,47764.99,1,1,0
9070,2011,2,RENT,1,Low,1,6400, 36 months,1,small_business,3,Low,1,Good Loan,0,6.99,A,1,16.16,6986.26,6400,0,197.59,409000009069,13-Aug-18,Indiaforensic NFS SETT 10-08-201,10,,-543882753.85,Gordon,619,Spain,172792.43,1,1,0
9071,2011,3,RENT,1,Low,1,11500, 36 months,1,debt_consolidation,6,High,2,Good Loan,0,14.79,C,3,22.95,14300.89088,11500,0,397.47,409000009070,13-Aug-18,Indiaforensic NFS SETT 10-08-201,"7,000.00",,-543889753.85,Johnston,468,Spain,64436.16,1,1,0
9072,2011,3,MORTGAGE,3,Low,1,5000, 36 months,1,debt_consolidation,6,High,2,Good Loan,0,13.49,C,3,17.59,6101.444515,5000,0,169.66,409000009071,13-Aug-18,Indiaforensic NFS SETT 10-08-201,200,,-543889953.85,De Luca,435,Germany,167461.50,1,1,0
9073,2011,10,OWN,2,Low,1,25000, 60 months,2,house,12,High,2,Good Loan,0,13.49,C,3,22.07,29731.53,25000,0,575.12,409000009072,13-Aug-18,Indiaforensic NFS SETT 10-08-201,"8,000.00",,-543897953.85,Hill,529,France,98348.66,1,1,0
9074,2011,4,RENT,1,Low,1,21000, 60 months,2,major_purchase,8,High,2,Bad Loan,1,16.89,D,4,6.29,9401.22,3739.78,991.46,520.67,409000009073,13-Aug-18,Indiaforensic NFS SETT 10-08-201,"7,000.00",,-543904953.85,Eluemuno,702,Germany,41536.59,1,1,0
9075,2011,6,MORTGAGE,3,Low,1,10000, 36 months,1,debt_consolidation,6,Low,1,Bad Loan,1,5.42,A,1,10.08,2864.35,2081.57,454.59,301.6,409000009074,13-Aug-18,Indiaforensic NFS SETT 10-08-201,"2,000.00",,-543906953.85,Howarth,608,France,72462.25,1,1,0
9076,2011,8,MORTGAGE,3,Medium,2,25000, 60 months,2,debt_consolidation,6,High,2,Bad Loan,1,13.49,C,3,6.49,21941.77,12081.81,2412.05,575.12,409000009075,13-Aug-18,Indiaforensic NFS SETT 10-08-201,"4,000.00",,-543910953.85,Thomson,576,France,112465.19,1,1,0
9077,2011,0.5,MORTGAGE,3,Low,1,7000, 36 months,1,car,2,Low,1,Good Loan,0,7.49,A,1,3.95,7815.839045,7000,0,217.72,409000009076,13-Aug-18,Indiaforensic NFS SETT 10-08-201,"7,000.00",,-543917953.85,King,666,France,64511.44,1,1,0
9078,2011,2,RENT,1,Low,1,31200, 60 months,2,debt_consolidation,6,High,2,Bad Loan,1,17.99,E,5,13.43,8614.54,1184.97,1734.1,792.11,409000009077,13-Aug-18,Indiaforensic NFS SETT 10-08-201,500,,-543918453.85,Grant,730,France,91830.75,1,1,0
9079,2011,4,RENT,1,Low,1,20000, 60 months,2,small_business,3,High,2,Good Loan,0,13.49,C,3,12.65,27372.33,20000,0,460.1,409000009078,13-Aug-18,Indiaforensic NFS SETT 10-08-201,"9,000.00",,-543927453.85,Gilbert,647,Germany,190806.36,1,1,0
9080,2011,0.5,OWN,2,Low,1,2800, 36 months,1,house,12,Low,1,Good Loan,0,10.59,B,2,19.34,3257.31,2800,0,91.13,409000009079,13-Aug-18,Indiaforensic NFS SETT 10-08-201,500,,-543927953.85,Richmond,516,Spain,112311.15,1,1,0
9081,2011,4,RENT,1,Low,1,6325, 60 months,2,other,4,Low,1,Good Loan,0,12.99,C,3,14.48,7450.38,5209.18,0,143.89,409000009080,13-Aug-18,Indiaforensic NFS SETT 10-08-201,"1,500.00",,-543929453.85,Fiorentino,711,France,72276.24,1,1,0
9082,2011,5,RENT,1,Low,1,8500, 60 months,2,debt_consolidation,6,High,2,Good Loan,0,18.79,E,5,23.64,12452.73525,8500,0,219.52,409000009081,13-Aug-18,Indiaforensic NFS SETT 10-08-201,500,,-543929953.85,Greece,736,France,84920.49,1,1,0
9083,2011,6,MORTGAGE,3,Low,1,33000, 36 months,1,debt_consolidation,6,Low,1,Good Loan,0,9.99,B,2,12.98,34140.96,33000,0,1064.67,409000009082,13-Aug-18,Indiaforensic NFS SETT 10-08-201,"4,500.00",,-543934453.85,Dickson,768,France,17348.56,1,1,0
9084,2011,2,MORTGAGE,3,Low,1,10000, 36 months,1,small_business,3,Low,1,Good Loan,0,6.99,A,1,13.52,11108.18732,10000,0,308.73,409000009083,13-Aug-18,Indiaforensic NFS SETT 10-08-201,"9,000.00",,-543943453.85,Henderson,427,Spain,82870.75,1,1,0
9085,2011,8,MORTGAGE,3,Low,1,12500, 60 months,2,wedding,5,High,2,Good Loan,0,16.49,D,4,11.24,16543.81777,12500,0,307.24,409000009084,13-Aug-18,Indiaforensic NFS SETT 10-08-201,"1,000.00",,-543944453.85,Stevens,686,Spain,32080.69,1,1,0
9086,2011,2,MORTGAGE,3,Low,1,14400, 36 months,1,debt_consolidation,6,Low,1,Good Loan,0,5.42,A,1,6.46,15634.09755,14400,0,434.31,409000009085,13-Aug-18,Indiaforensic NFS SETT 10-08-201,500,,-543944953.85,Mitchell,690,France,120512.08,1,1,0
9087,2011,6,MORTGAGE,3,Low,1,14100, 60 months,2,debt_consolidation,6,Low,1,Good Loan,0,8.49,A,1,25.74,16522.51214,14100,0,289.22,409000009086,13-Aug-18,Indiaforensic NFS SETT 11-08-201,"10,000.00",,-543954953.85,Nworie,647,Spain,179032.68,1,1,0
9088,2011,10,MORTGAGE,3,Low,1,9475, 36 months,1,debt_consolidation,6,High,2,Good Loan,0,13.99,C,3,19.32,11327.76,9475,0,323.79,409000009087,13-Aug-18,Indiaforensic NFS SETT 11-08-201,"10,000.00",,-543964953.85,Boni,714,France,95623.28,1,1,0
9089,2011,10,RENT,1,Low,1,6000, 36 months,1,vacation,11,Low,1,Good Loan,0,10.59,B,2,16.67,7027.278534,6000,0,195.27,409000009088,13-Aug-18,Indiaforensic NFS SETT 11-08-201,"7,700.00",,-543972653.85,Wentcher,736,Germany,110035.88,1,1,0
9090,2011,3,MORTGAGE,3,Low,1,25000, 60 months,2,debt_consolidation,6,Low,1,Good Loan,0,11.49,B,2,14.12,29521.52,25000,0,549.69,409000009089,13-Aug-18,Indiaforensic NFS SETT 11-08-201,"1,600.00",,-543974253.85,Bentley,608,France,168822.01,1,1,0
9091,2011,0.5,RENT,1,Low,1,9400, 60 months,2,other,4,High,2,Good Loan,0,21.36,F,6,6.82,12911.33,9400,0,256.21,409000009090,13-Aug-18,Indiaforensic NFS SETT 11-08-201,"10,000.00",,-543984253.85,Hayes-Williams,809,France,77705.75,1,1,0
9092,2011,3,RENT,1,Medium,2,22000, 36 months,1,credit_card,1,Low,1,Good Loan,0,11.49,B,2,10.99,26106.12679,22000,0,725.37,409000009091,13-Aug-18,Indiaforensic NFS SETT 11-08-201,"4,000.00",,-543988253.85,Johnstone,745,France,49815.62,1,1,0
9093,2011,3,MORTGAGE,3,Low,1,20000, 60 months,2,house,12,High,2,Good Loan,0,15.62,D,4,4.32,27240.08528,20000,0,482.34,409000009092,13-Aug-18,Indiaforensic NFS SETT 11-08-201,500,,-543988753.85,Johnstone,781,France,65632.33,1,1,0
9094,2011,9,RENT,1,Low,1,35000, 60 months,2,small_business,3,Low,1,Good Loan,0,12.99,C,3,15.44,41854.26,29757.01,0,796.18,409000009093,13-Aug-18,Indiaforensic NFS SETT 11-08-201,"1,900.00",,-543990653.85,Nixon,527,France,169361.89,1,1,0
9095,2011,10,RENT,1,Low,1,22400, 60 months,2,debt_consolidation,6,High,2,Good Loan,0,15.99,D,4,18.96,29714.14409,22400,0,544.61,409000009094,13-Aug-18,Indiaforensic NFS SETT 11-08-201,800,,-543991453.85,Trevisano,595,Germany,4721.30,1,1,0
9096,2011,10,MORTGAGE,3,Low,1,14350, 36 months,1,debt_consolidation,6,Low,1,Good Loan,0,9.99,B,2,14.41,15501.13,14350,0,462.97,409000009095,13-Aug-18,Indiaforensic NFS SETT 11-08-201,"7,000.00",,-543998453.85,Tsui,850,Germany,23974.85,1,1,0
9097,2011,6,MORTGAGE,3,Medium,2,6500, 36 months,1,debt_consolidation,6,Low,1,Good Loan,0,7.49,A,1,13.59,7273.734257,6500,0,202.17,409000009096,13-Aug-18,Indiaforensic NFS SETT 11-08-201,500,,-543998953.85,Moss,569,France,199929.17,1,1,0
9098,2011,6,MORTGAGE,3,Low,1,5500, 36 months,1,debt_consolidation,6,Low,1,Good Loan,0,7.49,A,1,15.23,6156.132502,5500,0,171.06,409000009097,13-Aug-18,Indiaforensic NFS SETT 11-08-201,"8,500.00",,-544007453.85,Graham,728,France,40023.70,1,1,0
9099,2011,3,RENT,1,Low,1,3000, 36 months,1,debt_consolidation,6,High,2,Good Loan,0,15.23,C,3,21.66,3751.973453,3000,0,104.34,409000009098,13-Aug-18,Indiaforensic NFS SETT 11-08-201,"4,000.00",,-544011453.85,Onyemauchechukwu,473,Germany,72946.95,1,1,0
9100,2011,7,RENT,1,Low,1,5000, 60 months,2,debt_consolidation,6,High,2,Good Loan,0,15.99,D,4,18.49,5324.45,5000,0,121.57,409000009099,13-Aug-18,Indiaforensic NFS SETT 11-08-201,"7,000.00",,-544018453.85,Saunders,738,France,170421.13,1,1,0
9101,2011,0.5,RENT,1,Low,1,12000, 36 months,1,credit_card,1,Low,1,Good Loan,0,5.99,A,1,14.28,13140.16662,12000,0,365.01,409000009100,13-Aug-18,Indiaforensic NFS SETT 11-08-201,"4,000.00",,-544022453.85,Ko,659,France,58879.11,1,1,0
9102,2011,8,MORTGAGE,3,Low,1,9000, 36 months,1,debt_consolidation,6,Low,1,Good Loan,0,7.49,A,1,23.8,9579.49,9000,0,279.92,409000009101,13-Aug-18,Indiaforensic NFS SETT 11-08-201,"8,500.00",,-544030953.85,Cairns,597,Spain,25059.05,1,1,0
9103,2011,5,MORTGAGE,3,Low,1,4000, 36 months,1,debt_consolidation,6,Low,1,Good Loan,0,11.49,B,2,9.3,4744.905226,4000,0,131.89,409000009102,13-Aug-18,Indiaforensic NFS SETT 11-08-201,"7,000.00",,-544037953.85,Chiemela,445,Germany,29909.84,1,1,0
9104,2011,2,RENT,1,Low,1,3000, 36 months,1,small_business,3,Low,1,Good Loan,0,7.49,A,1,0,3357.557257,3000,0,93.31,409000009103,13-Aug-18,Indiaforensic NFS SETT 11-08-201,500,,-544038453.85,Robertson,671,France,158043.11,1,1,0
9105,2011,5,MORTGAGE,3,Low,1,7000, 36 months,1,credit_card,1,Low,1,Good Loan,0,7.49,A,1,23.58,7798.18,7000,0,217.72,409000009104,13-Aug-18,Indiaforensic NFS SETT 11-08-201,500,,-544038953.85,P'eng,656,Spain,14032.62,1,1,0
9106,2011,10,RENT,1,Low,1,1500, 36 months,1,debt_consolidation,6,High,2,Good Loan,0,14.79,C,3,19.2,1865.045041,1500,0,51.85,409000009105,13-Aug-18,Indiaforensic NFS SETT 11-08-201,"8,000.00",,-544046953.85,Tseng,658,France,49809.88,1,1,0
9107,2011,4,RENT,1,Low,1,1200, 36 months,1,car,2,High,2,Good Loan,0,15.23,C,3,8.46,1473.46,1200,0,41.74,409000009106,13-Aug-18,Indiaforensic NFS SETT 11-08-201,600,,-544047553.85,Russell,698,Germany,28806.32,1,1,0
9108,2011,10,MORTGAGE,3,Low,1,14000, 36 months,1,debt_consolidation,6,Low,1,Good Loan,0,5.42,A,1,28.06,15199.16663,14000,0,422.24,409000009107,13-Aug-18,Indiaforensic NFS SETT 11-08-201,"8,000.00",,-544055553.85,Yen,655,Spain,90490.33,1,1,0
9109,2011,4,MORTGAGE,3,Low,1,3000, 36 months,1,home_improvement,7,Low,1,Good Loan,0,11.99,B,2,7.6,3586.451271,3000,0,99.63,409000009108,13-Aug-18,Indiaforensic NFS SETT 11-08-201,500,,-544056053.85,Yeh,772,Spain,75825.57,1,1,0
9110,2011,1,RENT,1,Low,1,12800, 60 months,2,small_business,3,High,2,Good Loan,0,19.69,E,5,20.34,17486.2,10277.4,0,336.92,409000009109,13-Aug-18,Indiaforensic NFS SETT 11-08-201,300,,-544056353.85,Kalinina,681,Spain,158336.36,1,1,0
9111,2011,4,RENT,1,Low,1,14000, 36 months,1,debt_consolidation,6,Low,1,Good Loan,0,8.49,A,1,26.08,15905.10206,14000,0,441.89,409000009110,13-Aug-18,Indiaforensic NFS SETT 11-08-201,200,,-544056553.85,Collier,688,Germany,143454.95,1,1,0
9112,2011,4,RENT,1,Low,1,7500, 36 months,1,debt_consolidation,6,Low,1,Good Loan,0,5.42,A,1,5.54,7824.11,7500,0,226.2,409000009111,13-Aug-18,Indiaforensic NFS SETT 11-08-201,200,,-544056753.85,Thomas,633,Germany,117279.49,1,1,0
9113,2011,5,RENT,1,Low,1,13200, 36 months,1,debt_consolidation,6,Low,1,Good Loan,0,5.42,A,1,7.99,14121,13200,0,398.11,409000009112,13-Aug-18,Indiaforensic NFS SETT 11-08-201,"4,000.00",,-544060753.85,Shaw,735,France,114283.33,1,1,0
9114,2011,7,MORTGAGE,3,Low,1,7200, 36 months,1,debt_consolidation,6,Low,1,Good Loan,0,10.99,B,2,8.57,8478.216669,7200,0,235.69,409000009113,13-Aug-18,Indiaforensic NFS SETT 11-08-201,"4,000.00",,-544064753.85,Francis,521,Germany,994.86,1,1,0
9115,2011,3,RENT,1,Low,1,22200, 60 months,2,other,4,High,2,Good Loan,0,22.11,G,7,3.76,31947.45,17661.16,0,614.53,409000009114,13-Aug-18,Indiaforensic NFS SETT 11-08-201,"5,000.00",,-544069753.85,George,541,France,124795.84,1,1,0
9116,2011,10,OWN,2,Medium,2,20000, 60 months,2,debt_consolidation,6,Low,1,Good Loan,0,11.99,B,2,8.58,23090.8,16572.33,0,444.79,409000009115,13-Aug-18,Indiaforensic NFS SETT 11-08-201,"8,000.00",,-544077753.85,Ikenna,612,Germany,77592.80,1,1,0
9117,2011,6,OWN,2,Low,1,4400, 36 months,1,debt_consolidation,6,High,2,Good Loan,0,16.89,D,4,15.49,5638.63,4400,0,156.64,409000009116,13-Aug-18,Indiaforensic NFS SETT 11-08-201,"1,000.00",,-544078753.85,Schatz,562,France,105986.01,1,1,0
9118,2011,0.5,MORTGAGE,3,Low,1,6400, 36 months,1,home_improvement,7,Low,1,Good Loan,0,9.99,B,2,18,7429.313697,6400,0,206.48,409000009117,13-Aug-18,Indiaforensic NFS SETT 11-08-201,"9,000.00",,-544087753.85,Tao,703,France,33606.52,1,1,0
9119,2011,3,RENT,1,Low,1,1600, 36 months,1,debt_consolidation,6,Low,1,Bad Loan,1,10.59,B,2,3.6,1690.99,1393.41,28.2,52.08,409000009118,13-Aug-18,Indiaforensic NFS SETT 11-08-201,300,,-544088053.85,Scott,710,Spain,134188.11,1,1,0
9120,2011,10,RENT,1,Low,1,20000, 60 months,2,debt_consolidation,6,High,2,Good Loan,0,17.49,D,4,24.43,25814.25,20000,0,502.34,409000009119,13-Aug-18,Indiaforensic NFS SETT 11-08-201,"8,500.00",,-544096553.85,Sims,731,Spain,159718.27,1,1,0
9121,2011,10,MORTGAGE,3,Medium,2,21000, 60 months,2,debt_consolidation,6,High,2,Good Loan,0,15.99,D,4,12.97,26509.91,17128.32,0,510.57,409000009120,13-Aug-18,Indiaforensic NFS SETT 11-08-201,100,,-544096653.85,Chibugo,703,Spain,85148.78,1,1,0
9122,2011,6,MORTGAGE,3,Low,1,12000, 36 months,1,debt_consolidation,6,Low,1,Good Loan,0,7.49,A,1,9.23,13383.52016,12000,0,373.22,409000009121,13-Aug-18,Indiaforensic NFS SETT 11-08-201,"5,000.00",,-544101653.85,Ku,618,France,119059.13,1,1,0
9123,2011,10,RENT,1,Low,1,18000, 60 months,2,credit_card,1,High,2,Good Loan,0,15.23,C,3,20.51,22289.75114,16500,0,394.53,409000009122,13-Aug-18,Indiaforensic NFS SETT 11-08-201,"3,000.00",,-544104653.85,Stanton,689,France,122998.26,1,1,0
9124,2011,7,RENT,1,Low,1,20000, 60 months,2,debt_consolidation,6,High,2,Good Loan,0,16.89,D,4,17.45,28006.65979,20000,0,495.87,409000009123,13-Aug-18,Indiaforensic NFS SETT 11-08-201,"5,500.00",,-544110153.85,Kung,718,France,117841.06,1,1,0
9125,2011,10,MORTGAGE,3,Low,1,8000, 36 months,1,small_business,3,Low,1,Good Loan,0,11.49,B,2,16.65,9492.352964,8000,0,263.78,409000009124,13-Aug-18,Indiaforensic NFS SETT 11-08-201,"2,200.00",,-544112353.85,Gibson,608,France,160593.41,1,1,0
9126,2011,10,MORTGAGE,3,Low,1,6000, 36 months,1,other,4,Low,1,Good Loan,0,7.49,A,1,14.97,6715.560845,6000,0,186.61,409000009125,13-Aug-18,Indiaforensic NFS SETT 11-08-201,"9,000.00",,-544121353.85,Iheanacho,749,Spain,174189.04,1,1,0
9127,2011,6,MORTGAGE,3,Low,1,14000, 36 months,1,home_improvement,7,Low,1,Good Loan,0,5.42,A,1,7.66,15199.22098,14000,0,422.24,409000009126,13-Aug-18,Indiaforensic NFS SETT 11-08-201,100,,-544121453.85,Costa,753,Spain,68260.27,1,1,0
9128,2011,5,MORTGAGE,3,Low,1,8000, 36 months,1,debt_consolidation,6,Low,1,Good Loan,0,6.99,A,1,16.38,8890.593556,8000,0,246.99,409000009127,13-Aug-18,Indiaforensic NFS SETT 11-08-201,100,,-544121553.85,Sal,630,Spain,58854.88,1,1,0
9129,2011,4,RENT,1,Low,1,14125, 36 months,1,debt_consolidation,6,Low,1,Good Loan,0,12.99,C,3,18.2,16366.57,14125,0,475.86,409000009128,13-Aug-18,Indiaforensic NFS SETT 11-08-201,"6,000.00",,-544127553.85,Lin,693,Germany,87994.95,1,1,0
9130,2011,5,RENT,1,Medium,2,7000, 36 months,1,other,4,Low,1,Good Loan,0,8.49,A,1,10.9,7320.41,7000,0,220.95,409000009129,13-Aug-18,Indiaforensic NFS SETT 11-08-201,"6,000.00",,-544133553.85,Ferri,838,Spain,150659.35,1,1,0
9131,2011,2,MORTGAGE,3,Medium,2,25000, 36 months,1,small_business,3,High,2,Good Loan,0,13.99,C,3,10.06,30749.64643,25000,0,854.32,409000009130,13-Aug-18,Indiaforensic NFS SETT 11-08-201,"8,400.00",,-544141953.85,Yin,756,Germany,109098.39,1,1,0
9132,2011,7,RENT,1,Low,1,2400, 36 months,1,other,4,High,2,Good Loan,0,16.49,D,4,2.04,3066.608881,2400,0,84.96,409000009131,13-Aug-18,Indiaforensic NFS SETT 12-08-201,"2,000.00",,-544143953.85,Avdeyeva,775,France,104112.00,1,1,0
9133,2011,2,RENT,1,Low,1,7000, 36 months,1,credit_card,1,High,2,Good Loan,0,13.49,C,3,6.47,8542.51488,7000,0,237.52,409000009132,13-Aug-18,Indiaforensic NFS SETT 12-08-201,500,,-544144453.85,Tu,635,France,122949.71,1,1,0
9134,2011,2,RENT,1,Low,1,9200, 60 months,2,wedding,5,Low,1,Good Loan,0,12.99,C,3,9.6,12185.8,8920.1,0,209.29,409000009133,13-Aug-18,Indiaforensic NFS SETT 12-08-201,"3,000.00",,-544147453.85,Donnelly,705,Spain,21807.16,1,1,0
9135,2011,10,MORTGAGE,3,Low,1,20000, 60 months,2,debt_consolidation,6,High,2,Good Loan,0,18.39,E,5,15.77,26628.73,16171.39,0,512.13,409000009134,13-Aug-18,Indiaforensic NFS SETT 12-08-201,"2,000.00",,-544149453.85,Loggia,481,France,32319.93,1,1,0
9136,2011,0.5,MORTGAGE,3,Low,1,15000, 36 months,1,debt_consolidation,6,Low,1,Bad Loan,1,5.99,A,1,1.11,4193.23,2826.91,699.64,456.27,409000009135,13-Aug-18,Indiaforensic NFS SETT 12-08-201,"1,000.00",,-544150453.85,Chao,727,Spain,190457.87,1,1,0
9137,2011,0.5,MORTGAGE,3,Medium,2,3700, 36 months,1,credit_card,1,Low,1,Good Loan,0,10.99,B,2,18.41,4326.64,3700,0,121.12,409000009136,13-Aug-18,Indiaforensic NFS SETT 12-08-201,"8,500.00",,-544158953.85,Belonwu,595,France,177738.98,1,1,0
9138,2011,3,MORTGAGE,3,Low,1,12800, 36 months,1,other,4,Low,1,Good Loan,0,5.42,A,1,6.17,13801.71,12800,0,386.05,409000009137,13-Aug-18,Indiaforensic NFS SETT 12-08-201,500,,-544159453.85,Welch,535,France,80425.65,1,1,0
9139,2011,2,RENT,1,Low,1,3600, 36 months,1,credit_card,1,Low,1,Good Loan,0,9.99,B,2,20.27,4178.658447,3600,0,116.15,409000009138,13-Aug-18,Indiaforensic NFS SETT 12-08-201,"5,000.00",,-544164453.85,Henderson,578,France,9445.42,1,1,0
9140,2011,7,RENT,1,Low,1,15000, 60 months,2,home_improvement,7,High,2,Good Loan,0,19.69,E,5,15.04,20807.79,15000,0,394.83,409000009139,13-Aug-18,Indiaforensic NFS SETT 12-08-201,"1,000.00",,-544165453.85,Yobanna,597,France,174825.57,1,1,0
9141,2011,2,RENT,1,Low,1,3600, 36 months,1,moving,10,Low,1,Good Loan,0,12.99,C,3,21.6,4364.294949,3600,0,121.29,409000009140,13-Aug-18,Indiaforensic NFS SETT 12-08-201,"2,000.00",,-544167453.85,Gallo,449,France,175743.92,1,1,0
9142,2011,6,OWN,2,Low,1,9000, 36 months,1,debt_consolidation,6,Low,1,Good Loan,0,7.49,A,1,19.74,9316.16,9000,0,279.92,409000009141,13-Aug-18,Indiaforensic NFS SETT 12-08-201,"1,000.00",,-544168453.85,Wilson,850,Germany,54949.73,1,1,0
9143,2011,1,OWN,2,Low,1,6800, 60 months,2,debt_consolidation,6,High,2,Good Loan,0,17.99,E,5,14.1,8986.29,5500.4,0,172.64,409000009142,13-Aug-18,Indiaforensic NFS SETT 12-08-201,100,,-544168553.85,Marino,494,France,183752.91,1,1,0
9144,2011,5,RENT,1,Low,1,10000, 36 months,1,medical,9,High,2,Good Loan,0,15.23,C,3,8.34,12515.25378,10000,0,347.79,409000009143,13-Aug-18,Indiaforensic NFS SETT 12-08-201,"8,500.00",,-544177053.85,Bailey,676,France,46038.28,1,1,0
9145,2011,2,RENT,1,Low,1,20000, 60 months,2,debt_consolidation,6,High,2,Good Loan,0,18.79,E,5,20.9,25343.95,20000,0,516.51,409000009144,13-Aug-18,Indiaforensic NFS SETT 12-08-201,"10,000.00",,-544187053.85,Gboliwe,818,Germany,78941.59,1,1,0
9146,2011,10,MORTGAGE,3,Low,1,20500, 60 months,2,debt_consolidation,6,High,2,Bad Loan,1,15.99,D,4,18.69,22592.54,13653.26,0,498.42,409000009145,14-Aug-18,Indiaforensic  RUPAY SETT 140818,"9,111.42",,-544196165.27,Chukwuhaenye,712,Spain,198398.68,1,1,0
9147,2011,4,RENT,1,Low,1,3000, 60 months,2,other,4,High,2,Bad Loan,1,16.89,D,4,16.68,1249.6,529.24,141.7,74.39,409000009146,14-Aug-18,Indiaforensic RUPAY STL INTC1408,,63.55,-544196101.72,Bianchi,672,Germany,188892.19,1,1,0
9148,2011,0.5,MORTGAGE,3,Medium,2,16000, 36 months,1,credit_card,1,Low,1,Good Loan,0,8.49,A,1,13.84,18201.74648,16000,0,505.01,409000009147,14-Aug-18,Indiaforensic RUPAY STL INTC1408,63.55,,-544196165.27,Ford,636,France,169286.74,1,1,0
9149,2011,0.5,RENT,1,Low,1,10000, 36 months,1,other,4,Low,1,Good Loan,0,12.99,C,3,16.44,12087.04001,10000,0,336.9,409000009148,14-Aug-18,Indiaforensic  RUPAY SETT 140818,"9,347.59",,-544205512.86,Rizzo,698,France,145004.39,1,1,0
9150,2011,3,RENT,1,Medium,2,8000, 60 months,2,medical,9,Low,1,Good Loan,0,10.99,B,2,0.22,9017.28,6647.64,0,173.9,409000009149,14-Aug-18,Indiaforensic RUPAY STL INTC1408,,70.64,-544205442.22,Lung,597,Germany,55809.92,1,1,0
9151,2011,5,MORTGAGE,3,Low,1,8850, 36 months,1,major_purchase,8,Low,1,Good Loan,0,6.99,A,1,26,9811.96275,8850,0,273.23,409000009150,14-Aug-18,Indiaforensic RUPAY STL INTC1408,70.64,,-544205512.86,Ramirez,717,France,54272.12,1,1,0
9152,2011,5,MORTGAGE,3,Low,1,16500, 36 months,1,credit_card,1,Low,1,Good Loan,0,7.49,A,1,9.08,17947.47,16500,0,513.18,409000009151,14-Aug-18,Indiaforensic NFS SETT 13-08-201,"2,500.00",,-544208012.86,Sabbatini,614,France,192440.54,1,1,0
9153,2011,0.5,RENT,1,Low,1,8000, 36 months,1,debt_consolidation,6,Low,1,Bad Loan,1,10.59,B,2,16.41,2198.34,1360.13,381,260.36,409000009152,14-Aug-18,Indiaforensic NFS SETT 13-08-201,"1,000.00",,-544209012.86,Ts'ao,708,Germany,103697.57,1,1,0
9154,2011,10,MORTGAGE,3,Low,1,18225, 60 months,2,debt_consolidation,6,High,2,Good Loan,0,13.49,C,3,20.11,16625.07,11468.78,0,320.35,409000009153,14-Aug-18,Indiaforensic NFS SETT 13-08-201,"9,000.00",,-544218012.86,Trevisan,507,Germany,119110.03,1,1,0
9155,2011,10,MORTGAGE,3,Low,1,25000, 60 months,2,debt_consolidation,6,High,2,Good Loan,0,16.49,D,4,11.05,31342.32,25000,0,614.48,409000009154,14-Aug-18,Indiaforensic NFS SETT 13-08-201,500,,-544218512.86,Chinwenma,581,France,194681.60,1,1,0
9156,2011,9,RENT,1,Low,1,10400, 36 months,1,credit_card,1,High,2,Good Loan,0,13.49,C,3,11.57,12691.53883,10400,0,352.88,409000009155,14-Aug-18,Indiaforensic NFS SETT 13-08-201,100,,-544218612.86,Berry,579,Spain,158948.63,1,1,0
9157,2011,3,MORTGAGE,3,Medium,2,14500, 36 months,1,home_improvement,7,Low,1,Good Loan,0,5.42,A,1,10.1,15028.3,14500,0,437.32,409000009156,14-Aug-18,Indiaforensic NFS SETT 13-08-201,"4,000.00",,-544222612.86,Colombo,504,Spain,165122.55,1,1,0
9158,2011,10,MORTGAGE,3,Low,1,12000, 60 months,2,debt_consolidation,6,High,2,Good Loan,0,15.23,C,3,24.17,15624.78,12000,0,286.93,409000009157,14-Aug-18,Indiaforensic NFS SETT 13-08-201,"2,000.00",,-544224612.86,Harris,737,France,189402.71,1,1,0
9159,2011,1,RENT,1,Low,1,8000, 36 months,1,credit_card,1,High,2,Good Loan,0,15.62,D,4,11.53,9607.83,8000,0,279.76,409000009158,14-Aug-18,Indiaforensic NFS SETT 13-08-201,"5,000.00",,-544229612.86,Bryan,540,Spain,158027.57,1,1,0
9160,2011,4,RENT,1,Low,1,21000, 60 months,2,debt_consolidation,6,Low,1,Bad Loan,1,10.99,B,2,5.97,4488.02,2298.58,712.1,315.74,409000009159,14-Aug-18,Indiaforensic NFS SETT 13-08-201,300,,-544229912.86,Chigozie,609,France,3815.48,1,1,0
9161,2011,3,RENT,1,Low,1,7150, 36 months,1,debt_consolidation,6,Low,1,Good Loan,0,6.99,A,1,11.02,7876.95,7150,0,220.74,409000009160,14-Aug-18,Indiaforensic NFS SETT 13-08-201,"7,000.00",,-544236912.86,Mullawirraburka,778,France,162809.20,1,1,0
9162,2011,10,MORTGAGE,3,Low,1,12000, 60 months,2,credit_card,1,Low,1,Bad Loan,1,11.49,B,2,3.87,3889.94,2074.58,443.01,215.48,409000009161,14-Aug-18,Indiaforensic NFS SETT 13-08-201,"4,000.00",,-544240912.86,Steele,621,France,89519.47,1,1,0
9163,2011,10,MORTGAGE,3,Medium,2,12000, 36 months,1,debt_consolidation,6,Low,1,Good Loan,0,12.99,C,3,11.9,14362.68,12000,0,404.27,409000009162,14-Aug-18,Indiaforensic NFS SETT 13-08-201,"8,500.00",,-544249412.86,Zakharov,665,Germany,25165.36,1,1,0
9164,2011,8,MORTGAGE,3,Medium,2,35000, 36 months,1,debt_consolidation,6,Low,1,Good Loan,0,12.99,C,3,7.62,42438.51821,35000,0,1179.12,409000009163,16-Aug-18,TRF FRM  Indiaforensic SERVICES,,105000.00,-544144412.86,Ch'eng,608,France,126012.57,1,1,0
9165,2011,10,MORTGAGE,3,Low,1,1000, 36 months,1,major_purchase,8,Low,1,Good Loan,0,5.42,A,1,28.85,1085.427216,1000,0,30.16,409000009164,16-Aug-18,Indiaforensic RUPAY SETT 150818,"1,744.56",,-544146157.42,Berry,680,Spain,20109.21,1,1,0
9166,2011,4,MORTGAGE,3,Low,1,2000, 36 months,1,vacation,11,Low,1,Good Loan,0,5.42,A,1,15.14,2143.31,2000,0,60.32,409000009165,16-Aug-18,Indiaforensic RUPAY STL INTC1508,,2017.84,-544144139.58,Jen,663,Germany,58257.23,1,1,0
9167,2011,2,RENT,1,Low,1,6000, 36 months,1,debt_consolidation,6,Low,1,Good Loan,0,11.49,B,2,5.52,6833.58,6000,0,197.83,409000009166,16-Aug-18,Indiaforensic RUPAY STL INTC1508,17.84,,-544144157.42,Wang,627,Germany,172269.21,1,1,0
9168,2011,10,MORTGAGE,3,Low,1,13000, 60 months,2,debt_consolidation,6,Low,1,Good Loan,0,8.49,A,1,20.19,15328.75784,13000,0,266.66,409000009167,16-Aug-18,Indiaforensic RUPAY STL INTC1508,,32.00,-544144125.42,Chubb,607,France,29818.20,1,1,0
9169,2011,0.5,MORTGAGE,3,Low,1,7800, 36 months,1,debt_consolidation,6,Low,1,Good Loan,0,10.59,B,2,6.36,9135.326348,7800,0,253.86,409000009168,16-Aug-18,Indiaforensic RUPAY SETT 160818,"2,079.83",,-544146205.25,Chen,681,France,114659.81,1,1,0
9170,2011,2,MORTGAGE,3,High,3,35000, 60 months,2,debt_consolidation,6,Low,1,Good Loan,0,10.99,B,2,1.82,26262.56,23200,0,504.31,409000009169,16-Aug-18,Indiaforensic RUPAY STL INTC1608,,2013.19,-544144192.06,Mazzanti,766,France,147184.74,1,1,0
9171,2011,9,MORTGAGE,3,Medium,2,30000, 60 months,2,debt_consolidation,6,High,2,Good Loan,0,17.99,E,5,19.04,39549.92,24270.52,0,761.64,409000009170,16-Aug-18,Indiaforensic RUPAY STL INTC1608,12.44,,-544144204.50,T'ao,694,France,15039.41,1,1,0
9172,2011,10,MORTGAGE,3,Low,1,8500, 36 months,1,wedding,5,Low,1,Bad Loan,1,5.42,A,1,25.88,1792.77,1545.1,0,256.36,409000009171,16-Aug-18,Indiaforensic RUPAY STL INTC1608,,32.00,-544144172.50,Ndubueze,411,France,76621.49,1,1,0
9173,2011,8,MORTGAGE,3,Low,1,16000, 60 months,2,debt_consolidation,6,Low,1,Good Loan,0,7.49,A,1,10.45,17420.32,16000,0,320.54,409000009172,16-Aug-18,Indiaforensic  RUPAY SETT 160818,86.42,,-544144258.92,Ferri,742,France,92985.78,1,1,0
9174,2011,2,RENT,1,Low,1,5000, 36 months,1,small_business,3,High,2,Bad Loan,1,15.23,C,3,22.87,360.01,205.91,0,173.9,409000009173,16-Aug-18,Indiaforensic RUPAY STL INTC1608,,0.60,-544144258.32,Thornton,673,Spain,6009.27,1,1,0
9175,2011,10,MORTGAGE,3,Low,1,14500, 60 months,2,car,2,Low,1,Good Loan,0,9.99,B,2,11.88,16773.54,14500,0,308.02,409000009174,16-Aug-18,Indiaforensic RUPAY STL INTC1608,0.6,,-544144258.92,DeRose,529,France,191370.97,1,1,0
9176,2011,7,MORTGAGE,3,Low,1,14400, 60 months,2,debt_consolidation,6,Low,1,Good Loan,0,9.99,B,2,13.34,15423.5,14400,0,305.89,409000009175,17-Aug-18,Indiaforensic  RUPAY SETT 170818,"1,553.14",,-544145812.06,Montes,519,France,188225.67,1,1,0
9177,2011,0.5,RENT,1,Low,1,10000, 36 months,1,debt_consolidation,6,High,2,Bad Loan,1,13.99,C,3,8.44,5612.03,914.82,4247.55,341.73,409000009176,17-Aug-18,Indiaforensic RUPAY STL INTC1708,,85.73,-544145726.33,Kwemto,573,France,11743.89,1,1,0
9178,2011,6.05,MORTGAGE,3,Low,1,2400, 36 months,1,debt_consolidation,6,Low,1,Good Loan,0,10.59,B,2,13.69,2701.55,2400,0,78.11,409000009177,17-Aug-18,Indiaforensic RUPAY STL INTC1708,16.81,,-544145743.14,Lucchese,453,Germany,136846.75,1,1,0
9179,2011,4,MORTGAGE,3,Low,1,5800, 36 months,1,debt_consolidation,6,Low,1,Good Loan,0,6.99,A,1,7.92,6380.23817,5800,0,179.07,409000009178,17-Aug-18,Indiaforensic RUPAY STL INTC1708,,0.52,-544145742.62,Huggins,798,Germany,164248.33,1,1,0
9180,2011,7,MORTGAGE,3,Low,1,15000, 36 months,1,debt_consolidation,6,Low,1,Good Loan,0,6.99,A,1,14.42,15706.58,15000,0,463.09,409000009179,17-Aug-18,Indiaforensic NFS SETT 14-08-201,"2,000.00",,-544147742.62,Wade,693,Spain,154631.35,1,1,0
9181,2011,10,MORTGAGE,3,Low,1,4400, 36 months,1,credit_card,1,Low,1,Good Loan,0,5.99,A,1,22.17,4807.964547,4400,0,133.84,409000009180,17-Aug-18,Indiaforensic NFS SETT 14-08-201,400,,-544148142.62,Kenenna,637,France,149665.65,1,1,0
9182,2011,3,RENT,1,Low,1,10500, 36 months,1,debt_consolidation,6,High,2,Good Loan,0,13.49,C,3,16.64,12117.31,10500,0,356.27,409000009181,17-Aug-18,Indiaforensic NFS SETT 14-08-201,"3,000.00",,-544151142.62,Wheeler,672,France,91574.92,1,1,0
9183,2011,6,MORTGAGE,3,Low,1,18825, 60 months,2,debt_consolidation,6,High,2,Bad Loan,1,17.49,D,4,11.91,13666.71,5915.3,1846.13,472.83,409000009182,17-Aug-18,Indiaforensic NFS SETT 14-08-201,500,,-544151642.62,Cartwright,597,France,127233.39,1,1,0
9184,2011,5,MORTGAGE,3,Low,1,5000, 36 months,1,small_business,3,Low,1,Good Loan,0,11.99,B,2,20.49,5977.418785,5000,0,166.05,409000009183,17-Aug-18,Indiaforensic NFS SETT 14-08-201,"8,500.00",,-544160142.62,Iloerika,543,France,56650.47,1,1,0
9185,2011,0.5,RENT,1,Low,1,6500, 36 months,1,credit_card,1,Low,1,Good Loan,0,10.99,B,2,11.04,6982.61,6500,0,212.78,409000009184,17-Aug-18,Indiaforensic NFS SETT 14-08-201,400,,-544160542.62,Palermo,695,Spain,84644.76,1,1,0
9186,2011,4,RENT,1,Low,1,20000, 60 months,2,moving,10,Low,1,Good Loan,0,11.99,B,2,29.51,23106.46,16582.28,0,444.79,409000009185,17-Aug-18,Indiaforensic NFS SETT 14-08-201,"10,000.00",,-544170542.62,Nkemakolam,584,France,148238.16,1,1,0
9187,2011,3,MORTGAGE,3,Low,1,12000, 60 months,2,small_business,3,High,2,Good Loan,0,16.89,D,4,15.24,13294.02,12000,0,297.53,409000009186,17-Aug-18,Indiaforensic NFS SETT 14-08-201,"7,000.00",,-544177542.62,Butler,652,Germany,193502.90,1,1,0
9188,2011,2,MORTGAGE,3,Medium,2,29700, 60 months,2,debt_consolidation,6,High,2,Good Loan,0,20.62,F,6,17.23,27587.86,15834.34,0,530.77,409000009187,17-Aug-18,Indiaforensic NFS SETT 14-08-201,300,,-544177842.62,Calabresi,601,France,38020.05,1,1,0
9189,2011,5,RENT,1,Low,1,3000, 36 months,1,medical,9,High,2,Bad Loan,1,16.89,D,4,2.54,2411.69,1678.19,75.99,106.8,409000009188,17-Aug-18,Indiaforensic NFS SETT 14-08-201,"10,000.00",,-544187842.62,Nkemdilim,628,Spain,176750.81,1,1,0
9190,2011,10,MORTGAGE,3,High,3,15000, 36 months,1,debt_consolidation,6,Low,1,Good Loan,0,7.49,A,1,8.37,16572.26,15000,0,466.53,409000009189,17-Aug-18,Indiaforensic NFS SETT 14-08-201,"2,500.00",,-544190342.62,Ch'iu,607,Germany,176580.63,1,1,0
9191,2011,3,RENT,1,Medium,2,35000, 60 months,2,debt_consolidation,6,High,2,Bad Loan,1,21.36,F,6,18.63,9463.66,3271.97,1075.84,599.64,409000009190,17-Aug-18,Indiaforensic NFS SETT 15-08-201,500,,-544190842.62,Alexander,646,France,133059.15,1,1,0
9192,2011,5,OWN,2,Low,1,8300, 36 months,1,debt_consolidation,6,Low,1,Bad Loan,1,8.49,A,1,2.88,878.54,406.6,356.32,261.98,409000009191,17-Aug-18,Indiaforensic NFS SETT 15-08-201,100,,-544190942.62,Chiabuotu,572,France,100843.82,1,1,0
9193,2011,1,MORTGAGE,3,Medium,2,30000, 60 months,2,debt_consolidation,6,High,2,Bad Loan,1,19.69,E,5,17.76,38920.06,21558.61,0,789.66,409000009192,17-Aug-18,Indiaforensic NFS SETT 15-08-201,700,,-544191642.62,Vasilyeva,801,Spain,30484.19,1,1,0
9194,2011,5,RENT,1,Low,1,3625, 36 months,1,debt_consolidation,6,Low,1,Good Loan,0,6.99,A,1,29.88,4028.009114,3625,0,111.92,409000009193,17-Aug-18,Indiaforensic NFS SETT 15-08-201,"10,000.00",,-544201642.62,Schneider,597,France,42330.58,1,1,0
9195,2011,3,RENT,1,Low,1,5500, 36 months,1,debt_consolidation,6,High,2,Good Loan,0,16.49,D,4,5.73,7006.035225,5500,0,194.7,409000009194,17-Aug-18,Indiaforensic NFS SETT 15-08-201,"10,000.00",,-544211642.62,Mason,613,France,193309.58,1,1,0
9196,2011,6,MORTGAGE,3,Low,1,3000, 60 months,2,debt_consolidation,6,High,2,Good Loan,0,16.49,D,4,21.44,3790.66,3000,0,73.74,409000009195,17-Aug-18,Indiaforensic NFS SETT 15-08-201,"5,000.00",,-544216642.62,Chukwukadibia,529,Germany,112813.79,1,1,0
9197,2011,5,MORTGAGE,3,Medium,2,24800, 36 months,1,home_improvement,7,Low,1,Good Loan,0,7.49,A,1,13.71,27632.9,24800,0,771.33,409000009196,17-Aug-18,Indiaforensic NFS SETT 15-08-201,"1,000.00",,-544217642.62,Tsui,794,Spain,68008.85,1,1,0
9198,2011,2,RENT,1,Low,1,7200, 36 months,1,debt_consolidation,6,Low,1,Good Loan,0,10.59,B,2,11.35,8431.721161,7200,0,234.33,409000009197,17-Aug-18,Indiaforensic NFS SETT 15-08-201,500,,-544218142.62,Banks,557,France,132673.22,1,1,0
9199,2011,0.5,RENT,1,Low,1,10600, 60 months,2,debt_consolidation,6,High,2,Good Loan,0,21.36,F,6,10.48,16524.98112,10600,0,288.92,409000009198,17-Aug-18,Indiaforensic NFS SETT 15-08-201,"3,500.00",,-544221642.62,Shih,499,France,22001.91,1,1,0
9200,2011,3,OWN,2,Low,1,12000, 60 months,2,other,4,Low,1,Good Loan,0,11.49,B,2,8.33,13685.32,9955.05,0,263.86,409000009199,17-Aug-18,Indiaforensic  RUPAY SETT 170818,300.42,,-544221943.04,Tretiakova,544,France,100200.40,1,1,0
9201,2011,5,RENT,1,Low,1,25000, 60 months,2,major_purchase,8,High,2,Good Loan,0,20.62,F,6,1.78,30760.36977,20625,0,553.58,409000009200,17-Aug-18,Indiaforensic RUPAY STL INTC1708,,2.09,-544221940.95,Barese,739,France,122604.44,1,1,0
9202,2011,0.5,RENT,1,Medium,2,30000, 36 months,1,wedding,5,Low,1,Good Loan,0,5.99,A,1,16.28,32783.06381,30000,0,912.53,409000009201,17-Aug-18,Indiaforensic RUPAY STL INTC1708,2.09,,-544221943.04,Longo,458,Germany,100564.37,1,1,0
9203,2011,5,MORTGAGE,3,Medium,2,25000, 36 months,1,debt_consolidation,6,Low,1,Good Loan,0,6.99,A,1,8.32,27587.2,25000,0,771.82,409000009202,18-Aug-18,Indiaforensic  RUPAY SETT 180818,"8,588.70",,-544230531.74,MacDonald,528,France,5419.31,1,1,0
9204,2011,8,MORTGAGE,3,Low,1,8000, 36 months,1,wedding,5,Low,1,Bad Loan,1,10.59,B,2,7.87,6428.75,4799.25,460.71,260.36,409000009203,18-Aug-18,Indiaforensic RUPAY STL INTC1808,,95.86,-544230435.88,Chambers,773,Spain,123587.83,1,1,0
9205,2011,8,MORTGAGE,3,Medium,2,28000, 36 months,1,small_business,3,Low,1,Good Loan,0,7.49,A,1,8.23,30635.88,28000,0,870.85,409000009204,18-Aug-18,Indiaforensic RUPAY STL INTC1808,87.23,,-544230523.11,Cowen,646,France,13935.32,1,1,0
9206,2011,4,MORTGAGE,3,Low,1,17000, 36 months,1,debt_consolidation,6,High,2,Good Loan,0,16.89,D,4,18.29,21768.00546,17000,0,605.17,409000009205,18-Aug-18,Indiaforensic RUPAY STL INTC1808,,0.04,-544230523.07,Iweobiegbunam,564,France,87060.77,1,1,0
9207,2011,5,MORTGAGE,3,Low,1,20950, 60 months,2,debt_consolidation,6,High,2,Bad Loan,1,21.36,F,6,19.92,1695.24,327.67,759.12,468.81,409000009206,20-Aug-18,Indiaforensic  RUPAY SETT 200818,"9,350.10",,-544239873.17,Mai,624,Germany,4859.59,1,1,0
9208,2011,2,RENT,1,Low,1,9000, 36 months,1,debt_consolidation,6,Low,1,Good Loan,0,11.49,B,2,12.13,10174.89,9000,0,296.75,409000009207,20-Aug-18,Indiaforensic RUPAY STL INTC2008,,94.93,-544239778.24,Yu,682,France,21085.17,1,1,0
9209,2011,4,MORTGAGE,3,Low,1,11400, 36 months,1,small_business,3,High,2,Bad Loan,1,17.99,E,5,2.27,7393.17,4622.78,399.71,412.09,409000009208,20-Aug-18,Indiaforensic RUPAY STL INTC2008,91.18,,-544239869.42,Duffy,726,France,26733.86,1,1,0
9210,2011,0.5,RENT,1,Low,1,8000, 36 months,1,credit_card,1,Low,1,Good Loan,0,10.99,B,2,18.49,9420.623603,8000,0,261.88,409000009209,20-Aug-18,Indiaforensic RUPAY STL INTC2008,,0.02,-544239869.40,Chiang,560,France,89734.70,1,1,0
9211,2011,10,RENT,1,Low,1,4500, 36 months,1,debt_consolidation,6,Low,1,Bad Loan,1,10.99,B,2,23.95,1381.7,873.04,207.86,147.31,409000009210,20-Aug-18,Indiaforensic  RUPAY SETT 190818,"11,490.41",,-544251359.81,Watts,382,Spain,179540.73,1,1,0
9212,2011,8,MORTGAGE,3,Low,1,3600, 36 months,1,home_improvement,7,Low,1,Good Loan,0,7.49,A,1,17.83,4028.143515,3600,0,111.97,409000009211,20-Aug-18,Indiaforensic RUPAY STL INTC1908,,95.83,-544251263.98,Daly,457,Spain,173219.09,1,1,0
9213,2011,10,RENT,1,Low,1,35000, 60 months,2,debt_consolidation,6,Low,1,Good Loan,0,11.49,B,2,27.63,28540.25013,22100,0,485.93,409000009212,20-Aug-18,Indiaforensic RUPAY STL INTC1908,95.08,,-544251359.06,Baker,673,France,37411.35,1,1,0
9214,2011,3,RENT,1,Low,1,23675, 60 months,2,debt_consolidation,6,High,2,Good Loan,0,16.89,D,4,24.35,30463.37,19231.99,0,586.99,409000009213,20-Aug-18,Indiaforensic  RUPAY SETT 200818,177.12,,-544251536.18,Uvarov,584,France,80852.11,1,1,0
9215,2011,0.5,RENT,1,Low,1,7000, 36 months,1,debt_consolidation,6,Low,1,Bad Loan,1,11.99,B,2,21.21,6348.9,4796.79,306.5,232.47,409000009214,20-Aug-18,Indiaforensic RUPAY STL INTC2008,,1.03,-544251535.15,Costa,629,France,43174.49,1,1,0
9216,2011,2,MORTGAGE,3,Low,1,5000, 36 months,1,major_purchase,8,Low,1,Good Loan,0,6.99,A,1,3.97,5555.92213,5000,0,154.37,409000009215,20-Aug-18,Indiaforensic RUPAY STL INTC2008,1.03,,-544251536.18,Genovesi,584,Germany,70927.11,1,1,0
9217,2011,4,RENT,1,Low,1,7000, 36 months,1,other,4,Low,1,Good Loan,0,5.42,A,1,17.33,7473.34,7000,0,211.12,409000009216,20-Aug-18,Indiaforensic NFS SETT 18-08-201,300,,-544251836.18,Doherty,724,France,54265.55,1,1,0
9218,2011,3,RENT,1,Low,1,16000, 60 months,2,debt_consolidation,6,High,2,Good Loan,0,18.39,E,5,13.79,21277.59,16000,0,409.7,409000009217,20-Aug-18,Indiaforensic NFS SETT 18-08-201,300,,-544252136.18,Kaleski,644,France,41872.17,1,1,0
9219,2011,6,RENT,1,Medium,2,30000, 36 months,1,debt_consolidation,6,Low,1,Good Loan,0,5.99,A,1,23.84,32782.76517,30000,0,912.53,409000009218,20-Aug-18,Indiaforensic NFS SETT 18-08-201,200,,-544252336.18,Wright,676,Germany,15068.53,1,1,0
9220,2011,3,MORTGAGE,3,High,3,28000, 36 months,1,small_business,3,Low,1,Good Loan,0,5.99,A,1,2.83,30660.3191,28000,0,851.69,409000009219,20-Aug-18,Indiaforensic NFS SETT 18-08-201,200,,-544252536.18,Huang,499,France,25950.49,1,1,0
9221,2011,0.5,MORTGAGE,3,Low,1,7775, 36 months,1,debt_consolidation,6,Low,1,Good Loan,0,5.99,A,1,4.43,8339.24,7775,0,236.5,409000009220,20-Aug-18,Indiaforensic NFS SETT 18-08-201,900,,-544253436.18,Trentino,598,France,197727.14,1,1,0
9222,2011,10,MORTGAGE,3,High,3,35000, 36 months,1,wedding,5,High,2,Good Loan,0,15.62,D,4,7.26,44055.75129,35000,0,1223.95,409000009221,20-Aug-18,Indiaforensic NFS SETT 18-08-201,"1,500.00",,-544254936.18,Chienezie,655,Germany,79555.08,1,1,0
9223,2011,1,RENT,1,Low,1,16400, 60 months,2,debt_consolidation,6,High,2,Bad Loan,1,22.48,G,7,8.17,1845.89,612.79,0,457.44,409000009222,20-Aug-18,Indiaforensic NFS SETT 18-08-201,"6,000.00",,-544260936.18,Sugden,559,France,15607.27,1,1,0
9224,2011,1,RENT,1,Low,1,12000, 60 months,2,other,4,Low,1,Good Loan,0,10.99,B,2,14.37,10739.31112,8700,0,189.12,409000009223,20-Aug-18,Indiaforensic NFS SETT 19-08-201,400,,-544261336.18,Tu,543,France,134612.48,1,1,0
9225,2011,3,MORTGAGE,3,Medium,2,14000, 36 months,1,medical,9,Low,1,Good Loan,0,11.99,B,2,6.81,15107.97,14000,0,464.94,409000009224,20-Aug-18,Indiaforensic NFS SETT 19-08-201,500,,-544261836.18,Onuchukwu,679,France,159830.58,1,1,0
9226,2011,1,MORTGAGE,3,Low,1,7200, 36 months,1,credit_card,1,Low,1,Good Loan,0,11.99,B,2,5.32,8607.508418,7200,0,239.11,409000009225,20-Aug-18,Indiaforensic NFS SETT 19-08-201,"10,000.00",,-544271836.18,Ugochukwutubelum,594,Germany,162961.79,1,1,0
9227,2011,10,MORTGAGE,3,Medium,2,21600, 36 months,1,major_purchase,8,Low,1,Good Loan,0,10.59,B,2,9.4,24096.36103,20600,0,670.43,409000009226,20-Aug-18,Indiaforensic NFS SETT 19-08-201,"1,500.00",,-544273336.18,Davidson,586,France,192427.16,1,1,0
9228,2011,2,MORTGAGE,3,Low,1,13500, 60 months,2,debt_consolidation,6,Low,1,Bad Loan,1,11.99,B,2,20.57,9938.19,6980.74,0,207.39,409000009227,20-Aug-18,Indiaforensic NFS SETT 19-08-201,500,,-544273836.18,Goddard,776,France,92647.94,1,1,0
9229,2011,6.05,RENT,1,Low,1,29100, 60 months,2,debt_consolidation,6,High,2,Good Loan,0,13.99,C,3,17.41,23423.46,15943.3,0,450.73,409000009228,21-Aug-18,Indiaforensic  RUPAY SETT 210818,216.07,,-544274052.25,Beck,699,France,180022.39,1,1,0
9230,2011,4,MORTGAGE,3,Low,1,6000, 36 months,1,debt_consolidation,6,Low,1,Good Loan,0,10.99,B,2,18.45,6886.24,6000,0,196.41,409000009229,21-Aug-18,Indiaforensic RUPAY STL INTC2108,,2.00,-544274050.25,Beam,847,Germany,183584.14,1,1,0
9231,2011,0.5,RENT,1,Low,1,7500, 36 months,1,debt_consolidation,6,High,2,Good Loan,0,13.49,C,3,7.5,9147.434422,7500,0,254.48,409000009230,21-Aug-18,Indiaforensic RUPAY STL INTC2108,2,,-544274052.25,Sheppard,582,Germany,28750.67,1,1,0
9232,2011,2,MORTGAGE,3,Low,1,10225, 36 months,1,debt_consolidation,6,Low,1,Good Loan,0,9.99,B,2,17.07,11871.87184,10225,0,329.89,409000009231,21-Aug-18,FDRL/INTERNAL FUND TRANSFE,,100000.00,-544174052.25,Godfrey,648,France,74846.67,1,1,0
9233,2011,1,OWN,2,Low,1,4800, 36 months,1,home_improvement,7,Low,1,Bad Loan,1,11.99,B,2,9.78,325.11,111.42,165.75,159.41,409000009232,21-Aug-18,Indiaforensic NFS SETT 16-08-201,700,,-544174752.25,Gray,618,France,89729.30,1,1,0
9234,2011,10,MORTGAGE,3,Medium,2,8575, 36 months,1,debt_consolidation,6,Low,1,Good Loan,0,11.99,B,2,22.86,9843.25,8575,0,284.78,409000009233,21-Aug-18,Indiaforensic NFS SETT 16-08-201,100,,-544174852.25,Hsiung,543,France,61843.73,1,1,0
9235,2011,0.5,RENT,1,Low,1,3600, 36 months,1,other,4,Low,1,Good Loan,0,11.99,B,2,21.07,4303.690792,3600,0,119.56,409000009234,21-Aug-18,Indiaforensic NFS SETT 16-08-201,300,,-544175152.25,Cameron,642,Germany,24770.22,1,1,0
9236,2011,10,MORTGAGE,3,Medium,2,10000, 60 months,2,major_purchase,8,High,2,Good Loan,0,13.49,C,3,4.69,9816.53,6771.77,0,189.22,409000009235,21-Aug-18,Indiaforensic NFS SETT 16-08-201,"10,000.00",,-544185152.25,Fleming,462,France,80587.27,1,1,0
9237,2011,6.05,MORTGAGE,3,Low,1,25000, 60 months,2,debt_consolidation,6,Low,1,Good Loan,0,11.99,B,2,14.05,20418.35,14653.56,0,393.09,409000009236,21-Aug-18,Indiaforensic NFS SETT 16-08-201,"2,000.00",,-544187152.25,Austin,640,Spain,116286.25,1,1,0
9238,2011,10,OWN,2,Medium,2,30000, 60 months,2,small_business,3,High,2,Bad Loan,1,13.99,C,3,8.92,27188.29,15456.57,2075.49,697.9,409000009237,21-Aug-18,Indiaforensic NFS SETT 16-08-201,"4,000.00",,-544191152.25,Wallace,740,Germany,129333.69,1,1,0
9239,2011,4,RENT,1,Low,1,35000, 60 months,2,debt_consolidation,6,High,2,Good Loan,0,16.49,D,4,20.65,44694.46,28504.39,0,860.28,409000009238,21-Aug-18,Indiaforensic NFS SETT 16-08-201,"6,900.00",,-544198052.25,Ku,773,France,129372.94,1,1,0
9240,2011,6,MORTGAGE,3,Low,1,9600, 36 months,1,credit_card,1,Low,1,Good Loan,0,5.42,A,1,3.72,10421.56277,9600,0,289.54,409000009239,21-Aug-18,Indiaforensic NFS SETT 16-08-201,"6,000.00",,-544204052.25,Fiorentino,583,Germany,18149.03,1,1,0
9241,2011,10,MORTGAGE,3,Low,1,5600, 36 months,1,debt_consolidation,6,Low,1,Good Loan,0,7.49,A,1,13.22,5854.53,5600,0,174.17,409000009240,21-Aug-18,Indiaforensic NFS SETT 16-08-201,200,,-544204252.25,Buccho,589,Spain,168369.37,1,1,0
9242,2011,2,RENT,1,Low,1,13000, 36 months,1,debt_consolidation,6,Low,1,Good Loan,0,12.99,C,3,19.57,15762.41004,13000,0,437.96,409000009241,21-Aug-18,Indiaforensic NFS SETT 16-08-201,"2,500.00",,-544206752.25,Gordon,509,France,67431.28,1,1,0
9243,2011,3,RENT,1,Low,1,12000, 60 months,2,debt_consolidation,6,High,2,Good Loan,0,15.99,D,4,15.86,16608.70724,12000,0,291.76,409000009242,21-Aug-18,Indiaforensic NFS SETT 16-08-201,"1,500.00",,-544208252.25,Haworth,612,Germany,177092.16,1,1,0
9244,2011,3,RENT,1,Low,1,5000, 36 months,1,medical,9,Low,1,Good Loan,0,11.49,B,2,2.97,5930.904849,5000,0,164.86,409000009243,21-Aug-18,Indiaforensic NFS SETT 16-08-201,"8,000.00",,-544216252.25,Guidry,505,Spain,93736.69,1,1,0
9245,2011,8,MORTGAGE,3,Low,1,7200, 36 months,1,other,4,High,2,Good Loan,0,15.23,C,3,0.98,8974.487293,7200,0,250.41,409000009244,21-Aug-18,Indiaforensic NFS SETT 16-08-201,500,,-544216752.25,Lettiere,546,Germany,131647.31,1,1,0
9246,2011,3,MORTGAGE,3,Medium,2,10000, 36 months,1,debt_consolidation,6,Low,1,Good Loan,0,10.99,B,2,11.41,11773.86008,10000,0,327.34,409000009245,21-Aug-18,Indiaforensic NFS SETT 16-08-201,100,,-544216852.25,Tai,681,France,175722.31,1,1,0
9247,2011,1,MORTGAGE,3,Low,1,8000, 36 months,1,home_improvement,7,Low,1,Good Loan,0,10.99,B,2,9.94,9422.393622,8000,0,261.88,409000009246,21-Aug-18,Indiaforensic NFS SETT 16-08-201,"8,700.00",,-544225552.25,Chigozie,762,France,85606.83,1,1,0
9248,2011,8,RENT,1,Low,1,11000, 36 months,1,debt_consolidation,6,Low,1,Good Loan,0,6.99,A,1,8.19,12224.40764,11000,0,339.6,409000009247,21-Aug-18,Indiaforensic NFS SETT 17-08-201,"5,000.00",,-544230552.25,Bezrukov,786,Spain,64945.57,1,1,0
9249,2011,0.5,OWN,2,Low,1,1600, 36 months,1,debt_consolidation,6,Low,1,Good Loan,0,9.99,B,2,1.63,1857.364125,1600,0,51.62,409000009248,21-Aug-18,Indiaforensic NFS SETT 17-08-201,400,,-544230952.25,Chia,629,Spain,190347.72,1,1,0
9250,2011,0.5,MORTGAGE,3,Medium,2,35000, 60 months,2,credit_card,1,Low,1,Good Loan,0,11.49,B,2,8.73,28163.91783,21850,0,480.43,409000009249,21-Aug-18,Indiaforensic NFS SETT 17-08-201,"1,000.00",,-544231952.25,Sheppard,787,Spain,100791.36,1,1,0
9251,2011,6.05,MORTGAGE,3,Low,1,10625, 36 months,1,debt_consolidation,6,Low,1,Good Loan,0,5.42,A,1,9.46,11534.79867,10625,0,320.45,409000009250,21-Aug-18,Indiaforensic NFS SETT 17-08-201,"5,900.00",,-544237852.25,Vasilyev,713,Spain,167873.49,1,1,0
9252,2011,3,MORTGAGE,3,Low,1,6000, 36 months,1,debt_consolidation,6,Low,1,Good Loan,0,11.49,B,2,9.73,7118.47332,6000,0,197.83,409000009251,21-Aug-18,Indiaforensic NFS SETT 17-08-201,"2,000.00",,-544239852.25,Maxwell,541,France,25289.23,1,1,0
9253,2011,3,RENT,1,Low,1,6800, 36 months,1,credit_card,1,Low,1,Good Loan,0,8.49,A,1,7.73,7650.141888,6800,0,214.63,409000009252,21-Aug-18,Indiaforensic NFS SETT 17-08-201,300,,-544240152.25,Maher,451,France,20388.77,1,1,0
9254,2011,2,OWN,2,Low,1,12600, 60 months,2,debt_consolidation,6,High,2,Good Loan,0,18.39,E,5,14.67,14779.72,12600,0,322.64,409000009253,21-Aug-18,Indiaforensic NFS SETT 17-08-201,100,,-544240252.25,Cocci,644,Spain,145089.64,1,1,0
9255,2011,10,MORTGAGE,3,Low,1,18225, 60 months,2,credit_card,1,High,2,Good Loan,0,17.49,D,4,20.84,26738.29957,18225,0,457.76,409000009254,21-Aug-18,Indiaforensic NFS SETT 17-08-201,100,,-544240352.25,P'an,686,France,179093.26,1,1,0
9256,2011,3,MORTGAGE,3,Low,1,14000, 60 months,2,major_purchase,8,Low,1,Good Loan,0,11.99,B,2,12.66,18243.18463,14000,0,311.36,409000009255,21-Aug-18,Indiaforensic NFS SETT 17-08-201,100,,-544240452.25,Rapuluchukwu,847,Germany,16025.17,1,1,0
9257,2011,10,MORTGAGE,3,Low,1,6800, 36 months,1,debt_consolidation,6,High,2,Good Loan,0,18.39,E,5,21.02,8308.23,6800,0,247.17,409000009256,21-Aug-18,Indiaforensic NFS SETT 17-08-201,500,,-544240952.25,Azuka,765,Germany,9087.81,1,1,0
9258,2011,10,MORTGAGE,3,Medium,2,35000, 60 months,2,debt_consolidation,6,High,2,Good Loan,0,18.39,E,5,18.44,48295.62617,35000,0,896.22,409000009257,21-Aug-18,Indiaforensic NFS SETT 17-08-201,"1,000.00",,-544241952.25,Esposito,678,Germany,21472.42,1,1,0
9259,2011,8,RENT,1,Medium,2,35000, 60 months,2,wedding,5,High,2,Good Loan,0,18.39,E,5,10.58,48637.92591,35000,0,896.22,409000009258,21-Aug-18,Indiaforensic NFS SETT 17-08-201,"2,000.00",,-544243952.25,Hou,539,France,146752.67,1,1,0
9260,2011,2,MORTGAGE,3,Low,1,6000, 36 months,1,debt_consolidation,6,High,2,Good Loan,0,14.79,C,3,20.59,7461.166714,6000,0,207.38,409000009259,21-Aug-18,Indiaforensic NFS SETT 17-08-201,500,,-544244452.25,Cyril,800,France,132562.23,1,1,0
9261,2011,3,RENT,1,Medium,2,16000, 60 months,2,wedding,5,Low,1,Good Loan,0,10.99,B,2,11.6,20426.62468,16000,0,347.8,409000009260,21-Aug-18,Indiaforensic NFS SETT 17-08-201,100,,-544244552.25,Tomlinson,799,Germany,139537.43,1,1,0
9262,2011,10,RENT,1,Low,1,1500, 36 months,1,other,4,High,2,Good Loan,0,15.62,D,4,13.08,1887.184441,1500,0,52.46,409000009261,21-Aug-18,Indiaforensic NFS SETT 17-08-201,100,,-544244652.25,Crawford,629,France,133672.61,1,1,0
9263,2011,10,RENT,1,Low,1,24000, 60 months,2,other,4,Low,1,Good Loan,0,11.99,B,2,12.36,27727.16,19898.43,0,533.75,409000009262,21-Aug-18,Indiaforensic NFS SETT 17-08-201,200,,-544244852.25,Chikwado,734,Germany,38984.37,1,1,0
9264,2011,10,RENT,1,Low,1,16000, 60 months,2,debt_consolidation,6,High,2,Good Loan,0,17.99,E,5,21.22,17622.37,16000,0,406.21,409000009263,21-Aug-18,Indiaforensic NFS SETT 17-08-201,"8,000.00",,-544252852.25,Hargreaves,542,France,115217.59,1,1,0
9265,2011,6.05,MORTGAGE,3,Low,1,4300, 60 months,2,vacation,11,Low,1,Good Loan,0,11.49,B,2,13.18,4885.28,3554.98,0,94.55,409000009264,21-Aug-18,Indiaforensic NFS SETT 17-08-201,300,,-544253152.25,Laidley,414,Spain,93844.82,1,1,0
9266,2011,7,MORTGAGE,3,Low,1,5000, 36 months,1,debt_consolidation,6,Low,1,Good Loan,0,5.42,A,1,7.51,5367.81,5000,0,150.8,409000009265,21-Aug-18,Indiaforensic NFS SETT 20-08-201,"2,500.00",,-544255652.25,Ferguson,675,France,22068.83,1,1,0
9267,2011,4,MORTGAGE,3,Medium,2,25000, 36 months,1,debt_consolidation,6,Low,1,Good Loan,0,7.49,A,1,21.5,26610.48,25000,0,777.55,409000009266,21-Aug-18,Indiaforensic NFS SETT 20-08-201,300,,-544255952.25,Burns,683,France,123846.07,1,1,0
9268,2011,4,MORTGAGE,3,Low,1,23675, 60 months,2,debt_consolidation,6,Low,1,Good Loan,0,12.99,C,3,25.12,23933.3,23675,0,538.56,409000009267,21-Aug-18,Indiaforensic NFS SETT 20-08-201,100,,-544256052.25,McNeill,748,France,172638.13,1,1,0
9269,2011,0.5,MORTGAGE,3,Low,1,11600, 36 months,1,major_purchase,8,Low,1,Good Loan,0,11.99,B,2,8.3,13789.67,11600,0,385.24,409000009268,21-Aug-18,Indiaforensic NFS SETT 20-08-201,300,,-544256352.25,Chukwuebuka,596,Spain,1591.19,1,1,0
9270,2011,6,MORTGAGE,3,Low,1,14000, 36 months,1,debt_consolidation,6,Low,1,Bad Loan,1,10.59,B,2,14.68,9111.53,7220.47,9.73,455.63,409000009269,21-Aug-18,Indiaforensic NFS SETT 20-08-201,"5,000.00",,-544261352.25,Shen,642,France,91775.51,1,1,0
9271,2011,5,RENT,1,Low,1,7250, 36 months,1,credit_card,1,Low,1,Good Loan,0,8.49,A,1,15.97,8191.21,7250,0,228.84,409000009270,21-Aug-18,Indiaforensic NFS SETT 20-08-201,"1,000.00",,-544262352.25,Diaz,499,France,153920.22,1,1,0
9272,2011,1,RENT,1,Low,1,1000, 36 months,1,debt_consolidation,6,High,2,Bad Loan,1,17.99,E,5,12.65,159.25,86.03,0,36.15,409000009271,21-Aug-18,Indiaforensic  RUPAY SETT 210818,"6,931.33",,-544269283.58,Kentish,649,Spain,71420.16,1,1,0
9273,2011,4,MORTGAGE,3,Low,1,5000, 60 months,2,other,4,High,2,Good Loan,0,13.49,C,3,3.62,6067.47,5000,0,115.03,409000009272,21-Aug-18,Indiaforensic RUPAY STL INTC2108,,51.98,-544269231.60,Persse,739,France,172149.76,1,1,0
9274,2011,3,RENT,1,Low,1,2400, 36 months,1,moving,10,High,2,Good Loan,0,15.23,C,3,18.01,3000.090413,2400,0,83.47,409000009273,21-Aug-18,Indiaforensic RUPAY STL INTC2108,51.98,,-544269283.58,Okwukwe,616,France,54706.75,1,1,0
9275,2011,2,MORTGAGE,3,Low,1,12500, 60 months,2,credit_card,1,High,2,Bad Loan,1,14.79,C,3,13.42,7050.7,3554.51,552.34,296,409000009274,23-Aug-18,Indiaforensic RUPAY SETT 220818,81.79,,-544269365.37,Watt,560,Spain,183358.21,1,1,0
9276,2011,7,MORTGAGE,3,Medium,2,6500, 36 months,1,wedding,5,High,2,Good Loan,0,15.99,D,4,13.01,7406.57,6500,0,228.49,409000009275,23-Aug-18,Indiaforensic RUPAY STL INTC2208,,1.36,-544269364.01,Carslaw,427,Germany,57098.00,1,1,0
9277,2011,0.5,RENT,1,Low,1,14125, 60 months,2,credit_card,1,High,2,Good Loan,0,15.23,C,3,22.58,19346.19095,14125,0,337.75,409000009276,23-Aug-18,Indiaforensic RUPAY STL INTC2208,0.61,,-544269364.62,Griffin,435,France,156910.46,1,1,0
9278,2011,1,RENT,1,Low,1,5500, 36 months,1,debt_consolidation,6,Low,1,Good Loan,0,10.99,B,2,23.45,6474.896549,5500,0,180.04,409000009277,23-Aug-18,Indiaforensic RUPAY SETT 230818,"6,361.51",,-544275726.13,Hsia,633,France,130224.73,1,1,0
9279,2011,0.5,RENT,1,Low,1,12000, 36 months,1,debt_consolidation,6,Low,1,Good Loan,0,10.59,B,2,18.58,14057.27461,12000,0,390.54,409000009278,23-Aug-18,Indiaforensic RUPAY STL INTC2308,91.34,,-544275817.47,Fyodorova,443,France,13946.66,1,1,0
9280,2011,10,RENT,1,High,3,33500, 60 months,2,debt_consolidation,6,High,2,Bad Loan,1,21.74,F,6,2.77,3078.04,604.67,0,582.4,409000009279,23-Aug-18,Indiaforensic RUPAY STL INTC2308,,143.32,-544275674.15,Chukwujekwu,727,France,38652.96,1,1,0
9281,2011,7,MORTGAGE,3,Low,1,8500, 36 months,1,other,4,Low,1,Good Loan,0,6.99,A,1,0.4,9446.358033,8500,0,262.42,409000009280,23-Aug-18,Indiaforensic RUPAY STL INTC2308,,0.39,-544275673.76,Townsend,674,France,140041.78,1,1,0
9282,2011,9,MORTGAGE,3,Low,1,6400, 36 months,1,credit_card,1,Low,1,Good Loan,0,5.99,A,1,11.43,7002.185184,6400,0,194.68,409000009281,23-Aug-18,Indiaforensic NFS SETT 21-08-201,"2,000.00",,-544277673.76,Marsh,661,France,166187.10,1,1,0
9283,2011,3,RENT,1,Low,1,4800, 60 months,2,small_business,3,High,2,Bad Loan,1,22.11,G,7,12.42,5392.28,2411.56,350.67,132.88,409000009282,23-Aug-18,Indiaforensic NFS SETT 21-08-201,400,,-544278073.76,Hayes,619,Spain,139919.38,1,1,0
9284,2011,2,MORTGAGE,3,High,3,30000, 36 months,1,home_improvement,7,Low,1,Good Loan,0,8.49,A,1,5.41,34044.24112,30000,0,946.89,409000009283,23-Aug-18,Indiaforensic NFS SETT 21-08-201,600,,-544278673.76,Padovano,562,France,28137.03,1,1,0
9285,2011,8,RENT,1,Low,1,5000, 60 months,2,car,2,High,2,Good Loan,0,13.99,C,3,3.52,5393.41,5000,0,116.32,409000009284,23-Aug-18,Indiaforensic NFS SETT 21-08-201,"10,000.00",,-544288673.76,Ma,633,France,50368.63,1,1,0
9286,2011,3,RENT,1,Low,1,5000, 36 months,1,major_purchase,8,High,2,Good Loan,0,13.49,C,3,19.75,5624.34,5000,0,169.66,409000009285,23-Aug-18,Indiaforensic NFS SETT 21-08-201,"4,000.00",,-544292673.76,Ham,551,Spain,94978.10,1,1,0
9287,2011,1,MORTGAGE,3,Low,1,4800, 36 months,1,major_purchase,8,Low,1,Good Loan,0,6.99,A,1,18.96,5296.76,4800,0,148.19,409000009286,23-Aug-18,Indiaforensic NFS SETT 21-08-201,"2,500.00",,-544295173.76,Paten,720,Germany,69903.93,1,1,0
9288,2011,10,RENT,1,Low,1,10000, 36 months,1,debt_consolidation,6,Low,1,Good Loan,0,10.59,B,2,22.76,11589.11,10000,0,325.45,409000009287,23-Aug-18,Indiaforensic NFS SETT 21-08-201,500,,-544295673.76,Cawthorne,688,France,177607.77,1,1,0
9289,2011,3,MORTGAGE,3,Low,1,6500, 36 months,1,debt_consolidation,6,High,2,Bad Loan,1,15.99,D,4,20.2,3883.85,2502.74,240.97,228.49,409000009288,23-Aug-18,Indiaforensic NFS SETT 21-08-201,800,,-544296473.76,Herbert,635,Germany,196731.08,1,1,0
9290,2011,1,RENT,1,Low,1,10000, 36 months,1,debt_consolidation,6,Low,1,Good Loan,0,7.49,A,1,7.77,11195.46671,10000,0,311.02,409000009289,23-Aug-18,Indiaforensic NFS SETT 21-08-201,200,,-544296673.76,Jen,561,France,65234.60,1,1,0
9291,2011,9,RENT,1,Low,1,4000, 36 months,1,major_purchase,8,Low,1,Good Loan,0,6.99,A,1,25.18,4131,4000,0,123.5,409000009290,23-Aug-18,Indiaforensic NFS SETT 22-08-201,"2,000.00",,-544298673.76,Saunders,850,France,186281.00,1,1,0
9292,2011,4,RENT,1,Low,1,3400, 36 months,1,debt_consolidation,6,Low,1,Good Loan,0,8.49,A,1,20.65,3679.9,3400,0,107.32,409000009291,23-Aug-18,Indiaforensic NFS SETT 22-08-201,500,,-544299173.76,Esquivel,636,France,111573.30,1,1,0
9293,2011,10,RENT,1,Low,1,6000, 36 months,1,debt_consolidation,6,High,2,Good Loan,0,15.23,C,3,14.88,7503.905874,6000,0,208.67,409000009292,23-Aug-18,Indiaforensic NFS SETT 22-08-201,200,,-544299373.76,Chao,461,Germany,196767.83,1,1,0
9294,2011,0.5,MORTGAGE,3,Low,1,8000, 36 months,1,car,2,Low,1,Good Loan,0,6.99,A,1,8.77,8724.07,8000,0,246.99,409000009293,23-Aug-18,Indiaforensic  RUPAY SETT 230818,624.71,,-544299998.47,Eluemuno,771,Germany,72985.61,1,1,0
9295,2011,7,RENT,1,Low,1,12000, 60 months,2,credit_card,1,Low,1,Good Loan,0,12.99,C,3,14.8,15126.745,12000,0,272.98,409000009294,23-Aug-18,Indiaforensic RUPAY STL INTC2308,6.86,,-544300005.33,Sidorova,713,France,143265.65,1,1,0
9296,2011,2,MORTGAGE,3,Low,1,7500, 36 months,1,home_improvement,7,High,2,Good Loan,0,13.99,C,3,16.67,9160.961979,7500,0,256.3,409000009295,23-Aug-18,Indiaforensic RUPAY STL INTC2308,,6.86,-544299998.47,Pirogova,658,Germany,159268.67,1,1,0
9297,2011,4,MORTGAGE,3,Low,1,2000, 36 months,1,debt_consolidation,6,Low,1,Good Loan,0,5.99,A,1,9.71,2145.31,2000,0,60.84,409000009296,24-Aug-18,Indiaforensic  RUPAY SETT 240818,"7,155.24",,-544307153.71,Benson,586,Germany,54448.41,1,1,0
9298,2011,2,RENT,1,Low,1,14000, 36 months,1,debt_consolidation,6,High,2,Good Loan,0,16.89,D,4,21.93,17922.46579,14000,0,498.38,409000009297,24-Aug-18,Indiaforensic RUPAY STL INTC2408,,54.95,-544307098.76,Santana,737,France,31928.50,1,1,0
9299,2011,5,RENT,1,Low,1,5000, 36 months,1,credit_card,1,Low,1,Good Loan,0,5.99,A,1,11.54,5320.37,5000,0,152.09,409000009298,24-Aug-18,Indiaforensic RUPAY STL INTC2408,54.95,,-544307153.71,Williamson,742,Germany,21793.59,1,1,0
9300,2011,6,MORTGAGE,3,Low,1,3000, 36 months,1,credit_card,1,Low,1,Good Loan,0,8.49,A,1,15.18,3119.31,3000,0,94.69,409000009299,24-Aug-18,Indiaforensic NFS SETT 23-08-201,500,,-544307653.71,North,824,France,21903.62,1,1,0
9301,2011,4,RENT,1,Low,1,5000, 36 months,1,credit_card,1,Low,1,Good Loan,0,11.99,B,2,18.83,5905.9,5000,0,166.05,409000009300,24-Aug-18,Indiaforensic NFS SETT 23-08-201,500,,-544308153.71,Davies,701,Germany,49405.93,1,1,0
9302,2011,1,RENT,1,Low,1,13000, 36 months,1,major_purchase,8,Low,1,Good Loan,0,10.99,B,2,9.32,15299.42341,13000,0,425.55,409000009301,24-Aug-18,Indiaforensic NFS SETT 23-08-201,100,,-544308253.71,Siciliano,623,Spain,154908.52,1,1,0
9303,2011,5,RENT,1,Low,1,8000, 36 months,1,debt_consolidation,6,Low,1,Good Loan,0,12.99,C,3,18.32,9698.743489,8000,0,269.52,409000009302,24-Aug-18,Indiaforensic  RUPAY SETT 240818,0.01,,-544308253.72,Mironov,744,France,182867.84,1,1,0
9304,2011,10,RENT,1,Low,1,5000, 60 months,2,other,4,High,2,Good Loan,0,15.99,D,4,21.17,6304.24,4074.25,0,121.57,409000009303,24-Aug-18,Indiaforensic RUPAY STL INTC2408,,1.50,-544308252.22,Amechi,698,Spain,16957.45,1,1,0
9305,2011,2,RENT,1,Low,1,14000, 60 months,2,wedding,5,High,2,Good Loan,0,21.74,F,6,9.38,18371.66,14000,0,384.6,409000009304,24-Aug-18,Indiaforensic RUPAY STL INTC2408,,0.01,-544308252.21,Toscano,616,France,93717.55,1,1,0
9306,2011,2,RENT,1,Low,1,6000, 36 months,1,small_business,3,High,2,Bad Loan,1,16.49,D,4,14.46,3604.17,2464.99,0,212.4,409000009305,27-Aug-18,Indiaforensic RUPAY SETT 250818,314.42,,-544308566.63,Su,662,France,61636.22,1,1,0
9307,2011,0.5,RENT,1,Low,1,12300, 36 months,1,debt_consolidation,6,Low,1,Good Loan,0,12.99,C,3,21.99,14872.05822,12300,0,414.38,409000009306,27-Aug-18,Indiaforensic RUPAY STL INTC2508,2.23,,-544308568.86,Chukwuemeka,594,France,95864.50,1,1,0
9308,2011,0.5,MORTGAGE,3,Low,1,2000, 36 months,1,home_improvement,7,High,2,Good Loan,0,13.99,C,3,17.07,2458.668551,2000,0,68.35,409000009307,27-Aug-18,Indiaforensic RUPAY SETT 260818,"1,569.02",,-544310137.88,P'eng,685,France,167400.29,1,1,0
9309,2011,1,RENT,1,Low,1,3000, 36 months,1,debt_consolidation,6,Low,1,Good Loan,0,10.99,B,2,9.17,3532.150099,3000,0,98.21,409000009308,27-Aug-18,Indiaforensic RUPAY STL INTC2608,12.56,,-544310150.44,Lombardo,742,France,131534.96,1,1,0
9310,2011,10,MORTGAGE,3,Medium,2,8800, 36 months,1,debt_consolidation,6,Low,1,Good Loan,0,10.59,B,2,17.77,10305.11073,8800,0,286.4,409000009309,27-Aug-18,Indiaforensic RUPAY SETT 270818,351.1,,-544310501.54,Lombardi,678,Germany,92934.41,1,1,0
9311,2011,10,RENT,1,Low,1,30000, 60 months,2,debt_consolidation,6,High,2,Good Loan,0,13.99,C,3,13.94,27723.26547,20575,0,478.64,409000009310,27-Aug-18,Indiaforensic RUPAY STL INTC2708,2.45,,-544310503.99,Butler,651,Spain,119808.64,1,1,0
9312,2011,10,MORTGAGE,3,Low,1,20000, 60 months,2,debt_consolidation,6,High,2,Good Loan,0,18.39,E,5,15.25,26628.73,16171.39,0,512.13,409000009311,27-Aug-18,Indiaforensic RUPAY STL INTC2508,,2.23,-544310501.76,Dean,585,Germany,9439.31,1,1,0
9313,2011,10,MORTGAGE,3,Medium,2,5000, 36 months,1,home_improvement,7,Low,1,Good Loan,0,11.49,B,2,8.77,5269.87,5000,0,164.86,409000009312,27-Aug-18,Indiaforensic RUPAY STL INTC2608,,12.56,-544310489.20,Piccio,579,Germany,18732.91,1,1,0
9314,2011,0.5,OWN,2,Low,1,1200, 36 months,1,debt_consolidation,6,Low,1,Good Loan,0,10.99,B,2,7.63,1381.58,1200,0,39.29,409000009313,27-Aug-18,Indiaforensic RUPAY STL INTC2708,,54.34,-544310434.86,Bradley,722,Germany,160162.42,1,1,0
9315,2011,10,RENT,1,Low,1,1600, 36 months,1,home_improvement,7,High,2,Good Loan,0,17.49,D,4,21,1711.26,1600,0,57.44,409000009314,27-Aug-18,Indiaforensic RUPAY STL INTC2708,,0.39,-544310434.47,Cameron,613,Germany,53630.90,1,1,0
9316,2011,1,RENT,1,Low,1,1500, 36 months,1,debt_consolidation,6,Low,1,Good Loan,0,7.49,A,1,27.35,1597.98,1500,0,46.66,409000009315,27-Aug-18,Indiaforensic  RUPAY SETT 270818,670.71,,-544311105.18,Chan,694,France,36405.21,1,1,0
9317,2011,6,RENT,1,Low,1,9000, 36 months,1,debt_consolidation,6,Low,1,Good Loan,0,7.49,A,1,19.74,9942.77,9000,0,279.92,409000009316,27-Aug-18,Indiaforensic RUPAY STL INTC2708,,10.72,-544311094.46,Lettiere,550,Germany,61446.92,1,1,0
9318,2011,6,OWN,2,Low,1,11000, 36 months,1,other,4,Low,1,Good Loan,0,8.49,A,1,22.1,12353.13,11000,0,347.2,409000009317,27-Aug-18,Indiaforensic RUPAY STL INTC2708,10.72,,-544311105.18,Mironova,741,France,194686.78,1,1,0
9319,2011,2,RENT,1,Low,1,7500, 36 months,1,credit_card,1,High,2,Bad Loan,1,16.89,D,4,19.36,596.32,160.44,330.97,266.99,409000009318,27-Aug-18,Indiaforensic NFS SETT 24-08-201,"10,000.00",,-544321105.18,Tsui,668,Spain,134483.07,1,1,0
9320,2011,2,RENT,1,Low,1,1500, 36 months,1,major_purchase,8,Low,1,Good Loan,0,7.49,A,1,18.53,1554.04,1500,0,46.66,409000009319,27-Aug-18,Indiaforensic NFS SETT 24-08-201,"2,000.00",,-544323105.18,Okoli,529,France,37769.98,1,1,0
9321,2011,2,RENT,1,Low,1,3500, 36 months,1,debt_consolidation,6,Low,1,Good Loan,0,5.99,A,1,19.45,3819.44973,3500,0,106.47,409000009320,27-Aug-18,Indiaforensic NFS SETT 24-08-201,100,,-544323205.18,Berry,636,France,2382.61,1,1,0
9322,2011,10,RENT,1,Low,1,17000, 60 months,2,debt_consolidation,6,Low,1,Good Loan,0,11.99,B,2,5.33,22007.23858,17000,0,378.07,409000009321,27-Aug-18,Indiaforensic NFS SETT 24-08-201,"1,000.00",,-544324205.18,Ruse,563,Spain,106826.92,1,1,0
9323,2011,9,MORTGAGE,3,Low,1,3250, 60 months,2,debt_consolidation,6,Low,1,Good Loan,0,12.99,C,3,24.59,3830.09,2677.94,0,73.94,409000009322,27-Aug-18,Indiaforensic NFS SETT 24-08-201,900,,-544325105.18,Bogolyubov,767,France,39511.61,1,1,0
9324,2011,10,OWN,2,Low,1,5000, 36 months,1,car,2,Low,1,Good Loan,0,8.49,A,1,11.61,5412.79,5000,0,157.82,409000009323,27-Aug-18,Indiaforensic NFS SETT 24-08-201,"2,000.00",,-544327105.18,Kennedy,644,France,196371.13,1,1,0
9325,2011,8,RENT,1,Low,1,14000, 60 months,2,debt_consolidation,6,High,2,Good Loan,0,13.49,C,3,10.45,16717.77,11531.44,0,322.07,409000009324,27-Aug-18,Indiaforensic NFS SETT 24-08-201,300,,-544327405.18,Bolton,780,Germany,122506.78,1,1,0
9326,2011,1,MORTGAGE,3,Low,1,3000, 36 months,1,home_improvement,7,High,2,Good Loan,0,15.99,D,4,1.31,3793.009228,3000,0,105.46,409000009325,27-Aug-18,Indiaforensic NFS SETT 25-08-201,"3,500.00",,-544330905.18,Chuang,635,Spain,61994.20,1,1,0
9327,2011,5,RENT,1,Low,1,8500, 36 months,1,debt_consolidation,6,Low,1,Good Loan,0,6.99,A,1,29.43,9431.561948,8500,0,262.42,409000009326,27-Aug-18,Indiaforensic NFS SETT 25-08-201,"1,000.00",,-544331905.18,Greco,641,Germany,192464.21,1,1,0
9328,2011,10,MORTGAGE,3,Low,1,21000, 36 months,1,debt_consolidation,6,High,2,Good Loan,0,15.62,D,4,13.55,26402.37845,21000,0,734.37,409000009327,27-Aug-18,Indiaforensic NFS SETT 25-08-201,400,,-544332305.18,Ma,593,Spain,5194.95,1,1,0
9329,2011,10,MORTGAGE,3,Low,1,7500, 36 months,1,vacation,11,Low,1,Good Loan,0,5.42,A,1,3.21,8106.56,7500,0,226.2,409000009328,27-Aug-18,Indiaforensic NFS SETT 25-08-201,"6,000.00",,-544338305.18,Nucci,540,Germany,198256.15,1,1,0
9330,2011,4,RENT,1,Low,1,2400, 36 months,1,moving,10,High,2,Good Loan,0,17.49,D,4,18.4,3065.61,2400,0,86.16,409000009329,27-Aug-18,Indiaforensic NFS SETT 25-08-201,"6,500.00",,-544344805.18,Yao,663,Spain,62634.94,1,1,0
9331,2011,5,MORTGAGE,3,Low,1,20000, 36 months,1,debt_consolidation,6,Low,1,Good Loan,0,11.49,B,2,13.9,23675.20991,20000,0,659.43,409000009330,27-Aug-18,Indiaforensic NFS SETT 25-08-201,"2,000.00",,-544346805.18,Palfreyman,630,France,114006.35,1,1,0
9332,2011,5,RENT,1,Low,1,13800, 60 months,2,credit_card,1,Low,1,Good Loan,0,12.99,C,3,19.31,16271,11374.59,0,313.93,409000009331,27-Aug-18,Indiaforensic NFS SETT 25-08-201,300,,-544347105.18,Webster,605,Germany,107994.99,1,1,0
9333,2011,0.5,RENT,1,Low,1,8000, 36 months,1,credit_card,1,Low,1,Good Loan,0,7.49,A,1,6.48,8568.71,8000,0,248.82,409000009332,27-Aug-18,Indiaforensic NFS SETT 26-08-201,500,,-544347605.18,Cardell,710,Germany,48571.14,1,1,0
9334,2011,2,MORTGAGE,3,Low,1,12000, 36 months,1,debt_consolidation,6,Low,1,Good Loan,0,6.99,A,1,15.39,13053.06,12000,0,370.48,409000009333,27-Aug-18,Indiaforensic NFS SETT 26-08-201,100,,-544347705.18,Bianchi,755,France,76016.49,1,1,0
9335,2011,5,MORTGAGE,3,Low,1,5800, 36 months,1,home_improvement,7,Low,1,Good Loan,0,6.99,A,1,21.36,6445.629269,5800,0,179.07,409000009334,27-Aug-18,Indiaforensic NFS SETT 26-08-201,200,,-544347905.18,Somadina,641,Spain,180808.39,1,1,0
9336,2011,10,RENT,1,Medium,2,8000, 36 months,1,debt_consolidation,6,High,2,Good Loan,0,16.49,D,4,18.09,9232.82,8000,0,283.2,409000009335,27-Aug-18,Indiaforensic NFS SETT 26-08-201,"3,000.00",,-544350905.18,Mellor,737,Germany,4225.11,1,1,0
9337,2011,10,RENT,1,Low,1,24000, 36 months,1,debt_consolidation,6,Low,1,Good Loan,0,10.99,B,2,25.46,17553.1791,14900,0,487.74,409000009336,28-Aug-18,Indiaforensic  RUPAY SETT 280818,"7,216.25",,-544358121.43,Tomlinson,695,France,135841.35,1,1,0
9338,2011,5,MORTGAGE,3,Low,1,15000, 60 months,2,home_improvement,7,Low,1,Good Loan,0,10.99,B,2,13.14,19221.56807,15000,0,326.07,409000009337,28-Aug-18,Indiaforensic RUPAY STL INTC2808,,64.76,-544358056.67,Pai,466,Germany,183536.24,1,1,0
9339,2011,0.5,RENT,1,Low,1,12000, 36 months,1,other,4,High,2,Good Loan,0,13.49,C,3,17.7,14503.23982,12000,0,407.17,409000009338,28-Aug-18,Indiaforensic RUPAY STL INTC2808,64.76,,-544358121.43,Lennox,558,Germany,88791.83,1,1,0
9340,2011,1,RENT,1,Low,1,4000, 36 months,1,other,4,Low,1,Bad Loan,1,11.49,B,2,21.44,1576.44,1179.48,0,131.89,409000009339,28-Aug-18,Indiaforensic  RUPAY SETT 280818,500.71,,-544358622.14,Meldrum,665,Spain,63732.90,1,1,0
9341,2011,4,RENT,1,High,3,14000, 60 months,2,debt_consolidation,6,High,2,Good Loan,0,13.99,C,3,0.98,15101.52,14000,0,325.69,409000009340,28-Aug-18,Indiaforensic RUPAY STL INTC2808,,8.00,-544358614.14,Watson,737,France,1364.54,1,1,0
9342,2011,1,RENT,1,Low,1,12000, 36 months,1,debt_consolidation,6,Low,1,Good Loan,0,7.49,A,1,0.66,13431.19521,12000,0,373.22,409000009341,28-Aug-18,Indiaforensic RUPAY STL INTC2808,8,,-544358622.14,Findlay,654,France,149184.15,1,1,0
9343,2011,6,MORTGAGE,3,Low,1,12000, 60 months,2,other,4,Low,1,Good Loan,0,10.59,B,2,12.26,13382.73,9973.95,0,258.47,409000009342,28-Aug-18,Indiaforensic NFS SETT 27-08-201,500,,-544359122.14,Su,619,France,53394.12,1,1,0
9344,2011,8,OWN,2,Medium,2,10000, 36 months,1,debt_consolidation,6,High,2,Good Loan,0,19.29,E,5,13.12,13242.91471,10000,0,368.03,409000009343,28-Aug-18,Indiaforensic NFS SETT 27-08-201,"2,000.00",,-544361122.14,Davidson,845,Germany,97910.06,1,1,0
9345,2011,2,RENT,1,Low,1,9600, 36 months,1,medical,9,High,2,Bad Loan,1,20.62,F,6,11.04,782.05,194.32,423.22,359.82,409000009344,28-Aug-18,Indiaforensic NFS SETT 27-08-201,500,,-544361622.14,Barrett,727,France,101433.76,1,1,0
9346,2011,4,MORTGAGE,3,High,3,30000, 36 months,1,home_improvement,7,Low,1,Good Loan,0,10.59,B,2,8.15,25118.99,22425,0,729.82,409000009345,28-Aug-18,Indiaforensic NFS SETT 27-08-201,900,,-544362522.14,Miah,582,France,116944.30,1,1,0
9347,2011,3,RENT,1,Low,1,2500, 36 months,1,car,2,Low,1,Good Loan,0,6.99,A,1,5.86,2541,2500,0,77.19,409000009346,28-Aug-18,Indiaforensic NFS SETT 27-08-201,400,,-544362922.14,Chamberlain,716,France,113267.48,1,1,0
9348,2011,2,RENT,1,Low,1,10800, 36 months,1,debt_consolidation,6,High,2,Good Loan,0,18.79,E,5,8.17,13346.71,10800,0,394.74,409000009347,28-Aug-18,Indiaforensic NFS SETT 27-08-201,"3,000.00",,-544365922.14,Vidal,660,Spain,181449.51,1,1,0
9349,2011,7,RENT,1,Low,1,2250, 36 months,1,debt_consolidation,6,Low,1,Bad Loan,1,6.99,A,1,13.2,1895.95,1573.44,94.15,69.47,409000009348,28-Aug-18,Indiaforensic NFS SETT 27-08-201,"1,200.00",,-544367122.14,Lung,664,France,179913.98,1,1,0
9350,2011,7,MORTGAGE,3,Low,1,5500, 36 months,1,car,2,Low,1,Good Loan,0,10.59,B,2,16.49,6441.052764,5500,0,179,409000009349,28-Aug-18,Indiaforensic NFS SETT 27-08-201,500,,-544367622.14,Tretyakova,801,France,98586.14,1,1,0
9351,2011,10,MORTGAGE,3,Low,1,34475, 60 months,2,debt_consolidation,6,High,2,Good Loan,0,13.99,C,3,14.78,47023.57595,34475,0,802,409000009350,28-Aug-18,Indiaforensic NFS SETT 27-08-201,200,,-544367822.14,Montgomery,615,Spain,120321.09,1,1,0
9352,2011,5,MORTGAGE,3,Low,1,9900, 60 months,2,other,4,High,2,Good Loan,0,13.49,C,3,12.74,11823.28,8155.25,0,227.75,409000009351,28-Aug-18,Indiaforensic NFS SETT 27-08-201,"1,000.00",,-544368822.14,Golubev,718,Germany,100538.80,1,1,0
9353,2011,10,MORTGAGE,3,Low,1,18000, 36 months,1,credit_card,1,Low,1,Good Loan,0,8.49,A,1,5.6,20450.25048,18000,0,568.14,409000009352,28-Aug-18,Indiaforensic NFS SETT 27-08-201,600,,-544369422.14,Han,667,France,98931.50,1,1,0
9354,2011,4,MORTGAGE,3,Medium,2,25000, 60 months,2,credit_card,1,High,2,Good Loan,0,20.25,F,6,23.88,27463.76,25000,0,665.83,409000009353,28-Aug-18,Indiaforensic NFS SETT 27-08-201,600,,-544370022.14,Pan,670,Spain,194493.57,1,1,0
9355,2011,10,MORTGAGE,3,Medium,2,12000, 36 months,1,debt_consolidation,6,Low,1,Good Loan,0,6.99,A,1,11.39,13323.78588,12000,0,370.48,409000009354,28-Aug-18,Indiaforensic NFS SETT 27-08-201,"2,000.00",,-544372022.14,Carroll,590,France,143628.31,1,1,0
9356,2011,10,MORTGAGE,3,Low,1,16000, 36 months,1,debt_consolidation,6,High,2,Good Loan,0,17.49,D,4,15.03,20233.68,16000,0,574.36,409000009355,28-Aug-18,Indiaforensic NFS SETT 27-08-201,800,,-544372822.14,Hawkins,739,Spain,167030.51,1,1,0
9357,2011,3,MORTGAGE,3,Low,1,4000, 36 months,1,debt_consolidation,6,Low,1,Bad Loan,1,9.99,B,2,18.6,3977.55,3232.75,124.03,129.05,409000009356,28-Aug-18,Indiaforensic NFS SETT 27-08-201,500,,-544373322.14,Loggia,373,France,77786.37,1,1,0
9358,2011,0.5,RENT,1,Low,1,8000, 36 months,1,credit_card,1,High,2,Good Loan,0,16.49,D,4,5.52,9071.44,7999.99,0,283.2,409000009357,28-Aug-18,Indiaforensic NFS SETT 27-08-201,100,,-544373422.14,Chesnokova,418,France,81014.50,1,1,0
9359,2011,10,MORTGAGE,3,Low,1,18900, 36 months,1,debt_consolidation,6,Low,1,Good Loan,0,10.59,B,2,18.43,22137.50059,18900,0,615.1,409000009358,28-Aug-18,Indiaforensic NFS SETT 27-08-201,100,,-544373522.14,Chambers,837,France,41866.26,1,1,0
9360,2011,8,RENT,1,Low,1,22750, 60 months,2,small_business,3,High,2,Bad Loan,1,15.62,D,4,16.52,19891.55,10315.11,1807.52,548.66,409000009359,28-Aug-18,Indiaforensic NFS SETT 27-08-201,100,,-544373622.14,Fleming,645,Germany,11302.70,1,1,0
9361,2011,10,RENT,1,Low,1,8800, 36 months,1,debt_consolidation,6,Low,1,Good Loan,0,7.49,A,1,16.77,9850.875827,8800,0,273.7,409000009360,28-Aug-18,Indiaforensic NFS SETT 27-08-201,900,,-544374522.14,Veale,552,Germany,149384.43,1,1,0
9362,2011,0.5,RENT,1,Low,1,10400, 60 months,2,other,4,High,2,Good Loan,0,20.25,F,6,1.71,15830.04664,10400,0,276.99,409000009361,28-Aug-18,Indiaforensic NFS SETT 27-08-201,900,,-544375422.14,Browne,580,Germany,169303.65,1,1,0
9363,2011,2,MORTGAGE,3,Medium,2,14000, 60 months,2,credit_card,1,High,2,Good Loan,0,16.49,D,4,18.84,17861.82,11392.83,0,344.11,409000009362,28-Aug-18,Indiaforensic NFS SETT 27-08-201,"1,500.00",,-544376922.14,Parsons,684,France,37264.11,1,1,0
9364,2011,1,MORTGAGE,3,Low,1,4000, 36 months,1,credit_card,1,Low,1,Good Loan,0,5.99,A,1,7.53,4191.49,4000,0,121.67,409000009363,28-Aug-18,Indiaforensic NFS SETT 27-08-201,500,,-544377422.14,Bailey,634,Spain,19515.48,1,1,0
9365,2011,2,MORTGAGE,3,Low,1,9000, 36 months,1,car,2,Low,1,Good Loan,0,10.99,B,2,17.31,10600.16623,9000,0,294.61,409000009364,28-Aug-18,Indiaforensic NFS SETT 27-08-201,500,,-544377922.14,Ferrari,607,France,103068.22,1,1,0
9366,2011,10,RENT,1,Low,1,25000, 60 months,2,debt_consolidation,6,High,2,Good Loan,0,20.99,F,6,19.69,35108.46,19968.58,0,676.2,409000009365,28-Aug-18,Indiaforensic NFS SETT 27-08-201,"1,000.00",,-544378922.14,Genovese,802,France,134459.12,1,1,0
9367,2011,6.05,RENT,1,Low,1,8000, 36 months,1,small_business,3,Low,1,Good Loan,0,12.99,C,3,13.05,8902.87,8000,0,269.52,409000009366,29-Aug-18,Indiaforensic  RUPAY SETT 290818,"7,143.73",,-544386065.87,McIntyre,736,France,70496.66,1,1,0
9368,2011,10,MORTGAGE,3,Low,1,4800, 36 months,1,home_improvement,7,Low,1,Good Loan,0,10.99,B,2,13.03,5565.16,4800,0,157.13,409000009367,29-Aug-18,Indiaforensic RUPAY STL INTC2908,,57.71,-544386008.16,Warner,629,France,175877.70,1,1,0
9369,2011,7,MORTGAGE,3,Low,1,12000, 60 months,2,home_improvement,7,High,2,Good Loan,0,19.29,E,5,24.02,16271.62,9643.08,0,313.21,409000009368,29-Aug-18,Indiaforensic RUPAY STL INTC2908,57.71,,-544386065.87,Gordon,737,France,106390.01,1,1,0
9370,2011,10,MORTGAGE,3,Low,1,25000, 60 months,2,other,4,Low,1,Good Loan,0,12.99,C,3,4.7,25443.62,17788.31,0,491.36,409000009369,29-Aug-18,TRF FROM  Indiaforensic SERVICES,,60000.00,-544326065.87,McMillan,718,Spain,52138.49,1,1,0
9371,2011,0.5,RENT,1,Low,1,5200, 36 months,1,debt_consolidation,6,Low,1,Good Loan,0,9.99,B,2,4.6,6035.304794,5200,0,167.77,409000009370,29-Aug-18,Indiaforensic  RUPAY SETT 290818,,0.83,-544326065.04,Cheng,561,France,18522.91,1,1,0
9372,2011,4,MORTGAGE,3,Low,1,10000, 36 months,1,home_improvement,7,High,2,Good Loan,0,16.89,D,4,11.21,12800.00794,10000,0,355.99,409000009371,29-Aug-18,Indiaforensic NFS SETT 28-08-201,"1,000.00",,-544327065.04,Akhtar,641,France,32231.60,1,1,0
9373,2011,10,MORTGAGE,3,Low,1,9750, 36 months,1,debt_consolidation,6,Low,1,Good Loan,0,8.49,A,1,12.5,11077.02772,9750,0,307.74,409000009372,29-Aug-18,Indiaforensic NFS SETT 28-08-201,"1,000.00",,-544328065.04,Iadanza,677,France,174225.88,1,1,0
9374,2011,4,MORTGAGE,3,Low,1,25000, 60 months,2,debt_consolidation,6,High,2,Good Loan,0,19.69,E,5,10.65,34194.9,20091.41,0,658.05,409000009373,29-Aug-18,Indiaforensic NFS SETT 28-08-201,500,,-544328565.04,Abernathy,641,Spain,102021.39,1,1,0
9375,2011,8,RENT,1,Low,1,21600, 60 months,2,debt_consolidation,6,High,2,Good Loan,0,14.79,C,3,24.19,25687.04,21600,0,511.49,409000009374,29-Aug-18,Indiaforensic NFS SETT 28-08-201,100,,-544328665.04,Watson,658,Spain,31484.76,1,1,0
9376,2011,10,MORTGAGE,3,Low,1,8000, 36 months,1,credit_card,1,Low,1,Good Loan,0,10.99,B,2,17.37,8474.67,8000,0,261.88,409000009375,29-Aug-18,Indiaforensic NFS SETT 28-08-201,200,,-544328865.04,Shen,659,Germany,82469.06,1,1,0
9377,2011,0.5,MORTGAGE,3,Medium,2,7000, 36 months,1,debt_consolidation,6,Low,1,Good Loan,0,10.99,B,2,20.33,8003.62,7000,0,229.14,409000009376,29-Aug-18,Indiaforensic NFS SETT 28-08-201,"1,000.00",,-544329865.04,Kershaw,567,France,110900.43,1,1,0
9378,2011,10,RENT,1,Low,1,8000, 36 months,1,debt_consolidation,6,Low,1,Good Loan,0,12.99,C,3,14.82,9699.003993,8000,0,269.52,409000009377,29-Aug-18,Indiaforensic NFS SETT 28-08-201,300,,-544330165.04,Reed,584,France,105105.35,1,1,0
9379,2011,5,RENT,1,Low,1,9000, 36 months,1,credit_card,1,Low,1,Good Loan,0,10.99,B,2,15.1,10596.8365,9000,0,294.61,409000009378,29-Aug-18,Indiaforensic NFS SETT 28-08-201,300,,-544330465.04,Mitchell,709,Spain,12674.68,1,1,0
9380,2011,6,MORTGAGE,3,Medium,2,12000, 60 months,2,vacation,11,High,2,Good Loan,0,20.25,F,6,2.25,14152.05,12000,0,319.6,409000009379,29-Aug-18,Indiaforensic NFS SETT 28-08-201,300,,-544330765.04,Webb,690,Spain,93255.85,1,1,0
9381,2011,7,MORTGAGE,3,Low,1,2500, 60 months,2,home_improvement,7,High,2,Good Loan,0,16.89,D,4,19.05,3222.17,2500,0,61.99,409000009380,29-Aug-18,Indiaforensic NFS SETT 28-08-201,600,,-544331365.04,Vanzetti,627,France,145299.50,1,1,0
9382,2011,1,RENT,1,Low,1,2500, 36 months,1,other,4,Low,1,Bad Loan,1,7.49,A,1,21.6,879.74,635.77,106.37,77.76,409000009381,29-Aug-18,Indiaforensic NFS SETT 28-08-201,200,,-544331565.04,Nnanna,765,Spain,47139.44,1,1,0
9383,2011,10,RENT,1,Low,1,25000, 60 months,2,debt_consolidation,6,High,2,Good Loan,0,13.99,C,3,23.79,28011.89,25000,0,581.58,409000009382,29-Aug-18,Indiaforensic NFS SETT 28-08-201,300,,-544331865.04,Campbell,645,France,167723.25,1,1,0
9384,2011,10,RENT,1,Low,1,35000, 60 months,2,other,4,High,2,Bad Loan,1,20.25,F,6,17.6,5444.11,1040.64,1951.32,932.17,409000009383,29-Aug-18,Indiaforensic NFS SETT 28-08-201,800,,-544332665.04,Capon,716,France,185900.88,1,1,0
9385,2011,0.5,MORTGAGE,3,Medium,2,35000, 36 months,1,debt_consolidation,6,Low,1,Bad Loan,1,7.49,A,1,13.62,3672.99,1744.94,1496.73,1088.56,409000009384,29-Aug-18,Indiaforensic NFS SETT 28-08-201,"5,000.00",,-544337665.04,Otutodilichukwu,771,France,85876.67,1,1,0
9386,2011,2,RENT,1,Low,1,9600, 36 months,1,wedding,5,Low,1,Good Loan,0,10.99,B,2,10.04,10891.93,9600,0,314.25,409000009385,30-Aug-18,Indiaforensic  RUPAY SETT 300818,"7,345.67",,-544345010.71,Boone,687,Germany,1787.85,1,1,0
9387,2011,0.5,MORTGAGE,3,Low,1,15000, 60 months,2,home_improvement,7,High,2,Good Loan,0,16.89,D,4,12.67,20783.23529,15000,0,371.91,409000009386,30-Aug-18,Indiaforensic RUPAY STL INTC3008,,302.74,-544344707.97,McIntyre,717,Germany,23231.93,1,1,0
9388,2011,7,MORTGAGE,3,Low,1,35000, 60 months,2,debt_consolidation,6,High,2,Good Loan,0,16.89,D,4,17.6,51679.89991,35000,0,867.78,409000009387,30-Aug-18,Indiaforensic RUPAY STL INTC3008,80.74,,-544344788.71,Zhdanov,524,France,187740.04,1,1,0
9389,2011,0.5,RENT,1,Low,1,10000, 36 months,1,wedding,5,Low,1,Good Loan,0,11.49,B,2,16.14,11864.34444,10000,0,329.72,409000009388,30-Aug-18,Indiaforensic RUPAY STL INTC3008,,3.55,-544344785.16,Nagy,679,Spain,100060.54,1,1,0
9390,2011,4,MORTGAGE,3,Low,1,12100, 36 months,1,small_business,3,High,2,Good Loan,0,16.89,D,4,11.16,15495.77541,12100,0,430.74,409000009389,30-Aug-18,Indiaforensic  RUPAY SETT 300818,326.06,,-544345111.22,Lombardo,538,France,80130.54,1,1,0
9391,2011,10,MORTGAGE,3,Low,1,4200, 36 months,1,other,4,Low,1,Bad Loan,1,10.99,B,2,16.85,2894.13,2489.79,0,137.49,409000009390,30-Aug-18,Indiaforensic RUPAY STL INTC3008,,48.28,-544345062.94,Simpson,752,Germany,132467.54,1,1,0
9392,2011,10,RENT,1,Low,1,8400, 36 months,1,home_improvement,7,High,2,Good Loan,0,13.99,C,3,8.34,10328.11903,8400,0,287.06,409000009391,30-Aug-18,Indiaforensic RUPAY STL INTC3008,1.63,,-544345064.57,Herbert,846,Spain,96202.44,1,1,0
9393,2011,7,MORTGAGE,3,Low,1,8400, 36 months,1,debt_consolidation,6,Low,1,Good Loan,0,10.99,B,2,20.66,9888.43097,8400,0,274.97,409000009392,30-Aug-18,Indiaforensic RUPAY STL INTC3008,,0.35,-544345064.22,Lehr,532,Spain,94977.30,1,1,0
9394,2011,6.05,MORTGAGE,3,Low,1,12000, 60 months,2,other,4,Low,1,Good Loan,0,10.99,B,2,20.79,13545.3,9984.18,0,260.85,409000009393,30-Aug-18,Indiaforensic NFS SETT 29-08-201,500,,-544345564.22,Chou,670,Germany,178827.30,1,1,0
9395,2011,10,MORTGAGE,3,Low,1,3000, 36 months,1,vacation,11,High,2,Good Loan,0,17.49,D,4,10.37,3604.77,2999.99,0,107.7,409000009394,30-Aug-18,Indiaforensic NFS SETT 29-08-201,100,,-544345664.22,Upchurch,597,Germany,192852.67,1,1,0
9396,2011,10,RENT,1,Low,1,7600, 60 months,2,debt_consolidation,6,High,2,Good Loan,0,21.36,F,6,5.58,10762.8,6064.18,0,207.15,409000009395,30-Aug-18,Indiaforensic NFS SETT 29-08-201,"1,000.00",,-544346664.22,Ugorji,627,Germany,177238.35,1,1,0
9397,2011,5,RENT,1,Low,1,18000, 36 months,1,credit_card,1,Low,1,Good Loan,0,8.49,A,1,12.67,20450.38844,18000,0,568.14,409000009396,30-Aug-18,Indiaforensic NFS SETT 29-08-201,500,,-544347164.22,Palerma,700,Spain,199753.97,1,1,0
9398,2011,2,RENT,1,Low,1,4000, 60 months,2,debt_consolidation,6,High,2,Good Loan,0,15.99,D,4,4.37,5713.072009,4000,0,97.26,409000009397,30-Aug-18,Indiaforensic NFS SETT 29-08-201,500,,-544347664.22,Coles,766,France,66193.61,1,1,0
9399,2011,3,MORTGAGE,3,Low,1,10000, 60 months,2,other,4,High,2,Good Loan,0,19.69,E,5,21.56,13064.81,10000,0,263.22,409000009398,30-Aug-18,Indiaforensic NFS SETT 29-08-201,500,,-544348164.22,Hsueh,488,France,181270.84,1,1,0
9400,2011,3,MORTGAGE,3,Medium,2,24000, 36 months,1,home_improvement,7,Low,1,Good Loan,0,7.49,A,1,5.14,25934.48,24000,0,746.44,409000009399,30-Aug-18,Indiaforensic NFS SETT 29-08-201,300,,-544348464.22,Tu,694,France,25407.59,1,1,0
9401,2011,10,MORTGAGE,3,Low,1,3500, 36 months,1,debt_consolidation,6,Low,1,Good Loan,0,5.42,A,1,6.78,3799.064702,3500,0,105.56,409000009400,30-Aug-18,Indiaforensic NFS SETT 29-08-201,300,,-544348764.22,Kuo,639,France,20973.80,1,1,0
9402,2011,6,MORTGAGE,3,Low,1,24250, 60 months,2,debt_consolidation,6,High,2,Good Loan,0,17.49,D,4,17.02,35819.2119,24250,0,609.09,409000009401,30-Aug-18,Indiaforensic NFS SETT 29-08-201,"10,000.00",,-544358764.22,Woodhouse,705,Germany,76544.90,1,1,0
9403,2011,2,RENT,1,Low,1,7800, 36 months,1,credit_card,1,Low,1,Good Loan,0,9.99,B,2,21.95,8221.12,7800,0,251.65,409000009402,30-Aug-18,Indiaforensic NFS SETT 29-08-201,"3,000.00",,-544361764.22,Tretiakova,810,Germany,110509.90,1,1,0
9404,2011,1,MORTGAGE,3,Low,1,21000, 60 months,2,home_improvement,7,Low,1,Good Loan,0,12.99,C,3,12.31,20560.36,18350,0,417.43,409000009403,30-Aug-18,Indiaforensic NFS SETT 29-08-201,"8,000.00",,-544369764.22,Gibson,638,France,164247.51,1,1,0
9405,2011,10,MORTGAGE,3,High,3,21600, 36 months,1,debt_consolidation,6,Low,1,Good Loan,0,12.99,C,3,6.12,26237.94495,21600,0,727.69,409000009404,30-Aug-18,Indiaforensic NFS SETT 29-08-201,500,,-544370264.22,Moss,595,Spain,105149.80,1,1,0
9406,2011,8,MORTGAGE,3,Medium,2,35000, 60 months,2,debt_consolidation,6,High,2,Good Loan,0,20.25,F,6,15.89,44657.8,35000,0,932.17,409000009405,30-Aug-18,Indiaforensic NFS SETT 29-08-201,200,,-544370464.22,Chineze,575,France,55868.97,1,1,0
9407,2011,3,MORTGAGE,3,Low,1,10000, 36 months,1,debt_consolidation,6,High,2,Good Loan,0,15.23,C,3,23.78,12108.25,10000,0,347.79,409000009406,30-Aug-18,Indiaforensic NFS SETT 29-08-201,"5,000.00",,-544375464.22,Davidson,850,France,178747.43,1,1,0
9408,2011,3,MORTGAGE,3,Medium,2,21000, 60 months,2,debt_consolidation,6,Low,1,Good Loan,0,11.49,B,2,8.44,19402.18,14116.31,0,374.89,409000009407,30-Aug-18,Indiaforensic NFS SETT 29-08-201,400,,-544375864.22,Liang,419,Spain,134720.51,1,1,0
9409,2011,8,RENT,1,Low,1,6000, 36 months,1,moving,10,High,2,Bad Loan,1,17.49,D,4,1.58,6077.51,4176.8,284.42,215.39,409000009408,30-Aug-18,Indiaforensic NFS SETT 29-08-201,"1,000.00",,-544376864.22,Graham,640,France,978.66,1,1,0
9410,2011,10,RENT,1,Low,1,5000, 36 months,1,vacation,11,Low,1,Good Loan,0,10.59,B,2,10.84,5855.50172,5000,0,162.73,409000009409,31-Aug-18,Indiaforensic  RUPAY SETT 310818,208.84,,-544377073.06,Nwebube,570,Spain,183387.12,1,1,0
9411,2011,9,RENT,1,Low,1,3600, 36 months,1,debt_consolidation,6,High,2,Good Loan,0,14.79,C,3,15.19,4476.677883,3600,0,124.43,409000009410,31-Aug-18,Indiaforensic RUPAY STL INTC3108,,2.24,-544377070.82,Sozonov,640,Germany,155876.06,1,1,0
9412,2011,10,MORTGAGE,3,Low,1,15000, 60 months,2,debt_consolidation,6,High,2,Good Loan,0,15.99,D,4,18.01,21648.77004,15000,0,364.7,409000009411,31-Aug-18,Indiaforensic RUPAY STL INTC3108,2.24,,-544377073.06,Forbes,689,Germany,119259.34,1,1,0
9413,2011,3,MORTGAGE,3,Low,1,5000, 36 months,1,debt_consolidation,6,High,2,Good Loan,0,15.99,D,4,14.51,6199.66,5000,0,175.77,409000009412,31-Aug-18,Indiaforensic  RUPAY SETT 310818,500.71,,-544377573.77,Chikezie,725,France,133720.57,1,1,0
9414,2011,8,OWN,2,Low,1,18800, 60 months,2,home_improvement,7,High,2,Bad Loan,1,19.69,E,5,12.98,16403.62,6861.18,1672.92,494.85,409000009413,31-Aug-18,Indiaforensic RUPAY STL INTC3108,,8.00,-544377565.77,Onwuemelie,751,France,170634.49,1,1,0
9415,2011,4,MORTGAGE,3,Low,1,19600, 60 months,2,small_business,3,Low,1,Good Loan,0,10.59,B,2,20.73,15889.38,11839.92,0,306.39,409000009414,31-Aug-18,Indiaforensic RUPAY STL INTC3108,8,,-544377573.77,Toth,544,Spain,125692.07,1,1,0
9416,2011,0.5,RENT,1,Low,1,10000, 36 months,1,debt_consolidation,6,Low,1,Good Loan,0,11.49,B,2,9.9,11845.82361,10000,0,329.72,409000009415,31-Aug-18,Indiaforensic NFS SETT 30-08-201,"1,000.00",,-544378573.77,Hunt,768,Germany,19150.14,1,1,0
9417,2011,7,MORTGAGE,3,High,3,28000, 36 months,1,home_improvement,7,Low,1,Good Loan,0,10.59,B,2,12.6,32799.63823,28000,0,911.26,409000009416,31-Aug-18,Indiaforensic NFS SETT 30-08-201,"5,000.00",,-544383573.77,Mazure,648,Germany,86894.67,1,1,0
9418,2011,9,MORTGAGE,3,Medium,2,16000, 36 months,1,credit_card,1,Low,1,Good Loan,0,6.99,A,1,3.49,17571.20774,16000,0,493.97,409000009417,31-Aug-18,Indiaforensic NFS SETT 30-08-201,"5,000.00",,-544388573.77,Hughes,577,Spain,57975.80,1,1,0
9419,2011,3,MORTGAGE,3,Low,1,10800, 36 months,1,debt_consolidation,6,Low,1,Good Loan,0,11.99,B,2,16.86,12839.58625,10800,0,358.67,409000009418,31-Aug-18,Indiaforensic NFS SETT 30-08-201,"10,000.00",,-544398573.77,Bennett,639,Spain,82938.99,1,1,0
9420,2011,7,MORTGAGE,3,Low,1,35000, 60 months,2,debt_consolidation,6,High,2,Good Loan,0,13.49,C,3,22.09,43050.32,35000,0,805.17,409000009419,31-Aug-18,Indiaforensic NFS SETT 30-08-201,"1,500.00",,-544400073.77,Tien,686,Germany,79189.40,1,1,0
9421,2011,7,MORTGAGE,3,Medium,2,12000, 36 months,1,credit_card,1,Low,1,Good Loan,0,8.49,A,1,9.75,12935.02,12000,0,378.76,409000009420,31-Aug-18,Indiaforensic NFS SETT 30-08-201,"1,500.00",,-544401573.77,Kay,657,France,5177.62,1,1,0
9422,2011,3,MORTGAGE,3,Low,1,15000, 36 months,1,debt_consolidation,6,Low,1,Good Loan,0,8.49,A,1,6.6,17042.18503,15000,0,473.45,409000009421,31-Aug-18,Indiaforensic NFS SETT 30-08-201,500,,-544402073.77,Bryan,613,France,44510.26,1,1,0
9423,2011,8,RENT,1,Low,1,22000, 60 months,2,debt_consolidation,6,High,2,Bad Loan,1,18.39,E,5,15.53,20841.18,11148.85,0,563.34,409000009422,31-Aug-18,Indiaforensic NFS SETT 30-08-201,500,,-544402573.77,Ingamells,701,France,190611.92,1,1,0
9424,2011,2,RENT,1,Low,1,4200, 36 months,1,debt_consolidation,6,Low,1,Bad Loan,1,10.99,B,2,16.2,3514.8,2629.94,233.28,137.49,409000009423,31-Aug-18,Indiaforensic NFS SETT 30-08-201,"8,700.00",,-544411273.77,Milne,578,Spain,177834.79,1,1,0
9425,2011,2,RENT,1,Low,1,7200, 36 months,1,debt_consolidation,6,Low,1,Good Loan,0,8.49,A,1,6.72,8177.650032,7200,0,227.26,409000009424,1-Sep-18,Indiaforensic  RUPAY SETT 010918,441.32,,-544411715.09,Lombardo,689,France,119446.64,1,1,0
9426,2011,0.5,RENT,1,Low,1,1325, 36 months,1,moving,10,High,2,Bad Loan,1,13.49,C,3,3.8,1476.64,1145.61,28.5,44.96,409000009425,1-Sep-18,Indiaforensic  RUPAY SETT 010918,,6.84,-544411708.25,Owens,687,Spain,50267.69,1,1,0
9427,2011,9,MORTGAGE,3,Low,1,8500, 36 months,1,other,4,Low,1,Good Loan,0,10.99,B,2,23.42,9602.48,8500,0,278.24,409000009426,1-Sep-18,Indiaforensic RUPAY STL INTC0109,6.84,,-544411715.09,Charlton,499,Spain,144849.10,1,1,0
9428,2011,2,MORTGAGE,3,Low,1,15000, 60 months,2,debt_consolidation,6,Low,1,Good Loan,0,11.49,B,2,20.68,19554.15556,15000,0,329.82,409000009427,1-Sep-18,Indiaforensic NFS SETT 31-08-201,400,,-544412115.09,Overby,693,Spain,81901.60,1,1,0
9429,2011,10,MORTGAGE,3,Low,1,20000, 60 months,2,debt_consolidation,6,High,2,Good Loan,0,18.39,E,5,12.66,24748.84,20000,0,512.13,409000009428,1-Sep-18,Indiaforensic NFS SETT 31-08-201,"8,000.00",,-544420115.09,Chifley,737,France,42576.86,1,1,0
9430,2011,2,RENT,1,Low,1,8700, 60 months,2,car,2,Low,1,Good Loan,0,12.99,C,3,3.83,10259.82,7171.97,0,197.91,409000009429,1-Sep-18,Indiaforensic NFS SETT 31-08-201,200,,-544420315.09,Oliver,651,France,87609.50,1,1,0
9431,2011,5,RENT,1,Low,1,7000, 36 months,1,medical,9,High,2,Good Loan,0,15.62,D,4,21.64,7885.91,7000,0,244.79,409000009430,1-Sep-18,Indiaforensic NFS SETT 31-08-201,"1,000.00",,-544421315.09,Hill,753,France,82820.85,1,1,0
9432,2011,2,RENT,1,Low,1,6000, 36 months,1,medical,9,Low,1,Bad Loan,1,10.59,B,2,4.07,2956.58,2103.12,232.88,195.27,409000009431,1-Sep-18,Indiaforensic NFS SETT 31-08-201,800,,-544422115.09,DeRose,523,Spain,155144.12,1,1,0
9433,2011,7,RENT,1,Low,1,4000, 36 months,1,other,4,Low,1,Good Loan,0,10.59,B,2,22.81,4366.21,4000,0,130.18,409000009432,1-Sep-18,Indiaforensic NFS SETT 31-08-201,500,,-544422615.09,Chuang,458,Germany,9578.24,1,1,0
9434,2011,0.5,RENT,1,Low,1,9600, 36 months,1,debt_consolidation,6,High,2,Good Loan,0,15.99,D,4,11.07,12132.38523,9600,0,337.47,409000009433,1-Sep-18,Indiaforensic NFS SETT 31-08-201,"2,000.00",,-544424615.09,Edwards,643,France,170392.59,1,1,0
9435,2011,2,RENT,1,Low,1,8575, 36 months,1,other,4,High,2,Good Loan,0,15.62,D,4,23.59,10787.89508,8575,0,299.87,409000009434,1-Sep-18,Indiaforensic NFS SETT 31-08-201,100,,-544424715.09,Rodriguez,638,Spain,3946.29,1,1,0
9436,2011,7,RENT,1,Low,1,7000, 36 months,1,credit_card,1,High,2,Good Loan,0,15.99,D,4,13.13,8870.3687,7000,0,246.07,409000009435,1-Sep-18,Indiaforensic  RUPAY SETT 010918,"1,148.42",,-544425863.51,Lo,685,Germany,102184.66,1,1,0
9437,2011,0.5,MORTGAGE,3,Low,1,11000, 36 months,1,debt_consolidation,6,Low,1,Good Loan,0,7.49,A,1,13.72,11659.01,11000.01,0,342.12,409000009436,1-Sep-18,Indiaforensic  RUPAY SETT 010918,,14.92,-544425848.59,Powell,684,France,75609.84,1,1,0
9438,2011,0.5,RENT,1,Low,1,8000, 36 months,1,other,4,Low,1,Good Loan,0,5.99,A,1,2.83,8760.089801,8000,0,243.34,409000009437,1-Sep-18,Indiaforensic RUPAY STL INTC0109,14.92,,-544425863.51,Chu,670,France,26170.08,1,1,0
9439,2011,10,MORTGAGE,3,Medium,2,18000, 36 months,1,debt_consolidation,6,Low,1,Good Loan,0,7.49,A,1,8.39,20080.39,18000,0,559.83,409000009438,3-Sep-18,Indiaforensic RUPAY SETT 020918,"10,992.12",,-544436855.63,Munro,701,Germany,144727.45,1,1,0
9440,2011,5,MORTGAGE,3,Low,1,12000, 60 months,2,car,2,Low,1,Good Loan,0,11.99,B,2,20.94,13857.66,9945.56,0,266.88,409000009439,3-Sep-18,Indiaforensic RUPAY SETT 020918,,174.74,-544436680.89,Onwumelu,705,France,58134.97,1,1,0
9441,2011,1,OWN,2,Low,1,10000, 36 months,1,credit_card,1,Low,1,Good Loan,0,10.99,B,2,16.84,11775.03704,10000,0,327.34,409000009440,3-Sep-18,Indiaforensic RUPAY STL INTC0209,174.74,,-544436855.63,Siciliani,593,Spain,94620.00,1,1,0
9442,2011,10,MORTGAGE,3,Low,1,6500, 36 months,1,credit_card,1,Low,1,Good Loan,0,7.49,A,1,20.2,6973.11,6500,0,202.17,409000009441,3-Sep-18,Indiaforensic RUPAY SETT 030918,"7,593.26",,-544444448.89,Yobachi,651,France,108764.69,1,1,0
9443,2011,1,MORTGAGE,3,Low,1,7000, 36 months,1,debt_consolidation,6,Low,1,Good Loan,0,6.99,A,1,13.87,7439.12,7000,0,216.11,409000009442,3-Sep-18,Indiaforensic RUPAY SETT 030918,,56.51,-544444392.38,Akabueze,741,France,149503.54,1,1,0
9444,2011,0.5,RENT,1,Low,1,4000, 60 months,2,other,4,High,2,Bad Loan,1,16.89,D,4,4.02,3258.54,173.52,2865.58,99.18,409000009443,3-Sep-18,Indiaforensic RUPAY STL INTC0309,54.17,,-544444446.55,Chiemenam,596,Germany,120314.75,1,1,0
9445,2011,4,RENT,1,Low,1,3500, 36 months,1,major_purchase,8,Low,1,Good Loan,0,12.99,C,3,6.66,4224.5897,3500,0,117.92,409000009444,3-Sep-18,Indiaforensic RUPAY STL INTC0309,,0.01,-544444446.54,Odinakachukwu,581,Germany,44205.95,1,1,0
9446,2011,10,RENT,1,Low,1,12000, 36 months,1,debt_consolidation,6,Low,1,Good Loan,0,8.49,A,1,8.36,13627.43265,12000,0,378.76,409000009445,3-Sep-18,Indiaforensic  RUPAY SETT 030918,"8,000.71",,-544452447.25,Reilly,689,Spain,6129.61,1,1,0
9447,2011,10,MORTGAGE,3,Low,1,13000, 60 months,2,debt_consolidation,6,High,2,Good Loan,0,13.99,C,3,14.06,16593.64,13000,0,302.42,409000009446,3-Sep-18,Indiaforensic  RUPAY SETT 030918,,88.00,-544452359.25,Forbes,544,France,126796.69,1,1,0
9448,2011,8,RENT,1,Low,1,18000, 36 months,1,debt_consolidation,6,Low,1,Good Loan,0,10.59,B,2,7.15,20068.54,18000,0,585.81,409000009447,3-Sep-18,Indiaforensic RUPAY STL INTC0309,88,,-544452447.25,Amadi,718,France,27509.52,1,1,0
9449,2011,5,RENT,1,Low,1,1900, 36 months,1,other,4,High,2,Good Loan,0,13.49,C,3,4.01,2318.998991,1900,0,64.47,409000009448,3-Sep-18,Indiaforensic NFS SETT 01-09-201,200,,-544452647.25,Ferri,583,Germany,42143.55,1,1,0
9450,2011,1,RENT,1,Low,1,5500, 36 months,1,credit_card,1,Low,1,Good Loan,0,5.42,A,1,12.63,5969.912098,5500,0,165.88,409000009449,3-Sep-18,Indiaforensic NFS SETT 01-09-201,"1,000.00",,-544453647.25,Y?an,663,Germany,87985.20,1,1,0
9451,2011,5,OWN,2,Low,1,10000, 60 months,2,small_business,3,High,2,Good Loan,0,20.25,F,6,5.14,14914.10508,10000,0,266.34,409000009450,3-Sep-18,Indiaforensic NFS SETT 01-09-201,500,,-544454147.25,Williamson,666,Germany,81884.80,1,1,0
9452,2011,10,RENT,1,Low,1,8000, 36 months,1,credit_card,1,Low,1,Good Loan,0,6.99,A,1,15.67,8890.516227,8000,0,246.99,409000009451,3-Sep-18,Indiaforensic NFS SETT 02-09-201,200,,-544454347.25,Briggs,524,Spain,2705.31,1,1,0
9453,2011,3,MORTGAGE,3,Low,1,6000, 36 months,1,debt_consolidation,6,High,2,Good Loan,0,13.49,C,3,0.31,7317.185278,6000,0,203.59,409000009452,3-Sep-18,Indiaforensic NFS SETT 02-09-201,"2,000.00",,-544456347.25,Napolitani,599,France,30546.40,1,1,0
9454,2011,4,RENT,1,Low,1,13800, 36 months,1,debt_consolidation,6,High,2,Good Loan,0,13.99,C,3,11.34,16963.13546,13800,0,471.59,409000009453,3-Sep-18,Indiaforensic NFS SETT 02-09-201,500,,-544456847.25,Carpenter,667,France,149402.59,1,1,0
9455,2011,10,RENT,1,Low,1,7400, 60 months,2,other,4,High,2,Good Loan,0,19.29,E,5,1.38,8741.48,7400,0,193.15,409000009454,3-Sep-18,Indiaforensic NFS SETT 02-09-201,"1,000.00",,-544457847.25,Lin,727,France,118429.02,1,1,0
9456,2011,10,MORTGAGE,3,Low,1,1400, 36 months,1,major_purchase,8,Low,1,Good Loan,0,5.42,A,1,12.07,1477.38,1400,0,42.23,409000009455,3-Sep-18,Indiaforensic NFS SETT 02-09-201,400,,-544458247.25,Robinson,689,Spain,58442.25,1,1,0
9457,2011,6.05,RENT,1,Low,1,6000, 36 months,1,other,4,Low,1,Good Loan,0,11.49,B,2,10.33,7117.831779,6000,0,197.83,409000009456,3-Sep-18,Indiaforensic NFS SETT 02-09-201,"1,000.00",,-544459247.25,Collins,639,France,30414.17,1,1,0
9458,2011,2,OWN,2,Low,1,12000, 36 months,1,other,4,Low,1,Good Loan,0,9.99,B,2,20.59,13922.7102,12000,0,387.15,409000009457,3-Sep-18,Indiaforensic NFS SETT 02-09-201,"1,000.00",,-544460247.25,Kingsley,678,France,58814.41,1,1,0
9459,2011,0.5,RENT,1,Low,1,6000, 36 months,1,other,4,Low,1,Good Loan,0,6.99,A,1,20.75,6471.87,6000,0,185.24,409000009458,3-Sep-18,Indiaforensic NFS SETT 02-09-201,300,,-544460547.25,Harvey,523,France,155304.53,1,1,0
9460,2011,10,OWN,2,Low,1,30000, 60 months,2,debt_consolidation,6,Low,1,Good Loan,0,11.99,B,2,11.15,38036.94611,30000,0,667.19,409000009459,3-Sep-18,Indiaforensic NFS SETT 02-09-201,200,,-544460747.25,Obiora,650,France,187943.60,1,1,0
9461,2011,3,RENT,1,Low,1,8000, 60 months,2,debt_consolidation,6,High,2,Good Loan,0,14.79,C,3,10.87,9271.24,8000,0,189.44,409000009460,4-Sep-18,Indiaforensic  RUPAY SETT 040918,783.13,,-544461530.38,Knight,744,Spain,43036.60,1,1,0
9462,2011,6,RENT,1,Low,1,15000, 36 months,1,debt_consolidation,6,Low,1,Good Loan,0,8.49,A,1,25,16448.67,14999.99,0,473.45,409000009461,4-Sep-18,Indiaforensic  RUPAY SETT 040918,,11.52,-544461518.86,Hung,697,France,26543.28,1,1,0
9463,2011,4,MORTGAGE,3,Low,1,6000, 36 months,1,debt_consolidation,6,Low,1,Good Loan,0,10.99,B,2,18.69,7065.97493,6000,0,196.41,409000009462,4-Sep-18,Indiaforensic RUPAY STL INTC0409,9,,-544461527.86,Curtis,800,Spain,171928.04,1,1,0
9464,2011,10,OWN,2,Low,1,9175, 36 months,1,credit_card,1,Low,1,Good Loan,0,10.99,B,2,17.9,10804.94531,9175,0,300.34,409000009463,4-Sep-18,Indiaforensic RUPAY STL INTC0409,,0.01,-544461527.85,Perez,664,France,35611.35,1,1,0
9465,2011,5,MORTGAGE,3,Low,1,6000, 36 months,1,credit_card,1,Low,1,Good Loan,0,10.99,B,2,21.06,6568.27,6000,0,196.41,409000009464,4-Sep-18,Indiaforensic  RUPAY SETT 040918,"9,391.73",,-544470919.58,Gosnell,740,France,19047.23,1,1,0
9466,2011,7,RENT,1,Low,1,12000, 60 months,2,debt_consolidation,6,High,2,Good Loan,0,19.69,E,5,11.49,16431.74,9620.31,0,315.87,409000009465,4-Sep-18,Indiaforensic  RUPAY SETT 040918,,68.56,-544470851.02,Fang,835,France,39820.13,1,1,0
9467,2011,1,MORTGAGE,3,Low,1,15000, 36 months,1,small_business,3,Low,1,Good Loan,0,9.99,B,2,11.24,17417.52596,15000,0,483.94,409000009466,4-Sep-18,Indiaforensic RUPAY STL INTC0409,68.56,,-544470919.58,Clarke,559,France,129013.59,1,1,0
9468,2011,1,RENT,1,Medium,2,12000, 36 months,1,debt_consolidation,6,Low,1,Good Loan,0,7.49,A,1,11.93,13434.89624,12000,0,373.22,409000009467,4-Sep-18,Indiaforensic NFS SETT 03-09-201,"1,000.00",,-544471919.58,Milanesi,676,Spain,113810.12,1,1,0
9469,2011,10,MORTGAGE,3,Low,1,8025, 36 months,1,debt_consolidation,6,High,2,Bad Loan,1,13.49,C,3,20.44,7351.94,5694.17,0,272.3,409000009468,4-Sep-18,Indiaforensic NFS SETT 03-09-201,500,,-544472419.58,Chia,613,Germany,34749.65,1,1,0
9470,2011,10,MORTGAGE,3,Low,1,10000, 36 months,1,home_improvement,7,Low,1,Good Loan,0,7.49,A,1,6.14,11193.78067,10000,0,311.02,409000009469,5-Sep-18,Indiaforensic  RUPAY SETT 050918,646.3,,-544473065.88,Gearhart,713,France,56268.98,1,1,0
9471,2011,3,MORTGAGE,3,Low,1,6000, 36 months,1,other,4,Low,1,Good Loan,0,8.49,A,1,10.27,6559.33,6000,0,189.38,409000009470,5-Sep-18,Indiaforensic  RUPAY SETT 050918,,6.76,-544473059.12,McLean,751,Germany,46630.47,1,1,0
9472,2011,10,MORTGAGE,3,Low,1,35000, 60 months,2,debt_consolidation,6,High,2,Good Loan,0,16.89,D,4,7.37,45011.46,28418.01,0,867.78,409000009471,5-Sep-18,Indiaforensic RUPAY STL INTC0509,6.01,,-544473065.13,Williamson,523,France,124906.59,1,1,0
9473,2011,3,RENT,1,Low,1,3000, 36 months,1,credit_card,1,Low,1,Good Loan,0,11.99,B,2,22.17,3586.449254,3000,0,99.63,409000009472,5-Sep-18,Indiaforensic  RUPAY SETT 050918,0.48,,-544473065.61,Murphy,775,Germany,134869.93,1,1,0
9474,2011,8,RENT,1,Low,1,10000, 60 months,2,debt_consolidation,6,High,2,Good Loan,0,16.49,D,4,13.07,12751.9,8134.44,0,245.8,409000009473,5-Sep-18,Indiaforensic  RUPAY SETT 050918,,64.12,-544473001.49,Angelo,608,Spain,36697.48,1,1,0
9475,2011,4,RENT,1,Low,1,6350, 60 months,2,small_business,3,Low,1,Good Loan,0,12.99,C,3,24.12,7480.8,5229.93,0,144.45,409000009474,5-Sep-18,Indiaforensic RUPAY STL INTC0509,,0.48,-544473001.01,Thomson,673,France,172200.91,1,1,0
9476,2011,6.05,OWN,2,Low,1,5125, 36 months,1,renewable_energy,13,Low,1,Good Loan,0,9.99,B,2,15.25,5566.74,5125,0,165.35,409000009475,5-Sep-18,Indiaforensic NFS SETT 04-09-201,500,,-544473501.01,Murray,616,France,137136.46,1,1,0
9477,2011,0.5,RENT,1,Low,1,4750, 36 months,1,debt_consolidation,6,Low,1,Good Loan,0,8.49,A,1,17.04,5328.96,4750,0,149.93,409000009476,5-Sep-18,Indiaforensic NFS SETT 04-09-201,"1,500.00",,-544475001.01,Kirby,650,Germany,57594.78,1,1,0
9478,2011,10,RENT,1,Medium,2,7000, 60 months,2,car,2,Low,1,Good Loan,0,11.49,B,2,5.7,8111.46,6999.99,0,153.92,409000009477,5-Sep-18,Indiaforensic NFS SETT 04-09-201,"1,900.00",,-544476901.01,Lane,655,France,36548.00,1,1,0
9479,2011,5,MORTGAGE,3,Low,1,11500, 36 months,1,debt_consolidation,6,Low,1,Good Loan,0,9.99,B,2,21.55,13267.39278,11500,0,371.02,409000009478,5-Sep-18,Indiaforensic NFS SETT 04-09-201,200,,-544477101.01,Bergamaschi,782,Germany,182960.46,1,1,0
9480,2011,3,MORTGAGE,3,Low,1,12000, 36 months,1,debt_consolidation,6,Low,1,Bad Loan,1,5.99,A,1,12.73,9685.19,8464.66,0,365.01,409000009479,5-Sep-18,Indiaforensic NFS SETT 04-09-201,200,,-544477301.01,Yang,781,Spain,42117.90,1,1,0
9481,2011,4,RENT,1,Low,1,1400, 36 months,1,major_purchase,8,High,2,Good Loan,0,15.62,D,4,2.28,1761.30844,1400,0,48.96,409000009480,5-Sep-18,Indiaforensic NFS SETT 04-09-201,"1,500.00",,-544478801.01,Mills,593,France,199478.05,1,1,0
9482,2011,8,RENT,1,Low,1,7000, 36 months,1,home_improvement,7,Low,1,Good Loan,0,6.99,A,1,6.32,7779.134625,7000,0,216.11,409000009481,6-Sep-18,Indiaforensic NFS SETT 05-09-201,"6,000.00",,-544484801.01,Chidubem,505,Spain,91092.84,1,1,0
9483,2011,0.5,MORTGAGE,3,Medium,2,21000, 36 months,1,debt_consolidation,6,Low,1,Good Loan,0,11.99,B,2,21.29,23990.15,21000,0,697.41,409000009482,6-Sep-18,Indiaforensic  RUPAY SETT 060918,"5,152.53",,-544489953.54,Findlay,707,France,14090.40,1,1,0
9484,2011,10,RENT,1,Low,1,13775, 60 months,2,debt_consolidation,6,Low,1,Good Loan,0,11.99,B,2,15.74,16838.85,13775,0,306.35,409000009483,6-Sep-18,Indiaforensic RUPAY STL INTC0609,79.27,,-544490032.81,Wood,692,France,178267.07,1,1,0
9485,2011,2,MORTGAGE,3,Low,1,10000, 36 months,1,car,2,Low,1,Good Loan,0,8.49,A,1,10.76,10070.99,10000,0,315.63,409000009484,6-Sep-18,Indiaforensic  RUPAY SETT 060918,,80.77,-544489952.04,Boyle,813,Germany,85808.22,1,1,0
9486,2011,1,RENT,1,Low,1,1500, 36 months,1,debt_consolidation,6,Low,1,Good Loan,0,6.99,A,1,29.3,1666.972062,1500,0,46.31,409000009485,6-Sep-18,Indiaforensic RUPAY STL INTC0609,,0.01,-544489952.03,Toscano,850,Spain,109659.12,1,1,0
9487,2011,10,MORTGAGE,3,Low,1,30000, 60 months,2,debt_consolidation,6,High,2,Good Loan,0,13.99,C,3,17.35,39478.47101,30000,0,697.9,409000009486,6-Sep-18,TRF FRM  Indiaforensic SERVICES,,2000000.00,-542489952.03,Seccombe,753,France,161642.08,1,1,0
9488,2011,10,MORTGAGE,3,Low,1,3075, 36 months,1,debt_consolidation,6,High,2,Good Loan,0,15.23,C,3,23.06,3587.82,3075,0,106.95,409000009487,6-Sep-18,TRF FROM  Indiaforensic SERVICES,,283000.00,-542206952.03,Uspenskaya,850,Spain,3830.59,1,1,0
9489,2011,5,RENT,1,Low,1,5000, 36 months,1,debt_consolidation,6,Low,1,Good Loan,0,10.59,B,2,10.34,5854.839779,5000,0,162.73,409000009488,6-Sep-18,Indiaforensic  RUPAY SETT 060918,115.71,,-542207067.74,McKenzie,671,Spain,146636.44,1,1,0
9490,2011,5,MORTGAGE,3,Low,1,20000, 36 months,1,major_purchase,8,Low,1,Good Loan,0,10.99,B,2,10.55,22596.86,20000,0,654.68,409000009489,6-Sep-18,Indiaforensic  RUPAY SETT 060918,,0.58,-542207067.16,Liang,791,France,144413.92,1,1,0
9491,2011,10,MORTGAGE,3,Medium,2,35000, 36 months,1,home_improvement,7,High,2,Good Loan,0,13.99,C,3,14.08,42482.71,35000,0,1196.05,409000009490,6-Sep-18,Indiaforensic RUPAY STL INTC0609,0.58,,-542207067.74,Yermakova,624,France,65801.44,1,1,0
9492,2011,1,RENT,1,Low,1,5000, 36 months,1,other,4,Low,1,Good Loan,0,7.49,A,1,12.42,5343.45,5000,0,155.51,409000009491,7-Sep-18,Indiaforensic  RUPAY SETT 070918,"7,607.12",,-542214674.86,White,649,France,192486.24,1,1,0
9493,2011,10,MORTGAGE,3,Low,1,8000, 36 months,1,debt_consolidation,6,High,2,Bad Loan,1,15.62,D,4,15.87,3076.63,2055.52,9.94,279.76,409000009492,7-Sep-18,Indiaforensic  RUPAY SETT 070918,,84.16,-542214590.70,Rounsevell,732,Germany,120852.85,1,1,0
9494,2011,1,OWN,2,Low,1,4200, 36 months,1,debt_consolidation,6,Low,1,Good Loan,0,7.49,A,1,8.61,4697.781743,4200,0,130.63,409000009493,7-Sep-18,Indiaforensic RUPAY STL INTC0709,84.16,,-542214674.86,Ts'ai,664,France,146191.82,1,1,0
9495,2011,8,MORTGAGE,3,Medium,2,15000, 36 months,1,credit_card,1,Low,1,Bad Loan,1,11.49,B,2,9.69,13897.53,9828.28,1534.98,494.57,409000009494,7-Sep-18,Indiaforensic NFS SETT 06-09-201,200,,-542214874.86,Stoneman,789,Germany,148412.24,1,1,0
9496,2011,6,RENT,1,Low,1,12600, 60 months,2,debt_consolidation,6,High,2,Good Loan,0,13.49,C,3,20.33,15057.72,10385.17,0,289.86,409000009495,7-Sep-18,Indiaforensic NFS SETT 06-09-201,200,,-542215074.86,Yao,680,France,164119.35,1,1,0
9497,2011,5,MORTGAGE,3,Low,1,12000, 60 months,2,debt_consolidation,6,Low,1,Good Loan,0,8.49,A,1,15.68,13962.27,12000,0,246.15,409000009496,7-Sep-18,Indiaforensic NFS SETT 06-09-201,100,,-542215174.86,Chukwukere,701,France,163457.55,1,1,0
9498,2011,10,MORTGAGE,3,Low,1,30000, 60 months,2,debt_consolidation,6,High,2,Bad Loan,1,20.25,F,6,16.32,11185.56,4574.35,13,799,409000009497,7-Sep-18,Indiaforensic  RUPAY SETT 070918,"10,441.12",,-542225615.98,Ifeatu,684,France,144978.47,1,1,0
9499,2011,10,MORTGAGE,3,Low,1,5000, 36 months,1,other,4,Low,1,Good Loan,0,7.49,A,1,24.67,5575.003612,5000,0,155.51,409000009498,7-Sep-18,Indiaforensic  RUPAY SETT 070918,,166.13,-542225449.85,Millar,586,France,67288.89,1,1,0
9500,2011,5,RENT,1,Low,1,1200, 36 months,1,medical,9,Low,1,Good Loan,0,11.49,B,2,9.6,1403.89,1200,0,39.57,409000009499,7-Sep-18,Indiaforensic RUPAY STL INTC0709,166.13,,-542225615.98,Igwebuike,522,Germany,103269.00,1,1,0
9501,2011,0.5,RENT,1,Low,1,4400, 36 months,1,debt_consolidation,6,High,2,Good Loan,0,15.62,D,4,6.35,5552.125349,4400,0,153.87,409000009500,10-Sep-18,Indiaforensic RUPAY SETT 080918,"35,636.21",,-542261252.19,Obidimkpa,739,Spain,106969.98,1,1,0
9502,2011,0.5,MORTGAGE,3,Low,1,15000, 60 months,2,debt_consolidation,6,Low,1,Good Loan,0,11.99,B,2,22.7,17328.3,12435.92,0,333.6,409000009501,10-Sep-18,Indiaforensic RUPAY SETT 080918,,630.19,-542260622.00,Hou,835,Germany,117632.63,1,1,0
9503,2011,2,RENT,1,Low,1,7000, 36 months,1,debt_consolidation,6,Low,1,Good Loan,0,12.99,C,3,18.35,8449.21125,7000,0,235.83,409000009502,10-Sep-18,Indiaforensic RUPAY STL INTC0809,556.53,,-542261178.53,Moody,790,Spain,189777.66,1,1,0
9504,2011,3,MORTGAGE,3,Medium,2,20200, 60 months,2,home_improvement,7,High,2,Good Loan,0,18.79,E,5,4.78,29358.50666,20200,0,521.67,409000009503,10-Sep-18,Indiaforensic RUPAY STL INTC0809,,0.54,-542261177.99,Keldie,671,France,66032.65,1,1,0
9505,2011,10,RENT,1,Low,1,4000, 36 months,1,debt_consolidation,6,Low,1,Bad Loan,1,11.49,B,2,21.6,4484.26,3726.44,16.8,131.89,409000009504,10-Sep-18,Indiaforensic RUPAY SETT 090918,"15,667.91",,-542276845.90,Liu,560,France,98661.27,1,1,0
9506,2011,4,RENT,1,Low,1,19400, 36 months,1,credit_card,1,High,2,Good Loan,0,13.49,C,3,10.71,23687.37818,19400,0,658.26,409000009505,10-Sep-18,Indiaforensic RUPAY SETT 090918,,207.98,-542276637.92,Ts'ao,651,France,74687.37,1,1,0
9507,2011,10,RENT,1,Low,1,7500, 36 months,1,credit_card,1,High,2,Good Loan,0,15.62,D,4,9.81,9437.256903,7500,0,262.28,409000009506,10-Sep-18,Indiaforensic RUPAY STL INTC0909,207.98,,-542276845.90,Walker,682,France,149604.18,1,1,0
9508,2011,4,MORTGAGE,3,Low,1,11200, 36 months,1,debt_consolidation,6,Low,1,Good Loan,0,10.99,B,2,5.05,13191.07112,11200,0,366.63,409000009507,10-Sep-18,Indiaforensic RUPAY SETT 100918,"14,530.50",,-542291376.40,Defalco,808,France,79888.78,1,1,0
9509,2011,3,RENT,1,Low,1,2500, 36 months,1,debt_consolidation,6,High,2,Bad Loan,1,15.62,D,4,22.92,1397.51,936.6,89.51,87.43,409000009508,10-Sep-18,Indiaforensic RUPAY SETT 100918,,355.67,-542291020.73,Lo Duca,644,Spain,138775.69,1,1,0
9510,2011,3,RENT,1,Medium,2,24000, 36 months,1,debt_consolidation,6,Low,1,Good Loan,0,11.99,B,2,10.61,28527.2895,24000,0,797.03,409000009509,10-Sep-18,Indiaforensic RUPAY STL INTC1009,143.81,,-542291164.54,Hyde,688,France,154695.57,1,1,0
9511,2011,10,MORTGAGE,3,Low,1,8000, 60 months,2,debt_consolidation,6,High,2,Good Loan,0,18.79,E,5,5.21,8730.53,8000,0,206.61,409000009510,10-Sep-18,Indiaforensic RUPAY STL INTC1009,,3.38,-542291161.16,Kanayochukwu,617,France,168834.38,1,1,0
9512,2011,5,MORTGAGE,3,Low,1,5000, 60 months,2,car,2,Low,1,Bad Loan,1,10.99,B,2,16.24,324.69,189.62,0,108.69,409000009511,10-Sep-18,Indiaforensic  RUPAY SETT 100918,657.87,,-542291819.03,Yen,738,France,105817.63,1,1,0
9513,2011,7,MORTGAGE,3,Low,1,8575, 36 months,1,credit_card,1,High,2,Good Loan,0,13.49,C,3,21.1,9950.3,8575,0,290.96,409000009512,10-Sep-18,Indiaforensic RUPAY STL INTC1009,10.1,,-542291829.13,Ts'ui,663,France,48682.10,1,1,0
9514,2011,3,MORTGAGE,3,Medium,2,4800, 36 months,1,other,4,Low,1,Good Loan,0,7.49,A,1,3.11,5371.525712,4800,0,149.29,409000009513,10-Sep-18,Indiaforensic  RUPAY SETT 100918,,12.73,-542291816.40,Tillman,515,France,147955.91,1,1,0
9515,2011,10,MORTGAGE,3,Medium,2,35000, 36 months,1,credit_card,1,High,2,Good Loan,0,17.49,D,4,17.8,42368.34,35000,0,1256.4,409000009514,10-Sep-18,Indiaforensic RUPAY STL INTC1009,,0.01,-542291816.39,Riley,845,France,56185.98,1,1,0
9516,2011,10,RENT,1,Low,1,10625, 36 months,1,debt_consolidation,6,Low,1,Good Loan,0,6.99,A,1,29.76,11807.9713,10625,0,328.03,409000009515,10-Sep-18,Indiaforensic NFS SETT 07-09-201,"7,000.00",,-542298816.39,Tu,639,Spain,81861.10,1,1,0
9517,2011,4,RENT,1,Low,1,15000, 60 months,2,debt_consolidation,6,High,2,Good Loan,0,20.62,F,6,15.46,17225.67,15000,0,402.61,409000009516,10-Sep-18,Indiaforensic NFS SETT 07-09-201,500,,-542299316.39,Ruiz,557,France,69826.80,1,1,0
9518,2011,10,MORTGAGE,3,Low,1,6000, 36 months,1,medical,9,Low,1,Good Loan,0,10.99,B,2,21.56,6807.71,6000,0,196.41,409000009517,10-Sep-18,Indiaforensic NFS SETT 07-09-201,"5,000.00",,-542304316.39,Goliwe,543,Germany,118059.19,1,1,0
9519,2011,10,MORTGAGE,3,Medium,2,30000, 60 months,2,debt_consolidation,6,High,2,Bad Loan,1,19.69,E,5,19.9,27810.98,12354.9,2541.86,789.66,409000009518,10-Sep-18,Indiaforensic NFS SETT 07-09-201,"1,500.00",,-542305816.39,Balashov,585,Germany,112333.22,1,1,0
9520,2011,1,MORTGAGE,3,Low,1,4000, 36 months,1,debt_consolidation,6,High,2,Bad Loan,1,17.49,D,4,11.46,1536.93,906.88,107.63,143.59,409000009519,10-Sep-18,Indiaforensic NFS SETT 07-09-201,"5,000.00",,-542310816.39,Leonard,610,France,14546.76,1,1,0
9521,2011,2,MORTGAGE,3,Low,1,15000, 36 months,1,credit_card,1,High,2,Bad Loan,1,13.99,C,3,12.05,4093.84,2809.88,0,512.6,409000009520,10-Sep-18,Indiaforensic NFS SETT 07-09-201,"1,500.00",,-542312316.39,Onyekaozulu,727,Germany,126172.11,1,1,0
9522,2011,8,RENT,1,Low,1,28000, 36 months,1,debt_consolidation,6,Low,1,Good Loan,0,8.49,A,1,19.79,31410.44,28000,0,883.77,409000009521,10-Sep-18,Indiaforensic NFS SETT 07-09-201,"6,000.00",,-542318316.39,Carpenter,540,Spain,3560.00,1,1,0
9523,2011,10,MORTGAGE,3,Medium,2,6000, 36 months,1,debt_consolidation,6,Low,1,Good Loan,0,7.49,A,1,24.84,6714.529172,6000,0,186.61,409000009522,10-Sep-18,Indiaforensic NFS SETT 07-09-201,"6,500.00",,-542324816.39,Beede,418,France,88878.15,1,1,0
9524,2011,4,RENT,1,Low,1,8400, 36 months,1,credit_card,1,Low,1,Good Loan,0,6.99,A,1,9.14,9242.79,8400,0,259.33,409000009523,10-Sep-18,Indiaforensic NFS SETT 07-09-201,"7,500.00",,-542332316.39,Beneventi,660,France,84605.00,1,1,0
9525,2011,10,RENT,1,Medium,2,18400, 36 months,1,debt_consolidation,6,High,2,Good Loan,0,14.79,C,3,9.79,22885.70505,18400,0,635.96,409000009524,10-Sep-18,Indiaforensic NFS SETT 07-09-201,"2,000.00",,-542334316.39,Sadlier,850,Germany,78268.61,1,1,0
9526,2011,10,RENT,1,Low,1,2500, 36 months,1,other,4,Low,1,Bad Loan,1,11.49,B,2,7.68,329,236.83,0,82.43,409000009525,10-Sep-18,Indiaforensic NFS SETT 07-09-201,"5,000.00",,-542339316.39,Lewis,618,France,120668.46,1,1,0
9527,2011,7,MORTGAGE,3,Medium,2,28000, 36 months,1,debt_consolidation,6,High,2,Good Loan,0,17.49,D,4,16.32,35404.53,28000,0,1005.12,409000009526,10-Sep-18,Indiaforensic NFS SETT 07-09-201,"3,500.00",,-542342816.39,Chiazagomekpele,642,Germany,10063.75,1,1,0
9528,2011,6.05,RENT,1,Low,1,12725, 60 months,2,debt_consolidation,6,Low,1,Good Loan,0,10.59,B,2,13.82,14223.36,10597.75,0,274.08,409000009527,10-Sep-18,Indiaforensic NFS SETT 07-09-201,"3,500.00",,-542346316.39,Elliott,850,France,163989.66,1,1,0
9529,2011,1,RENT,1,Medium,2,10000, 36 months,1,credit_card,1,Low,1,Good Loan,0,10.99,B,2,15.12,11810.8452,10000,0,327.34,409000009528,10-Sep-18,Indiaforensic NFS SETT 07-09-201,"7,000.00",,-542353316.39,Liang,739,France,60584.33,1,1,0
9530,2011,10,RENT,1,Low,1,5000, 36 months,1,home_improvement,7,Low,1,Good Loan,0,8.49,A,1,16.52,5677.500449,5000,0,157.82,409000009529,10-Sep-18,Indiaforensic NFS SETT 07-09-201,"8,000.00",,-542361316.39,She,508,France,94170.84,1,1,0
9531,2011,1,MORTGAGE,3,Low,1,3250, 36 months,1,small_business,3,Low,1,Good Loan,0,11.49,B,2,11.88,3739.16,3250,0,107.16,409000009530,10-Sep-18,Indiaforensic NFS SETT 07-09-201,500,,-542361816.39,Bozeman,667,France,167181.77,1,1,0
9532,2011,10,RENT,1,Medium,2,3725, 36 months,1,credit_card,1,Low,1,Good Loan,0,10.59,B,2,18.57,4119.79,3725,0,121.23,409000009531,10-Sep-18,Indiaforensic NFS SETT 07-09-201,"8,000.00",,-542369816.39,Yu,741,France,38914.51,1,1,0
9533,2011,5,MORTGAGE,3,Low,1,12000, 36 months,1,other,4,Low,1,Good Loan,0,11.49,B,2,14.79,10115.53681,8525,0,281.08,409000009532,10-Sep-18,Indiaforensic NFS SETT 07-09-201,"7,500.00",,-542377316.39,Teng,592,France,91196.67,1,1,0
9534,2011,1,RENT,1,Low,1,6000, 36 months,1,small_business,3,High,2,Good Loan,0,15.99,D,4,3.84,7587.68777,6000,0,210.92,409000009533,10-Sep-18,Indiaforensic NFS SETT 07-09-201,"10,000.00",,-542387316.39,Davide,651,Germany,85869.89,1,1,0
9535,2011,10,RENT,1,Low,1,14400, 60 months,2,credit_card,1,High,2,Good Loan,0,13.49,C,3,23.14,17816.56,14399.99,0,331.27,409000009534,10-Sep-18,Indiaforensic NFS SETT 07-09-201,500,,-542387816.39,Beneventi,773,Spain,57337.79,1,1,0
9536,2011,5,MORTGAGE,3,Low,1,16000, 60 months,2,debt_consolidation,6,Low,1,Good Loan,0,11.49,B,2,14.83,18238.62,13267.56,0,351.81,409000009535,10-Sep-18,Indiaforensic NFS SETT 07-09-201,"2,500.00",,-542390316.39,Yobachukwu,850,Spain,175347.28,1,1,0
9537,2011,10,MORTGAGE,3,Low,1,8500, 60 months,2,debt_consolidation,6,Low,1,Good Loan,0,10.99,B,2,11.87,10853.467,8500,0,184.77,409000009536,10-Sep-18,Indiaforensic NFS SETT 07-09-201,"7,200.00",,-542397516.39,Douglas,550,Germany,63092.65,1,1,0
9538,2011,4,RENT,1,Low,1,2800, 36 months,1,other,4,Low,1,Good Loan,0,10.99,B,2,3,3046.08,2800,0,91.66,409000009537,10-Sep-18,Indiaforensic NFS SETT 07-09-201,"9,000.00",,-542406516.39,Egobudike,783,France,109742.55,1,1,0
9539,2011,7,RENT,1,Medium,2,11200, 36 months,1,car,2,High,2,Bad Loan,1,13.99,C,3,13.5,8036.64,5948.79,15.48,382.74,409000009538,10-Sep-18,Indiaforensic NFS SETT 07-09-201,"8,500.00",,-542415016.39,Shelby,777,France,124489.88,1,1,0
9540,2011,10,RENT,1,Low,1,12000, 60 months,2,debt_consolidation,6,Low,1,Good Loan,0,12.99,C,3,3.07,13782.74,12000,0,272.98,409000009539,10-Sep-18,Indiaforensic NFS SETT 07-09-201,"8,300.00",,-542423316.39,Golubov,659,France,56971.41,1,1,0
9541,2011,10,MORTGAGE,3,Low,1,4000, 36 months,1,home_improvement,7,Low,1,Good Loan,0,6.99,A,1,3.29,4113.06,4000,0,123.5,409000009540,10-Sep-18,Indiaforensic NFS SETT 07-09-201,"9,000.00",,-542432316.39,Williamson,727,Germany,130752.01,1,1,0
9542,2011,1,RENT,1,Low,1,10000, 60 months,2,other,4,Low,1,Good Loan,0,10.99,B,2,4.55,12296.55471,10000,0,217.38,409000009541,10-Sep-18,Indiaforensic NFS SETT 07-09-201,"9,000.00",,-542441316.39,Fan,603,France,191457.06,1,1,0
9543,2011,7,RENT,1,Low,1,2000, 36 months,1,credit_card,1,Low,1,Good Loan,0,5.42,A,1,11.73,2169.335364,2000,0,60.32,409000009542,10-Sep-18,Indiaforensic NFS SETT 07-09-201,"8,000.00",,-542449316.39,Nwebube,644,Spain,96442.86,1,1,0
9544,2011,10,RENT,1,Medium,2,25000, 60 months,2,small_business,3,High,2,Good Loan,0,15.99,D,4,7.29,18783.36,15875,0,385.97,409000009543,10-Sep-18,Indiaforensic NFS SETT 07-09-201,"7,000.00",,-542456316.39,Bellucci,647,France,122584.29,1,1,0
9545,2011,10,MORTGAGE,3,Low,1,10000, 36 months,1,debt_consolidation,6,Low,1,Good Loan,0,10.59,B,2,22.53,11627.00629,10000,0,325.45,409000009544,10-Sep-18,Indiaforensic NFS SETT 07-09-201,"9,000.00",,-542465316.39,Udinese,648,Germany,57215.85,1,1,0
9546,2011,6,MORTGAGE,3,Low,1,14000, 60 months,2,home_improvement,7,High,2,Good Loan,0,13.49,C,3,28.13,14915.6,14000,0,322.07,409000009545,10-Sep-18,Indiaforensic NFS SETT 07-09-201,500,,-542465816.39,Marian,721,Spain,195940.96,1,1,0
9547,2011,9,RENT,1,Medium,2,21000, 60 months,2,debt_consolidation,6,High,2,Bad Loan,1,19.29,E,5,14,21299.99,10143.64,1595.63,548.11,409000009546,10-Sep-18,Indiaforensic NFS SETT 07-09-201,500,,-542466316.39,Chizoba,524,France,105448.74,1,1,0
9548,2011,9,RENT,1,Low,1,20375, 60 months,2,debt_consolidation,6,High,2,Good Loan,0,18.39,E,5,16.16,20689.3,20375,0,521.73,409000009547,10-Sep-18,Indiaforensic NFS SETT 07-09-201,"8,000.00",,-542474316.39,McFarland,626,France,37870.29,1,1,0
9549,2011,7,RENT,1,Low,1,25000, 60 months,2,debt_consolidation,6,High,2,Good Loan,0,18.39,E,5,21.67,33286.52,20214.4,0,640.16,409000009548,10-Sep-18,Indiaforensic NFS SETT 07-09-201,"8,000.00",,-542482316.39,McDonald,569,France,52534.81,1,1,0
9550,2011,0.5,MORTGAGE,3,Low,1,6000, 36 months,1,home_improvement,7,Low,1,Good Loan,0,12.99,C,3,19.11,7215.06,6000,0,202.14,409000009549,10-Sep-18,Indiaforensic NFS SETT 07-09-201,"7,000.00",,-542489316.39,Chiemezie,578,Spain,141533.19,1,1,0
9551,2011,2,RENT,1,Low,1,8000, 36 months,1,debt_consolidation,6,Low,1,Good Loan,0,10.59,B,2,3.58,9230.69,8000,0,260.36,409000009550,10-Sep-18,Indiaforensic NFS SETT 07-09-201,"10,000.00",,-542499316.39,Fane,769,France,50568.02,1,1,0
9552,2011,10,MORTGAGE,3,Low,1,25000, 60 months,2,home_improvement,7,Low,1,Good Loan,0,11.99,B,2,2.7,28861.98,20714.37,0,555.99,409000009551,10-Sep-18,Indiaforensic NFS SETT 07-09-201,"3,000.00",,-542502316.39,Marchesi,694,Germany,26116.82,1,1,0
9553,2011,10,MORTGAGE,3,Low,1,9500, 36 months,1,credit_card,1,Low,1,Good Loan,0,7.49,A,1,24.46,9893.99,9499.99,0,295.47,409000009552,10-Sep-18,Indiaforensic NFS SETT 07-09-201,"8,000.00",,-542510316.39,Scott,664,France,152054.33,1,1,0
9554,2011,5,RENT,1,Low,1,6000, 36 months,1,other,4,Low,1,Good Loan,0,11.49,B,2,13.18,7113.153459,6000,0,197.83,409000009553,10-Sep-18,Indiaforensic NFS SETT 07-09-201,"6,500.00",,-542516816.39,H?,646,France,1528.40,1,1,0
9555,2011,3,RENT,1,Low,1,8400, 36 months,1,small_business,3,Low,1,Bad Loan,1,7.49,A,1,15.32,3462.17,2588.44,333.53,261.26,409000009554,10-Sep-18,Indiaforensic NFS SETT 07-09-201,400,,-542517216.39,Craig,779,France,127939.26,1,1,0
9556,2011,4,MORTGAGE,3,Low,1,12000, 60 months,2,other,4,Low,1,Good Loan,0,10.99,B,2,7.17,13018.21282,10675,0,232.05,409000009555,10-Sep-18,Indiaforensic NFS SETT 07-09-201,"6,500.00",,-542523716.39,Chikelu,782,Germany,2605.65,1,1,0
9557,2011,1,RENT,1,Low,1,5100, 60 months,2,house,12,High,2,Bad Loan,1,21.36,F,6,10.09,5892.87,2769.27,341.13,139.01,409000009556,10-Sep-18,Indiaforensic NFS SETT 07-09-201,"7,500.00",,-542531216.39,Caffyn,769,Germany,57841.89,1,1,0
9558,2011,10,MORTGAGE,3,Low,1,15000, 36 months,1,car,2,Low,1,Good Loan,0,8.49,A,1,16.84,16373.16,15000,0,473.45,409000009557,10-Sep-18,Indiaforensic NFS SETT 07-09-201,"9,000.00",,-542540216.39,Otitodilichukwu,655,Germany,186995.17,1,1,0
9559,2011,2,RENT,1,Low,1,20000, 36 months,1,debt_consolidation,6,Low,1,Good Loan,0,10.99,B,2,23.98,20903.99,20000,0,654.68,409000009558,10-Sep-18,Indiaforensic NFS SETT 07-09-201,"7,500.00",,-542547716.39,Green,623,Spain,5549.11,1,1,0
9560,2011,3,MORTGAGE,3,Medium,2,10000, 36 months,1,home_improvement,7,Low,1,Good Loan,0,5.99,A,1,0.14,10643.08,10000.01,0,304.18,409000009559,10-Sep-18,Indiaforensic NFS SETT 07-09-201,"10,000.00",,-542557716.39,Y?an,705,Spain,11682.36,1,1,0
9561,2011,5,RENT,1,Low,1,15000, 36 months,1,credit_card,1,Low,1,Good Loan,0,11.49,B,2,12.57,17796.63853,15000,0,494.57,409000009560,10-Sep-18,Indiaforensic NFS SETT 07-09-201,500,,-542558216.39,Mao,686,France,106939.34,1,1,0
9562,2011,10,OWN,2,Low,1,14000, 60 months,2,debt_consolidation,6,High,2,Bad Loan,1,20.62,F,6,8.22,11065.96,4589.9,933.13,375.77,409000009561,10-Sep-18,Indiaforensic NFS SETT 07-09-201,"1,500.00",,-542559716.39,Dahlenburg,678,Germany,53172.02,1,1,0
9563,2011,9,RENT,1,Medium,2,12500, 36 months,1,debt_consolidation,6,Low,1,Good Loan,0,11.99,B,2,15.45,10029.35711,8400,0,278.97,409000009562,10-Sep-18,Indiaforensic NFS SETT 07-09-201,"2,500.00",,-542562216.39,Shih,738,France,114388.98,1,1,0
9564,2011,3,RENT,1,Low,1,17000, 60 months,2,other,4,Low,1,Good Loan,0,11.99,B,2,16.99,19645.84,14098.23,0,378.07,409000009563,10-Sep-18,Indiaforensic NFS SETT 07-09-201,"10,000.00",,-542572216.39,Maclean,703,France,2151.17,1,1,0
9565,2011,6.05,RENT,1,Low,1,17600, 36 months,1,debt_consolidation,6,Low,1,Good Loan,0,12.99,C,3,21.85,21343.6591,17600,0,592.93,409000009564,10-Sep-18,Indiaforensic NFS SETT 07-09-201,"3,500.00",,-542575716.39,Fiorentino,554,Spain,183492.90,1,1,0
9566,2011,7,MORTGAGE,3,Low,1,30000, 60 months,2,debt_consolidation,6,High,2,Bad Loan,1,20.25,F,6,18.42,7988.31,3155.84,9.11,799,409000009565,10-Sep-18,Indiaforensic NFS SETT 07-09-201,"1,500.00",,-542577216.39,Long,582,France,76582.95,1,1,0
9567,2011,10,MORTGAGE,3,Medium,2,7000, 36 months,1,debt_consolidation,6,Low,1,Good Loan,0,10.59,B,2,11.68,8198.529378,7000,0,227.82,409000009566,10-Sep-18,Indiaforensic NFS SETT 07-09-201,500,,-542577716.39,Olson,644,France,104217.96,1,1,0
9568,2011,10,MORTGAGE,3,Medium,2,21000, 60 months,2,debt_consolidation,6,High,2,Good Loan,0,19.29,E,5,24.88,28470.52,16900.97,0,548.11,409000009567,10-Sep-18,Indiaforensic NFS SETT 07-09-201,"4,500.00",,-542582216.39,McKenzie,724,France,8982.75,1,1,0
9569,2011,2,RENT,1,Low,1,1200, 36 months,1,other,4,High,2,Bad Loan,1,19.29,E,5,8.65,96.96,24.87,52.8,44.17,409000009568,10-Sep-18,Indiaforensic NFS SETT 07-09-201,"7,000.00",,-542589216.39,Rossi,593,France,9984.40,1,1,0
9570,2011,4,RENT,1,Low,1,15000, 36 months,1,debt_consolidation,6,Low,1,Good Loan,0,9.99,B,2,16.56,17330.55,15000,0,483.94,409000009569,10-Sep-18,Indiaforensic NFS SETT 07-09-201,"8,000.00",,-542597216.39,Power,710,Spain,19500.10,1,1,0
9571,2011,10,RENT,1,Low,1,1250, 36 months,1,other,4,Low,1,Good Loan,0,11.49,B,2,22.15,1356.49,1250,0,41.22,409000009570,10-Sep-18,Indiaforensic NFS SETT 07-09-201,"9,000.00",,-542606216.39,Yen,631,France,79146.36,1,1,0
9572,2011,5,RENT,1,Low,1,19075, 36 months,1,small_business,3,Low,1,Good Loan,0,7.49,A,1,18.88,20464.01,19075,0,593.27,409000009571,10-Sep-18,Indiaforensic NFS SETT 07-09-201,"10,000.00",,-542616216.39,Norris,739,Spain,191694.77,1,1,0
9573,2011,2,RENT,1,Low,1,3200, 36 months,1,debt_consolidation,6,Low,1,Good Loan,0,10.99,B,2,23.19,3769.262496,3200,0,104.75,409000009572,10-Sep-18,Indiaforensic NFS SETT 07-09-201,"5,000.00",,-542621216.39,Collier,644,Spain,59645.24,1,1,0
9574,2011,0.5,RENT,1,Low,1,11000, 36 months,1,credit_card,1,Low,1,Good Loan,0,8.49,A,1,22.34,12488.70884,11000,0,347.2,409000009573,10-Sep-18,Indiaforensic NFS SETT 07-09-201,"8,200.00",,-542629416.39,Rivers,652,Germany,55207.88,1,1,0
9575,2011,0.5,RENT,1,Low,1,6000, 36 months,1,debt_consolidation,6,Low,1,Good Loan,0,7.49,A,1,6.96,6715.495958,6000,0,186.61,409000009574,10-Sep-18,Indiaforensic NFS SETT 07-09-201,500,,-542629916.39,Hudson,554,Spain,166177.30,1,1,0
9576,2011,10,MORTGAGE,3,High,3,30000, 60 months,2,other,4,High,2,Good Loan,0,17.99,E,5,3.39,44190.0584,30000,0,761.64,409000009575,10-Sep-18,Indiaforensic NFS SETT 07-09-201,"1,200.00",,-542631116.39,Milani,483,France,136356.97,1,1,0
9577,2011,4,RENT,1,Low,1,3800, 36 months,1,credit_card,1,Low,1,Good Loan,0,6.99,A,1,3.18,4222.611629,3800,0,117.32,409000009576,10-Sep-18,Indiaforensic NFS SETT 07-09-201,"10,000.00",,-542641116.39,Hunt,669,Germany,148611.52,1,1,0
9578,2011,10,MORTGAGE,3,Low,1,13225, 60 months,2,debt_consolidation,6,High,2,Bad Loan,1,19.69,E,5,24.33,5088.64,813.4,2991.24,348.11,409000009577,10-Sep-18,Indiaforensic NFS SETT 07-09-201,"9,500.00",,-542650616.39,Oluchukwu,841,Germany,85516.37,1,1,0
9579,2011,2,MORTGAGE,3,Low,1,5000, 36 months,1,major_purchase,8,Low,1,Good Loan,0,5.42,A,1,12.75,5393.82,5000,0,150.8,409000009578,10-Sep-18,Indiaforensic NFS SETT 07-09-201,"9,000.00",,-542659616.39,Lorenzo,662,France,55120.79,1,1,0
9580,2011,0.5,RENT,1,Low,1,8000, 36 months,1,small_business,3,High,2,Good Loan,0,16.89,D,4,7.03,9992.56,7999.99,0,284.79,409000009579,10-Sep-18,Indiaforensic NFS SETT 07-09-201,"8,200.00",,-542667816.39,Chidiegwu,821,Germany,131778.58,1,1,0
9581,2011,5,MORTGAGE,3,Low,1,16800, 60 months,2,debt_consolidation,6,High,2,Bad Loan,1,16.89,D,4,10.85,2914.21,1307,16.28,416.54,409000009580,10-Sep-18,Indiaforensic NFS SETT 07-09-201,"9,500.00",,-542677316.39,Warren,783,France,153269.98,1,1,0
9582,2011,0.5,RENT,1,Low,1,4850, 36 months,1,debt_consolidation,6,Low,1,Good Loan,0,8.49,A,1,5.67,5489.945173,4850,0,153.09,409000009581,10-Sep-18,Indiaforensic NFS SETT 07-09-201,"10,000.00",,-542687316.39,Glover,850,France,164864.67,1,1,0
9583,2011,10,RENT,1,Low,1,7000, 60 months,2,other,4,High,2,Good Loan,0,17.49,D,4,2.06,10446.04001,7000,0,175.82,409000009582,10-Sep-18,Indiaforensic NFS SETT 07-09-201,"3,600.00",,-542690916.39,Andersen,559,France,20367.68,1,1,0
9584,2011,3,MORTGAGE,3,Low,1,22000, 60 months,2,house,12,High,2,Bad Loan,1,13.49,C,3,7.97,8096.74,4501.68,11.78,506.11,409000009583,10-Sep-18,Indiaforensic NFS SETT 07-09-201,200,,-542691116.39,Arcuri,602,Spain,39542.00,1,1,0
9585,2011,3,RENT,1,Low,1,8000, 36 months,1,debt_consolidation,6,Low,1,Good Loan,0,11.49,B,2,19.68,8560.56,8000,0,263.78,409000009584,10-Sep-18,Indiaforensic NFS SETT 07-09-201,"4,400.00",,-542695516.39,Mackinlay,563,Germany,19412.80,1,1,0
9586,2011,3,RENT,1,Low,1,25000, 60 months,2,debt_consolidation,6,High,2,Good Loan,0,21.36,F,6,17.13,35881.68,25000.01,0,681.41,409000009585,10-Sep-18,Indiaforensic NFS SETT 07-09-201,"8,700.00",,-542704216.39,McCarthy,695,Spain,127977.66,1,1,0
9587,2011,3,RENT,1,Low,1,20000, 60 months,2,other,4,High,2,Bad Loan,1,13.99,C,3,12.9,6970.8,3776.07,0,465.27,409000009586,10-Sep-18,Indiaforensic NFS SETT 07-09-201,"10,000.00",,-542714216.39,Chiu,546,France,20508.85,1,1,0
9588,2011,4,MORTGAGE,3,Low,1,35000, 36 months,1,small_business,3,High,2,Good Loan,0,13.99,C,3,19.09,42792.5,35000,0,1196.05,409000009587,10-Sep-18,Indiaforensic NFS SETT 07-09-201,"5,000.00",,-542719216.39,Norriss,719,Germany,176244.87,1,1,0
9589,2011,2,RENT,1,Low,1,25000, 60 months,2,debt_consolidation,6,High,2,Good Loan,0,13.49,C,3,21.16,32895.16199,25000,0,575.12,409000009588,10-Sep-18,Indiaforensic NFS SETT 07-09-201,"9,500.00",,-542728716.39,Moore,539,Germany,105013.63,1,1,0
9590,2011,4,RENT,1,Low,1,5300, 36 months,1,debt_consolidation,6,High,2,Good Loan,0,15.23,C,3,4.7,6612.987431,5300,0,184.33,409000009589,10-Sep-18,Indiaforensic NFS SETT 07-09-201,"3,000.00",,-542731716.39,Mott,632,France,27597.76,1,1,0
9591,2011,10,MORTGAGE,3,Low,1,5000, 36 months,1,debt_consolidation,6,Low,1,Good Loan,0,8.49,A,1,13.31,5285.36,5000,0,157.82,409000009590,10-Sep-18,Indiaforensic NFS SETT 07-09-201,"10,000.00",,-542741716.39,Ts'ai,772,Germany,121073.23,1,1,0
9592,2011,0.5,RENT,1,Low,1,25000, 60 months,2,debt_consolidation,6,High,2,Good Loan,0,15.99,D,4,9.17,35838.73545,25000,0,607.82,409000009591,10-Sep-18,Indiaforensic NFS SETT 07-09-201,"6,500.00",,-542748216.39,Fokina,708,Spain,101089.76,1,1,0
9593,2011,6,MORTGAGE,3,Low,1,6800, 36 months,1,car,2,High,2,Good Loan,0,15.99,D,4,8.87,8046.95,6800,0,239.04,409000009592,10-Sep-18,Indiaforensic NFS SETT 07-09-201,"9,400.00",,-542757616.39,Nikitina,668,Germany,114258.18,1,1,0
9594,2011,4,RENT,1,Low,1,5100, 60 months,2,home_improvement,7,High,2,Bad Loan,1,15.99,D,4,12.26,1858.9,784.65,257.3,124,409000009593,10-Sep-18,Indiaforensic NFS SETT 07-09-201,600,,-542758216.39,Henry,738,France,22762.23,1,1,0
9595,2011,0.5,MORTGAGE,3,Medium,2,16000, 36 months,1,home_improvement,7,Low,1,Good Loan,0,6.99,A,1,5.05,17784.48426,16000,0,493.97,409000009594,10-Sep-18,Indiaforensic NFS SETT 07-09-201,"9,300.00",,-542767516.39,Chiefo,785,France,7008.65,1,1,0
9596,2011,2,RENT,1,Low,1,12000, 60 months,2,debt_consolidation,6,High,2,Good Loan,0,16.89,D,4,19.98,17691.44,11980.77,0,297.53,409000009595,10-Sep-18,Indiaforensic NFS SETT 07-09-201,"8,900.00",,-542776416.39,Mao,597,France,81299.17,1,1,0
9597,2011,10,MORTGAGE,3,Low,1,3000, 36 months,1,debt_consolidation,6,Low,1,Good Loan,0,11.99,B,2,15.96,3586.506091,3000,0,99.63,409000009596,10-Sep-18,Indiaforensic NFS SETT 07-09-201,"7,300.00",,-542783716.39,Bezrukova,531,France,147521.35,1,1,0
9598,2011,3,MORTGAGE,3,Low,1,2200, 36 months,1,credit_card,1,Low,1,Good Loan,0,8.49,A,1,19.23,2497.646863,2200,0,69.44,409000009597,10-Sep-18,Indiaforensic NFS SETT 07-09-201,"9,500.00",,-542793216.39,Dodd,509,France,6177.83,1,1,0
9599,2011,2,RENT,1,Low,1,28000, 36 months,1,debt_consolidation,6,Low,1,Good Loan,0,7.49,A,1,23.84,30257.01,28000,0,870.85,409000009598,10-Sep-18,Indiaforensic NFS SETT 07-09-201,600,,-542793816.39,Lori,508,France,59374.82,1,1,0
9600,2011,5,MORTGAGE,3,Low,1,6000, 36 months,1,debt_consolidation,6,Low,1,Good Loan,0,9.99,B,2,21.85,6964.367852,6000,0,193.58,409000009599,10-Sep-18,Indiaforensic NFS SETT 07-09-201,"8,000.00",,-542801816.39,Yudina,749,Germany,157648.12,1,1,0
9601,2011,10,MORTGAGE,3,Low,1,30000, 60 months,2,debt_consolidation,6,High,2,Bad Loan,1,18.39,E,5,10.53,23049.46,5156.57,11528.56,768.19,409000009600,10-Sep-18,Indiaforensic NFS SETT 07-09-201,500,,-542802316.39,Conti,621,Germany,75685.59,1,1,0
9602,2011,5,RENT,1,Low,1,18000, 60 months,2,debt_consolidation,6,High,2,Bad Loan,1,17.99,E,5,21.16,1178,375.72,0,456.99,409000009601,10-Sep-18,Indiaforensic NFS SETT 07-09-201,"8,200.00",,-542810516.39,Volkova,659,France,136540.09,1,1,0
9603,2011,2,OWN,2,Low,1,8400, 36 months,1,credit_card,1,Low,1,Good Loan,0,5.99,A,1,8.7,9197.969521,8400,0,255.51,409000009602,10-Sep-18,Indiaforensic NFS SETT 07-09-201,600,,-542811116.39,Boni,634,Germany,97939.40,1,1,0
9604,2011,10,MORTGAGE,3,Low,1,7500, 36 months,1,home_improvement,7,Low,1,Good Loan,0,8.49,A,1,3.81,8517.356033,7500,0,236.73,409000009603,10-Sep-18,Indiaforensic NFS SETT 07-09-201,200,,-542811316.39,Ritchie,675,France,36267.21,1,1,0
9605,2011,0.5,RENT,1,Low,1,10200, 36 months,1,credit_card,1,High,2,Good Loan,0,16.89,D,4,10.73,12997.56881,10200,0,363.1,409000009604,10-Sep-18,Indiaforensic NFS SETT 07-09-201,"8,500.00",,-542819816.39,McMillan,770,France,186064.34,1,1,0
9606,2011,10,RENT,1,Low,1,6000, 36 months,1,moving,10,Low,1,Good Loan,0,10.99,B,2,5.8,7064.711886,6000,0,196.41,409000009605,10-Sep-18,Indiaforensic NFS SETT 07-09-201,"8,500.00",,-542828316.39,Phillips,736,France,176152.70,1,1,0
9607,2011,5,RENT,1,Low,1,3000, 36 months,1,medical,9,Low,1,Good Loan,0,7.49,A,1,13.33,3310.44,3000,0,93.31,409000009606,10-Sep-18,Indiaforensic NFS SETT 07-09-201,800,,-542829116.39,Lombardi,524,France,82117.20,1,1,0
9608,2011,10,MORTGAGE,3,Medium,2,5000, 36 months,1,home_improvement,7,Low,1,Good Loan,0,5.42,A,1,10.9,5127.13,5000,0,150.8,409000009607,10-Sep-18,Indiaforensic NFS SETT 07-09-201,"8,000.00",,-542837116.39,Ireland,674,France,151925.25,1,1,0
9609,2011,3,RENT,1,Low,1,7500, 36 months,1,car,2,Low,1,Good Loan,0,11.49,B,2,7.4,8898.915241,7500,0,247.29,409000009608,10-Sep-18,Indiaforensic NFS SETT 07-09-201,"8,800.00",,-542845916.39,Boan,700,Spain,142287.65,1,1,0
9610,2011,5,MORTGAGE,3,Low,1,17000, 36 months,1,debt_consolidation,6,Low,1,Good Loan,0,7.49,A,1,9.07,19032.13981,17000,0,528.73,409000009609,10-Sep-18,Indiaforensic NFS SETT 07-09-201,"10,000.00",,-542855916.39,Shao,741,France,36557.55,1,1,0
9611,2011,0.5,RENT,1,Low,1,5000, 36 months,1,debt_consolidation,6,Low,1,Good Loan,0,9.99,B,2,12.16,5618.54,5000,0,161.32,409000009610,10-Sep-18,Indiaforensic NFS SETT 07-09-201,"1,000.00",,-542856916.39,Chiemenam,455,France,129975.34,1,1,0
9612,2011,4,MORTGAGE,3,Low,1,29900, 60 months,2,debt_consolidation,6,High,2,Good Loan,0,13.49,C,3,27.92,29255.58,20176.68,0,563.04,409000009611,10-Sep-18,Indiaforensic NFS SETT 07-09-201,500,,-542857416.39,Hunter,608,Spain,21967.15,1,1,0
9613,2011,9,RENT,1,Low,1,8000, 60 months,2,debt_consolidation,6,High,2,Bad Loan,1,15.99,D,4,6.76,1352.89,636.44,0,194.51,409000009612,10-Sep-18,Indiaforensic NFS SETT 07-09-201,"6,000.00",,-542863416.39,McKay,776,France,53477.76,1,1,0
9614,2011,10,OWN,2,Medium,2,12000, 60 months,2,medical,9,High,2,Good Loan,0,13.49,C,3,6.14,14346.88,9902,0,276.06,409000009613,10-Sep-18,Indiaforensic NFS SETT 07-09-201,500,,-542863916.39,Roberts,635,France,178067.33,1,1,0
9615,2011,2,RENT,1,Low,1,3675, 36 months,1,small_business,3,Low,1,Good Loan,0,8.49,A,1,17,4170.219577,3675,0,116,409000009614,10-Sep-18,Indiaforensic NFS SETT 07-09-201,100,,-542864016.39,Aitken,746,France,171039.56,1,1,0
9616,2011,2,MORTGAGE,3,Medium,2,31000, 60 months,2,debt_consolidation,6,Low,1,Good Loan,0,11.99,B,2,8.36,38094.6,31000,0,689.43,409000009615,10-Sep-18,Indiaforensic NFS SETT 07-09-201,"8,500.00",,-542872516.39,Chao,692,Spain,150802.41,1,1,0
9617,2011,10,MORTGAGE,3,Low,1,21000, 60 months,2,debt_consolidation,6,High,2,Good Loan,0,18.39,E,5,22.96,30251.90438,21000,0,537.73,409000009616,10-Sep-18,Indiaforensic NFS SETT 07-09-201,"7,000.00",,-542879516.39,Bruce,683,Spain,82951.12,1,1,0
9618,2011,10,MORTGAGE,3,Low,1,13000, 60 months,2,debt_consolidation,6,High,2,Good Loan,0,20.25,F,6,7.83,13651.1,13000,0,346.24,409000009617,10-Sep-18,Indiaforensic NFS SETT 07-09-201,"8,300.00",,-542887816.39,Chan,591,Germany,57064.57,1,1,0
9619,2011,0.5,RENT,1,Low,1,3000, 36 months,1,other,4,High,2,Good Loan,0,14.79,C,3,11.1,3703.071735,3000,0,103.69,409000009618,10-Sep-18,Indiaforensic NFS SETT 07-09-201,"7,600.00",,-542895416.39,Watts,581,France,45755.00,1,1,0
9620,2011,0.5,RENT,1,Low,1,3200, 36 months,1,small_business,3,Low,1,Good Loan,0,10.99,B,2,4.2,3744.087807,3200,0,104.75,409000009619,10-Sep-18,Indiaforensic NFS SETT 07-09-201,"9,500.00",,-542904916.39,Gibbons,684,Germany,176882.08,1,1,0
9621,2011,10,MORTGAGE,3,Low,1,4500, 60 months,2,car,2,Low,1,Good Loan,0,9.99,B,2,7.55,4966.18,3760.09,0,95.59,409000009620,10-Sep-18,Indiaforensic NFS SETT 07-09-201,"5,000.00",,-542909916.39,Ni,561,Spain,88838.14,1,1,0
9622,2011,10,RENT,1,Low,1,4000, 36 months,1,vacation,11,Low,1,Good Loan,0,10.59,B,2,0.43,4661.367066,4000,0,130.18,409000009621,10-Sep-18,Indiaforensic NFS SETT 07-09-201,"2,500.00",,-542912416.39,Jen,718,Germany,88592.80,1,1,0
9623,2011,10,MORTGAGE,3,Low,1,8475, 36 months,1,home_improvement,7,Low,1,Good Loan,0,6.99,A,1,20.61,9402.556238,8475,0,261.65,409000009622,10-Sep-18,Indiaforensic NFS SETT 07-09-201,"2,500.00",,-542914916.39,Phillips,590,France,26261.42,1,1,0
9624,2011,10,MORTGAGE,3,Low,1,4000, 36 months,1,other,4,Low,1,Good Loan,0,7.49,A,1,4.6,4476.797387,4000,0,124.41,409000009623,10-Sep-18,Indiaforensic NFS SETT 07-09-201,"2,500.00",,-542917416.39,Amaechi,573,France,29586.73,1,1,0
9625,2011,10,MORTGAGE,3,Medium,2,8400, 36 months,1,debt_consolidation,6,High,2,Bad Loan,1,15.99,D,4,5.06,5019.26,3455.72,23.64,295.28,409000009624,10-Sep-18,Indiaforensic NFS SETT 07-09-201,500,,-542917916.39,Maslow,350,France,172321.21,1,1,0
9626,2011,7,MORTGAGE,3,Low,1,13500, 36 months,1,credit_card,1,Low,1,Good Loan,0,8.49,A,1,21.63,15291.83111,13500,0,426.1,409000009625,10-Sep-18,Indiaforensic NFS SETT 07-09-201,500,,-542918416.39,Rowley,504,Germany,158036.72,1,1,0
9627,2011,6,MORTGAGE,3,Low,1,7000, 36 months,1,small_business,3,Low,1,Good Loan,0,12.99,C,3,9.54,8487.422254,7000,0,235.83,409000009626,10-Sep-18,Indiaforensic NFS SETT 07-09-201,"4,000.00",,-542922416.39,Chukwuemeka,813,Spain,115733.16,1,1,0
9628,2011,8,RENT,1,Low,1,3600, 36 months,1,other,4,Low,1,Good Loan,0,9.99,B,2,14.78,4179.353501,3600,0,116.15,409000009627,10-Sep-18,Indiaforensic NFS SETT 07-09-201,"1,000.00",,-542923416.39,Bevan,641,Spain,59927.99,1,1,0
9629,2011,2,RENT,1,Low,1,20000, 36 months,1,credit_card,1,High,2,Good Loan,0,16.49,D,4,11.8,20806.62,20000,0,707.99,409000009628,10-Sep-18,Indiaforensic NFS SETT 07-09-201,"5,400.00",,-542928816.39,Topp,662,France,44377.65,1,1,0
9630,2011,4,RENT,1,Low,1,18200, 36 months,1,debt_consolidation,6,Low,1,Good Loan,0,10.99,B,2,20.01,19643.11,18200,0,595.76,409000009629,10-Sep-18,Indiaforensic NFS SETT 07-09-201,100,,-542928916.39,Burgoyne,497,Spain,79691.40,1,1,0
9631,2011,10,MORTGAGE,3,Medium,2,33600, 60 months,2,debt_consolidation,6,Low,1,Good Loan,0,11.99,B,2,7.88,39960.13,33600,0,747.25,409000009630,10-Sep-18,Indiaforensic NFS SETT 07-09-201,500,,-542929416.39,Yermakov,716,France,51503.51,1,1,0
9632,2011,7,RENT,1,Low,1,7500, 60 months,2,credit_card,1,High,2,Bad Loan,1,14.79,C,3,14.69,7390.84,4223.03,479.44,177.6,409000009631,10-Sep-18,Indiaforensic NFS SETT 08-09-201,"9,500.00",,-542938916.39,Ts'ui,526,France,62830.97,1,1,0
9633,2011,4,RENT,1,Low,1,2000, 36 months,1,debt_consolidation,6,High,2,Good Loan,0,15.99,D,4,15.63,2501.77,2000,0,70.31,409000009632,10-Sep-18,Indiaforensic NFS SETT 08-09-201,500,,-542939416.39,Kodilinyechukwu,760,Germany,90346.10,1,1,0
9634,2011,4,MORTGAGE,3,Low,1,15000, 60 months,2,debt_consolidation,6,High,2,Good Loan,0,13.99,C,3,23.96,20784.23002,15000,0,348.95,409000009633,10-Sep-18,Indiaforensic NFS SETT 08-09-201,"2,000.00",,-542941416.39,K?,669,France,40467.82,1,1,0
9635,2011,3,RENT,1,Low,1,10000, 36 months,1,debt_consolidation,6,Low,1,Good Loan,0,10.59,B,2,13.4,11702.90593,10000,0,325.45,409000009634,10-Sep-18,Indiaforensic NFS SETT 08-09-201,"8,000.00",,-542949416.39,Marino,655,France,51620.94,1,1,0
9636,2011,4,MORTGAGE,3,Low,1,12050, 60 months,2,debt_consolidation,6,High,2,Good Loan,0,16.89,D,4,20.27,15491.34,9781.28,0,298.77,409000009635,10-Sep-18,Indiaforensic NFS SETT 08-09-201,"9,000.00",,-542958416.39,Lucas,547,France,65466.93,1,1,0
9637,2011,4,RENT,1,Medium,2,35000, 60 months,2,debt_consolidation,6,High,2,Bad Loan,1,20.99,F,6,18.93,19982.43,7691.14,2479.3,671.47,409000009636,10-Sep-18,Indiaforensic NFS SETT 08-09-201,800,,-542959216.39,Anderson,648,Germany,667.66,1,1,0
9638,2011,0.5,RENT,1,Low,1,11600, 36 months,1,small_business,3,Low,1,Good Loan,0,10.99,B,2,2.11,13664.77902,11600,0,379.72,409000009637,10-Sep-18,Indiaforensic NFS SETT 08-09-201,"8,500.00",,-542967716.39,Wei,790,France,172437.12,1,1,0
9639,2011,2,MORTGAGE,3,Low,1,11525, 36 months,1,small_business,3,Low,1,Good Loan,0,7.49,A,1,26.12,12902.56125,11525,0,358.45,409000009638,10-Sep-18,Indiaforensic NFS SETT 08-09-201,700,,-542968416.39,Baldwin,744,Germany,106061.47,1,1,0
9640,2011,7,RENT,1,Low,1,15600, 36 months,1,debt_consolidation,6,Low,1,Good Loan,0,7.49,A,1,23.85,16147.69,15600,0,485.19,409000009639,10-Sep-18,Indiaforensic NFS SETT 08-09-201,"8,500.00",,-542976916.39,Foster,761,Spain,177622.38,1,1,0
9641,2011,6,RENT,1,Low,1,12000, 36 months,1,credit_card,1,Low,1,Good Loan,0,12.99,C,3,5.97,14505.65207,12000,0,404.27,409000009640,10-Sep-18,Indiaforensic NFS SETT 08-09-201,"7,800.00",,-542984716.39,Gebhart,750,France,191520.50,1,1,0
9642,2011,4,MORTGAGE,3,Low,1,14400, 60 months,2,other,4,Low,1,Good Loan,0,10.99,B,2,11.89,17850.65527,14400,0,313.02,409000009641,10-Sep-18,Indiaforensic NFS SETT 08-09-201,"10,000.00",,-542994716.39,Fedorov,680,France,95686.60,1,1,0
9643,2011,2,MORTGAGE,3,Low,1,8000, 36 months,1,debt_consolidation,6,High,2,Good Loan,0,16.49,D,4,14,9646.26,7999.99,0,283.2,409000009642,10-Sep-18,Indiaforensic NFS SETT 08-09-201,500,,-542995216.39,Robertson,704,Spain,173776.50,1,1,0
9644,2011,8,RENT,1,Low,1,12000, 36 months,1,debt_consolidation,6,Low,1,Good Loan,0,8.49,A,1,12.55,13572.83866,12000,0,378.76,409000009643,10-Sep-18,Indiaforensic NFS SETT 08-09-201,"10,000.00",,-543005216.39,Tudawali,521,France,113089.43,1,1,0
9645,2011,8,MORTGAGE,3,Medium,2,28000, 36 months,1,debt_consolidation,6,Low,1,Good Loan,0,8.49,A,1,6.05,29905.14,28000,0,883.77,409000009644,10-Sep-18,Indiaforensic NFS SETT 08-09-201,"4,900.00",,-543010116.39,Iloerika,452,France,149614.81,1,1,0
9646,2011,0.5,RENT,1,Low,1,5000, 36 months,1,car,2,High,2,Bad Loan,1,15.99,D,4,11.56,4801.11,3342.65,255.97,175.77,409000009645,10-Sep-18,Indiaforensic NFS SETT 08-09-201,500,,-543010616.39,Onyemauchechukwu,695,France,99537.68,1,1,0
9647,2011,0.5,MORTGAGE,3,Low,1,1500, 36 months,1,other,4,High,2,Good Loan,0,15.99,D,4,2.64,1895.792077,1500,0,52.73,409000009646,10-Sep-18,Indiaforensic NFS SETT 08-09-201,"9,500.00",,-543020116.39,Muir,850,Spain,97893.40,1,1,0
9648,2011,0.5,MORTGAGE,3,Low,1,5025, 36 months,1,wedding,5,Low,1,Good Loan,0,7.49,A,1,6.32,5623.625839,5025,0,156.29,409000009647,10-Sep-18,Indiaforensic NFS SETT 08-09-201,"10,000.00",,-543030116.39,Walker,625,France,90.07,1,1,0
9649,2011,10,MORTGAGE,3,Medium,2,25000, 60 months,2,debt_consolidation,6,High,2,Good Loan,0,15.23,C,3,17.97,31058.76,20401.33,0,597.78,409000009648,10-Sep-18,Indiaforensic NFS SETT 08-09-201,"3,000.00",,-543033116.39,Charlton,608,Germany,161154.85,1,1,0
9650,2011,10,MORTGAGE,3,Low,1,20000, 60 months,2,debt_consolidation,6,High,2,Bad Loan,1,16.49,D,4,16.16,6882.1,3309.44,24.06,491.59,409000009649,10-Sep-18,Indiaforensic NFS SETT 08-09-201,"7,000.00",,-543040116.39,Tseng,715,France,332.81,1,1,0
9651,2011,2,RENT,1,Low,1,5550, 36 months,1,debt_consolidation,6,Low,1,Good Loan,0,7.49,A,1,7.97,6016.92,5550,0,172.62,409000009650,10-Sep-18,Indiaforensic NFS SETT 08-09-201,"1,000.00",,-543041116.39,Ifeatu,834,Spain,66285.18,1,1,0
9652,2011,4,OWN,2,Low,1,15000, 36 months,1,debt_consolidation,6,Low,1,Good Loan,0,11.99,B,2,21.78,16768.87,15000,0,498.15,409000009651,10-Sep-18,Indiaforensic NFS SETT 08-09-201,"1,900.00",,-543043016.39,Chin,469,France,163477.22,1,1,0
9653,2011,10,MORTGAGE,3,Low,1,6625, 36 months,1,credit_card,1,Low,1,Good Loan,0,8.49,A,1,27.65,7525.221998,6625,0,209.11,409000009652,10-Sep-18,Indiaforensic NFS SETT 08-09-201,"8,000.00",,-543051016.39,Blinova,480,France,170332.67,1,1,0
9654,2011,2,MORTGAGE,3,Low,1,20000, 60 months,2,debt_consolidation,6,High,2,Good Loan,0,13.99,C,3,25.78,23196.32,19999.99,0,465.27,409000009653,10-Sep-18,Indiaforensic NFS SETT 08-09-201,400,,-543051416.39,Maconochie,527,Germany,126144.96,1,1,0
9655,2011,8,MORTGAGE,3,Low,1,4800, 36 months,1,wedding,5,High,2,Good Loan,0,13.49,C,3,15.8,5857.167338,4800,0,162.87,409000009654,10-Sep-18,Indiaforensic NFS SETT 08-09-201,"8,000.00",,-543059416.39,Ch'in,834,Spain,53437.10,1,1,0
9656,2011,0.5,MORTGAGE,3,Low,1,3600, 36 months,1,major_purchase,8,Low,1,Good Loan,0,7.49,A,1,13.11,3745.44,3600,0,111.97,409000009655,10-Sep-18,Indiaforensic NFS SETT 08-09-201,"5,600.00",,-543065016.39,Nicholson,583,France,26920.43,1,1,0
9657,2011,1,MORTGAGE,3,Low,1,22500, 36 months,1,debt_consolidation,6,Low,1,Good Loan,0,7.49,A,1,14.82,24993.86,22500,0,699.79,409000009656,10-Sep-18,Indiaforensic NFS SETT 08-09-201,"8,000.00",,-543073016.39,Burgess,696,Germany,52314.71,1,1,0
9658,2011,10,RENT,1,Low,1,7000, 36 months,1,debt_consolidation,6,Low,1,Good Loan,0,10.99,B,2,5.71,7304.1,7000,0,229.14,409000009657,10-Sep-18,Indiaforensic NFS SETT 08-09-201,"2,000.00",,-543075016.39,Young,606,France,116885.59,1,1,0
9659,2011,3,RENT,1,Low,1,24000, 36 months,1,credit_card,1,Low,1,Good Loan,0,10.99,B,2,17.32,28164.89541,24000,0,785.62,409000009658,10-Sep-18,Indiaforensic NFS SETT 08-09-201,"8,000.00",,-543083016.39,Plumb,713,France,126263.97,1,1,0
9660,2011,4,MORTGAGE,3,Medium,2,4800, 36 months,1,moving,10,Low,1,Good Loan,0,12.99,C,3,7.84,5819.271524,4800,0,161.71,409000009659,10-Sep-18,Indiaforensic NFS SETT 08-09-201,"10,000.00",,-543093016.39,Trentino,821,Germany,64613.81,1,1,0
9661,2011,10,MORTGAGE,3,Low,1,16000, 60 months,2,debt_consolidation,6,Low,1,Bad Loan,1,10.99,B,2,19.75,15998.8,11438.67,16.5,347.8,409000009660,10-Sep-18,Indiaforensic NFS SETT 08-09-201,"8,000.00",,-543101016.39,Allen,550,France,89216.29,1,1,0
9662,2011,2,RENT,1,Low,1,20000, 60 months,2,house,12,Low,1,Good Loan,0,11.99,B,2,14.4,25700.47415,20000,0,444.79,409000009661,10-Sep-18,Indiaforensic NFS SETT 08-09-201,"8,000.00",,-543109016.39,Benford,675,France,83419.15,1,1,0
9663,2011,2,RENT,1,Low,1,6000, 36 months,1,debt_consolidation,6,Low,1,Good Loan,0,9.99,B,2,24,6963.981211,6000,0,193.58,409000009662,10-Sep-18,Indiaforensic NFS SETT 08-09-201,"2,000.00",,-543111016.39,Gallo,748,Spain,123998.52,1,1,0
9664,2011,5,MORTGAGE,3,Low,1,22000, 36 months,1,debt_consolidation,6,Low,1,Good Loan,0,10.59,B,2,26.52,23856.93,22000,0,715.99,409000009663,10-Sep-18,Indiaforensic NFS SETT 08-09-201,200,,-543111216.39,Cobb,606,Germany,96985.58,1,1,0
9665,2011,10,MORTGAGE,3,Low,1,15000, 36 months,1,credit_card,1,Low,1,Good Loan,0,8.49,A,1,11.52,17024.08401,15000,0,473.45,409000009664,10-Sep-18,Indiaforensic NFS SETT 08-09-201,"10,000.00",,-543121216.39,Doherty,726,Germany,146154.06,1,1,0
9666,2011,5,MORTGAGE,3,Low,1,15000, 36 months,1,debt_consolidation,6,High,2,Good Loan,0,16.89,D,4,18.11,17210.5,15000.01,0,533.98,409000009665,10-Sep-18,Indiaforensic NFS SETT 08-09-201,800,,-543122016.39,Cocci,547,France,18471.86,1,1,0
9667,2011,6.05,RENT,1,Low,1,9600, 36 months,1,debt_consolidation,6,Low,1,Good Loan,0,9.99,B,2,17.1,10427.87,9599.99,0,309.72,409000009666,10-Sep-18,Indiaforensic NFS SETT 08-09-201,"8,700.00",,-543130716.39,Macadam,758,Spain,95009.60,1,1,0
9668,2011,2,MORTGAGE,3,Low,1,12600, 36 months,1,debt_consolidation,6,Low,1,Good Loan,0,9.99,B,2,19.6,14629.85339,12600,0,406.51,409000009667,10-Sep-18,Indiaforensic NFS SETT 08-09-201,"5,000.00",,-543135716.39,Tychonoff,596,France,121175.86,1,1,0
9669,2011,4,MORTGAGE,3,Low,1,3250, 36 months,1,home_improvement,7,High,2,Good Loan,0,13.49,C,3,15.28,3964.11934,3250,0,110.28,409000009668,10-Sep-18,Indiaforensic NFS SETT 08-09-201,"4,500.00",,-543140216.39,Johnson,720,Spain,77047.78,1,1,0
9670,2011,6,MORTGAGE,3,Low,1,5975, 60 months,2,debt_consolidation,6,Low,1,Bad Loan,1,10.99,B,2,26.03,3636.92,2376.19,16.24,129.89,409000009669,10-Sep-18,Indiaforensic NFS SETT 08-09-201,"8,400.00",,-543148616.39,Tu,674,France,158049.90,1,1,0
9671,2011,9,MORTGAGE,3,Low,1,14000, 36 months,1,debt_consolidation,6,Low,1,Good Loan,0,11.49,B,2,20.19,16380.15,14000,0,461.6,409000009670,10-Sep-18,Indiaforensic NFS SETT 08-09-201,500,,-543149116.39,Chidiebere,756,France,147040.25,1,1,0
9672,2011,5,MORTGAGE,3,Low,1,4000, 36 months,1,other,4,High,2,Bad Loan,1,16.49,D,4,5.45,2804.87,1861.09,122.07,141.6,409000009671,10-Sep-18,Indiaforensic NFS SETT 08-09-201,"9,000.00",,-543158116.39,Pope,649,Germany,142566.75,1,1,0
9673,2011,7,RENT,1,Low,1,13000, 36 months,1,debt_consolidation,6,Low,1,Good Loan,0,7.49,A,1,10.45,14553.03211,13000,0,404.33,409000009672,10-Sep-18,Indiaforensic NFS SETT 08-09-201,100,,-543158216.39,Sutherland,613,Germany,185483.24,1,1,0
9674,2011,7,RENT,1,Medium,2,24000, 36 months,1,debt_consolidation,6,High,2,Good Loan,0,15.62,D,4,16.25,28986.99,24000.01,0,839.28,409000009673,10-Sep-18,Indiaforensic NFS SETT 08-09-201,"9,000.00",,-543167216.39,Beneventi,643,France,155870.82,1,1,0
9675,2011,10,MORTGAGE,3,Low,1,3000, 36 months,1,major_purchase,8,Low,1,Good Loan,0,5.42,A,1,13.94,3077.02,3000,0,90.48,409000009674,10-Sep-18,Indiaforensic NFS SETT 08-09-201,"3,000.00",,-543170216.39,Jamieson,600,France,121555.51,1,1,0
9676,2011,10,MORTGAGE,3,Low,1,9600, 36 months,1,home_improvement,7,Low,1,Good Loan,0,7.49,A,1,14.31,10642.52,9600,0,298.58,409000009675,10-Sep-18,Indiaforensic NFS SETT 08-09-201,"8,000.00",,-543178216.39,Simmons,735,Spain,40223.74,1,1,0
9677,2011,2,MORTGAGE,3,Medium,2,9000, 36 months,1,home_improvement,7,Low,1,Good Loan,0,11.49,B,2,14.65,10124.14,9000,0,296.75,409000009676,10-Sep-18,Indiaforensic NFS SETT 08-09-201,500,,-543178716.39,Chijioke,585,France,75503.60,1,1,0
9678,2011,10,MORTGAGE,3,Medium,2,14000, 60 months,2,home_improvement,7,High,2,Good Loan,0,13.99,C,3,15.99,19400.70002,14000,0,325.69,409000009677,10-Sep-18,Indiaforensic NFS SETT 08-09-201,"8,000.00",,-543186716.39,Iloerika,724,Germany,186942.49,1,1,0
9679,2011,6,RENT,1,Low,1,17000, 36 months,1,credit_card,1,Low,1,Good Loan,0,8.49,A,1,12.61,19199.44498,17000,0,536.57,409000009678,10-Sep-18,Indiaforensic NFS SETT 08-09-201,"6,000.00",,-543192716.39,Chia,635,Spain,117173.80,1,1,0
9680,2011,6.05,MORTGAGE,3,Low,1,30000, 60 months,2,home_improvement,7,Low,1,Good Loan,0,11.99,B,2,4.53,34674.08,24882.66,0,667.19,409000009679,10-Sep-18,Indiaforensic NFS SETT 08-09-201,"3,500.00",,-543196216.39,Nwachinemelu,472,France,3453.40,1,1,0
9681,2011,6,MORTGAGE,3,Medium,2,8700, 36 months,1,debt_consolidation,6,Low,1,Good Loan,0,12.99,C,3,14.67,10548.29346,8700,0,293.1,409000009680,10-Sep-18,Indiaforensic NFS SETT 08-09-201,"1,000.00",,-543197216.39,Becher,590,France,48876.84,1,1,0
9682,2011,1,RENT,1,Low,1,3000, 36 months,1,debt_consolidation,6,Low,1,Good Loan,0,6.99,A,1,4.2,3333.734836,3000,0,92.62,409000009681,10-Sep-18,Indiaforensic NFS SETT 08-09-201,"8,500.00",,-543205716.39,Romano,651,Spain,11830.53,1,1,0
9683,2011,10,MORTGAGE,3,Low,1,2000, 36 months,1,small_business,3,Low,1,Good Loan,0,10.99,B,2,11.75,2236.65,2000,0,65.47,409000009682,10-Sep-18,Indiaforensic NFS SETT 08-09-201,"9,500.00",,-543215216.39,Walker,686,Germany,162820.60,1,1,0
9684,2011,3,MORTGAGE,3,Low,1,10000, 36 months,1,debt_consolidation,6,Low,1,Good Loan,0,8.49,A,1,24.68,11357.51205,10000,0,315.63,409000009683,10-Sep-18,Indiaforensic NFS SETT 08-09-201,"7,500.00",,-543222716.39,Chiawuotu,606,France,36540.63,1,1,0
9685,2011,7,MORTGAGE,3,Low,1,11000, 36 months,1,major_purchase,8,High,2,Good Loan,0,16.89,D,4,15.31,14087.49398,11000,0,391.58,409000009684,10-Sep-18,Indiaforensic NFS SETT 08-09-201,300,,-543223016.39,Watt,781,France,6959.00,1,1,0
9686,2011,5,RENT,1,Low,1,5600, 36 months,1,wedding,5,Low,1,Good Loan,0,7.49,A,1,12.52,6264.09839,5600,0,174.17,409000009685,10-Sep-18,Indiaforensic NFS SETT 08-09-201,"2,000.00",,-543225016.39,Udegbunam,593,France,10828.78,1,1,0
9687,2011,10,RENT,1,Low,1,35000, 60 months,2,debt_consolidation,6,High,2,Bad Loan,1,15.62,D,4,8.16,17404.47,8109.51,1544.23,844.09,409000009686,10-Sep-18,Indiaforensic NFS SETT 08-09-201,"6,000.00",,-543231016.39,Watson,793,France,80272.06,1,1,0
9688,2011,10,MORTGAGE,3,Low,1,14000, 60 months,2,home_improvement,7,Low,1,Good Loan,0,11.49,B,2,11.49,16972.16,14000,0,307.83,409000009687,10-Sep-18,Indiaforensic NFS SETT 08-09-201,300,,-543231316.39,Bryant,791,France,22184.14,1,1,0
9689,2011,5,RENT,1,Low,1,12000, 36 months,1,credit_card,1,Low,1,Good Loan,0,11.99,B,2,10.68,13774.48,12000,0,398.52,409000009688,10-Sep-18,Indiaforensic NFS SETT 08-09-201,"4,000.00",,-543235316.39,Ward,850,France,186335.07,1,1,0
9690,2011,5,RENT,1,Medium,2,4500, 36 months,1,credit_card,1,High,2,Good Loan,0,13.49,C,3,3.5,4741.23,4500,0,152.69,409000009689,10-Sep-18,Indiaforensic NFS SETT 08-09-201,"2,500.00",,-543237816.39,Urban,698,France,105715.01,1,1,0
9691,2011,10,MORTGAGE,3,Low,1,17000, 60 months,2,debt_consolidation,6,Low,1,Good Loan,0,9.99,B,2,23.52,18770.44,14211.25,0,361.12,409000009690,10-Sep-18,Indiaforensic NFS SETT 09-09-201,"6,000.00",,-543243816.39,Sutherland,846,France,68393.64,1,1,0
9692,2011,2,MORTGAGE,3,Low,1,5000, 36 months,1,debt_consolidation,6,High,2,Good Loan,0,13.99,C,3,20.16,5832.92,5000,0,170.87,409000009691,10-Sep-18,Indiaforensic NFS SETT 09-09-201,"5,000.00",,-543248816.39,K'ung,765,France,82868.34,1,1,0
9693,2011,5,MORTGAGE,3,Low,1,12375, 36 months,1,debt_consolidation,6,Low,1,Good Loan,0,10.99,B,2,19.51,14675.39843,12375,0,405.09,409000009692,10-Sep-18,Indiaforensic NFS SETT 09-09-201,"1,000.00",,-543249816.39,Iweobiegbunam,574,Spain,196257.67,1,1,0
9694,2011,0.5,RENT,1,Low,1,26000, 60 months,2,debt_consolidation,6,High,2,Good Loan,0,15.23,C,3,25.27,29123.25,26000,0,621.69,409000009693,10-Sep-18,Indiaforensic NFS SETT 09-09-201,"5,000.00",,-543254816.39,Wei,617,Germany,93439.75,1,1,0
9695,2011,6.05,RENT,1,Low,1,9975, 36 months,1,debt_consolidation,6,Low,1,Good Loan,0,10.99,B,2,17.67,11749.82373,9975,0,326.53,409000009694,10-Sep-18,Indiaforensic NFS SETT 09-09-201,"3,000.00",,-543257816.39,Lascelles,581,France,150319.49,1,1,0
9696,2011,10,RENT,1,Low,1,8000, 36 months,1,debt_consolidation,6,Low,1,Bad Loan,1,11.99,B,2,24.9,1328.05,947.23,0,265.68,409000009695,10-Sep-18,Indiaforensic NFS SETT 09-09-201,"9,500.00",,-543267316.39,Ts'ao,710,Germany,46523.60,1,1,0
9697,2011,4,MORTGAGE,3,Low,1,19125, 36 months,1,debt_consolidation,6,High,2,Good Loan,0,13.99,C,3,14.68,22052.84,19125,0,653.56,409000009696,10-Sep-18,Indiaforensic NFS SETT 09-09-201,"10,000.00",,-543277316.39,Mack,550,France,199138.84,1,1,0
9698,2011,6.05,MORTGAGE,3,Low,1,14500, 60 months,2,debt_consolidation,6,High,2,Bad Loan,1,18.79,E,5,22.43,6365.12,2837.47,18.51,374.47,409000009697,10-Sep-18,Indiaforensic NFS SETT 09-09-201,"9,000.00",,-543286316.39,Campbell,533,Germany,79559.02,1,1,0
9699,2011,6,RENT,1,Low,1,32500, 36 months,1,debt_consolidation,6,Low,1,Good Loan,0,9.99,B,2,19.51,29575.28,28250,0,911.42,409000009698,10-Sep-18,Indiaforensic NFS SETT 09-09-201,"10,000.00",,-543296316.39,Fiorentini,779,France,116893.87,1,1,0
9700,2011,10,OWN,2,Low,1,29800, 36 months,1,other,4,Low,1,Good Loan,0,10.99,B,2,0.64,29240.66,28975,0,948.47,409000009699,10-Sep-18,Indiaforensic NFS SETT 09-09-201,"8,500.00",,-543304816.39,Long,763,France,153983.99,1,1,0
9701,2011,7,MORTGAGE,3,Low,1,12000, 36 months,1,credit_card,1,Low,1,Good Loan,0,7.49,A,1,9.35,13430.66366,12000,0,373.22,409000009700,10-Sep-18,Indiaforensic NFS SETT 09-09-201,"1,000.00",,-543305816.39,Lloyd,563,Spain,63531.19,1,1,0
9702,2011,10,MORTGAGE,3,Low,1,25000, 60 months,2,other,4,Low,1,Good Loan,0,11.99,B,2,17.68,31013.18447,25000,0,555.99,409000009701,10-Sep-18,Indiaforensic NFS SETT 09-09-201,"6,500.00",,-543312316.39,Sneddon,678,Spain,126253.31,1,1,0
9703,2011,3,MORTGAGE,3,Low,1,4000, 36 months,1,debt_consolidation,6,High,2,Bad Loan,1,15.62,D,4,10.82,1678.37,958.5,174.42,139.88,409000009702,10-Sep-18,Indiaforensic NFS SETT 09-09-201,200,,-543312516.39,Gorshkov,644,Spain,73922.95,1,1,0
9704,2011,10,MORTGAGE,3,Low,1,24000, 36 months,1,debt_consolidation,6,Low,1,Good Loan,0,7.49,A,1,26.43,25748.27,24000,0,746.44,409000009703,10-Sep-18,Indiaforensic NFS SETT 09-09-201,"1,500.00",,-543314016.39,Forbes,682,Germany,64679.30,1,1,0
9705,2011,0.5,RENT,1,Medium,2,18000, 60 months,2,major_purchase,8,High,2,Good Loan,0,18.79,E,5,4.32,24890.48,18000,0,464.86,409000009704,10-Sep-18,Indiaforensic NFS SETT 09-09-201,"9,000.00",,-543323016.39,L?,625,France,157072.91,1,1,0
9706,2011,6,RENT,1,Low,1,24000, 36 months,1,debt_consolidation,6,Low,1,Good Loan,0,10.99,B,2,9.32,27119.79,24000.01,0,785.62,409000009705,10-Sep-18,Indiaforensic NFS SETT 09-09-201,"5,000.00",,-543328016.39,Hopetoun,733,Spain,108377.82,1,1,0
9707,2011,4,MORTGAGE,3,Low,1,24575, 60 months,2,debt_consolidation,6,High,2,Good Loan,0,14.79,C,3,16.82,32653.46469,24575,0,581.94,409000009706,10-Sep-18,Indiaforensic NFS SETT 09-09-201,"7,000.00",,-543335016.39,Lucchesi,512,France,88827.31,1,1,0
9708,2011,10,RENT,1,Low,1,1200, 36 months,1,other,4,Low,1,Good Loan,0,8.49,A,1,3.85,1358.351921,1200,0,37.88,409000009707,10-Sep-18,Indiaforensic NFS SETT 09-09-201,"1,000.00",,-543336016.39,Faria,642,France,37674.47,1,1,0
9709,2011,0.5,RENT,1,Low,1,14000, 36 months,1,debt_consolidation,6,Low,1,Good Loan,0,10.99,B,2,21.14,16492.53131,14000,0,458.28,409000009708,10-Sep-18,Indiaforensic NFS SETT 09-09-201,500,,-543336516.39,Yefremov,737,Germany,106327.85,1,1,0
9710,2011,5,OWN,2,Low,1,4800, 36 months,1,credit_card,1,High,2,Good Loan,0,15.62,D,4,14.07,6038.695299,4800,0,167.86,409000009709,10-Sep-18,Indiaforensic NFS SETT 09-09-201,"4,000.00",,-543340516.39,Genovesi,575,France,84475.13,1,1,0
9711,2011,3,RENT,1,Medium,2,18000, 60 months,2,debt_consolidation,6,High,2,Good Loan,0,15.99,D,4,23.27,22584.43,18000,0,437.63,409000009710,10-Sep-18,Indiaforensic NFS SETT 09-09-201,"9,000.00",,-543349516.39,Marquez,543,Germany,33998.70,1,1,0
9712,2011,3,RENT,1,Medium,2,12000, 36 months,1,debt_consolidation,6,Low,1,Good Loan,0,10.99,B,2,18.82,13940.69,12000,0,392.81,409000009711,10-Sep-18,Indiaforensic NFS SETT 09-09-201,200,,-543349716.39,Trevisani,521,Germany,20491.15,1,1,0
9713,2011,1,RENT,1,Low,1,3500, 36 months,1,debt_consolidation,6,Low,1,Good Loan,0,5.42,A,1,0.41,3799.175321,3500,0,105.56,409000009712,10-Sep-18,Indiaforensic NFS SETT 09-09-201,"8,000.00",,-543357716.39,Tung,637,France,197827.06,1,1,0
9714,2011,2,MORTGAGE,3,High,3,35000, 60 months,2,home_improvement,7,High,2,Good Loan,0,15.23,C,3,10.77,45833.8881,35000,0,836.88,409000009713,10-Sep-18,Indiaforensic NFS SETT 09-09-201,"3,000.00",,-543360716.39,Barnhill,714,France,96687.25,1,1,0
9715,2011,0.5,RENT,1,Low,1,15000, 60 months,2,other,4,High,2,Good Loan,0,19.69,E,5,15.09,20509.56,12052.39,0,394.83,409000009714,10-Sep-18,Indiaforensic NFS SETT 09-09-201,"4,800.00",,-543365516.39,Marshall,726,Spain,46044.70,1,1,0
9716,2011,2,RENT,1,Medium,2,4100, 60 months,2,wedding,5,High,2,Good Loan,0,22.11,G,7,8.88,5895.1,3260.39,0,113.5,409000009715,11-Sep-18,Indiaforensic  RUPAY SETT 110918,"8,522.91",,-543374039.30,Bednall,680,Spain,98949.85,1,1,0
9717,2011,3,MORTGAGE,3,Low,1,10000, 36 months,1,home_improvement,7,Low,1,Good Loan,0,5.42,A,1,1.69,10855.75023,10000,0,301.6,409000009716,11-Sep-18,Indiaforensic  RUPAY SETT 110918,,99.02,-543373940.28,Pan,812,Germany,185599.34,1,1,0
9718,2011,6,RENT,1,Low,1,7000, 36 months,1,debt_consolidation,6,Low,1,Good Loan,0,5.99,A,1,10.68,7383.59,6999.99,0,212.93,409000009717,11-Sep-18,Indiaforensic RUPAY STL INTC1109,94.02,,-543374034.30,Ogg,757,Spain,198341.15,1,1,0
9719,2011,3,RENT,1,Low,1,2800, 36 months,1,debt_consolidation,6,High,2,Good Loan,0,13.99,C,3,12.43,3301.23,2800,0,95.69,409000009718,11-Sep-18,Indiaforensic RUPAY STL INTC1109,,0.08,-543374034.22,T'ang,710,Spain,119348.76,1,1,0
9720,2011,6,MORTGAGE,3,Low,1,2600, 60 months,2,debt_consolidation,6,High,2,Good Loan,0,20.25,F,6,4.96,2730.23,2600,0,69.25,409000009719,11-Sep-18,TRF FROM  Indiaforensic SERVICES,,15000.00,-543359034.22,Baresi,516,Germany,149614.17,1,1,0
9721,2011,4,MORTGAGE,3,Low,1,3600, 60 months,2,other,4,Low,1,Good Loan,0,10.59,B,2,19.3,4012.88,2990.8,0,77.54,409000009720,11-Sep-18,TRF FROM  Indiaforensic SERVICES,,60000.00,-543299034.22,Obiajulu,803,France,12328.08,1,1,0
9722,2011,10,MORTGAGE,3,Low,1,32350, 60 months,2,home_improvement,7,High,2,Bad Loan,1,21.74,F,6,21.3,39991.5,20753.43,34.38,888.7,409000009721,11-Sep-18,Indiaforensic  RUPAY SETT 110918,"2,046.54",,-543301080.76,McGregor,560,France,33245.97,1,1,0
9723,2011,6,MORTGAGE,3,Low,1,7000, 36 months,1,debt_consolidation,6,High,2,Good Loan,0,15.62,D,4,20.17,8805.994712,7000,0,244.79,409000009722,11-Sep-18,Indiaforensic  RUPAY SETT 110918,,25.87,-543301054.89,Lung,679,France,2243.41,1,1,0
9724,2011,0.5,MORTGAGE,3,Low,1,4500, 36 months,1,car,2,Low,1,Bad Loan,1,5.99,A,1,11.65,957.67,812.6,0,136.88,409000009723,11-Sep-18,Indiaforensic RUPAY STL INTC1109,25.87,,-543301080.76,Jamieson,526,France,86786.41,1,1,0
9725,2011,4,MORTGAGE,3,Low,1,10000, 36 months,1,debt_consolidation,6,High,2,Bad Loan,1,15.99,D,4,21.6,9174.21,6915.25,176.97,351.53,409000009724,11-Sep-18,Indiaforensic NFS SETT 10-09-201,"5,000.00",,-543306080.76,Pinto,485,France,12706.67,1,1,0
9726,2011,5,MORTGAGE,3,Low,1,12000, 60 months,2,wedding,5,Low,1,Good Loan,0,8.49,A,1,0.43,13863.6,11235.67,0,246.15,409000009725,11-Sep-18,Indiaforensic NFS SETT 10-09-201,"1,900.00",,-543307980.76,Fallaci,625,France,41295.10,1,1,0
9727,2011,10,RENT,1,Low,1,10000, 60 months,2,other,4,High,2,Bad Loan,1,13.99,C,3,6.33,4628.36,2304.13,450.56,232.64,409000009726,11-Sep-18,Indiaforensic NFS SETT 10-09-201,"6,000.00",,-543313980.76,Goliwe,773,Spain,177357.16,1,1,0
9728,2011,6,MORTGAGE,3,Low,1,21000, 36 months,1,debt_consolidation,6,Low,1,Good Loan,0,11.99,B,2,10.32,25105.42896,21000,0,697.41,409000009727,11-Sep-18,Indiaforensic NFS SETT 10-09-201,"10,000.00",,-543323980.76,Ferri,530,France,190663.89,1,1,0
9729,2011,4,RENT,1,Low,1,4500, 60 months,2,other,4,High,2,Good Loan,0,17.49,D,4,22.17,5987.76,4500,0,113.03,409000009728,11-Sep-18,Indiaforensic NFS SETT 10-09-201,"10,000.00",,-543333980.76,Rowley,616,Germany,115262.54,1,1,0
9730,2011,4,MORTGAGE,3,Low,1,15000, 36 months,1,other,4,Low,1,Good Loan,0,10.59,B,2,9.5,16626.98,15000.01,0,488.18,409000009729,11-Sep-18,Indiaforensic NFS SETT 10-09-201,"10,000.00",,-543343980.76,Tretiakova,651,France,170099.23,1,1,0
9731,2011,7,MORTGAGE,3,Low,1,21000, 60 months,2,debt_consolidation,6,High,2,Good Loan,0,15.23,C,3,14.97,26300.14,17636.87,0,502.13,409000009730,11-Sep-18,Indiaforensic NFS SETT 10-09-201,"1,000.00",,-543344980.76,She,586,Germany,189143.94,1,1,0
9732,2011,10,MORTGAGE,3,Medium,2,1600, 36 months,1,moving,10,High,2,Good Loan,0,13.99,C,3,9.01,1736.96,1600,0,54.68,409000009731,11-Sep-18,Indiaforensic NFS SETT 10-09-201,500,,-543345480.76,Nebeolisa,607,Germany,163257.44,1,1,0
9733,2011,2,MORTGAGE,3,Low,1,9000, 36 months,1,debt_consolidation,6,Low,1,Good Loan,0,8.49,A,1,8.46,10222.64972,9000,0,284.07,409000009732,11-Sep-18,Indiaforensic NFS SETT 10-09-201,"7,000.00",,-543352480.76,Young,724,Spain,95562.81,1,1,0
9734,2011,10,RENT,1,Low,1,11200, 36 months,1,debt_consolidation,6,Low,1,Good Loan,0,9.99,B,2,24.16,13001.57456,11200,0,361.34,409000009733,11-Sep-18,Indiaforensic NFS SETT 10-09-201,"6,500.00",,-543358980.76,Fitzgerald,733,France,75272.63,1,1,0
9735,2011,3,RENT,1,Medium,2,14000, 36 months,1,debt_consolidation,6,Low,1,Good Loan,0,9.99,B,2,6.36,16250.34464,14000,0,451.68,409000009734,11-Sep-18,Indiaforensic NFS SETT 10-09-201,"2,900.00",,-543361880.76,Arnold,667,Germany,20881.96,1,1,0
9736,2011,2,MORTGAGE,3,Low,1,15000, 36 months,1,wedding,5,High,2,Good Loan,0,15.99,D,4,21.13,18975.34872,15000,0,527.29,409000009735,11-Sep-18,Indiaforensic NFS SETT 10-09-201,"7,000.00",,-543368880.76,Chidimma,700,France,161845.81,1,1,0
9737,2011,3,MORTGAGE,3,High,3,10200, 60 months,2,other,4,High,2,Good Loan,0,20.62,F,6,5.29,14227.34,8166.03,0,273.77,409000009736,11-Sep-18,Indiaforensic NFS SETT 10-09-201,"2,000.00",,-543370880.76,Wells,659,Spain,49978.67,1,1,0
9738,2011,3,MORTGAGE,3,Low,1,1400, 36 months,1,home_improvement,7,High,2,Good Loan,0,14.79,C,3,10.9,1526.66,1400,0,48.39,409000009737,11-Sep-18,Indiaforensic NFS SETT 10-09-201,"1,000.00",,-543371880.76,Calzada,710,Spain,107292.91,1,1,0
9739,2011,0.5,RENT,1,Low,1,5325, 36 months,1,debt_consolidation,6,Low,1,Good Loan,0,10.99,B,2,18.19,6153.38,5324.99,0,174.31,409000009738,11-Sep-18,Indiaforensic NFS SETT 10-09-201,"7,500.00",,-543379380.76,Black,760,France,32863.24,1,1,0
9740,2011,10,MORTGAGE,3,Low,1,4800, 36 months,1,other,4,Low,1,Good Loan,0,9.99,B,2,16.5,5571.236894,4800,0,154.86,409000009739,11-Sep-18,Indiaforensic NFS SETT 10-09-201,"8,500.00",,-543387880.76,Sopuluchukwu,677,France,179608.96,1,1,0
9741,2011,0.5,RENT,1,Low,1,16425, 60 months,2,debt_consolidation,6,High,2,Good Loan,0,19.29,E,5,24.22,22336.5556,16425,0,428.7,409000009740,11-Sep-18,Indiaforensic NFS SETT 10-09-201,"1,500.00",,-543389380.76,Ts'ao,798,Germany,70223.22,1,1,0
9742,2011,0.5,RENT,1,Low,1,8000, 36 months,1,other,4,Low,1,Good Loan,0,9.99,B,2,18.95,9283.985086,8000,0,258.1,409000009741,11-Sep-18,Indiaforensic NFS SETT 10-09-201,"8,000.00",,-543397380.76,Ukaegbunam,758,France,77951.84,1,1,0
9743,2011,5,MORTGAGE,3,Low,1,10000, 36 months,1,debt_consolidation,6,High,2,Good Loan,0,13.49,C,3,22.56,12200.98634,10000,0,339.31,409000009742,11-Sep-18,Indiaforensic NFS SETT 10-09-201,"4,000.00",,-543401380.76,Wood,715,France,55043.93,1,1,0
9744,2011,2,OWN,2,Low,1,14400, 60 months,2,debt_consolidation,6,Low,1,Good Loan,0,11.49,B,2,23.99,16518.92,14400,0,316.63,409000009743,11-Sep-18,Indiaforensic NFS SETT 10-09-201,"8,500.00",,-543409880.76,Furneaux,752,Germany,101677.46,1,1,0
9745,2011,10,MORTGAGE,3,Low,1,2000, 36 months,1,major_purchase,8,Low,1,Good Loan,0,5.42,A,1,2.4,2170.764688,2000,0,60.32,409000009744,11-Sep-18,Indiaforensic NFS SETT 10-09-201,"7,000.00",,-543416880.76,Gresswell,586,Germany,79366.98,1,1,0
9746,2011,1,RENT,1,Low,1,1000, 36 months,1,other,4,Low,1,Good Loan,0,11.99,B,2,20.69,1038.66,1000,0,33.21,409000009745,11-Sep-18,Indiaforensic NFS SETT 10-09-201,"4,000.00",,-543420880.76,Ch'in,818,France,8037.03,1,1,0
9747,2011,9,MORTGAGE,3,Low,1,20000, 60 months,2,debt_consolidation,6,Low,1,Good Loan,0,11.99,B,2,25.06,22885.11,20000.01,0,444.79,409000009746,11-Sep-18,Indiaforensic NFS SETT 10-09-201,500,,-543421380.76,Ma,490,Germany,176254.12,1,1,0
9748,2011,3,RENT,1,Low,1,10000, 36 months,1,debt_consolidation,6,Low,1,Good Loan,0,9.99,B,2,13.97,11287.05082,10000,0,322.63,409000009747,11-Sep-18,Indiaforensic NFS SETT 10-09-201,"3,000.00",,-543424380.76,Iweobiegbunam,610,Germany,192743.06,1,1,0
9749,2011,8,MORTGAGE,3,Low,1,25000, 60 months,2,debt_consolidation,6,High,2,Good Loan,0,20.62,F,6,11.67,36272.52436,25000,0,671.01,409000009748,11-Sep-18,Indiaforensic NFS SETT 10-09-201,"7,000.00",,-543431380.76,Marcelo,627,Germany,56793.02,1,1,0
9750,2011,5,MORTGAGE,3,Medium,2,35000, 60 months,2,home_improvement,7,High,2,Good Loan,0,15.23,C,3,0.9,39382.13,35000.01,0,836.88,409000009749,11-Sep-18,TRF FRM  Indiaforensic SERVICES,,36164.00,-543395216.76,Azubuike,533,France,187900.12,1,1,0
9751,2011,10,MORTGAGE,3,Low,1,5000, 36 months,1,credit_card,1,Low,1,Good Loan,0,8.49,A,1,8.22,5674.462694,5000,0,157.82,409000009750,12-Sep-18,Indiaforensic  RUPAY SETT 120918,"5,386.74",,-543400603.50,Stewart,708,France,92920.04,1,1,0
9752,2011,7,RENT,1,Low,1,25000, 36 months,1,debt_consolidation,6,High,2,Good Loan,0,16.49,D,4,18.18,31676.29939,25000,0,884.99,409000009751,12-Sep-18,Indiaforensic  RUPAY SETT 120918,,63.98,-543400539.52,Yen,681,France,140166.95,1,1,0
9753,2011,2,RENT,1,Low,1,2600, 60 months,2,debt_consolidation,6,High,2,Bad Loan,1,17.49,D,4,13.02,1327.08,54.82,1091.3,65.31,409000009752,12-Sep-18,Indiaforensic RUPAY STL INTC1209,63.23,,-543400602.75,Hsieh,690,France,155782.89,1,1,0
9754,2011,1,RENT,1,Low,1,10000, 36 months,1,small_business,3,Low,1,Good Loan,0,9.99,B,2,1.61,11606.89139,10000,0,322.63,409000009753,12-Sep-18,Indiaforensic NFS SETT 11-09-201,"2,000.00",,-543402602.75,Chiedozie,656,Germany,186574.68,1,1,0
9755,2011,10,RENT,1,Low,1,28000, 60 months,2,debt_consolidation,6,High,2,Good Loan,0,13.49,C,3,25.9,37724.27186,28000,0,644.14,409000009754,12-Sep-18,Indiaforensic NFS SETT 11-09-201,"1,000.00",,-543403602.75,Shih,673,Spain,3258.60,1,1,0
9756,2011,0.5,RENT,1,Low,1,5000, 36 months,1,debt_consolidation,6,Low,1,Good Loan,0,9.99,B,2,15.5,5777.53,5000,0,161.32,409000009755,12-Sep-18,Indiaforensic NFS SETT 11-09-201,"4,500.00",,-543408102.75,Amechi,806,Germany,106714.28,1,1,0
9757,2011,4,RENT,1,Low,1,7000, 36 months,1,debt_consolidation,6,Low,1,Good Loan,0,7.49,A,1,20.5,7825.79664,7000,0,217.72,409000009756,12-Sep-18,Indiaforensic NFS SETT 11-09-201,500,,-543408602.75,Ko,648,Spain,144532.85,1,1,0
9758,2011,10,MORTGAGE,3,Low,1,25000, 60 months,2,debt_consolidation,6,Low,1,Good Loan,0,11.49,B,2,20.09,28544.27,20761.36,0,549.69,409000009757,12-Sep-18,Indiaforensic NFS SETT 11-09-201,500,,-543409102.75,Chimezie,501,France,13591.52,1,1,0
9759,2011,6,RENT,1,Medium,2,15000, 60 months,2,credit_card,1,High,2,Good Loan,0,17.49,D,4,11.25,18364.63,15000,0,376.76,409000009758,12-Sep-18,Indiaforensic NFS SETT 11-09-201,"7,000.00",,-543416102.75,Azubuike,556,Germany,74854.97,1,1,0
9760,2011,0.5,RENT,1,Low,1,6000, 36 months,1,debt_consolidation,6,Low,1,Good Loan,0,7.49,A,1,20.47,6712.6835,6000,0,186.61,409000009759,12-Sep-18,Indiaforensic NFS SETT 11-09-201,"8,000.00",,-543424102.75,Aguirre,627,France,125451.01,1,1,0
9761,2011,5,RENT,1,Low,1,13000, 36 months,1,debt_consolidation,6,Low,1,Good Loan,0,11.99,B,2,7.59,13383.13,13000,0,431.73,409000009760,12-Sep-18,Indiaforensic NFS SETT 11-09-201,"4,000.00",,-543428102.75,Lung,652,France,149740.22,1,1,0
9762,2011,7,RENT,1,Low,1,4000, 36 months,1,vacation,11,Low,1,Good Loan,0,11.49,B,2,10.19,4744.706164,4000,0,131.89,409000009761,12-Sep-18,Indiaforensic NFS SETT 11-09-201,"4,000.00",,-543432102.75,Adams,807,Germany,17355.36,1,1,0
9763,2011,3,MORTGAGE,3,Low,1,35000, 36 months,1,small_business,3,Low,1,Good Loan,0,10.59,B,2,4.6,41003.05567,35000,0,1139.08,409000009762,12-Sep-18,Indiaforensic NFS SETT 11-09-201,"2,500.00",,-543434602.75,Castiglione,708,Germany,50294.09,1,1,0
9764,2011,4,RENT,1,Low,1,22100, 60 months,2,other,4,Low,1,Good Loan,0,10.99,B,2,7.69,28347.9495,22100,0,480.4,409000009763,12-Sep-18,Indiaforensic NFS SETT 11-09-201,"6,000.00",,-543440602.75,Yao,619,France,156394.74,1,1,0
9765,2011,0.5,RENT,1,Low,1,9600, 36 months,1,credit_card,1,Low,1,Good Loan,0,10.99,B,2,23.79,10795.61,9600,0,314.25,409000009764,12-Sep-18,Indiaforensic NFS SETT 11-09-201,"9,000.00",,-543449602.75,Morales,601,France,77977.69,1,1,0
9766,2011,8,RENT,1,Low,1,4500, 36 months,1,car,2,High,2,Bad Loan,1,13.49,C,3,21.57,3194.23,2261.88,139.36,152.69,409000009765,12-Sep-18,Indiaforensic NFS SETT 11-09-201,500,,-543450102.75,Thomas,445,France,43678.06,1,1,0
9767,2011,0.5,MORTGAGE,3,Low,1,5600, 36 months,1,debt_consolidation,6,Low,1,Good Loan,0,7.49,A,1,12.67,6265.434158,5600,0,174.17,409000009766,12-Sep-18,Indiaforensic NFS SETT 11-09-201,200,,-543450302.75,Vasiliev,800,Germany,13906.34,1,1,0
9768,2011,10,MORTGAGE,3,Low,1,25000, 60 months,2,debt_consolidation,6,Low,1,Good Loan,0,12.99,C,3,14.91,33561.88767,25000,0,568.7,409000009767,12-Sep-18,Indiaforensic NFS SETT 11-09-201,"1,000.00",,-543451302.75,Chukwueloka,554,France,12766.74,1,1,0
9769,2011,9,OWN,2,Medium,2,14000, 60 months,2,debt_consolidation,6,High,2,Good Loan,0,18.39,E,5,21.19,21195.50332,14000,0,358.49,409000009768,12-Sep-18,Indiaforensic NFS SETT 11-09-201,"3,500.00",,-543454802.75,Ko,714,Germany,51308.54,1,1,0
9770,2011,2,RENT,1,Low,1,4000, 36 months,1,moving,10,Low,1,Good Loan,0,5.99,A,1,13.74,4379.924075,4000,0,121.67,409000009769,12-Sep-18,Indiaforensic NFS SETT 11-09-201,"10,000.00",,-543464802.75,Atkins,656,France,127444.14,1,1,0
9771,2011,1,MORTGAGE,3,Low,1,12800, 60 months,2,debt_consolidation,6,Low,1,Good Loan,0,11.99,B,2,20.4,14785.14,10610.85,0,284.67,409000009770,12-Sep-18,Indiaforensic NFS SETT 11-09-201,"4,000.00",,-543468802.75,Moffitt,520,France,72577.33,1,1,0
9772,2011,0.5,OWN,2,Low,1,5650, 36 months,1,credit_card,1,High,2,Good Loan,0,15.99,D,4,10.92,7138.820607,5650,0,198.61,409000009771,13-Sep-18,TRF FRM  Indiaforensic SERVICES,,169047.00,-543299755.75,Panicucci,480,Spain,82438.13,1,1,0
9773,2011,3,RENT,1,Low,1,16000, 60 months,2,debt_consolidation,6,High,2,Good Loan,0,13.49,C,3,6.76,19131.67,13182.75,0,368.08,409000009772,13-Sep-18,Indiaforensic  RUPAY SETT 120918,"9,293.12",,-543309048.87,Akobundu,660,Germany,60485.98,1,1,0
9774,2011,10,MORTGAGE,3,Medium,2,12000, 36 months,1,debt_consolidation,6,Low,1,Good Loan,0,12.99,C,3,22.3,14549.61943,12000,0,404.27,409000009773,13-Sep-18,Indiaforensic  RUPAY SETT 120918,,65.58,-543308983.29,Chiu,532,France,132798.78,1,1,0
9775,2011,0.5,RENT,1,Low,1,6000, 36 months,1,debt_consolidation,6,Low,1,Good Loan,0,6.99,A,1,19.68,6558.69,6000,0,185.24,409000009774,13-Sep-18,Indiaforensic RUPAY STL INTC1209,65.58,,-543309048.87,Tsui,679,France,71823.15,1,1,0
9776,2011,10,MORTGAGE,3,Low,1,16000, 60 months,2,debt_consolidation,6,High,2,Good Loan,0,13.99,C,3,10.52,22141.25,16000,0,372.21,409000009775,13-Sep-18,Indiaforensic  RUPAY SETT 130918,"4,999.66",,-543314048.53,Yobanna,780,France,117144.15,1,1,0
9777,2011,10,MORTGAGE,3,Low,1,3625, 36 months,1,debt_consolidation,6,High,2,Good Loan,0,13.49,C,3,21.24,4423.119821,3625,0,123,409000009776,13-Sep-18,Indiaforensic  RUPAY SETT 130918,,46.21,-543314002.32,Hollis,747,France,141706.43,1,1,0
9778,2011,3,RENT,1,Medium,2,10000, 36 months,1,vacation,11,Low,1,Good Loan,0,11.49,B,2,9.66,10777.4,9999.99,0,329.72,409000009777,13-Sep-18,Indiaforensic RUPAY STL INTC1309,46.21,,-543314048.53,Cattaneo,705,France,54517.25,1,1,0
9779,2011,1,RENT,1,Low,1,25000, 60 months,2,debt_consolidation,6,High,2,Good Loan,0,15.23,C,3,12.66,30275.08,25000,0,597.78,409000009778,13-Sep-18,Indiaforensic  RUPAY SETT 130918,922.07,,-543314970.60,Lung,732,France,183147.17,1,1,0
9780,2011,0.5,MORTGAGE,3,Medium,2,25000, 60 months,2,home_improvement,7,High,2,Good Loan,0,13.49,C,3,5.25,31813.55987,25000,0,575.12,409000009779,13-Sep-18,Indiaforensic  RUPAY SETT 130918,,5.00,-543314965.60,Angelo,515,Spain,138360.29,1,1,0
9781,2011,6,RENT,1,Low,1,18000, 36 months,1,debt_consolidation,6,High,2,Good Loan,0,13.49,C,3,18.58,21979.09633,18000,0,610.75,409000009780,13-Sep-18,Indiaforensic RUPAY STL INTC1309,5,,-543314970.60,Folliero,816,Germany,79580.56,1,1,0
9782,2011,7,MORTGAGE,3,Medium,2,8000, 36 months,1,credit_card,1,Low,1,Good Loan,0,11.99,B,2,17.31,8587.69,8000,0,265.68,409000009781,14-Sep-18,Indiaforensic  RUPAY SETT 140918,"3,386.53",,-543318357.13,Bryant,641,France,157458.61,1,1,0
9783,2011,10,MORTGAGE,3,Medium,2,34000, 60 months,2,debt_consolidation,6,High,2,Good Loan,0,18.79,E,5,4.82,45617.61,27425.9,0,878.06,409000009782,14-Sep-18,Indiaforensic  RUPAY SETT 140918,,47.79,-543318309.34,Weigel,509,France,171770.58,1,1,0
9784,2011,6.05,MORTGAGE,3,Low,1,3000, 36 months,1,major_purchase,8,Low,1,Good Loan,0,10.99,B,2,3.33,3531.797909,3000,0,98.21,409000009783,14-Sep-18,Indiaforensic RUPAY STL INTC1409,37.79,,-543318347.13,Ajuluchukwu,601,Germany,104263.82,1,1,0
9785,2011,6,RENT,1,Low,1,11000, 36 months,1,debt_consolidation,6,High,2,Good Loan,0,13.49,C,3,13.94,13424.80704,11000,0,373.24,409000009784,14-Sep-18,Indiaforensic RUPAY STL INTC1409,,0.16,-543318346.97,Zhirov,527,France,167183.07,1,1,0
9786,2011,4,RENT,1,Low,1,11200, 36 months,1,debt_consolidation,6,High,2,Good Loan,0,13.99,C,3,20.04,13333.54,11200,0,382.74,409000009785,14-Sep-18,Indiaforensic  RUPAY SETT 140918,190.71,,-543318537.68,Cox,455,France,70774.97,1,1,0
9787,2011,10,RENT,1,Low,1,6800, 36 months,1,debt_consolidation,6,Low,1,Good Loan,0,10.59,B,2,13.53,7505.04,6800,0,221.31,409000009786,14-Sep-18,Indiaforensic  RUPAY SETT 140918,,0.95,-543318536.73,Chimaraoke,803,Germany,114869.56,1,1,0
9788,2011,3,MORTGAGE,3,Low,1,20000, 60 months,2,wedding,5,High,2,Good Loan,0,16.49,D,4,24.58,22109.89,20000,0,491.59,409000009787,14-Sep-18,Indiaforensic RUPAY STL INTC1409,0.95,,-543318537.68,Genovese,553,France,109159.58,1,1,0
9789,2011,6.05,MORTGAGE,3,Low,1,5000, 60 months,2,other,4,Low,1,Good Loan,0,10.99,B,2,16.39,5637.78,4156.11,0,108.69,409000009788,14-Sep-18,TRF FRM  Indiaforensic SERVICES,,162000.00,-543156537.68,Ohearn,724,France,59351.68,1,1,0
9790,2011,2,RENT,1,Low,1,12000, 36 months,1,debt_consolidation,6,High,2,Good Loan,0,15.99,D,4,5.43,15168.3499,12000,0,421.83,409000009789,14-Sep-18,Indiaforensic NFS SETT 12-09-201,"10,000.00",,-543166537.68,Munroe,610,France,199657.46,1,1,0
9791,2011,4,OWN,2,Low,1,14000, 36 months,1,vacation,11,Low,1,Good Loan,0,10.99,B,2,13.71,16009.78,14000,0,458.28,409000009790,14-Sep-18,Indiaforensic NFS SETT 12-09-201,"8,000.00",,-543174537.68,Morrison,559,Spain,121151.10,1,1,0
9792,2011,1,MORTGAGE,3,Low,1,4200, 36 months,1,credit_card,1,Low,1,Good Loan,0,5.99,A,1,8.38,4515.43,4200,0,127.76,409000009791,14-Sep-18,Indiaforensic NFS SETT 12-09-201,500,,-543175037.68,Parkhill,825,Germany,26342.33,1,1,0
9793,2011,10,MORTGAGE,3,Low,1,25000, 60 months,2,other,4,High,2,Bad Loan,1,19.29,E,5,23.07,27337.85,11645.55,4516.8,652.51,409000009792,14-Sep-18,Indiaforensic NFS SETT 12-09-201,"8,000.00",,-543183037.68,Y?,819,Spain,102799.14,1,1,0
9794,2011,10,MORTGAGE,3,Low,1,1500, 60 months,2,other,4,Low,1,Good Loan,0,8.49,A,1,22.01,1596.74,1259.27,0,30.77,409000009793,14-Sep-18,Indiaforensic NFS SETT 12-09-201,"8,500.00",,-543191537.68,Hilton,772,Germany,90928.48,1,1,0
9795,2011,5,MORTGAGE,3,High,3,10000, 36 months,1,debt_consolidation,6,Low,1,Good Loan,0,8.49,A,1,2.85,10397.77,10000,0,315.63,409000009794,14-Sep-18,Indiaforensic NFS SETT 12-09-201,400,,-543191937.68,Thompson,685,Spain,141152.28,1,1,0
9796,2011,5,MORTGAGE,3,Low,1,20800, 60 months,2,credit_card,1,High,2,Good Loan,0,20.62,F,6,19.73,31688.74684,20800,0,558.28,409000009795,14-Sep-18,Indiaforensic NFS SETT 12-09-201,"8,000.00",,-543199937.68,Yobanna,506,France,105568.60,1,1,0
9797,2011,6,MORTGAGE,3,Low,1,5000, 36 months,1,debt_consolidation,6,Low,1,Good Loan,0,11.49,B,2,5.02,5652.25,5000,0,164.86,409000009796,14-Sep-18,Indiaforensic NFS SETT 12-09-201,"10,000.00",,-543209937.68,Thorpe,642,Germany,183045.46,1,1,0
9798,2011,3,MORTGAGE,3,Low,1,13000, 36 months,1,debt_consolidation,6,Low,1,Bad Loan,1,8.49,A,1,11.69,8949.61,7151.59,333.85,410.32,409000009797,14-Sep-18,Indiaforensic NFS SETT 12-09-201,800,,-543210737.68,Harvey,627,Spain,194792.42,1,1,0
9799,2011,10,MORTGAGE,3,Low,1,4000, 36 months,1,other,4,Low,1,Good Loan,0,10.99,B,2,12.27,4691.643852,4000,0,130.94,409000009798,14-Sep-18,Indiaforensic NFS SETT 12-09-201,"5,000.00",,-543215737.68,Robinson,600,Germany,21852.91,1,1,0
9800,2011,0.5,MORTGAGE,3,Low,1,3000, 60 months,2,car,2,High,2,Bad Loan,1,13.99,C,3,6.82,981.75,444.42,146.55,69.79,409000009799,14-Sep-18,Indiaforensic NFS SETT 12-09-201,500,,-543216237.68,Manna,653,France,78250.13,1,1,0
9801,2011,5,MORTGAGE,3,Low,1,14000, 60 months,2,debt_consolidation,6,Low,1,Good Loan,0,11.49,B,2,18.17,15966.95,11614.58,0,307.83,409000009800,14-Sep-18,Indiaforensic NFS SETT 12-09-201,"3,000.00",,-543219237.68,Li,762,Spain,47114.18,1,1,0
9802,2011,10,MORTGAGE,3,Low,1,8000, 36 months,1,car,2,Low,1,Good Loan,0,5.42,A,1,24.16,8684.130421,8000,0,241.28,409000009801,14-Sep-18,Indiaforensic NFS SETT 12-09-201,"1,000.00",,-543220237.68,Hancock,569,Spain,33230.37,1,1,0
9803,2011,9,RENT,1,Low,1,18000, 36 months,1,debt_consolidation,6,High,2,Good Loan,0,13.99,C,3,13.16,20755.58,18000,0,615.11,409000009802,14-Sep-18,Indiaforensic NFS SETT 12-09-201,"8,000.00",,-543228237.68,Hao,756,France,114279.63,1,1,0
9804,2011,4,OWN,2,Low,1,10500, 36 months,1,debt_consolidation,6,Low,1,Good Loan,0,7.49,A,1,4.96,11753.53899,10500,0,326.57,409000009803,14-Sep-18,Indiaforensic NFS SETT 12-09-201,"1,000.00",,-543229237.68,Nicholls,673,France,38802.03,1,1,0
9805,2011,1,RENT,1,Low,1,10000, 36 months,1,debt_consolidation,6,Low,1,Good Loan,0,7.49,A,1,11.86,10876.79,10000,0,311.02,409000009804,14-Sep-18,Indiaforensic NFS SETT 12-09-201,"1,000.00",,-543230237.68,Folliero,637,France,72504.76,1,1,0
9806,2011,10,RENT,1,Low,1,3000, 36 months,1,debt_consolidation,6,Low,1,Good Loan,0,10.99,B,2,20.96,3454.82,3000,0,98.21,409000009805,14-Sep-18,Indiaforensic NFS SETT 12-09-201,"3,000.00",,-543233237.68,Trumbull,644,France,43943.09,1,1,0
9807,2011,6.05,MORTGAGE,3,High,3,8500, 36 months,1,credit_card,1,Low,1,Good Loan,0,7.49,A,1,9.22,9511.881724,8500,0,264.37,409000009806,14-Sep-18,Indiaforensic NFS SETT 12-09-201,400,,-543233637.68,Medvedeva,658,Spain,68141.92,1,1,0
9808,2011,10,MORTGAGE,3,Low,1,4400, 36 months,1,medical,9,Low,1,Good Loan,0,5.99,A,1,8.43,4813.921,4400,0,133.84,409000009807,14-Sep-18,Indiaforensic NFS SETT 12-09-201,"7,000.00",,-543240637.68,Crist,649,France,109179.89,1,1,0
9809,2011,10,MORTGAGE,3,Low,1,6000, 36 months,1,vacation,11,Low,1,Good Loan,0,6.99,A,1,18.16,6666.677069,6000,0,185.24,409000009808,14-Sep-18,Indiaforensic NFS SETT 12-09-201,"8,000.00",,-543248637.68,Middleton,603,France,48224.72,1,1,0
9810,2011,10,RENT,1,Low,1,25300, 36 months,1,small_business,3,Low,1,Bad Loan,1,10.99,B,2,1.68,25242.42,20779.44,0,828.17,409000009809,14-Sep-18,Indiaforensic NFS SETT 12-09-201,200,,-543248837.68,Watts,820,France,61538.43,1,1,0
9811,2011,10,MORTGAGE,3,Low,1,7000, 36 months,1,home_improvement,7,Low,1,Good Loan,0,8.49,A,1,12.22,7950.843538,7000,0,220.95,409000009810,14-Sep-18,Indiaforensic NFS SETT 12-09-201,"8,000.00",,-543256837.68,Udinese,712,Spain,94544.88,1,1,0
9812,2011,8,MORTGAGE,3,Low,1,10000, 36 months,1,debt_consolidation,6,High,2,Good Loan,0,13.49,C,3,16.69,12042.33,10000,0,339.31,409000009811,14-Sep-18,Indiaforensic NFS SETT 13-09-201,"4,000.00",,-543260837.68,Tretiakov,645,Germany,2850.01,1,1,0
9813,2011,2,RENT,1,Low,1,4000, 36 months,1,debt_consolidation,6,High,2,Bad Loan,1,15.62,D,4,11.86,1841.33,1050.33,168.55,139.88,409000009812,14-Sep-18,Indiaforensic NFS SETT 13-09-201,600,,-543261437.68,O'Kane,705,Germany,163484.80,1,1,0
9814,2011,5,MORTGAGE,3,High,3,35000, 36 months,1,credit_card,1,High,2,Good Loan,0,13.99,C,3,21.76,42316.83,35000,0,1196.05,409000009813,14-Sep-18,Indiaforensic NFS SETT 13-09-201,"1,500.00",,-543262937.68,Vasilyeva,590,Spain,129629.41,1,1,0
9815,2011,3,MORTGAGE,3,Low,1,7200, 36 months,1,debt_consolidation,6,Low,1,Good Loan,0,10.59,B,2,26.4,8433.809038,7200,0,234.33,409000009814,14-Sep-18,Indiaforensic NFS SETT 13-09-201,"1,500.00",,-543264437.68,Wei,631,France,133141.34,1,1,0
9816,2011,10,RENT,1,Low,1,15000, 60 months,2,debt_consolidation,6,Low,1,Good Loan,0,10.99,B,2,13.42,16948.56,12475.05,0,326.07,409000009815,14-Sep-18,Indiaforensic NFS SETT 13-09-201,500,,-543264937.68,Chinonyelum,604,France,188078.55,1,1,0
9817,2011,8,RENT,1,Low,1,5175, 60 months,2,debt_consolidation,6,Low,1,Good Loan,0,11.99,B,2,4.93,5963.98,4281.2,0,115.09,409000009816,14-Sep-18,Indiaforensic NFS SETT 13-09-201,500,,-543265437.68,Chin,643,Spain,174729.30,1,1,0
9818,2011,6,MORTGAGE,3,Medium,2,12000, 36 months,1,debt_consolidation,6,Low,1,Good Loan,0,11.99,B,2,9.27,14345.79702,12000,0,398.52,409000009817,14-Sep-18,Indiaforensic NFS SETT 13-09-201,"2,000.00",,-543267437.68,Lorimer,690,Spain,78700.03,1,1,0
9819,2011,2,RENT,1,Low,1,14700, 60 months,2,debt_consolidation,6,Low,1,Good Loan,0,11.99,B,2,17.71,18759.28141,14700,0,326.92,409000009818,14-Sep-18,Indiaforensic NFS SETT 13-09-201,500,,-543267937.68,Yeh,558,France,198269.08,1,1,0
9820,2011,1,RENT,1,Low,1,7000, 60 months,2,debt_consolidation,6,High,2,Good Loan,0,20.99,F,6,12.77,10923.89657,7000,0,189.34,409000009819,14-Sep-18,Indiaforensic NFS SETT 13-09-201,400,,-543268337.68,Duffy,637,Germany,55266.96,1,1,0
9821,2011,10,MORTGAGE,3,Low,1,11300, 60 months,2,debt_consolidation,6,Low,1,Bad Loan,1,12.99,C,3,17.62,9254.16,5857.52,58.5,257.06,409000009820,14-Sep-18,Indiaforensic NFS SETT 13-09-201,"3,000.00",,-543271337.68,Onyekachukwu,648,Germany,51636.70,1,1,0
9822,2011,2,MORTGAGE,3,Low,1,24000, 60 months,2,small_business,3,High,2,Good Loan,0,17.99,E,5,24.33,31664.84,19429.07,0,609.32,409000009821,14-Sep-18,Indiaforensic NFS SETT 13-09-201,200,,-543271537.68,Banks,652,Spain,198251.52,1,1,0
9823,2011,5,MORTGAGE,3,Low,1,3600, 36 months,1,home_improvement,7,Low,1,Good Loan,0,5.99,A,1,13.25,3936.483668,3600,0,109.51,409000009822,14-Sep-18,Indiaforensic NFS SETT 13-09-201,"5,000.00",,-543276537.68,Hughes,808,Germany,171442.36,1,1,0
9824,2011,1,RENT,1,Low,1,3600, 36 months,1,car,2,Low,1,Good Loan,0,5.99,A,1,12.54,3701.72,3600,0,109.51,409000009823,14-Sep-18,Indiaforensic NFS SETT 13-09-201,"5,000.00",,-543281537.68,Lai,551,France,49778.79,1,1,0
9825,2011,3,RENT,1,Low,1,5000, 36 months,1,car,2,Low,1,Good Loan,0,11.49,B,2,8.24,5931.679535,5000,0,164.86,409000009824,14-Sep-18,Indiaforensic NFS SETT 13-09-201,"5,000.00",,-543286537.68,Matthews,711,Germany,19262.05,1,1,0
9826,2011,10,MORTGAGE,3,Low,1,18400, 36 months,1,debt_consolidation,6,Low,1,Good Loan,0,5.99,A,1,17.89,20148.18595,18400,0,559.69,409000009825,14-Sep-18,Indiaforensic NFS SETT 13-09-201,"6,000.00",,-543292537.68,Bell,467,Germany,32349.29,1,1,0
9827,2011,3,RENT,1,Low,1,11100, 36 months,1,debt_consolidation,6,Low,1,Good Loan,0,10.59,B,2,25.08,12998.91993,11100,0,361.25,409000009826,14-Sep-18,Indiaforensic NFS SETT 13-09-201,"5,000.00",,-543297537.68,Tu,789,Spain,137402.27,1,1,0
9828,2011,2,MORTGAGE,3,Low,1,10000, 36 months,1,debt_consolidation,6,Low,1,Good Loan,0,10.59,B,2,2.95,10851.91,10000,0,325.45,409000009827,14-Sep-18,Indiaforensic NFS SETT 13-09-201,"4,000.00",,-543301537.68,Hsia,602,Spain,64038.34,1,1,0
9829,2011,10,MORTGAGE,3,Low,1,4800, 36 months,1,major_purchase,8,Low,1,Good Loan,0,10.99,B,2,14.15,5422.96,4800,0,157.13,409000009828,14-Sep-18,Indiaforensic NFS SETT 13-09-201,"9,000.00",,-543310537.68,Cheng,576,France,68814.23,1,1,0
9830,2011,2,RENT,1,Low,1,12000, 60 months,2,moving,10,High,2,Good Loan,0,17.49,D,4,20.79,13573.95,12000.01,0,301.41,409000009829,14-Sep-18,Indiaforensic NFS SETT 13-09-201,"1,500.00",,-543312037.68,Cheng,584,France,173632.92,1,1,0
9831,2011,4,RENT,1,Low,1,2400, 36 months,1,small_business,3,Low,1,Good Loan,0,12.99,C,3,15.01,2909.535465,2400,0,80.86,409000009830,14-Sep-18,Indiaforensic NFS SETT 13-09-201,"5,500.00",,-543317537.68,Lin,593,France,128384.11,1,1,0
9832,2011,2,MORTGAGE,3,High,3,35000, 60 months,2,home_improvement,7,High,2,Good Loan,0,20.99,F,6,12.95,35612.74,35000,0,946.68,409000009831,14-Sep-18,Indiaforensic NFS SETT 13-09-201,100,,-543317637.68,Higgins,705,Germany,99475.95,1,1,0
9833,2011,4,MORTGAGE,3,Low,1,16000, 60 months,2,home_improvement,7,High,2,Good Loan,0,17.99,E,5,13.53,21103.37,16000,0,406.21,409000009832,15-Sep-18,Indiaforensic  RUPAY SETT 150918,"8,745.61",,-543326383.29,Chukwujekwu,595,Germany,89935.73,1,1,0
9834,2011,0.5,RENT,1,High,3,6000, 36 months,1,car,2,Low,1,Good Loan,0,10.99,B,2,5.51,6695.12,6000,0,196.41,409000009833,15-Sep-18,Indiaforensic  RUPAY SETT 150918,,111.08,-543326272.21,McKay,699,Germany,94142.35,1,1,0
9835,2011,5,RENT,1,Low,1,10000, 36 months,1,credit_card,1,Low,1,Good Loan,0,7.49,A,1,8.44,11193.70631,10000,0,311.02,409000009834,15-Sep-18,Indiaforensic RUPAY STL INTC1509,106.58,,-543326378.79,Vincent,516,France,171681.86,1,1,0
9836,2011,3,RENT,1,Low,1,3500, 60 months,2,renewable_energy,13,High,2,Good Loan,0,18.39,E,5,3.09,4242.84,3500,0,89.63,409000009835,15-Sep-18,Indiaforensic RUPAY STL INTC1509,,0.02,-543326378.77,Ubanwa,838,France,8222.96,1,1,0
9837,2011,7,RENT,1,Low,1,20000, 60 months,2,credit_card,1,High,2,Good Loan,0,17.99,E,5,18.04,26372.92,16183.15,0,507.76,409000009836,15-Sep-18,Indiaforensic  RUPAY SETT 150918,"1,027.14",,-543327405.91,Ch'ien,587,France,170409.45,1,1,0
9838,2011,2,MORTGAGE,3,Medium,2,15600, 60 months,2,other,4,High,2,Good Loan,0,20.99,F,6,16.01,17193.91,15600,0,421.95,409000009837,15-Sep-18,Indiaforensic  RUPAY SETT 150918,,13.40,-543327392.51,T'ien,750,France,46555.15,1,1,0
9839,2011,10,MORTGAGE,3,Low,1,21000, 60 months,2,small_business,3,High,2,Good Loan,0,20.25,F,6,13.14,30284.58184,21000,0,559.3,409000009838,15-Sep-18,Indiaforensic RUPAY STL INTC1509,10.68,,-543327403.19,Ricci,581,Germany,161655.55,1,1,0
9840,2011,10,MORTGAGE,3,Low,1,6000, 36 months,1,debt_consolidation,6,Low,1,Good Loan,0,10.99,B,2,24.53,7065.080274,6000,0,196.41,409000009839,15-Sep-18,Indiaforensic RUPAY STL INTC1509,,0.02,-543327403.17,McDowell,484,France,74267.35,1,1,0
9841,2011,10,MORTGAGE,3,Low,1,8500, 36 months,1,medical,9,Low,1,Good Loan,0,11.49,B,2,13.26,10083.20623,8500,0,280.26,409000009840,15-Sep-18,Indiaforensic NFS SETT 14-09-201,"4,000.00",,-543331403.17,Maclean,576,Spain,34101.06,1,1,0
9842,2011,9,MORTGAGE,3,Low,1,9800, 36 months,1,credit_card,1,Low,1,Good Loan,0,6.99,A,1,21.2,10465.84,9800,0,302.56,409000009841,15-Sep-18,Indiaforensic NFS SETT 14-09-201,"5,000.00",,-543336403.17,Manna,567,Germany,109572.58,1,1,0
9843,2011,2,MORTGAGE,3,Low,1,7000, 36 months,1,car,2,Low,1,Good Loan,0,7.49,A,1,18.83,7835.862895,7000,0,217.72,409000009842,15-Sep-18,Indiaforensic NFS SETT 14-09-201,"2,500.00",,-543338903.17,Jibunoh,638,Spain,106642.97,1,1,0
9844,2011,10,RENT,1,Low,1,20500, 60 months,2,debt_consolidation,6,High,2,Good Loan,0,22.85,G,7,23.07,29928.98,16161.82,0,576.14,409000009843,15-Sep-18,Indiaforensic NFS SETT 14-09-201,"8,000.00",,-543346903.17,Fan,646,Germany,18897.29,1,1,0
9845,2011,4,OWN,2,Low,1,7000, 36 months,1,major_purchase,8,Low,1,Good Loan,0,7.49,A,1,7.26,7835.788532,7000,0,217.72,409000009844,15-Sep-18,Indiaforensic NFS SETT 14-09-201,"9,000.00",,-543355903.17,Hsieh,658,France,189607.71,1,1,0
9846,2011,5,RENT,1,Low,1,10000, 36 months,1,small_business,3,Low,1,Good Loan,0,9.99,B,2,21.93,11575.14164,10000,0,322.63,409000009845,15-Sep-18,Indiaforensic NFS SETT 14-09-201,"1,000.00",,-543356903.17,Parsons,590,Spain,148750.16,1,1,0
9847,2011,10,MORTGAGE,3,Medium,2,7000, 36 months,1,medical,9,Low,1,Good Loan,0,11.99,B,2,15.42,8368.43843,7000,0,232.47,409000009846,15-Sep-18,Indiaforensic NFS SETT 14-09-201,"6,000.00",,-543362903.17,Udinese,546,Spain,105279.74,1,1,0
9848,2011,5,MORTGAGE,3,Low,1,22000, 60 months,2,credit_card,1,Low,1,Good Loan,0,12.99,C,3,9.85,28688.37924,22000,0,500.46,409000009847,15-Sep-18,Indiaforensic NFS SETT 14-09-201,400,,-543363303.17,Root,603,France,167916.35,1,1,0
9849,2011,10,MORTGAGE,3,Low,1,3325, 36 months,1,major_purchase,8,Low,1,Good Loan,0,5.42,A,1,25.7,3609.226469,3325,0,100.29,409000009848,15-Sep-18,Indiaforensic NFS SETT 14-09-201,"1,000.00",,-543364303.17,Chiemezie,619,Spain,8646.58,1,1,0
9850,2011,1,RENT,1,Low,1,12000, 60 months,2,debt_consolidation,6,High,2,Bad Loan,1,14.79,C,3,14.72,8245.99,3975.56,1137.8,284.16,409000009849,15-Sep-18,Indiaforensic NFS SETT 14-09-201,200,,-543364503.17,Toscani,678,France,124592.84,1,1,0
9851,2011,0.5,RENT,1,Low,1,4500, 36 months,1,other,4,High,2,Bad Loan,1,13.49,C,3,23.02,1802.33,1165.86,190.91,152.69,409000009850,15-Sep-18,Indiaforensic NFS SETT 14-09-201,100,,-543364603.17,Obidimkpa,459,France,50016.17,1,1,0
9852,2011,2,RENT,1,Low,1,9175, 60 months,2,small_business,3,Low,1,Bad Loan,1,10.59,B,2,26.25,7661.52,4420.82,1140.06,197.62,409000009851,15-Sep-18,Indiaforensic NFS SETT 14-09-201,"5,600.00",,-543370203.17,Degtyaryov,671,Germany,125422.66,1,1,0
9853,2011,10,MORTGAGE,3,Medium,2,30000, 36 months,1,home_improvement,7,Low,1,Good Loan,0,9.99,B,2,7.43,34838.00016,30000,0,967.88,409000009852,15-Sep-18,Indiaforensic NFS SETT 14-09-201,"5,500.00",,-543375703.17,Maclean,501,Spain,81123.59,1,1,0
9854,2011,5,RENT,1,Low,1,4000, 36 months,1,debt_consolidation,6,Low,1,Bad Loan,1,12.99,C,3,18.6,672.65,466.51,0,134.76,409000009853,15-Sep-18,Indiaforensic NFS SETT 14-09-201,"7,000.00",,-543382703.17,Giordano,719,Spain,80408.59,1,1,0
9855,2011,3,RENT,1,Low,1,24000, 60 months,2,debt_consolidation,6,High,2,Good Loan,0,15.99,D,4,21.85,33874.15758,24000,0,583.51,409000009854,15-Sep-18,Indiaforensic NFS SETT 14-09-201,"4,000.00",,-543386703.17,Saad,681,Spain,146366.08,1,1,0
9856,2011,6.05,OWN,2,Low,1,1500, 36 months,1,other,4,Low,1,Good Loan,0,5.99,A,1,12.6,1640.18426,1500,0,45.63,409000009855,15-Sep-18,Indiaforensic NFS SETT 14-09-201,"8,000.00",,-543394703.17,Lord,706,Spain,24402.87,1,1,0
9857,2011,3,RENT,1,Low,1,6000, 36 months,1,moving,10,Low,1,Good Loan,0,8.49,A,1,8.93,6813.403474,6000,0,189.38,409000009856,15-Sep-18,Indiaforensic NFS SETT 14-09-201,100,,-543394803.17,Hope,763,Germany,60552.44,1,1,0
9858,2011,6,MORTGAGE,3,Low,1,12800, 36 months,1,debt_consolidation,6,Low,1,Bad Loan,1,7.49,A,1,15.34,3582.21,2926.69,11.19,398.11,409000009857,15-Sep-18,Indiaforensic NFS SETT 14-09-201,100,,-543394903.17,K?,716,France,76476.05,1,1,0
9859,2011,5,MORTGAGE,3,Medium,2,12000, 36 months,1,debt_consolidation,6,Low,1,Good Loan,0,11.99,B,2,7.86,14341.91375,12000,0,398.52,409000009858,15-Sep-18,Indiaforensic NFS SETT 14-09-201,400,,-543395303.17,Bull,507,Germany,92075.01,1,1,0
9860,2011,3,RENT,1,Low,1,5400, 36 months,1,debt_consolidation,6,Low,1,Good Loan,0,11.99,B,2,10.19,6322.33,5400,0,179.34,409000009859,15-Sep-18,Indiaforensic NFS SETT 14-09-201,"5,000.00",,-543400303.17,Adams,678,Germany,184125.10,1,1,0
9861,2011,5,MORTGAGE,3,Low,1,10000, 36 months,1,credit_card,1,Low,1,Good Loan,0,8.49,A,1,12.24,11163.9,9999.99,0,315.63,409000009860,15-Sep-18,Indiaforensic NFS SETT 14-09-201,"4,000.00",,-543404303.17,Brookes,775,France,96170.38,1,1,0
9862,2011,10,RENT,1,Low,1,9500, 60 months,2,debt_consolidation,6,Low,1,Good Loan,0,10.99,B,2,17.7,9758.19,9500,0,206.51,409000009861,15-Sep-18,Indiaforensic NFS SETT 14-09-201,"2,000.00",,-543406303.17,Victor,544,France,98208.62,1,1,0
9863,2011,6.05,OWN,2,Low,1,8000, 60 months,2,other,4,Low,1,Good Loan,0,11.99,B,2,1.05,9229.34,6624.56,0,177.92,409000009862,15-Sep-18,Indiaforensic NFS SETT 14-09-201,"1,100.00",,-543407403.17,Giles,756,France,157932.75,1,1,0
9864,2011,6.05,MORTGAGE,3,Low,1,7800, 36 months,1,debt_consolidation,6,Low,1,Good Loan,0,6.99,A,1,20.11,8667.418419,7800,0,240.81,409000009863,15-Sep-18,Indiaforensic NFS SETT 14-09-201,"1,500.00",,-543408903.17,Ferrari,757,Germany,3497.43,1,1,0
9865,2011,10,MORTGAGE,3,Low,1,3200, 36 months,1,debt_consolidation,6,Low,1,Good Loan,0,5.99,A,1,14.58,3472.64,3200,0,97.34,409000009864,15-Sep-18,Indiaforensic NFS SETT 14-09-201,200,,-543409103.17,Milne,742,Germany,51387.10,1,1,0
9866,2011,2,RENT,1,Low,1,20000, 60 months,2,debt_consolidation,6,Low,1,Good Loan,0,12.99,C,3,12.22,20846.96,20000,0,454.96,409000009865,15-Sep-18,Indiaforensic NFS SETT 14-09-201,"1,000.00",,-543410103.17,Parry,591,France,50123.44,1,1,0
9867,2011,2,MORTGAGE,3,Low,1,1800, 60 months,2,debt_consolidation,6,High,2,Good Loan,0,20.25,F,6,2.63,2485.68,1440.67,0,47.94,409000009866,15-Sep-18,Indiaforensic NFS SETT 14-09-201,"6,000.00",,-543416103.17,Allan,667,France,180329.83,1,1,0
9868,2011,10,MORTGAGE,3,Low,1,24000, 60 months,2,debt_consolidation,6,Low,1,Good Loan,0,12.99,C,3,6.88,16639.31,15100,0,343.5,409000009867,15-Sep-18,Indiaforensic NFS SETT 14-09-201,100,,-543416203.17,Warren,787,France,13238.93,1,1,0
9869,2011,1,RENT,1,Low,1,3000, 36 months,1,credit_card,1,Low,1,Good Loan,0,8.49,A,1,9.18,3406.409744,3000,0,94.69,409000009868,15-Sep-18,Indiaforensic NFS SETT 14-09-201,"7,000.00",,-543423203.17,Rowntree,718,France,167554.86,1,1,0
9870,2011,0.5,RENT,1,Low,1,5600, 36 months,1,credit_card,1,Low,1,Good Loan,0,8.49,A,1,11.85,6344.757154,5600,0,176.76,409000009869,15-Sep-18,Indiaforensic NFS SETT 14-09-201,500,,-543423703.17,Andrejew,521,France,51454.06,1,1,0
9871,2011,2,RENT,1,Low,1,5000, 36 months,1,major_purchase,8,High,2,Bad Loan,1,17.99,E,5,0.4,720.84,431.47,0,180.74,409000009870,15-Sep-18,Indiaforensic NFS SETT 14-09-201,"10,000.00",,-543433703.17,Corby,607,Spain,19842.22,1,1,0
9872,2011,2,RENT,1,Low,1,3000, 36 months,1,credit_card,1,High,2,Good Loan,0,13.49,C,3,18.94,3644.212034,3000,0,101.8,409000009871,15-Sep-18,Indiaforensic NFS SETT 14-09-201,"3,000.00",,-543436703.17,Kennedy,633,France,38315.04,1,1,0
9873,2011,10,MORTGAGE,3,Low,1,16000, 60 months,2,debt_consolidation,6,Low,1,Good Loan,0,10.99,B,2,24.13,17754.53,16000,0,347.8,409000009872,15-Sep-18,Indiaforensic NFS SETT 14-09-201,"10,000.00",,-543446703.17,Young,588,Spain,187816.59,1,1,0
9874,2011,0.5,MORTGAGE,3,Low,1,10000, 36 months,1,wedding,5,Low,1,Bad Loan,1,10.59,B,2,14.75,6527.43,4790.43,297.82,325.45,409000009873,15-Sep-18,Indiaforensic NFS SETT 14-09-201,"10,000.00",,-543456703.17,Poole,724,Germany,197148.24,1,1,0
9875,2011,5,RENT,1,Low,1,2500, 36 months,1,credit_card,1,Low,1,Good Loan,0,11.99,B,2,15.1,2926.78,2500,0,83.03,409000009874,15-Sep-18,Indiaforensic NFS SETT 14-09-201,"10,000.00",,-543466703.17,Fletcher,720,France,163471.01,1,1,0
9876,2011,10,MORTGAGE,3,Low,1,4800, 36 months,1,debt_consolidation,6,Low,1,Good Loan,0,11.49,B,2,0.02,5694.476994,4800,0,158.27,409000009875,15-Sep-18,Indiaforensic NFS SETT 14-09-201,"1,000.00",,-543467703.17,Tsao,521,France,653.58,1,1,0
9877,2011,8,RENT,1,Low,1,12000, 36 months,1,debt_consolidation,6,High,2,Good Loan,0,13.99,C,3,10.25,14758.22682,12000,0,410.08,409000009876,15-Sep-18,Indiaforensic NFS SETT 14-09-201,"9,000.00",,-543476703.17,Gilroy,620,Spain,45414.09,1,1,0
9878,2011,4,RENT,1,Low,1,9350, 36 months,1,credit_card,1,Low,1,Good Loan,0,7.49,A,1,22.01,10481.85159,9350,0,290.81,409000009877,17-Sep-18,Indiaforensic RUPAY SETT 160918,"3,832.92",,-543480536.09,Onwuamaeze,505,Germany,45445.78,1,1,0
9879,2011,10,RENT,1,Low,1,20000, 36 months,1,debt_consolidation,6,Low,1,Good Loan,0,7.49,A,1,18.86,22365.99939,20000,0,622.04,409000009878,17-Sep-18,Indiaforensic RUPAY SETT 160918,,45.13,-543480490.96,Manna,728,Spain,139024.31,1,1,0
9880,2011,0.5,RENT,1,Low,1,6000, 36 months,1,credit_card,1,Low,1,Good Loan,0,7.49,A,1,12,6715.384405,6000,0,186.61,409000009879,17-Sep-18,Indiaforensic RUPAY STL INTC1609,44.38,,-543480535.34,Pisano,486,Germany,168034.83,1,1,0
9881,2011,10,RENT,1,Low,1,13600, 36 months,1,debt_consolidation,6,Low,1,Good Loan,0,11.99,B,2,3.76,16258.7033,13600,0,451.65,409000009880,17-Sep-18,Indiaforensic RUPAY SETT 170918,"5,738.35",,-543486273.69,Thorpe,584,Germany,25669.10,1,1,0
9882,2011,3,RENT,1,Low,1,13650, 60 months,2,debt_consolidation,6,High,2,Bad Loan,1,23.59,G,7,15.42,15463.37,6486.18,1087.02,389.45,409000009881,17-Sep-18,Indiaforensic RUPAY SETT 170918,,60.70,-543486212.99,Dwyer,687,Spain,8207.36,1,1,0
9883,2011,3,RENT,1,Low,1,5000, 36 months,1,debt_consolidation,6,Low,1,Good Loan,0,7.49,A,1,15.49,5592.34873,5000,0,155.51,409000009882,17-Sep-18,Indiaforensic RUPAY STL INTC1709,58.97,,-543486271.96,Okeke,771,France,16281.68,1,1,0
9884,2011,10,MORTGAGE,3,Low,1,14000, 36 months,1,debt_consolidation,6,High,2,Good Loan,0,15.62,D,4,17.29,17610.41307,14000,0,489.58,409000009883,17-Sep-18,Indiaforensic RUPAY STL INTC1709,,0.01,-543486271.95,Zito,678,France,14083.12,1,1,0
9885,2011,0.5,RENT,1,Low,1,2800, 36 months,1,major_purchase,8,Low,1,Good Loan,0,6.99,A,1,15.44,3097.88,2800,0,86.45,409000009884,17-Sep-18,Indiaforensic  RUPAY SETT 170918,"3,257.00",,-543489528.95,Sergeyeva,751,France,30165.06,1,1,0
9886,2011,7,MORTGAGE,3,Low,1,12000, 60 months,2,credit_card,1,High,2,Bad Loan,1,15.23,C,3,20.18,14591.43,9550.36,0,286.93,409000009885,17-Sep-18,Indiaforensic  RUPAY SETT 170918,,26.66,-543489502.29,Fang,670,France,39451.09,1,1,0
9887,2011,4,MORTGAGE,3,Low,1,10000, 36 months,1,major_purchase,8,Low,1,Good Loan,0,8.49,A,1,11.46,11163.98,10000,0,315.63,409000009886,17-Sep-18,Indiaforensic RUPAY STL INTC1709,26.66,,-543489528.95,Flannagan,675,Spain,60270.87,1,1,0
9888,2011,5,MORTGAGE,3,Medium,2,5400, 36 months,1,other,4,Low,1,Good Loan,0,5.99,A,1,4.46,5596.46,5400,0,164.26,409000009887,17-Sep-18,Indiaforensic NFS SETT 15-09-201,"10,000.00",,-543499528.95,Mao,684,Spain,22527.27,1,1,0
9889,2011,1,RENT,1,Low,1,30000, 60 months,2,other,4,High,2,Good Loan,0,20.99,F,6,16.68,47423.19536,30000,0,811.44,409000009888,17-Sep-18,Indiaforensic NFS SETT 15-09-201,"10,000.00",,-543509528.95,Sturdee,637,France,175072.47,1,1,0
9890,2011,8,RENT,1,Low,1,8400, 36 months,1,debt_consolidation,6,High,2,Good Loan,0,13.99,C,3,12.44,10327.03701,8400,0,287.06,409000009889,17-Sep-18,Indiaforensic NFS SETT 15-09-201,200,,-543509728.95,Azikiwe,760,Spain,114565.35,1,1,0
9891,2011,6,OWN,2,Low,1,6000, 36 months,1,debt_consolidation,6,Low,1,Bad Loan,1,7.49,A,1,28.76,4248.17,3490.21,161.01,186.61,409000009890,17-Sep-18,Indiaforensic NFS SETT 15-09-201,"6,000.00",,-543515728.95,Chidi,662,Spain,48930.80,1,1,0
9892,2011,5,RENT,1,Low,1,4000, 60 months,2,debt_consolidation,6,High,2,Good Loan,0,13.49,C,3,19.65,4686.39,4000,0,92.02,409000009891,17-Sep-18,Indiaforensic NFS SETT 15-09-201,"7,500.00",,-543523228.95,Hull,680,France,187008.45,1,1,0
9893,2011,7,RENT,1,Low,1,2800, 36 months,1,other,4,Low,1,Good Loan,0,10.99,B,2,2.79,3295.923117,2800,0,91.66,409000009892,17-Sep-18,Indiaforensic NFS SETT 15-09-201,400,,-543523628.95,Shah,604,Spain,113581.85,1,1,0
9894,2011,7,RENT,1,Low,1,18825, 60 months,2,debt_consolidation,6,High,2,Good Loan,0,16.49,D,4,18.96,25487.48247,18825,0,462.71,409000009893,17-Sep-18,Indiaforensic NFS SETT 15-09-201,"1,000.00",,-543524628.95,Morgan,764,France,124095.69,1,1,0
9895,2011,6,RENT,1,Low,1,3500, 36 months,1,debt_consolidation,6,Low,1,Bad Loan,1,8.49,A,1,7.27,1780.31,1339.94,137.21,110.48,409000009894,17-Sep-18,Indiaforensic NFS SETT 15-09-201,"5,500.00",,-543530128.95,Vagin,521,France,49054.10,1,1,0
9896,2011,6,RENT,1,Low,1,6600, 36 months,1,other,4,Low,1,Good Loan,0,7.49,A,1,2.1,7352.95,6600,0,205.28,409000009895,17-Sep-18,Indiaforensic NFS SETT 15-09-201,"5,500.00",,-543535628.95,Bruno,684,Germany,80593.49,1,1,0
9897,2011,4,MORTGAGE,3,Low,1,35000, 36 months,1,home_improvement,7,Low,1,Good Loan,0,9.99,B,2,4.04,39571.19,35000,0,1129.19,409000009896,17-Sep-18,Indiaforensic NFS SETT 15-09-201,"7,000.00",,-543542628.95,Osinachi,795,France,183044.86,1,1,0
9898,2011,2,MORTGAGE,3,Low,1,13250, 60 months,2,debt_consolidation,6,Low,1,Good Loan,0,10.59,B,2,14.3,15109.56,13250,0,285.39,409000009897,17-Sep-18,Indiaforensic NFS SETT 15-09-201,"5,000.00",,-543547628.95,Ho,678,Spain,159938.82,1,1,0
9899,2011,3,RENT,1,Low,1,3600, 36 months,1,vacation,11,Low,1,Good Loan,0,5.99,A,1,20.32,3737.85,3600,0,109.51,409000009898,17-Sep-18,Indiaforensic NFS SETT 15-09-201,700,,-543548328.95,Tsui,589,France,95483.48,1,1,0
9900,2011,0.5,RENT,1,Low,1,5000, 36 months,1,credit_card,1,Low,1,Good Loan,0,5.42,A,1,11.3,5290.02,5000,0,150.8,409000009899,17-Sep-18,Indiaforensic NFS SETT 15-09-201,500,,-543548828.95,Gordon,660,Spain,198069.71,1,1,0
9901,2011,6.05,MORTGAGE,3,Low,1,15000, 60 months,2,debt_consolidation,6,High,2,Good Loan,0,18.39,E,5,6.96,20354.3,12468.1,0,384.1,409000009900,17-Sep-18,Indiaforensic NFS SETT 15-09-201,500,,-543549328.95,Duncan,646,Germany,61793.47,1,1,0
9902,2011,1,RENT,1,Medium,2,20000, 36 months,1,debt_consolidation,6,High,2,Good Loan,0,17.99,E,5,3.61,26018.4547,20000,0,722.95,409000009901,17-Sep-18,Indiaforensic NFS SETT 15-09-201,"5,000.00",,-543554328.95,Hu,706,Germany,86383.61,1,1,0
9903,2011,10,MORTGAGE,3,Low,1,18000, 60 months,2,debt_consolidation,6,Low,1,Good Loan,0,11.49,B,2,6.18,20952.94,15317.71,0,395.78,409000009902,17-Sep-18,Indiaforensic NFS SETT 15-09-201,400,,-543554728.95,Docherty,730,France,144099.48,1,1,0
9904,2011,2,RENT,1,Low,1,12000, 36 months,1,debt_consolidation,6,Low,1,Good Loan,0,7.49,A,1,5.95,13432.8883,12000,0,373.22,409000009903,17-Sep-18,Indiaforensic NFS SETT 15-09-201,"10,000.00",,-543564728.95,Brookes,606,France,155641.46,1,1,0
9905,2011,10,MORTGAGE,3,Low,1,13500, 36 months,1,debt_consolidation,6,Low,1,Good Loan,0,9.99,B,2,6.96,15672.67163,13500,0,435.55,409000009904,17-Sep-18,Indiaforensic NFS SETT 15-09-201,200,,-543564928.95,Angelo,690,Spain,135784.94,1,1,0
9906,2011,8,MORTGAGE,3,Low,1,6000, 36 months,1,other,4,Low,1,Good Loan,0,10.99,B,2,17.06,6607.24,6000,0,196.41,409000009905,17-Sep-18,Indiaforensic NFS SETT 15-09-201,"7,000.00",,-543571928.95,Emenike,645,Germany,123982.14,1,1,0
9907,2011,5,RENT,1,Low,1,8000, 36 months,1,major_purchase,8,Low,1,Good Loan,0,10.99,B,2,14.7,9417.929693,8000,0,261.88,409000009906,17-Sep-18,Indiaforensic NFS SETT 15-09-201,200,,-543572128.95,Pugh,579,France,193130.55,1,1,0
9908,2011,0.5,MORTGAGE,3,Low,1,18000, 36 months,1,debt_consolidation,6,Low,1,Good Loan,0,9.99,B,2,8.36,18771.22,18000,0,580.73,409000009907,17-Sep-18,Indiaforensic NFS SETT 16-09-201,"8,000.00",,-543580128.95,McKenzie,481,France,145215.96,1,1,0
9909,2011,10,MORTGAGE,3,Low,1,12400, 60 months,2,debt_consolidation,6,High,2,Good Loan,0,18.39,E,5,5.21,14709.84,12400,0,317.52,409000009908,17-Sep-18,Indiaforensic NFS SETT 16-09-201,"1,000.00",,-543581128.95,Mach,492,Germany,164741.81,1,1,0
9910,2011,10,OWN,2,Low,1,3000, 36 months,1,debt_consolidation,6,Low,1,Good Loan,0,7.49,A,1,22.29,3355.253105,3000,0,93.31,409000009909,17-Sep-18,Indiaforensic NFS SETT 16-09-201,"1,000.00",,-543582128.95,Endrizzi,739,France,72168.53,1,1,0
9911,2011,10,MORTGAGE,3,Low,1,16000, 60 months,2,major_purchase,8,High,2,Good Loan,0,17.49,D,4,11.1,21283.81,13336.11,0,401.87,409000009910,17-Sep-18,Indiaforensic NFS SETT 16-09-201,"7,000.00",,-543589128.95,L?,624,France,95022.02,1,1,0
9912,2011,5,MORTGAGE,3,Low,1,35000, 36 months,1,small_business,3,Low,1,Good Loan,0,12.99,C,3,5.28,42443.06637,35000,0,1179.12,409000009911,17-Sep-18,Indiaforensic NFS SETT 16-09-201,"1,000.00",,-543590128.95,MacPherson,682,France,23766.40,1,1,0
9913,2011,5,RENT,1,Low,1,5000, 36 months,1,major_purchase,8,Low,1,Good Loan,0,9.99,B,2,15.45,5784.751569,5000,0,161.32,409000009912,17-Sep-18,Indiaforensic NFS SETT 16-09-201,400,,-543590528.95,Michael,701,Spain,119374.74,1,1,0
9914,2011,2,RENT,1,Low,1,4800, 36 months,1,house,12,High,2,Bad Loan,1,15.23,C,3,2.08,1797.13,1115.31,138.93,166.94,409000009913,17-Sep-18,Indiaforensic NFS SETT 16-09-201,"8,000.00",,-543598528.95,Chiedozie,718,France,139049.24,1,1,0
9915,2011,10,MORTGAGE,3,Low,1,25000, 60 months,2,home_improvement,7,High,2,Good Loan,0,13.49,C,3,0.21,26172.77,25000,0,575.12,409000009914,17-Sep-18,Indiaforensic NFS SETT 16-09-201,"5,000.00",,-543603528.95,Hughes,496,France,180844.81,1,1,0
9916,2011,6.05,MORTGAGE,3,Low,1,6200, 36 months,1,home_improvement,7,Low,1,Good Loan,0,10.99,B,2,18.81,7300.323528,6200,0,202.96,409000009915,17-Sep-18,Indiaforensic NFS SETT 16-09-201,"5,000.00",,-543608528.95,Taylor,543,Spain,143980.29,1,1,0
9917,2011,0.5,MORTGAGE,3,Low,1,12000, 36 months,1,debt_consolidation,6,Low,1,Good Loan,0,12.99,C,3,17.88,14362.71,12000,0,404.27,409000009916,18-Sep-18,Indiaforensic  RUPAY SETT 180918,"3,015.80",,-543611544.75,Evdokimov,616,Spain,137392.77,1,1,0
9918,2011,5,RENT,1,Low,1,8000, 60 months,2,debt_consolidation,6,High,2,Good Loan,0,16.49,D,4,18.28,11708.01,8000,0,196.64,409000009917,18-Sep-18,Indiaforensic  RUPAY SETT 180918,,37.38,-543611507.37,Davis,635,Germany,123646.57,1,1,0
9919,2011,7,RENT,1,Low,1,30000, 60 months,2,debt_consolidation,6,High,2,Good Loan,0,22.48,G,7,8.27,45833.32789,30000,0,836.78,409000009918,18-Sep-18,Indiaforensic RUPAY STL INTC1809,37.38,,-543611544.75,Ubanwa,652,Spain,158054.49,1,1,0
9920,2011,10,MORTGAGE,3,Low,1,11000, 36 months,1,debt_consolidation,6,High,2,Good Loan,0,16.49,D,4,23.24,11152.04,11000,0,389.4,409000009919,18-Sep-18,Indiaforensic NFS SETT 17-09-201,"2,000.00",,-543613544.75,Murray,688,France,105784.85,1,1,0
9921,2011,5,RENT,1,Low,1,14000, 60 months,2,credit_card,1,High,2,Bad Loan,1,20.25,F,6,20.58,14149.35,6423.87,1146.6,372.87,409000009920,18-Sep-18,Indiaforensic NFS SETT 17-09-201,100,,-543613644.75,Smith,678,France,738.88,1,1,0
9922,2011,8,MORTGAGE,3,Low,1,7750, 60 months,2,debt_consolidation,6,High,2,Bad Loan,1,16.49,D,4,22.74,6721.51,3331.3,625.83,190.49,409000009921,18-Sep-18,Indiaforensic NFS SETT 17-09-201,"9,000.00",,-543622644.75,Evseev,757,Germany,64539.64,1,1,0
9923,2011,3,RENT,1,Low,1,3600, 36 months,1,moving,10,Low,1,Good Loan,0,11.49,B,2,23.39,4271.298767,3600,0,118.7,409000009922,18-Sep-18,Indiaforensic NFS SETT 17-09-201,"2,500.00",,-543625144.75,Mitchell,667,France,79871.16,1,1,0
9924,2011,4,RENT,1,High,3,15000, 36 months,1,medical,9,Low,1,Good Loan,0,12.99,C,3,11.82,18189.42809,15000,0,505.34,409000009923,18-Sep-18,Indiaforensic NFS SETT 17-09-201,500,,-543625644.75,Ni,725,France,190776.83,1,1,0
9925,2011,10,MORTGAGE,3,Low,1,6000, 60 months,2,other,4,Low,1,Good Loan,0,7.49,A,1,15.62,6673.84,6000,0,120.2,409000009924,18-Sep-18,Indiaforensic  RUPAY SETT 180918,404.11,,-543626048.86,Palerma,632,Germany,6985.34,1,1,0
9926,2011,1,MORTGAGE,3,Low,1,12000, 60 months,2,wedding,5,High,2,Good Loan,0,15.99,D,4,12,15420.08,10039.1,0,291.76,409000009925,18-Sep-18,Indiaforensic  RUPAY SETT 180918,,172.20,-543625876.66,Yuan,694,France,85522.84,1,1,0
9927,2011,5,MORTGAGE,3,Low,1,22500, 60 months,2,small_business,3,Low,1,Good Loan,0,10.99,B,2,3.55,26394.06,22500,0,489.1,409000009926,18-Sep-18,Indiaforensic RUPAY STL INTC1809,4.2,,-543625880.86,Knight,803,France,149370.93,1,1,0
9928,2011,3,OWN,2,Low,1,6000, 36 months,1,debt_consolidation,6,Low,1,Good Loan,0,9.99,B,2,12.88,6758.1,6000,0,193.58,409000009927,18-Sep-18,Indiaforensic RUPAY STL INTC1809,,2.69,-543625878.17,Rapuokwu,814,France,188516.45,1,1,0
9929,2011,3,MORTGAGE,3,Low,1,5075, 36 months,1,debt_consolidation,6,Low,1,Good Loan,0,5.99,A,1,20.1,5259.69,5075,0,154.37,409000009928,19-Sep-18,Indiaforensic  RUPAY SETT 190918,"35,590.25",,-543661468.42,Wan,611,France,2444.29,1,1,0
9930,2011,10,RENT,1,Medium,2,35000, 60 months,2,debt_consolidation,6,High,2,Good Loan,0,13.49,C,3,6.32,42643.11,29590.72,0,805.17,409000009929,19-Sep-18,Indiaforensic RUPAY STL INTC1909,275.18,,-543661743.60,Artamonova,755,Germany,19762.88,1,1,0
9931,2011,0.5,RENT,1,Low,1,4000, 36 months,1,debt_consolidation,6,High,2,Good Loan,0,19.29,E,5,4.46,4725.97,4000,0,147.22,409000009930,19-Sep-18,Indiaforensic  RUPAY SETT 190918,,275.18,-543661468.42,Rossi,425,Germany,172646.88,1,1,0
9932,2011,5,MORTGAGE,3,Low,1,2500, 36 months,1,car,2,Low,1,Good Loan,0,6.99,A,1,19.38,2777.900259,2500,0,77.19,409000009931,19-Sep-18,Indiaforensic NFS SETT 18-09-201,500,,-543661968.42,Greco,850,France,33501.98,1,1,0
9933,2011,3,RENT,1,Low,1,6000, 36 months,1,moving,10,High,2,Good Loan,0,16.49,D,4,18.2,6740.34,5999.99,0,212.4,409000009932,19-Sep-18,Indiaforensic NFS SETT 18-09-201,"6,000.00",,-543667968.42,Fleetwood-Smith,677,Spain,114858.90,1,1,0
9934,2011,0.5,OWN,2,Low,1,4000, 36 months,1,wedding,5,Low,1,Good Loan,0,7.49,A,1,8.4,4475.272912,4000,0,124.41,409000009933,19-Sep-18,Indiaforensic NFS SETT 18-09-201,"10,000.00",,-543677968.42,Butusov,797,France,162668.33,1,1,0
9935,2011,2,RENT,1,Low,1,6000, 60 months,2,wedding,5,Low,1,Good Loan,0,10.99,B,2,8.27,6701.26,6000,0,130.43,409000009934,19-Sep-18,Indiaforensic NFS SETT 18-09-201,"1,000.00",,-543678968.42,West,692,Germany,161241.65,1,1,0
9936,2011,10,MORTGAGE,3,Low,1,20400, 60 months,2,home_improvement,7,Low,1,Good Loan,0,11.49,B,2,7.14,26227.4089,20400,0,448.55,409000009935,19-Sep-18,Indiaforensic NFS SETT 18-09-201,"5,000.00",,-543683968.42,Sanders,735,Germany,114957.22,1,1,0
9937,2011,7,MORTGAGE,3,Low,1,12000, 60 months,2,debt_consolidation,6,High,2,Good Loan,0,14.79,C,3,24.14,14026.61,12000,0,284.16,409000009936,19-Sep-18,Indiaforensic NFS SETT 18-09-201,200,,-543684168.42,Parks,609,France,18708.76,1,1,0
9938,2011,10,MORTGAGE,3,Low,1,12000, 36 months,1,home_improvement,7,Low,1,Good Loan,0,6.99,A,1,1.53,13241.79,12000,0,370.48,409000009937,19-Sep-18,Indiaforensic NFS SETT 18-09-201,"1,500.00",,-543685668.42,Edith,700,France,105305.72,1,1,0
9939,2011,4,MORTGAGE,3,Low,1,9000, 36 months,1,debt_consolidation,6,Low,1,Good Loan,0,10.59,B,2,8.36,10540.74233,9000,0,292.91,409000009938,19-Sep-18,Indiaforensic NFS SETT 18-09-201,"10,000.00",,-543695668.42,Korovin,526,Spain,58111.71,1,1,0
9940,2011,1,RENT,1,Low,1,20000, 60 months,2,debt_consolidation,6,High,2,Good Loan,0,18.79,E,5,12.58,30429.07121,20000,0,516.51,409000009939,19-Sep-18,Indiaforensic NFS SETT 18-09-201,200,,-543695868.42,Lajoie,693,Spain,135502.77,1,1,0
9941,2011,2,RENT,1,Low,1,6000, 36 months,1,debt_consolidation,6,Low,1,Good Loan,0,9.99,B,2,15.14,6962.964664,6000,0,193.58,409000009940,19-Sep-18,Indiaforensic NFS SETT 18-09-201,200,,-543696068.42,Bergamaschi,748,France,10792.42,1,1,0
9942,2011,6,RENT,1,Low,1,3000, 36 months,1,wedding,5,Low,1,Good Loan,0,11.49,B,2,3,3558.882362,3000,0,98.92,409000009941,19-Sep-18,Indiaforensic NFS SETT 18-09-201,"1,500.00",,-543697568.42,T'ien,657,Spain,123866.43,1,1,0
9943,2011,5,RENT,1,Low,1,11600, 60 months,2,debt_consolidation,6,High,2,Good Loan,0,13.49,C,3,20.69,13568.53,11600,0,266.86,409000009942,19-Sep-18,Indiaforensic NFS SETT 18-09-201,"5,000.00",,-543702568.42,Torode,739,Germany,129181.27,1,1,0
9944,2011,7,MORTGAGE,3,Low,1,6000, 36 months,1,renewable_energy,13,High,2,Good Loan,0,16.49,D,4,9.89,7642.510138,6000,0,212.4,409000009943,19-Sep-18,Indiaforensic NFS SETT 18-09-201,400,,-543702968.42,Fu,784,Spain,6847.73,1,1,0
9945,2011,10,MORTGAGE,3,Low,1,7200, 36 months,1,other,4,Low,1,Bad Loan,1,9.99,B,2,6.5,5806.88,4753.19,17.63,232.29,409000009944,19-Sep-18,Indiaforensic NFS SETT 18-09-201,300,,-543703268.42,Cameron,744,Germany,138361.48,1,1,0
9946,2011,1,RENT,1,Low,1,8000, 36 months,1,debt_consolidation,6,Low,1,Good Loan,0,9.99,B,2,24.91,9285.474913,8000,0,258.1,409000009945,19-Sep-18,Indiaforensic NFS SETT 18-09-201,400,,-543703668.42,Cattaneo,645,France,166707.22,1,1,0
9947,2011,10,MORTGAGE,3,Medium,2,10000, 36 months,1,home_improvement,7,Low,1,Bad Loan,1,10.99,B,2,14.98,9164.3,7471.32,0,327.34,409000009946,19-Sep-18,Indiaforensic  RUPAY SETT 190918,"5,563.25",,-543709231.67,James,669,France,107221.03,1,1,0
9948,2011,6,RENT,1,Medium,2,10000, 36 months,1,debt_consolidation,6,Low,1,Good Loan,0,7.49,A,1,10.72,11194.07814,10000,0,311.02,409000009947,19-Sep-18,Indiaforensic  RUPAY SETT 190918,,69.93,-543709161.74,Abramovich,615,France,73124.53,1,1,0
9949,2011,4,MORTGAGE,3,Low,1,4200, 36 months,1,moving,10,Low,1,Good Loan,0,7.49,A,1,5.07,4696.603723,4200,0,130.63,409000009948,19-Sep-18,Indiaforensic RUPAY STL INTC1909,69.93,,-543709231.67,Onwughara,724,Germany,12913.92,1,1,0
9950,2011,0.5,MORTGAGE,3,Low,1,15000, 36 months,1,debt_consolidation,6,Low,1,Good Loan,0,11.99,B,2,22.18,17759.71,15000,0,498.15,409000009949,20-Sep-18,Indiaforensic RUPAY SETT 200918,"2,505.54",,-543711737.21,Wan,850,France,44351.77,1,1,0
9951,2011,10,MORTGAGE,3,Medium,2,3525, 60 months,2,other,4,Low,1,Good Loan,0,10.99,B,2,16.74,4541.71442,3525,0,76.63,409000009950,20-Sep-18,Indiaforensic RUPAY SETT 200918,,43.74,-543711693.47,Salinas,625,Germany,96444.88,1,1,0
9952,2011,5,MORTGAGE,3,Low,1,10000, 36 months,1,major_purchase,8,Low,1,Good Loan,0,11.49,B,2,9.99,11856.97816,10000,0,329.72,409000009951,20-Sep-18,Indiaforensic RUPAY STL INTC2009,28.24,,-543711721.71,Ho,635,Spain,60739.16,1,1,0
9953,2011,0.5,OWN,2,Low,1,27000, 60 months,2,debt_consolidation,6,High,2,Good Loan,0,18.39,E,5,14.77,38684.44296,27000,0,691.37,409000009952,20-Sep-18,Indiaforensic RUPAY STL INTC2009,,0.12,-543711721.59,Cleveland,724,Germany,118570.53,1,1,0
9954,2011,10,RENT,1,Low,1,16000, 60 months,2,debt_consolidation,6,Low,1,Good Loan,0,10.99,B,2,10.76,18416.6,13641.14,0,347.8,409000009953,20-Sep-18,Indiaforensic RUPAY SETT 200918-,682.12,,-543712403.71,Burke,550,France,97057.28,1,1,0
9955,2011,0.5,RENT,1,Low,1,2600, 36 months,1,moving,10,High,2,Good Loan,0,19.29,E,5,15.67,3444.624824,2600,0,95.69,409000009954,20-Sep-18,Indiaforensic RUPAY SETT 200918-,,6.40,-543712397.31,Trentino,645,France,3449.22,1,1,0
9956,2011,10,MORTGAGE,3,Low,1,6000, 36 months,1,major_purchase,8,Low,1,Good Loan,0,5.42,A,1,6.48,6477.826392,6000,0,180.96,409000009955,20-Sep-18,Indiaforensic RUPAY STL INTC2009,6.4,,-543712403.71,Kashiwagi,714,Spain,37605.90,1,1,0
9957,2011,8,RENT,1,Low,1,29100, 36 months,1,debt_consolidation,6,High,2,Good Loan,0,15.99,D,4,22.37,36816.03545,29100,0,1022.93,409000009956,21-Sep-18,Indiaforensic RUPAY SETT 210918,"1,084.47",,-543713488.18,Nucci,520,France,117369.52,1,1,0
9958,2011,10,MORTGAGE,3,Low,1,6400, 36 months,1,other,4,High,2,Bad Loan,1,15.99,D,4,9.34,4191.41,2475.42,246.55,224.98,409000009957,21-Sep-18,Indiaforensic RUPAY SETT 210918,,269.03,-543713219.15,Oluchi,633,France,100598.98,1,1,0
9959,2011,9,MORTGAGE,3,Low,1,9800, 36 months,1,debt_consolidation,6,Low,1,Bad Loan,1,7.49,A,1,7.32,8594.46,7120.49,388.08,304.8,409000009958,21-Sep-18,Indiaforensic RUPAY STL INTC2109,10.21,,-543713229.36,Ts'ui,537,France,17802.42,1,1,0
9960,2011,4,RENT,1,Low,1,6000, 36 months,1,debt_consolidation,6,Low,1,Good Loan,0,5.99,A,1,26.34,6569.809065,6000,0,182.51,409000009959,21-Sep-18,Indiaforensic RUPAY STL INTC2109,,1.93,-543713227.43,Graham,764,Spain,91094.46,1,1,0
9961,2011,10,MORTGAGE,3,Low,1,17500, 60 months,2,home_improvement,7,High,2,Good Loan,0,16.49,D,4,1.54,25298.84826,17500,0,430.14,409000009960,21-Sep-18,Indiaforensic RUPAY SETT 210918-,303.97,,-543713531.40,Lucciano,795,Germany,120853.83,1,1,0
9962,2011,9,RENT,1,Low,1,15000, 36 months,1,debt_consolidation,6,Low,1,Good Loan,0,12.99,C,3,18.14,16807.89,15000,0,505.34,409000009961,21-Sep-18,Indiaforensic RUPAY SETT 210918-,,4.72,-543713526.68,Aldridge,573,Spain,107124.17,1,1,0
9963,2011,2,RENT,1,Low,1,8000, 36 months,1,wedding,5,Low,1,Good Loan,0,8.49,A,1,1.65,9085.453547,8000,0,252.51,409000009962,21-Sep-18,Indiaforensic RUPAY STL INTC2109,4.72,,-543713531.40,Flynn,702,Spain,59207.41,1,1,0
9964,2011,10,MORTGAGE,3,Low,1,2100, 36 months,1,other,4,Low,1,Good Loan,0,11.49,B,2,12.96,2490.817469,2100,0,69.24,409000009963,21-Sep-18,Indiaforensic NFS SETT 19-09-201,"1,500.00",,-543715031.40,Scott,740,Germany,136869.31,1,1,0
9965,2011,2,MORTGAGE,3,Low,1,6000, 36 months,1,debt_consolidation,6,High,2,Good Loan,0,15.23,C,3,18.55,6293.4,6000,0,208.67,409000009964,21-Sep-18,Indiaforensic NFS SETT 19-09-201,500,,-543715531.40,Douglas,479,France,113308.29,1,1,0
9966,2011,2,MORTGAGE,3,Low,1,24000, 60 months,2,debt_consolidation,6,High,2,Good Loan,0,13.49,C,3,14.63,32294.39152,24000,0,552.12,409000009965,21-Sep-18,Indiaforensic NFS SETT 19-09-201,"5,000.00",,-543720531.40,Shao,627,Germany,159334.93,1,1,0
9967,2011,10,MORTGAGE,3,Low,1,5000, 60 months,2,car,2,Low,1,Good Loan,0,7.49,A,1,13.59,5987.15,5000,0,100.17,409000009966,21-Sep-18,Indiaforensic NFS SETT 19-09-201,500,,-543721031.40,Ch'en,479,Spain,20393.44,1,1,0
9968,2011,10,RENT,1,Low,1,20000, 36 months,1,debt_consolidation,6,Low,1,Good Loan,0,7.49,A,1,13.71,20910.12,20000,0,622.04,409000009967,21-Sep-18,Indiaforensic NFS SETT 19-09-201,200,,-543721231.40,Pugliesi,623,France,158590.25,1,1,0
9969,2011,10,RENT,1,Medium,2,7000, 36 months,1,other,4,Low,1,Good Loan,0,9.99,B,2,15.07,8124.961895,7000,0,225.84,409000009968,21-Sep-18,Indiaforensic NFS SETT 20-09-201,"2,000.00",,-543723231.40,McGregor,512,Germany,23101.13,1,1,0
9970,2011,6.05,MORTGAGE,3,Low,1,25000, 36 months,1,credit_card,1,Low,1,Good Loan,0,10.99,B,2,15.29,27982.74,25000.01,0,818.35,409000009969,21-Sep-18,Indiaforensic NFS SETT 20-09-201,"9,000.00",,-543732231.40,Hou,609,France,112585.19,1,1,0
9971,2011,0.5,OWN,2,Low,1,4200, 36 months,1,other,4,High,2,Good Loan,0,15.62,D,4,3.2,5283.282807,4200,0,146.88,409000009970,21-Sep-18,Indiaforensic NFS SETT 20-09-201,"3,500.00",,-543735731.40,Thompson,518,France,119377.36,1,1,0
9972,2011,0.5,RENT,1,Low,1,4000, 60 months,2,debt_consolidation,6,Low,1,Bad Loan,1,11.99,B,2,24.18,3705.2,2312.34,251.66,88.96,409000009971,21-Sep-18,Indiaforensic NFS SETT 20-09-201,"10,000.00",,-543745731.40,Chou,833,France,166472.81,1,1,0
9973,2011,1,RENT,1,Low,1,35000, 36 months,1,debt_consolidation,6,Low,1,Good Loan,0,11.99,B,2,22.76,39784.09,35000,0,1162.34,409000009972,21-Sep-18,Indiaforensic NFS SETT 20-09-201,900,,-543746631.40,Ch'in,758,France,171552.02,1,1,0
9974,2011,5,RENT,1,Low,1,11200, 36 months,1,wedding,5,High,2,Bad Loan,1,16.89,D,4,8.08,3509.33,2019.44,330.37,398.7,409000009973,24-Sep-18,Indiaforensic RUPAY SETT 220918,"1,272.42",,-543747903.82,Miller,611,France,157474.10,1,1,0
9975,2011,2,RENT,1,Low,1,8000, 36 months,1,debt_consolidation,6,High,2,Good Loan,0,13.49,C,3,14.92,9764.171033,8000,0,271.45,409000009974,24-Sep-18,Indiaforensic RUPAY SETT 220918,,13.98,-543747889.84,Barker,583,France,13549.24,1,1,0
9976,2011,4,RENT,1,Low,1,6500, 36 months,1,small_business,3,High,2,Good Loan,0,17.49,D,4,7.91,8372.458065,6500,0,233.34,409000009975,24-Sep-18,Indiaforensic RUPAY STL INTC2209,13.98,,-543747903.82,Smith,610,Germany,196526.55,1,1,0
9977,2011,10,MORTGAGE,3,Low,1,1800, 36 months,1,other,4,Low,1,Good Loan,0,7.49,A,1,11.3,1890.75,1800,0,55.99,409000009976,24-Sep-18,Indiaforensic RUPAY SETT 230918,"5,732.95",,-543753636.77,Azikiwe,637,France,84419.78,1,1,0
9978,2011,6,RENT,1,Low,1,5000, 36 months,1,debt_consolidation,6,Low,1,Good Loan,0,6.99,A,1,27.86,5556.781383,5000,0,154.37,409000009977,24-Sep-18,Indiaforensic RUPAY STL INTC2309,55.93,,-543753692.70,Mancini,683,France,24991.92,1,1,0
9979,2011,6,MORTGAGE,3,Low,1,6000, 36 months,1,debt_consolidation,6,Low,1,Good Loan,0,11.99,B,2,24.06,7172.898509,6000,0,199.26,409000009978,24-Sep-18,Indiaforensic RUPAY SETT 240918,"14,688.52",,-543768381.22,P'eng,774,France,191608.97,1,1,0
9980,2011,6,MORTGAGE,3,Low,1,15000, 36 months,1,debt_consolidation,6,Low,1,Good Loan,0,11.99,B,2,9.27,17618.89,15000,0,498.15,409000009979,24-Sep-18,Indiaforensic RUPAY STL INTC2409,138.34,,-543768519.56,Diribe,677,France,2988.28,1,1,0
9981,2011,7,MORTGAGE,3,Low,1,35000, 60 months,2,other,4,High,2,Good Loan,0,13.49,C,3,20.54,47658.65698,35000,0,805.17,409000009980,24-Sep-18,Indiaforensic RUPAY SETT 230918,,55.93,-543768463.63,T'ao,741,Spain,99595.67,1,1,0
9982,2011,10,RENT,1,Low,1,14000, 36 months,1,debt_consolidation,6,Low,1,Good Loan,0,8.49,A,1,22.67,15092.85,14000,0,441.89,409000009981,24-Sep-18,Indiaforensic RUPAY SETT 240918,,138.34,-543768325.29,Burbidge,498,Germany,53445.17,1,1,0
9983,2011,3,MORTGAGE,3,Low,1,12000, 36 months,1,credit_card,1,High,2,Bad Loan,1,15.23,C,3,14.85,13218.44,9985.31,280.9,417.34,409000009982,24-Sep-18,Indiaforensic NFS SETT 21-09-201,"1,000.00",,-543769325.29,Griffin,655,Germany,115146.40,1,1,0
9984,2011,3,MORTGAGE,3,Low,1,8000, 36 months,1,small_business,3,Low,1,Good Loan,0,6.99,A,1,9.19,8047.24,8000,0,246.99,409000009983,24-Sep-18,Indiaforensic NFS SETT 21-09-201,500,,-543769825.29,Cocci,613,France,151325.24,1,1,0
9985,2011,4,RENT,1,Low,1,3200, 36 months,1,other,4,Low,1,Good Loan,0,11.99,B,2,14.68,3815.049221,3200,0,106.28,409000009984,24-Sep-18,Indiaforensic NFS SETT 21-09-201,200,,-543770025.29,Echezonachukwu,602,Germany,51695.41,1,1,0
9986,2011,2,MORTGAGE,3,Low,1,16000, 36 months,1,small_business,3,Low,1,Good Loan,0,10.99,B,2,4.53,18859.71594,16000,0,523.75,409000009985,24-Sep-18,Indiaforensic NFS SETT 21-09-201,"2,000.00",,-543772025.29,Nepean,659,France,96833.00,1,1,0
9987,2011,10,MORTGAGE,3,Low,1,9000, 36 months,1,home_improvement,7,High,2,Good Loan,0,16.49,D,4,24.78,11462.87178,9000,0,318.6,409000009986,24-Sep-18,Indiaforensic NFS SETT 21-09-201,"8,000.00",,-543780025.29,Bartlett,673,Germany,34047.54,1,1,0
9988,2011,8,RENT,1,Low,1,12000, 60 months,2,debt_consolidation,6,Low,1,Good Loan,0,11.99,B,2,9.36,14433.22,12000.01,0,266.88,409000009987,24-Sep-18,Indiaforensic NFS SETT 22-09-201,"1,000.00",,-543781025.29,Mancini,606,Spain,1914.41,1,1,0
9989,2011,10,MORTGAGE,3,Low,1,14500, 36 months,1,debt_consolidation,6,Low,1,Bad Loan,1,7.49,A,1,0,12715.41,10544.05,539.69,450.98,409000009988,24-Sep-18,Indiaforensic NFS SETT 22-09-201,500,,-543781525.29,Pirozzi,775,France,49337.84,1,1,0
9990,2011,4,RENT,1,Low,1,4500, 36 months,1,credit_card,1,Low,1,Good Loan,0,7.49,A,1,27.63,5017.214099,4500,0,139.96,409000009989,24-Sep-18,Indiaforensic NFS SETT 22-09-201,"1,000.00",,-543782525.29,McMillan,841,Spain,179436.60,1,1,0
9991,2011,1,RENT,1,Low,1,8450, 60 months,2,debt_consolidation,6,Low,1,Bad Loan,1,11.49,B,2,24.71,7608.77,6983.37,11.86,185.8,409000009990,24-Sep-18,Indiaforensic NFS SETT 22-09-201,"4,000.00",,-543786525.29,Nkemakonam,714,Germany,53667.08,1,1,0
9992,2011,6,MORTGAGE,3,Low,1,8000, 36 months,1,debt_consolidation,6,High,2,Good Loan,0,13.49,C,3,16.06,9761.525664,8000,0,271.45,409000009991,24-Sep-18,Indiaforensic NFS SETT 22-09-201,"1,500.00",,-543788025.29,Ajuluchukwu,597,France,69384.71,1,1,0
9993,2011,6,RENT,1,Low,1,4800, 36 months,1,debt_consolidation,6,Low,1,Good Loan,0,10.59,B,2,20.21,5621.286555,4800,0,156.22,409000009992,24-Sep-18,Indiaforensic NFS SETT 22-09-201,700,,-543788725.29,Chukwualuka,726,Spain,195192.40,1,1,0
9994,2011,10,MORTGAGE,3,Medium,2,9000, 36 months,1,debt_consolidation,6,Low,1,Bad Loan,1,11.49,B,2,15.36,4492.7,3082.5,339.03,296.75,409000009993,24-Sep-18,Indiaforensic NFS SETT 22-09-201,"2,000.00",,-543790725.29,Rahman,644,France,29179.52,1,1,0
9995,2011,3,RENT,1,Low,1,10000, 60 months,2,small_business,3,Low,1,Good Loan,0,12.99,C,3,11.66,12012.34,8447.31,0,227.48,409000009994,24-Sep-18,Indiaforensic NFS SETT 23-09-201,100,,-543790825.29,Wood,800,France,167773.55,1,1,0
9996,2011,10,MORTGAGE,3,Medium,2,5000, 36 months,1,wedding,5,High,2,Good Loan,0,13.49,C,3,12.96,6082.924072,5000,0,169.66,409000009995,24-Sep-18,Indiaforensic NFS SETT 23-09-201,"1,000.00",,-543791825.29,Obijiaku,771,France,96270.64,1,1,0
9997,2011,3,RENT,1,Low,1,14975, 60 months,2,debt_consolidation,6,High,2,Good Loan,0,13.49,C,3,15.71,20455.95911,14975,0,344.5,409000009996,24-Sep-18,Indiaforensic NFS SETT 23-09-201,400,,-543792225.29,Johnstone,516,France,101699.77,1,1,0
9998,2011,2,RENT,1,Medium,2,3600, 36 months,1,other,4,High,2,Good Loan,0,15.62,D,4,21.62,4528.348007,3600,0,125.9,409000009997,24-Sep-18,Indiaforensic NFS SETT 23-09-201,"4,000.00",,-543796225.29,Liu,709,France,42085.58,1,1,0
9999,2011,6.05,OWN,2,Low,1,15000, 36 months,1,other,4,High,2,Good Loan,0,18.39,E,5,14.25,19619.2948,15000,0,545.23,409000009998,25-Sep-18,Indiaforensic  RUPAY SETT 250918,"2,715.07",,-543798940.36,Sabbatini,772,Germany,92888.52,1,1,0
10000,2011,1,RENT,1,Low,1,14675, 60 months,2,debt_consolidation,6,Low,1,Bad Loan,1,11.49,B,2,23.1,2375.29,923.65,770.19,322.67,409000009999,25-Sep-18,Indiaforensic  RUPAY SETT 250918,,31.22,-543798909.14,Walker,792,France,38190.78,1,1,0
